,"""Source Port""","""Destination Port""","""NAT Source Port""","""NAT Destination Port""",Bytes,"""Bytes Sent""","""Bytes Received""",Packets,"""Elapsed Time (sec)""",pkts_sent,pkts_received
0,57222,53,54587,53,177,94,83,2,30,1,1
1,56258,3389,56258,3389,4768,1600,3168,19,17,10,9
2,6881,50321,43265,50321,238,118,120,2,1199,1,1
3,50553,3389,50553,3389,3327,1438,1889,15,17,8,7
4,50002,443,45848,443,25358,6778,18580,31,16,13,18
5,51465,443,39975,443,3961,1595,2366,21,16,12,9
6,60513,47094,45469,47094,320,140,180,6,7,3,3
7,50049,443,21285,443,7912,3269,4643,23,96,12,11
8,52244,58774,2211,58774,70,70,0,1,5,1,0
9,50627,443,16215,443,8256,1674,6582,31,75,15,16
10,43676,80,45378,80,696,378,318,12,35,7,5
11,52190,443,16680,443,7942,870,7072,22,15,10,12
12,50690,80,20479,80,4805,3639,1166,16,31,9,7
13,55597,53,45448,53,168,86,82,2,30,1,1
14,49164,443,45916,443,7292,950,6342,19,75,9,10
15,36887,443,63451,443,10922,2532,8390,27,28,13,14
16,1939,53,33288,53,210,78,132,2,30,1,1
17,50281,53,33175,53,195,102,93,2,30,1,1
18,57222,53,51448,53,177,94,83,2,30,1,1
19,56710,53,57885,53,177,94,83,2,30,1,1
20,48488,443,26104,443,12993,3240,9753,36,24,18,18
21,50691,80,62082,80,4237,3610,627,15,31,8,7
22,50693,80,54649,80,4465,3390,1075,14,30,8,6
23,1940,53,23603,53,210,78,132,2,30,1,1
24,50172,53,37056,53,211,78,133,2,30,1,1
25,38802,53,38802,53,216,90,126,2,30,1,1
26,50281,53,8038,53,195,102,93,2,30,1,1
27,50051,443,1683,443,7912,3269,4643,23,96,12,11
28,52192,443,41129,443,13948,1150,12798,29,15,14,15
29,57886,443,10717,443,33667,25477,8190,60,33,34,26
30,50289,80,7131,80,7166,1086,6080,18,87,9,9
31,58615,443,30095,443,6796,1541,5255,23,121,11,12
32,38551,53,14191,53,168,78,90,2,30,1,1
33,64787,53,29856,53,728,102,626,2,30,1,1
34,34529,443,30445,443,62652,30891,31761,158,381,67,91
35,52184,443,13267,443,13902,3253,10649,26,135,14,12
36,60377,443,34261,443,8678,2974,5704,50,123,27,23
37,59347,80,59347,80,108790,4633,104157,192,15,66,126
38,50077,443,40548,443,7976,3333,4643,23,25,12,11
39,50149,80,2917,80,11574,901,10673,20,46,11,9
40,50004,443,10108,443,8745,2603,6142,19,15,11,8
41,60411,80,48309,80,1589,941,648,11,121,6,5
42,60354,80,7611,80,644,256,388,8,124,5,3
43,60399,80,36861,80,1168,815,353,10,122,6,4
44,60348,80,15161,80,10335,1617,8718,19,124,9,10
45,60420,80,1065,80,14498,6454,8044,24,120,12,12
46,60423,443,61729,443,6849,1103,5746,23,120,12,11
47,60360,443,62556,443,5212,1101,4111,22,123,12,10
48,60363,443,28558,443,5214,1101,4113,22,123,12,10
49,9523,443,27776,443,7199,1410,5789,22,33,11,11
50,63842,45682,31353,45682,4687209,3850148,837061,4974,107,3004,1970
51,60430,443,49199,443,5696,1143,4553,23,119,12,11
52,59878,443,30562,443,3864,2812,1052,17,112,8,9
53,53179,12502,28254,12502,70,70,0,2,7,2,0
54,60414,80,46472,80,5124,3499,1625,14,121,8,6
55,60400,80,41884,80,1704,808,896,10,122,6,4
56,60407,443,49458,443,8328,1611,6717,25,121,14,11
57,60398,80,57820,80,378,192,186,7,122,4,3
58,60339,80,1887,80,35136,7862,27274,53,124,26,27
59,38641,443,31615,443,318,192,126,6,14,4,2
60,54996,53,2476,53,168,86,82,2,31,1,1
61,48066,443,56844,443,62,62,0,1,4,1,0
62,60811,40010,33835,40010,316,136,180,6,5,3,3
63,52103,80,61932,80,68083,5515,62568,90,38,40,50
64,52195,443,11275,443,13948,1150,12798,29,15,14,15
65,50000,53,16568,53,502,115,387,4,52,2,2
66,52193,443,50924,443,13948,1150,12798,29,15,14,15
67,55234,53,5157,53,177,94,83,2,29,1,1
68,50692,80,30484,80,5727,3584,2143,15,31,8,7
69,60370,80,40899,80,1243,769,474,9,123,6,3
70,65401,53,57745,53,235,102,133,2,29,1,1
71,51737,53,3505,53,231,78,153,2,30,1,1
72,50685,80,6959,80,63891,26626,37265,86,34,39,47
73,52191,443,46265,443,7882,810,7072,21,15,9,12
74,54557,80,41721,80,2091,799,1292,10,15,6,4
75,48818,443,11974,443,4167,1669,2498,23,15,12,11
76,64223,53,57211,53,199,94,105,2,30,1,1
77,49245,53,34102,53,376,126,250,2,29,1,1
78,65258,443,17337,443,6043,1568,4475,11,120,4,7
79,64399,53,50659,53,230,110,120,2,29,1,1
80,55234,53,22160,53,177,94,83,2,30,1,1
81,64593,53,56394,53,94,94,0,1,30,1,0
82,56911,53,36658,53,177,94,83,2,31,1,1
83,53977,22266,9645,22266,492,306,186,8,17,5,3
84,50148,80,57004,80,9058,868,8190,18,46,10,8
85,53178,42671,48767,42671,70,70,0,2,8,2,0
86,52181,443,64436,443,7855,815,7040,21,15,9,12
87,65004,53,23515,53,323,94,229,2,30,1,1
88,46265,443,19534,443,173828,9311,164517,245,448,118,127
89,49158,443,27828,443,14490,4227,10263,35,36,19,16
90,33067,53,47200,53,168,78,90,2,30,1,1
91,56911,53,39355,53,177,94,83,2,30,1,1
92,22767,53,22767,53,226,106,120,2,30,1,1
93,52715,443,38027,443,164840,5975,158865,179,122,61,118
94,33845,80,39303,80,424,210,214,7,27,4,3
95,61442,443,19223,443,3403,1891,1512,24,42,13,11
96,9446,443,50836,443,8672,1863,6809,22,46,11,11
97,52194,443,38386,443,12374,1090,11284,27,15,13,14
98,58306,443,59387,443,864,436,428,13,29,7,6
99,42412,443,55628,443,204,70,134,4,26,2,2
100,56710,53,52813,53,177,94,83,2,30,1,1
101,61396,443,45721,443,550484,8433,542051,541,246,99,442
102,61273,443,55960,443,19675,8597,11078,137,480,68,69
103,50016,53,14072,53,766,103,663,4,41,2,2
104,58307,443,36806,443,934,506,428,14,29,8,6
105,55182,53,36739,53,293,94,199,2,30,1,1
106,56911,53,31733,53,177,94,83,2,30,1,1
107,41631,443,38429,443,20180,2917,17263,35,124,14,21
108,38637,443,8499,443,12339,2392,9947,36,287,15,21
109,45317,53,22055,53,86,86,0,1,30,1,0
110,56704,53,2427,53,318,94,224,2,30,1,1
111,49410,53,62890,53,177,94,83,2,30,1,1
112,56504,53,45710,53,102,102,0,1,30,1,0
113,50003,443,32664,443,13812,3042,10770,29,16,15,14
114,40737,443,35009,443,44004,3909,40095,80,135,38,42
115,38082,443,14308,443,284,164,120,4,15,2,2
116,36036,443,36036,443,261234,32183,229051,326,212,153,173
117,55476,53,58894,53,232,110,122,2,30,1,1
118,49395,53,40831,53,390,111,279,4,53,2,2
119,56172,53,35826,53,253,87,166,4,30,2,2
120,56624,53,36589,53,177,94,83,2,31,1,1
121,57470,20220,32069,20220,870,330,540,12,2308,6,6
122,33856,443,15413,443,8171028,105740,8065288,6637,149,745,5892
123,59983,443,26904,443,296863,14073,282790,351,127,130,221
124,15503,63425,41497,63425,481,150,331,2,1200,1,1
125,53987,16571,20059,16571,70,70,0,1,5,1,0
126,53986,54070,39036,54070,70,70,0,1,5,1,0
127,64094,1024,62040,1024,70,70,0,1,5,1,0
128,64095,1976,59706,1976,70,70,0,1,5,1,0
129,52126,443,21159,443,1672,1149,523,13,37,8,5
130,52144,80,16896,80,366,240,126,7,33,5,2
131,50816,443,50681,443,134,60,74,3,6,2,1
132,50057,80,26007,80,1570,754,816,10,16,6,4
133,52146,80,44068,80,366,240,126,7,33,5,2
134,54139,53,64934,53,168,78,90,2,31,1,1
135,49410,53,29049,53,177,94,83,2,31,1,1
136,53994,16605,15809,16605,70,70,0,2,8,2,0
137,35242,8635,35242,8635,138,78,60,2,6,1,1
138,52148,80,27900,80,366,240,126,7,33,5,2
139,49900,443,28761,443,1820,1101,719,18,73,10,8
140,43931,53,36161,53,168,78,90,2,31,1,1
141,51048,445,0,0,70,70,0,1,0,1,0
142,51045,445,0,0,70,70,0,1,0,1,0
143,13394,23,0,0,60,60,0,1,0,1,0
144,61078,57470,0,0,62,62,0,1,0,1,0
145,55725,445,0,0,70,70,0,1,0,1,0
146,55723,445,0,0,70,70,0,1,0,1,0
147,55724,445,0,0,70,70,0,1,0,1,0
148,51125,445,0,0,66,66,0,1,0,1,0
149,51123,445,0,0,66,66,0,1,0,1,0
150,51122,445,0,0,66,66,0,1,0,1,0
151,51121,445,0,0,66,66,0,1,0,1,0
152,51126,445,0,0,66,66,0,1,0,1,0
153,51124,445,0,0,66,66,0,1,0,1,0
154,51120,445,0,0,66,66,0,1,0,1,0
155,51119,445,0,0,66,66,0,1,0,1,0
156,62776,62413,0,0,146,146,0,1,0,1,0
157,51041,445,0,0,70,70,0,1,0,1,0
158,46448,30170,0,0,159,159,0,1,0,1,0
159,10688,25174,0,0,146,146,0,1,0,1,0
160,34086,25174,0,0,62,62,0,1,0,1,0
161,64605,25174,0,0,62,62,0,1,0,1,0
162,51039,445,0,0,70,70,0,1,0,1,0
163,56688,25174,0,0,62,62,0,1,0,1,0
164,57015,42707,0,0,62,62,0,1,0,1,0
165,41213,25174,0,0,62,62,0,1,0,1,0
166,57131,8055,0,0,145,145,0,1,0,1,0
167,45855,25174,0,0,62,62,0,1,0,1,0
168,54483,25174,0,0,66,66,0,1,0,1,0
169,45855,25174,0,0,146,146,0,1,0,1,0
170,49990,62413,0,0,66,66,0,1,0,1,0
171,1582,56205,0,0,62,62,0,1,0,1,0
172,65003,57470,0,0,78,78,0,1,0,1,0
173,55718,445,0,0,70,70,0,1,0,1,0
174,55717,445,0,0,70,70,0,1,0,1,0
175,55713,445,0,0,70,70,0,1,0,1,0
176,55708,445,0,0,70,70,0,1,0,1,0
177,63486,51505,0,0,66,66,0,1,0,1,0
178,54100,37965,0,0,62,62,0,1,0,1,0
179,51034,445,0,0,70,70,0,1,0,1,0
180,51107,445,0,0,66,66,0,1,0,1,0
181,51105,445,0,0,66,66,0,1,0,1,0
182,51104,445,0,0,66,66,0,1,0,1,0
183,1815,22114,0,0,66,66,0,1,0,1,0
184,443,47582,0,0,60,60,0,1,0,1,0
185,443,47582,0,0,85,85,0,1,0,1,0
186,443,47582,0,0,100,100,0,1,0,1,0
187,59126,57470,0,0,66,66,0,1,0,1,0
188,27621,50584,0,0,62,62,0,1,0,1,0
189,52266,50038,0,0,66,66,0,1,0,1,0
190,56456,1433,0,0,60,60,0,1,0,1,0
191,43537,2323,0,0,60,60,0,1,0,1,0
192,40772,15503,0,0,74,74,0,1,0,1,0
193,50594,25174,0,0,66,66,0,1,0,1,0
194,4323,64147,0,0,62,62,0,1,0,1,0
195,55703,445,0,0,70,70,0,1,0,1,0
196,55701,445,0,0,70,70,0,1,0,1,0
197,55696,445,0,0,70,70,0,1,0,1,0
198,55698,445,0,0,70,70,0,1,0,1,0
199,34349,25174,0,0,146,146,0,1,0,1,0
200,39587,22114,0,0,62,62,0,1,0,1,0
201,42542,25174,0,0,62,62,0,1,0,1,0
202,49529,21247,0,0,62,62,0,1,0,1,0
203,64579,37965,0,0,66,66,0,1,0,1,0
204,51021,445,0,0,70,70,0,1,0,1,0
205,53771,57470,0,0,66,66,0,1,0,1,0
206,15701,37965,0,0,146,146,0,1,0,1,0
207,4529,56205,0,0,62,62,0,1,0,1,0
208,45060,37965,0,0,62,62,0,1,0,1,0
209,32554,34729,0,0,62,62,0,1,0,1,0
210,51018,445,0,0,70,70,0,1,0,1,0
211,47913,25174,0,0,146,146,0,1,0,1,0
212,55686,445,0,0,70,70,0,1,0,1,0
213,55683,445,0,0,70,70,0,1,0,1,0
214,55679,445,0,0,70,70,0,1,0,1,0
215,2206,25174,0,0,62,62,0,1,0,1,0
216,64808,62413,0,0,62,62,0,1,0,1,0
217,17244,22114,0,0,62,62,0,1,0,1,0
218,51095,445,0,0,66,66,0,1,0,1,0
219,51014,445,0,0,70,70,0,1,0,1,0
220,58925,25174,0,0,66,66,0,1,0,1,0
221,32549,37807,0,0,146,146,0,1,0,1,0
222,51012,445,0,0,70,70,0,1,0,1,0
223,52838,37965,0,0,66,66,0,1,0,1,0
224,34217,23,0,0,60,60,0,1,0,1,0
225,52459,33890,0,0,60,60,0,1,0,1,0
226,51010,445,0,0,70,70,0,1,0,1,0
227,55678,445,0,0,70,70,0,1,0,1,0
228,6666,3389,0,0,60,60,0,1,0,1,0
229,1024,21854,0,0,157,157,0,1,0,1,0
230,55677,445,0,0,70,70,0,1,0,1,0
231,25533,22114,0,0,62,62,0,1,0,1,0
232,47132,1433,0,0,60,60,0,1,0,1,0
233,56119,37965,0,0,62,62,0,1,0,1,0
234,51080,445,0,0,66,66,0,1,0,1,0
235,51076,445,0,0,66,66,0,1,0,1,0
236,51003,445,0,0,70,70,0,1,0,1,0
237,54502,34729,0,0,66,66,0,1,0,1,0
238,53626,30317,0,0,66,66,0,1,0,1,0
239,53712,25174,0,0,66,66,0,1,0,1,0
240,51001,445,0,0,70,70,0,1,0,1,0
241,33726,44847,0,0,62,62,0,1,0,1,0
242,22568,37965,0,0,66,66,0,1,0,1,0
243,443,49988,0,0,82,82,0,1,0,1,0
244,55667,445,0,0,70,70,0,1,0,1,0
245,55665,445,0,0,70,70,0,1,0,1,0
246,55660,445,0,0,70,70,0,1,0,1,0
247,55658,445,0,0,70,70,0,1,0,1,0
248,53985,30188,0,0,62,62,0,1,0,1,0
249,57613,42707,0,0,62,62,0,1,0,1,0
250,6666,6001,0,0,60,60,0,1,0,1,0
251,45941,23386,0,0,60,60,0,1,0,1,0
252,51000,445,0,0,70,70,0,1,0,1,0
253,51071,445,0,0,66,66,0,1,0,1,0
254,50999,445,0,0,70,70,0,1,0,1,0
255,50998,445,0,0,70,70,0,1,0,1,0
256,55759,5900,0,0,60,60,0,1,0,1,0
257,50995,445,0,0,70,70,0,1,0,1,0
258,50992,445,0,0,70,70,0,1,0,1,0
259,51067,445,0,0,66,66,0,1,0,1,0
260,51066,445,0,0,66,66,0,1,0,1,0
261,51065,445,0,0,66,66,0,1,0,1,0
262,51062,445,0,0,66,66,0,1,0,1,0
263,51057,445,0,0,66,66,0,1,0,1,0
264,51063,445,0,0,66,66,0,1,0,1,0
265,51059,445,0,0,66,66,0,1,0,1,0
266,55651,445,0,0,70,70,0,1,0,1,0
267,21268,62609,0,0,146,146,0,1,0,1,0
268,21268,62609,0,0,146,146,0,1,0,1,0
269,55648,445,0,0,70,70,0,1,0,1,0
270,55646,445,0,0,70,70,0,1,0,1,0
271,55644,445,0,0,70,70,0,1,0,1,0
272,50980,445,0,0,70,70,0,1,0,1,0
273,50979,445,0,0,70,70,0,1,0,1,0
274,23758,44847,0,0,62,62,0,1,0,1,0
275,50975,445,0,0,70,70,0,1,0,1,0
276,53324,44847,0,0,66,66,0,1,0,1,0
277,50970,445,0,0,70,70,0,1,0,1,0
278,50969,445,0,0,70,70,0,1,0,1,0
279,53243,57470,0,0,74,74,0,1,0,1,0
280,64776,25174,0,0,66,66,0,1,0,1,0
281,50547,22197,0,0,66,66,0,1,0,1,0
282,64298,50584,0,0,66,66,0,1,0,1,0
283,30456,36237,0,0,62,62,0,1,0,1,0
284,56816,443,16188,443,7956,1967,5989,20,15,11,9
285,52011,80,26180,80,23580,10536,13044,36,39,18,18
286,50198,3389,50198,3389,3343,1454,1889,15,16,8,7
287,56624,53,45708,53,170,87,83,2,30,1,1
288,56813,443,32005,443,8021,2001,6020,20,16,11,9
289,52007,443,2667,443,10217,8266,1951,33,39,20,13
290,64092,14447,29856,14447,66,66,0,1,5,1,0
291,64270,443,64270,443,4747,1840,2907,19,27,11,8
292,51163,443,48007,443,9466,2602,6864,41,185,20,21
293,52469,443,22069,443,29896,14149,15747,61,209,35,26
294,46898,53,46898,53,194,87,107,2,30,1,1
295,53198,443,53198,443,4591,1684,2907,19,28,11,8
296,5886,80,5886,80,138678,5557,133121,152,16,58,94
297,56815,443,53722,443,7903,1914,5989,20,15,11,9
298,52270,3708,62556,3708,316,136,180,6,6,3,3
299,52264,43015,38341,43015,70,70,0,2,7,2,0
300,62685,443,28394,443,7023,2352,4671,18,75,10,8
301,49333,443,8337,443,50226,4284,45942,76,75,31,45
302,62892,443,62892,443,4377,1470,2907,19,30,11,8
303,50487,3389,50487,3389,6312,2620,3692,25,24,12,13
304,39430,443,21846,443,506,292,214,8,50,5,3
305,45232,80,45232,80,2895,1484,1411,10,15,6,4
306,51164,443,28609,443,5040,2743,2297,34,185,18,16
307,64099,55470,50878,55470,66,66,0,1,5,1,0
308,52240,52893,2825,52893,66,66,0,1,5,1,0
309,48550,443,45303,443,778,358,420,12,43,6,6
310,47845,53,47845,53,243,94,149,2,32,1,1
311,52263,16350,50284,16350,70,70,0,2,8,2,0
312,53177,8595,28264,8595,70,70,0,2,9,2,0
313,53984,57077,2292,57077,70,70,0,1,5,1,0
314,56674,443,44964,443,237,177,60,3,5,2,1
315,34440,53,34440,53,235,90,145,2,32,1,1
316,44389,443,27883,443,3067,1817,1250,18,16,8,10
317,52265,32078,35097,32078,70,70,0,2,7,2,0
318,54996,53,39612,53,168,86,82,2,35,1,1
319,35609,443,35165,443,237,177,60,3,5,2,1
320,55727,43736,19578,43736,70,70,0,1,5,1,0
321,56911,53,21649,53,170,87,83,2,30,1,1
322,50193,3389,50193,3389,3409,1454,1955,16,16,8,8
323,49935,53,10954,53,75,75,0,1,30,1,0
324,52852,53,0,0,82,82,0,1,30,1,0
325,59226,53,59226,53,194,87,107,2,30,1,1
326,60286,443,29238,443,7576,1897,5679,23,136,13,10
327,27313,53,27313,53,194,87,107,2,31,1,1
328,55674,53,14625,53,744,89,655,2,31,1,1
329,40814,53,40814,53,213,87,126,2,31,1,1
330,53067,4040,59736,4040,115,115,0,1,31,1,0
331,56730,53,30044,53,170,87,83,2,31,1,1
332,46713,53,46713,53,217,87,130,2,31,1,1
333,32806,53,32806,53,194,87,107,2,31,1,1
334,56434,53,6758,53,701,88,613,2,31,1,1
335,51221,64767,41578,64767,330,330,0,6,1200,6,0
336,19502,53,19502,53,198,89,109,2,31,1,1
337,53151,53,29237,53,168,78,90,2,31,1,1
338,56086,443,31892,443,6817,3598,3219,32,143,15,17
339,27839,53,27839,53,213,87,126,2,31,1,1
340,22835,51221,0,0,62,62,0,1,0,1,0
341,65305,51221,0,0,66,66,0,1,0,1,0
342,23001,64147,0,0,62,62,0,1,0,1,0
343,52128,37807,0,0,62,62,0,1,0,1,0
344,23632,64147,0,0,66,66,0,1,0,1,0
345,48706,23393,0,0,60,60,0,1,0,1,0
346,64288,53,54415,53,398,103,295,4,41,2,2
347,52041,80,18599,80,2901,1407,1494,15,38,9,6
348,64087,80,46757,80,314,192,122,6,15,4,2
349,56052,53,22562,53,177,94,83,2,30,1,1
350,52150,80,40663,80,546,300,246,10,32,6,4
351,48706,23393,0,0,60,60,0,1,0,1,0
352,55641,445,0,0,70,70,0,1,0,1,0
353,55642,445,0,0,70,70,0,1,0,1,0
354,55640,445,0,0,70,70,0,1,0,1,0
355,51050,445,0,0,66,66,0,1,0,1,0
356,35207,22114,0,0,62,62,0,1,0,1,0
357,55635,445,0,0,70,70,0,1,0,1,0
358,50957,445,0,0,70,70,0,1,0,1,0
359,51432,25174,0,0,146,146,0,1,0,1,0
360,51047,445,0,0,66,66,0,1,0,1,0
361,51046,445,0,0,66,66,0,1,0,1,0
362,51045,445,0,0,66,66,0,1,0,1,0
363,17925,26467,0,0,66,66,0,1,0,1,0
364,34993,15503,0,0,62,62,0,1,0,1,0
365,8040,44847,0,0,66,66,0,1,0,1,0
366,39588,25174,0,0,66,66,0,1,0,1,0
367,51042,445,0,0,66,66,0,1,0,1,0
368,2978,48817,0,0,66,66,0,1,0,1,0
369,1536,48817,0,0,62,62,0,1,0,1,0
370,43269,50584,0,0,66,66,0,1,0,1,0
371,33453,64147,0,0,62,62,0,1,0,1,0
372,51414,22,0,0,60,60,0,1,0,1,0
373,34810,25174,0,0,62,62,0,1,0,1,0
374,50951,445,0,0,70,70,0,1,0,1,0
375,5685,35440,0,0,62,62,0,1,0,1,0
376,55633,445,0,0,70,70,0,1,0,1,0
377,51598,56079,0,0,66,66,0,1,0,1,0
378,40239,22114,0,0,146,146,0,1,0,1,0
379,443,18368,0,0,60,60,0,1,0,1,0
380,55622,445,0,0,70,70,0,1,0,1,0
381,52145,80,50375,80,366,240,126,7,32,5,2
382,50039,7000,50039,7000,3050,1659,1391,16,15,9,7
383,56717,80,40230,80,3894448,104279,3790169,4041,97,1411,2630
384,52162,443,20113,443,1461,924,537,13,31,7,6
385,52272,37105,49502,37105,316,136,180,6,6,3,3
386,56504,53,24881,53,198,102,96,2,32,1,1
387,64098,10096,50669,10096,70,70,0,1,4,1,0
388,52241,51717,19106,51717,70,70,0,1,4,1,0
389,52143,80,6472,80,366,240,126,7,32,5,2
390,50050,443,8381,443,7912,3269,4643,23,95,12,11
391,52164,443,54936,443,4187,773,3414,16,30,9,7
392,52115,443,22081,443,11551,3870,7681,29,37,16,13
393,52147,80,1117,80,366,240,126,7,32,5,2
394,52157,80,19874,80,366,240,126,7,32,5,2
395,55526,80,37218,80,78,78,0,2,8,2,0
396,52151,80,38473,80,546,300,246,10,32,6,4
397,49359,443,64650,443,63494,7222,56272,107,81,49,58
398,60512,6881,33887,6881,320,140,180,6,6,3,3
399,53982,24226,55007,24226,70,70,0,1,4,1,0
400,53985,26515,42482,26515,70,70,0,1,4,1,0
401,16965,3389,16965,3389,4085,1916,2169,21,18,12,9
402,52000,80,35679,80,3604,2064,1540,15,40,10,5
403,38717,443,31292,443,958865,18695,940170,908,16,266,642
404,56624,53,34436,53,177,94,83,2,30,1,1
405,49795,53,44891,53,263,94,169,2,30,1,1
406,50057,53,37422,53,177,94,83,2,30,1,1
407,55306,53,39881,53,177,94,83,2,30,1,1
408,52159,80,23650,80,502,310,192,9,31,6,3
409,52153,80,26645,80,366,240,126,7,32,5,2
410,55725,14704,64431,14704,70,70,0,1,5,1,0
411,50711,80,19117,80,1658,1247,411,8,15,5,3
412,58304,443,13109,443,13442,1200,12242,26,29,11,15
413,58305,443,38970,443,11659,1027,10632,25,29,11,14
414,60291,53,5136,53,78,78,0,1,30,1,0
415,56555,53,42493,53,348,94,254,2,30,1,1
416,49436,53,61599,53,718,94,624,2,30,1,1
417,64226,53,54672,53,245,94,151,2,30,1,1
418,55379,443,27244,443,13679,7277,6402,35,262,15,20
419,33825,443,41237,443,9407,2233,7174,38,96,16,22
420,19763,53,19763,53,216,82,134,2,32,1,1
421,56741,53,5499,53,370,94,276,2,30,1,1
422,51041,80,59300,80,1514,480,1034,11,15,6,5
423,56663,53,41717,53,181,94,87,2,33,1,1
424,56440,53,62063,53,212,102,110,2,30,1,1
425,49961,443,64983,443,16890,7125,9765,33,98,19,14
426,52236,15313,26526,15313,70,70,0,1,5,1,0
427,56052,53,19569,53,177,94,83,2,30,1,1
428,53971,80,16324,80,662,448,214,10,15,7,3
429,64196,53,65372,53,262,94,168,2,30,1,1
430,38330,123,58815,123,184,94,90,2,30,1,1
431,49935,53,45170,53,168,86,82,2,30,1,1
432,55639,53,27613,53,244,94,150,2,30,1,1
433,53470,53,29709,53,168,78,90,2,30,1,1
434,51986,80,28001,80,1420,888,532,11,49,7,4
435,40831,80,63406,80,1614,1300,314,10,15,5,5
436,36138,443,58693,443,50384,5218,45166,76,99,26,50
437,33151,53,41502,53,168,78,90,2,30,1,1
438,50563,53,11644,53,718,94,624,2,30,1,1
439,50480,443,25461,443,57535,3735,53800,70,122,26,44
440,57138,443,59763,443,70379,4205,66174,101,403,51,50
441,52152,80,10469,80,366,240,126,7,32,5,2
442,55724,45682,6518,45682,70,70,0,1,5,1,0
443,51999,80,34655,80,20433,10970,9463,34,42,19,15
444,51934,443,39970,443,9735,2891,6844,36,82,17,19
445,56521,53,35277,53,305,86,219,2,30,1,1
446,50056,27018,7128,27018,468,390,78,5,30,4,1
447,65078,53,19268,53,177,94,83,2,30,1,1
448,55999,443,53262,443,45632,2078,43554,58,120,22,36
449,43088,5228,50878,5228,4708,1753,2955,27,4133,12,15
450,37647,443,55661,443,697381,19797,677584,725,106,247,478
451,58424,443,8670,443,81295,4140,77155,114,117,42,72
452,52142,80,50942,80,246,120,126,5,32,3,2
453,52155,80,52769,80,366,240,126,7,32,5,2
454,65524,443,51488,443,282968,9210,273758,296,15,106,190
455,52163,443,4704,443,4187,773,3414,16,30,9,7
456,52161,443,17095,443,1461,924,537,13,31,7,6
457,53995,41985,42236,41985,70,70,0,2,7,2,0
458,51221,51413,17316,51413,460,150,310,2,1200,1,1
459,65525,443,9387,443,92247,4799,87448,107,15,43,64
460,52080,80,40918,80,27100,21684,5416,39,38,25,14
461,52158,80,31502,80,502,310,192,9,31,6,3
462,10151,11888,57602,11888,491,150,341,2,1200,1,1
463,52154,80,54882,80,366,240,126,7,32,5,2
464,49899,443,6307,443,1820,1101,719,18,72,10,8
465,53983,40500,9041,40500,70,70,0,1,4,1,0
466,49668,443,64842,443,1288,754,534,13,50,5,8
467,64093,64828,53558,64828,70,70,0,1,4,1,0
468,52237,16801,7817,16801,70,70,0,1,5,1,0
469,57242,53,53275,53,184,86,98,2,29,1,1
470,60833,443,43148,443,1157,817,340,10,26,5,5
471,32971,443,57614,443,300,180,120,4,15,2,2
472,52027,80,10157,80,9732,8170,1562,18,38,10,8
473,56172,53,12622,53,253,87,166,4,29,2,2
474,56663,53,55920,53,181,94,87,2,30,1,1
475,56773,80,16432,80,1462,703,759,8,16,5,3
476,44421,443,9990,443,2548,1565,983,20,330,11,9
477,55806,53,2252,53,200,102,98,2,30,1,1
478,17129,53,49932,53,225,78,147,2,31,1,1
479,51404,443,29692,443,9076,2650,6426,35,247,15,20
480,36503,443,18047,443,3549,899,2650,13,120,6,7
481,53660,443,62189,443,2955,864,2091,11,119,5,6
482,54401,443,33851,443,11527127,373718,11153409,12286,144,4090,8196
483,52018,80,60048,80,4988,2667,2321,15,38,10,5
484,55726,32463,19971,32463,70,70,0,1,5,1,0
485,50054,443,33481,443,7630,839,6791,20,79,9,11
486,56624,53,60055,53,328,87,241,4,52,2,2
487,56667,53,36173,53,232,94,138,2,30,1,1
488,56684,53,5087,53,194,94,100,2,30,1,1
489,65001,53,27011,53,200,78,122,2,30,1,1
490,56751,53,35800,53,177,94,83,2,30,1,1
491,52127,80,9783,80,2412,1750,662,13,36,9,4
492,12939,53,12939,53,216,82,134,2,32,1,1
493,52486,443,26318,443,57366,41661,15705,111,440,66,45
494,52238,48996,43886,48996,70,70,0,1,5,1,0
495,55848,53,3289,53,387,134,253,2,30,1,1
496,65484,53,10578,53,195,86,109,2,30,1,1
497,49695,53,29724,53,240,102,138,2,30,1,1
498,64877,53,41929,53,209,110,99,2,30,1,1
499,43516,53,56876,53,168,78,90,2,30,1,1
500,52865,443,19165,443,13139,6481,6658,36,262,16,20
501,50684,443,36548,443,6909,2495,4414,20,15,11,9
502,52013,80,47338,80,27271,12050,15221,45,38,24,21
503,51946,80,42668,80,1716,952,764,13,69,8,5
504,52160,80,10438,80,502,310,192,9,31,6,3
505,52267,55982,31620,55982,70,70,0,2,6,2,0
506,24965,53,24965,53,247,98,149,2,32,1,1
507,52266,31225,1238,31225,70,70,0,1,5,1,0
508,51930,443,10848,443,9114,2713,6401,33,82,15,18
509,38999,443,34634,443,12742,1983,10759,47,123,14,33
510,57986,80,48652,80,1056,682,374,10,15,6,4
511,49410,53,59985,53,324,87,237,4,55,2,2
512,54877,53,59244,53,199,94,105,2,30,1,1
513,49432,53,21540,53,199,94,105,2,30,1,1
514,49743,53,1715,53,210,94,116,2,30,1,1
515,49913,53,15271,53,177,94,83,2,30,1,1
516,39311,443,39728,443,12825,8114,4711,63,269,25,38
517,42046,443,15950,443,10195,2175,8020,25,187,14,11
518,44323,5228,8392,5228,7292,4509,2783,50,6392,25,25
519,55072,53,55776,53,177,94,83,2,30,1,1
520,49980,53,9358,53,168,94,74,2,31,1,1
521,55306,53,44864,53,177,94,83,2,31,1,1
522,47739,5228,19332,5228,2852,2143,709,16,121,8,8
523,6881,6881,13981,6881,150,150,0,1,1200,1,0
524,65078,53,50659,53,177,94,83,2,30,1,1
525,49980,53,26131,53,152,78,74,2,30,1,1
526,55065,53,9474,53,168,78,90,2,30,1,1
527,45151,53,40658,53,168,78,90,2,30,1,1
528,55072,53,50967,53,177,94,83,2,31,1,1
529,57470,13613,53702,13613,1577,594,983,20,1638,10,10
530,53637,443,7341,443,8473,1099,7374,20,119,9,11
531,50064,80,16215,80,186,64,122,4,25,2,2
532,50065,80,29478,80,4709,4006,703,11,25,6,5
533,58964,80,7375,80,5541,4758,783,16,16,8,8
534,57262,53,45135,53,94,94,0,1,30,1,0
535,53638,443,29587,443,2090,1100,990,17,119,9,8
536,28007,443,40494,443,31586,15587,15999,213,884,105,108
537,49964,53,64934,53,749,94,655,2,30,1,1
538,49854,443,20438,443,5578,2780,2798,14,120,7,7
539,64112,24707,56635,24707,66,66,0,2,8,2,0
540,53895,443,16317,443,375374,160846,214528,633,1412,294,339
541,56751,53,10691,53,177,94,83,2,30,1,1
542,55563,53,42353,53,177,94,83,2,30,1,1
543,55619,445,0,0,70,70,0,1,0,1,0
544,3456,11392,0,0,62,62,0,1,0,1,0
545,50942,445,0,0,70,70,0,1,0,1,0
546,50939,445,0,0,70,70,0,1,0,1,0
547,50941,445,0,0,70,70,0,1,0,1,0
548,443,34920,0,0,60,60,0,1,0,1,0
549,15774,56205,0,0,66,66,0,1,0,1,0
550,50937,445,0,0,70,70,0,1,0,1,0
551,443,14591,0,0,131,131,0,1,0,1,0
552,63421,44847,0,0,66,66,0,1,0,1,0
553,62949,37965,0,0,62,62,0,1,0,1,0
554,55517,25174,0,0,66,66,0,1,0,1,0
555,50935,445,0,0,70,70,0,1,0,1,0
556,63346,37965,0,0,66,66,0,1,0,1,0
557,42564,50584,0,0,62,62,0,1,0,1,0
558,51032,445,0,0,66,66,0,1,0,1,0
559,45652,10214,0,0,62,62,0,1,0,1,0
560,33314,44847,0,0,62,62,0,1,0,1,0
561,52470,14037,0,0,66,66,0,1,0,1,0
562,1024,35894,0,0,62,62,0,1,0,1,0
563,43704,37965,0,0,66,66,0,1,0,1,0
564,48830,5900,0,0,60,60,0,1,0,1,0
565,51024,445,0,0,66,66,0,1,0,1,0
566,55608,445,0,0,70,70,0,1,0,1,0
567,56039,50584,0,0,62,62,0,1,0,1,0
568,50928,445,0,0,70,70,0,1,0,1,0
569,59977,30188,0,0,66,66,0,1,0,1,0
570,26884,57866,0,0,74,74,0,1,0,1,0
571,61624,30317,0,0,66,66,0,1,0,1,0
572,51021,445,0,0,66,66,0,1,0,1,0
573,60141,30188,0,0,66,66,0,1,0,1,0
574,52812,25174,0,0,62,62,0,1,0,1,0
575,11643,81,0,0,60,60,0,1,0,1,0
576,52769,51221,0,0,62,62,0,1,0,1,0
577,50920,445,0,0,70,70,0,1,0,1,0
578,11056,6881,0,0,62,62,0,1,0,1,0
579,50917,445,0,0,70,70,0,1,0,1,0
580,51014,445,0,0,66,66,0,1,0,1,0
581,6666,62078,0,0,60,60,0,1,0,1,0
582,39213,25174,0,0,62,62,0,1,0,1,0
583,47063,15503,0,0,146,146,0,1,0,1,0
584,56428,30317,0,0,66,66,0,1,0,1,0
585,51007,445,0,0,66,66,0,1,0,1,0
586,24534,50584,0,0,62,62,0,1,0,1,0
587,50913,445,0,0,70,70,0,1,0,1,0
588,50912,445,0,0,70,70,0,1,0,1,0
589,42981,44847,0,0,146,146,0,1,0,1,0
590,7151,37965,0,0,66,66,0,1,0,1,0
591,60722,37965,0,0,62,62,0,1,0,1,0
592,56940,5900,0,0,60,60,0,1,0,1,0
593,65003,57470,0,0,78,78,0,1,0,1,0
594,56366,51221,0,0,66,66,0,1,0,1,0
595,3945,35440,0,0,66,66,0,1,0,1,0
596,55597,445,0,0,70,70,0,1,0,1,0
597,55595,445,0,0,70,70,0,1,0,1,0
598,55596,445,0,0,70,70,0,1,0,1,0
599,50996,445,0,0,66,66,0,1,0,1,0
600,50997,445,0,0,66,66,0,1,0,1,0
601,50998,445,0,0,66,66,0,1,0,1,0
602,50991,445,0,0,66,66,0,1,0,1,0
603,50995,445,0,0,66,66,0,1,0,1,0
604,50994,445,0,0,66,66,0,1,0,1,0
605,50993,445,0,0,66,66,0,1,0,1,0
606,50990,445,0,0,66,66,0,1,0,1,0
607,50908,445,0,0,70,70,0,1,0,1,0
608,36357,25174,0,0,62,62,0,1,0,1,0
609,64333,57470,0,0,78,78,0,1,0,1,0
610,35319,51505,0,0,62,62,0,1,0,1,0
611,56876,11392,0,0,66,66,0,1,0,1,0
612,50907,445,0,0,70,70,0,1,0,1,0
613,47141,50584,0,0,62,62,0,1,0,1,0
614,52340,22114,0,0,62,62,0,1,0,1,0
615,6889,5529,0,0,143,143,0,1,0,1,0
616,5151,50584,0,0,62,62,0,1,0,1,0
617,40988,60043,0,0,146,146,0,1,0,1,0
618,50902,445,0,0,70,70,0,1,0,1,0
619,55593,445,0,0,70,70,0,1,0,1,0
620,55592,445,0,0,70,70,0,1,0,1,0
621,55582,445,0,0,70,70,0,1,0,1,0
622,55580,445,0,0,70,70,0,1,0,1,0
623,20012,8443,0,0,60,60,0,1,0,1,0
624,50978,445,0,0,66,66,0,1,0,1,0
625,50976,445,0,0,66,66,0,1,0,1,0
626,50975,445,0,0,66,66,0,1,0,1,0
627,59610,51505,0,0,66,66,0,1,0,1,0
628,64406,25174,0,0,62,62,0,1,0,1,0
629,50506,10214,0,0,66,66,0,1,0,1,0
630,7110,25174,0,0,66,66,0,1,0,1,0
631,55575,445,0,0,70,70,0,1,0,1,0
632,443,49988,0,0,82,82,0,1,0,1,0
633,62111,35440,0,0,66,66,0,1,0,1,0
634,60799,25174,0,0,66,66,0,1,0,1,0
635,6666,5000,0,0,60,60,0,1,0,1,0
636,1116,44847,0,0,66,66,0,1,0,1,0
637,61202,35894,0,0,66,66,0,1,0,1,0
638,55569,445,0,0,70,70,0,1,0,1,0
639,55568,445,0,0,70,70,0,1,0,1,0
640,55567,445,0,0,70,70,0,1,0,1,0
641,50889,445,0,0,70,70,0,1,0,1,0
642,35744,64147,0,0,66,66,0,1,0,1,0
643,26424,27189,0,0,66,66,0,1,0,1,0
644,1038,37965,0,0,62,62,0,1,0,1,0
645,50886,445,0,0,70,70,0,1,0,1,0
646,50127,64147,0,0,62,62,0,1,0,1,0
647,61183,25174,0,0,62,62,0,1,0,1,0
648,59972,25174,0,0,62,62,0,1,0,1,0
649,55558,445,0,0,70,70,0,1,0,1,0
650,55555,445,0,0,70,70,0,1,0,1,0
651,55551,445,0,0,70,70,0,1,0,1,0
652,55043,57470,0,0,78,78,0,1,0,1,0
653,60128,22114,0,0,62,62,0,1,0,1,0
654,14263,22114,0,0,66,66,0,1,0,1,0
655,7521,20234,0,0,157,157,0,1,0,1,0
656,27153,50584,0,0,146,146,0,1,0,1,0
657,50963,445,0,0,66,66,0,1,0,1,0
658,50882,445,0,0,70,70,0,1,0,1,0
659,50880,445,0,0,70,70,0,1,0,1,0
660,10669,49756,0,0,60,60,0,1,0,1,0
661,10669,49756,0,0,60,60,0,1,0,1,0
662,10669,49756,0,0,60,60,0,1,0,1,0
663,10669,49756,0,0,60,60,0,1,0,1,0
664,10669,49756,0,0,60,60,0,1,0,1,0
665,10594,25174,0,0,146,146,0,1,0,1,0
666,50878,445,0,0,70,70,0,1,0,1,0
667,49001,48817,0,0,160,160,0,1,0,1,0
668,56432,35253,0,0,66,66,0,1,0,1,0
669,55550,445,0,0,70,70,0,1,0,1,0
670,63321,37807,0,0,66,66,0,1,0,1,0
671,55512,23718,0,0,66,66,0,1,0,1,0
672,55547,445,0,0,70,70,0,1,0,1,0
673,19875,30170,0,0,145,145,0,1,0,1,0
674,43671,17372,0,0,62,62,0,1,0,1,0
675,45941,23386,0,0,60,60,0,1,0,1,0
676,50871,445,0,0,70,70,0,1,0,1,0
677,48071,25174,0,0,62,62,0,1,0,1,0
678,50950,445,0,0,66,66,0,1,0,1,0
679,50947,445,0,0,66,66,0,1,0,1,0
680,54280,3385,0,0,60,60,0,1,0,1,0
681,47266,25174,0,0,146,146,0,1,0,1,0
682,50869,445,0,0,70,70,0,1,0,1,0
683,28875,51505,0,0,62,62,0,1,0,1,0
684,36229,62413,0,0,62,62,0,1,0,1,0
685,52225,31985,35881,31985,66,66,0,1,5,1,0
686,52234,64624,43132,64624,136,136,0,3,14,3,0
687,57575,443,57575,443,206737,25710,181027,212,180,75,137
688,57573,443,57573,443,775362,32338,743024,683,180,169,514
689,55410,53,27764,53,711,87,624,2,30,1,1
690,55059,53,53925,53,711,87,624,2,30,1,1
691,2182,53,2182,53,643,88,555,2,30,1,1
692,55613,53,34338,53,170,87,83,2,30,1,1
693,64775,443,64775,443,4559,1652,2907,19,27,11,8
694,52277,443,52277,443,1880,941,939,17,21,7,10
695,51493,80,21444,80,9524,736,8788,18,131,9,9
696,57570,443,57570,443,175212,28668,146544,186,180,69,117
697,52224,37178,41727,37178,136,136,0,3,14,3,0
698,56434,53,56434,53,243,94,149,2,32,1,1
699,52259,25011,50909,25011,70,70,0,2,8,2,0
700,55589,443,3953,443,7894,1557,6337,20,150,9,11
701,53527,443,25088,443,127391,26326,101065,179,172,76,103
702,55893,53,56779,53,711,87,624,2,30,1,1
703,55836,53,8077,53,170,87,83,2,31,1,1
704,64928,53,11072,53,762,98,664,2,30,1,1
705,56752,53,39858,53,701,88,613,2,30,1,1
706,49241,443,49241,443,31778,6075,25703,54,49,28,26
707,60443,443,1656,443,10961,4286,6675,53,320,21,32
708,52235,48910,47820,48910,136,136,0,3,14,3,0
709,53993,6881,30701,6881,70,70,0,2,8,2,0
710,52221,33166,38901,33166,66,66,0,1,5,1,0
711,56597,443,50431,443,10135129,248530,9886599,9808,64,3124,6684
712,64089,20260,49392,20260,66,66,0,1,5,1,0
713,50895,443,61149,443,130,70,60,3,5,2,1
714,64114,64126,30827,64126,66,66,0,2,8,2,0
715,59937,443,15432,443,7701,3981,3720,27,70,12,15
716,55592,443,17919,443,8049,1560,6489,19,150,9,10
717,55591,443,37425,443,7902,1565,6337,20,150,9,11
718,56811,443,16024,443,8020,2000,6020,20,15,11,9
719,49336,80,14005,80,3060,1219,1841,11,19,7,4
720,53527,5228,55667,5228,9674,1776,7898,29,3764,11,18
721,51152,443,11725,443,44048,4441,39607,97,317,43,54
722,64111,1830,17922,1830,66,66,0,2,8,2,0
723,52230,47803,46448,47803,136,136,0,3,14,3,0
724,56812,443,34534,443,8073,2053,6020,20,15,11,9
725,55590,443,56220,443,7906,1569,6337,20,150,9,11
726,52260,52142,32000,52142,70,70,0,2,8,2,0
727,55100,53,57209,53,711,87,624,2,30,1,1
728,56810,443,52495,443,8072,2052,6020,20,16,11,9
729,59895,53,59895,53,643,88,555,2,30,1,1
730,42625,443,18977,443,218298,5904,212394,220,120,63,157
731,46422,80,48489,80,1447,468,979,9,181,5,4
732,44847,18659,47289,18659,150,150,0,1,1200,1,0
733,54153,443,43773,443,5008,2097,2911,13,121,6,7
734,3376,35440,0,0,66,66,0,1,0,1,0
735,50868,445,0,0,70,70,0,1,0,1,0
736,55538,445,0,0,70,70,0,1,0,1,0
737,55532,445,0,0,70,70,0,1,0,1,0
738,55530,445,0,0,70,70,0,1,0,1,0
739,55529,445,0,0,70,70,0,1,0,1,0
740,50867,445,0,0,70,70,0,1,0,1,0
741,53243,57470,0,0,74,74,0,1,0,1,0
742,50866,445,0,0,70,70,0,1,0,1,0
743,50862,445,0,0,70,70,0,1,0,1,0
744,50861,445,0,0,70,70,0,1,0,1,0
745,2815,62413,0,0,66,66,0,1,0,1,0
746,41477,50584,0,0,66,66,0,1,0,1,0
747,59393,25174,0,0,66,66,0,1,0,1,0
748,50945,445,0,0,66,66,0,1,0,1,0
749,53089,24211,0,0,62,62,0,1,0,1,0
750,55206,22114,0,0,66,66,0,1,0,1,0
751,13406,22114,0,0,62,62,0,1,0,1,0
752,18745,64147,0,0,62,62,0,1,0,1,0
753,53189,62413,0,0,62,62,0,1,0,1,0
754,50934,445,0,0,66,66,0,1,0,1,0
755,50936,445,0,0,66,66,0,1,0,1,0
756,50938,445,0,0,66,66,0,1,0,1,0
757,50932,445,0,0,66,66,0,1,0,1,0
758,55590,53,20424,53,177,94,83,2,30,1,1
759,50929,445,0,0,66,66,0,1,0,1,0
760,50927,445,0,0,66,66,0,1,0,1,0
761,50928,445,0,0,66,66,0,1,0,1,0
762,50848,445,0,0,70,70,0,1,0,1,0
763,50847,445,0,0,70,70,0,1,0,1,0
764,443,49988,0,0,82,82,0,1,0,1,0
765,443,41237,0,0,89,89,0,1,0,1,0
766,50843,445,0,0,70,70,0,1,0,1,0
767,55523,445,0,0,70,70,0,1,0,1,0
768,50838,445,0,0,70,70,0,1,0,1,0
769,50837,445,0,0,70,70,0,1,0,1,0
770,45964,2777,0,0,60,60,0,1,0,1,0
771,55520,445,0,0,70,70,0,1,0,1,0
772,55518,445,0,0,70,70,0,1,0,1,0
773,55516,445,0,0,70,70,0,1,0,1,0
774,53275,21247,0,0,62,62,0,1,0,1,0
775,53750,25174,0,0,62,62,0,1,0,1,0
776,65288,44847,0,0,66,66,0,1,0,1,0
777,60003,36829,0,0,66,66,0,1,0,1,0
778,53667,22114,0,0,62,62,0,1,0,1,0
779,65270,3855,0,0,78,78,0,1,0,1,0
780,51827,56205,0,0,66,66,0,1,0,1,0
781,58835,17372,0,0,66,66,0,1,0,1,0
782,42674,22114,0,0,62,62,0,1,0,1,0
783,49587,35776,0,0,157,157,0,1,0,1,0
784,50826,445,0,0,70,70,0,1,0,1,0
785,12655,30627,0,0,62,62,0,1,0,1,0
786,55514,445,0,0,70,70,0,1,0,1,0
787,55515,445,0,0,70,70,0,1,0,1,0
788,55509,445,0,0,70,70,0,1,0,1,0
789,52102,443,62995,443,343074,14649,328425,390,41,159,231
790,52262,14418,18744,14418,70,70,0,2,8,2,0
791,52231,1026,54310,1026,136,136,0,3,14,3,0
792,42873,443,33511,443,3379,2111,1268,19,15,10,9
793,57441,53,7425,53,177,94,83,2,30,1,1
794,54571,443,54134,443,10546,2453,8093,28,15,16,12
795,51502,80,42285,80,1515,481,1034,11,15,6,5
796,64581,53,7849,53,514,88,426,4,42,2,2
797,34220,443,12969,443,7946,2731,5215,27,18,15,12
798,50008,53,2633,53,232,94,138,2,29,1,1
799,57470,21158,39017,21158,2182,798,1384,19,1199,10,9
800,52211,80,22459,80,8559,5109,3450,23,160,12,11
801,47159,443,53350,443,777,432,345,10,15,5,5
802,49291,443,62267,443,18607,4906,13701,47,255,20,27
803,49255,80,49255,80,8453,961,7492,18,20,9,9
804,49300,443,26110,443,8282,3240,5042,40,255,20,20
805,46452,53,46452,53,247,98,149,2,32,1,1
806,21018,53,21018,53,235,90,145,2,31,1,1
807,49913,53,61333,53,177,94,83,2,29,1,1
808,55563,53,47396,53,177,94,83,2,29,1,1
809,55135,53,55135,53,220,90,130,2,29,1,1
810,50705,80,25198,80,499,192,307,6,26,4,2
811,50697,80,65344,80,318,192,126,6,27,4,2
812,35671,443,43722,443,6824,1142,5682,24,134,13,11
813,52228,49974,17167,49974,230,136,94,4,14,3,1
814,50746,443,34629,443,8422,1676,6746,25,16,13,12
815,49486,7000,49486,7000,3370,1595,1775,16,15,9,7
816,59877,443,61626,443,9024,1533,7491,25,110,11,14
817,60526,443,60526,443,1462,863,599,15,37,9,6
818,47009,53,0,0,86,86,0,1,30,1,0
819,55067,443,5248,443,17968,12031,5937,38,63,21,17
820,65077,53,33139,53,734,86,648,2,30,1,1
821,52258,58792,14441,58792,316,136,180,6,8,3,3
822,41431,443,64563,443,190,70,120,4,15,2,2
823,49508,443,20014,443,13719,5017,8702,40,283,20,20
824,52256,41337,31273,41337,316,136,180,6,8,3,3
825,37419,443,55901,443,558,210,348,9,28,4,5
826,51817,443,24496,443,2811130,115323,2695807,3382,206,1445,1937
827,52232,35126,13178,35126,70,70,0,1,5,1,0
828,60372,53,60372,53,222,90,132,2,30,1,1
829,52220,65128,1362,65128,70,70,0,1,5,1,0
830,52223,11979,45106,11979,70,70,0,1,5,1,0
831,40189,443,26952,443,7221,2940,4281,30,23,16,14
832,55836,53,20362,53,177,94,83,2,30,1,1
833,52802,443,30052,443,4202,1924,2278,27,80,13,14
834,55613,53,57785,53,177,94,83,2,30,1,1
835,35216,123,45101,123,184,94,90,2,30,1,1
836,51221,49857,1668,49857,791,266,525,8,1200,4,4
837,65139,53,12315,53,210,102,108,2,30,1,1
838,52101,80,34628,80,55117,3792,51325,69,36,29,40
839,49474,7000,49474,7000,2990,1599,1391,15,15,8,7
840,37466,443,58228,443,13829,1724,12105,28,516,13,15
841,50700,80,14024,80,648,256,392,8,27,5,3
842,50704,80,8069,80,499,192,307,6,26,4,2
843,43744,53,43744,53,235,90,145,2,32,1,1
844,50226,80,13987,80,1746,780,966,19,102,7,12
845,50665,443,2947,443,2626,1638,988,19,83,11,8
846,56441,80,54346,80,17008,1379,15629,22,25,7,15
847,57441,53,33174,53,177,94,83,2,30,1,1
848,1935,53,17873,53,260,86,174,2,30,1,1
849,56022,53,29566,53,728,102,626,2,30,1,1
850,50265,17555,24395,17555,1488,930,558,21,1200,12,9
851,53973,50546,28275,50546,2069,1081,988,12,16,7,5
852,57913,80,64220,80,6515,1210,5305,15,23,8,7
853,49240,443,49240,443,8448,3368,5080,25,48,15,10
854,53705,443,25596,443,1579,988,591,13,44,7,6
855,64110,51617,13818,51617,66,66,0,2,7,2,0
856,52233,42673,65112,42673,136,136,0,3,14,3,0
857,56275,53,54180,53,177,94,83,2,30,1,1
858,52222,11516,7975,11516,70,70,0,1,5,1,0
859,60474,443,49891,443,5888,1175,4713,19,76,11,8
860,35922,443,6231,443,6997,1773,5224,27,17,15,12
861,50433,443,11749,443,134,60,74,3,10,2,1
862,33042,443,32323,443,130,70,60,2,14,1,1
863,59833,443,63196,443,15252,5376,9876,35,154,16,19
864,52257,6712,42589,6712,70,70,0,2,8,2,0
865,38716,443,32682,443,90273,3481,86792,96,15,31,65
866,52226,48784,61623,48784,70,70,0,1,5,1,0
867,52645,6881,55258,6881,841,535,306,10,14,5,5
868,64081,59517,43134,59517,504,382,122,8,16,6,2
869,55806,53,43969,53,200,102,98,2,32,1,1
870,50057,53,42578,53,177,94,83,2,29,1,1
871,52149,80,41444,80,1638,1324,314,10,15,5,5
872,56730,53,39267,53,177,94,83,2,29,1,1
873,52015,80,59849,80,14830,11044,3786,27,37,15,12
874,53024,123,1742,123,184,94,90,2,30,1,1
875,50366,80,48017,80,23852,1662,22190,36,15,19,17
876,56730,53,28037,53,177,94,83,2,30,1,1
877,55306,53,18601,53,177,94,83,2,29,1,1
878,55354,53,28658,53,168,94,74,2,30,1,1
879,54351,53,59901,53,168,78,90,2,29,1,1
880,55613,53,25861,53,177,94,83,2,30,1,1
881,55613,53,1186,53,177,94,83,2,30,1,1
882,1937,53,32884,53,210,78,132,2,30,1,1
883,51406,443,19359,443,5360,3775,1585,22,35,13,9
884,55354,53,24160,53,168,94,74,2,30,1,1
885,43625,53,13195,53,86,86,0,1,30,1,0
886,56730,53,28651,53,177,94,83,2,30,1,1
887,56962,53,33318,53,210,102,108,2,30,1,1
888,50171,53,22623,53,211,78,133,2,30,1,1
889,57470,8999,23972,8999,1577,594,983,20,1616,10,10
890,65062,53,47695,53,229,110,119,2,30,1,1
891,33065,443,50330,443,6746,2826,3920,19,399,11,8
892,56528,443,54144,443,8313,3597,4716,16,119,8,8
893,54391,80,1850,80,1378,808,570,13,361,7,6
894,50698,80,39680,80,318,192,126,6,27,4,2
895,60809,40010,63910,40010,316,136,180,6,6,3,3
896,52255,16087,20036,16087,70,70,0,2,8,2,0
897,55723,80,48588,80,70,70,0,1,5,1,0
898,52229,54711,46262,54711,136,136,0,3,14,3,0
899,45839,80,2983,80,1638,1324,314,10,15,5,5
900,52048,80,14488,80,41486,20844,20642,64,37,32,32
901,50961,5222,36046,5222,8318,2850,5468,54,255,27,27
902,37426,443,35217,443,7477,3305,4172,21,400,12,9
903,53176,58851,59130,58851,70,70,0,2,8,2,0
904,59949,80,40471,80,730296,15564,714732,723,57,218,505
905,41314,80,2894,80,1723,438,1285,10,136,6,4
906,43225,443,17321,443,3831584,85342,3746242,3246,110,597,2649
907,55836,53,51304,53,177,94,83,2,30,1,1
908,39097,443,24428,443,6747,2827,3920,19,399,11,8
909,46295,443,39789,443,178,118,60,2,15,1,1
910,54343,443,5667,443,7990,2701,5289,30,61,17,13
911,50707,80,44331,80,16427,3830,12597,28,25,12,16
912,52261,48208,15422,48208,70,70,0,2,8,2,0
913,49335,80,26214,80,1193,703,490,8,18,5,3
914,43227,443,35933,443,1139403,49178,1090225,1155,108,353,802
915,123,123,15177,123,184,94,90,2,30,1,1
916,1938,53,25817,53,210,78,132,2,30,1,1
917,37427,443,48428,443,10281,4850,5431,23,400,13,10
918,50584,51413,16088,51413,475,150,325,2,1200,1,1
919,51221,40624,20030,40624,594,594,0,10,1200,10,0
920,57470,8999,31471,8999,1577,594,983,20,1614,10,10
921,55387,443,54944,443,3997,1374,2623,14,136,7,7
922,19473,45556,7986,45556,469,150,319,2,1200,1,1
923,30188,12494,61043,12494,502,150,352,2,1200,1,1
924,57470,24276,41676,24276,132,132,0,3,1200,3,0
925,21133,51413,43233,51413,460,150,310,2,1200,1,1
926,55650,53,22960,53,179,94,85,2,31,1,1
927,53126,53,53126,53,247,98,149,2,32,1,1
928,58990,53,6423,53,168,78,90,2,30,1,1
929,21846,53,21846,53,247,98,149,2,33,1,1
930,5111,53,5111,53,235,90,145,2,33,1,1
931,53980,36153,43274,36153,164,70,94,2,5,1,1
932,40785,443,32724,443,646,292,354,10,41,5,5
933,46271,7700,56460,7700,1440,956,484,15,36,8,7
934,50253,53,23205,53,167,86,81,2,31,1,1
935,57449,80,1245,80,4508,2978,1530,13,15,6,7
936,52194,443,33437,443,9075,3727,5348,38,50,18,20
937,56841,53,62125,53,177,94,83,2,30,1,1
938,55494,53,4891,53,255,102,153,2,30,1,1
939,50920,445,0,0,66,66,0,1,0,1,0
940,55507,445,0,0,70,70,0,1,0,1,0
941,53305,50584,0,0,62,62,0,1,0,1,0
942,50919,445,0,0,66,66,0,1,0,1,0
943,63495,50584,0,0,66,66,0,1,0,1,0
944,50915,445,0,0,66,66,0,1,0,1,0
945,50917,445,0,0,66,66,0,1,0,1,0
946,50913,445,0,0,66,66,0,1,0,1,0
947,51114,25174,0,0,66,66,0,1,0,1,0
948,59549,50584,0,0,66,66,0,1,0,1,0
949,50822,445,0,0,70,70,0,1,0,1,0
950,59107,25174,0,0,66,66,0,1,0,1,0
951,443,49988,0,0,82,82,0,1,0,1,0
952,45941,23388,0,0,60,60,0,1,0,1,0
953,55504,445,0,0,70,70,0,1,0,1,0
954,55310,50584,0,0,66,66,0,1,0,1,0
955,50813,445,0,0,70,70,0,1,0,1,0
956,50811,445,0,0,70,70,0,1,0,1,0
957,50810,445,0,0,70,70,0,1,0,1,0
958,36992,25174,0,0,62,62,0,1,0,1,0
959,55498,445,0,0,70,70,0,1,0,1,0
960,55491,445,0,0,70,70,0,1,0,1,0
961,993,34205,0,0,66,66,0,1,0,1,0
962,50807,445,0,0,70,70,0,1,0,1,0
963,50806,445,0,0,70,70,0,1,0,1,0
964,50903,445,0,0,66,66,0,1,0,1,0
965,20112,64147,0,0,62,62,0,1,0,1,0
966,27507,25174,0,0,62,62,0,1,0,1,0
967,54539,26467,0,0,62,62,0,1,0,1,0
968,61583,64147,0,0,66,66,0,1,0,1,0
969,26420,25174,0,0,66,66,0,1,0,1,0
970,443,49988,0,0,82,82,0,1,0,1,0
971,57325,60043,0,0,62,62,0,1,0,1,0
972,50800,445,0,0,70,70,0,1,0,1,0
973,50895,445,0,0,66,66,0,1,0,1,0
974,59497,64097,0,0,66,66,0,1,0,1,0
975,56576,9000,0,0,60,60,0,1,0,1,0
976,61932,25174,0,0,66,66,0,1,0,1,0
977,22029,50584,0,0,66,66,0,1,0,1,0
978,55481,445,0,0,70,70,0,1,0,1,0
979,58460,36237,0,0,66,66,0,1,0,1,0
980,65003,57470,0,0,78,78,0,1,0,1,0
981,51348,25174,0,0,66,66,0,1,0,1,0
982,63409,50265,0,0,66,66,0,1,0,1,0
983,50893,445,0,0,66,66,0,1,0,1,0
984,443,35385,0,0,161,161,0,1,0,1,0
985,50792,445,0,0,70,70,0,1,0,1,0
986,3914,37965,0,0,62,62,0,1,0,1,0
987,3911,37965,0,0,66,66,0,1,0,1,0
988,50789,445,0,0,70,70,0,1,0,1,0
989,32722,25174,0,0,62,62,0,1,0,1,0
990,50885,445,0,0,66,66,0,1,0,1,0
991,53353,26467,0,0,62,62,0,1,0,1,0
992,35616,21247,0,0,146,146,0,1,0,1,0
993,50882,445,0,0,66,66,0,1,0,1,0
994,3093,62413,0,0,62,62,0,1,0,1,0
995,31410,25174,0,0,62,62,0,1,0,1,0
996,50785,445,0,0,70,70,0,1,0,1,0
997,50784,445,0,0,70,70,0,1,0,1,0
998,53194,35440,0,0,66,66,0,1,0,1,0
999,10652,57470,0,0,66,66,0,1,0,1,0
1000,62838,44847,0,0,66,66,0,1,0,1,0
1001,14578,50584,0,0,66,66,0,1,0,1,0
1002,6546,37965,0,0,62,62,0,1,0,1,0
1003,3667,56205,0,0,146,146,0,1,0,1,0
1004,50780,445,0,0,70,70,0,1,0,1,0
1005,40418,25174,0,0,62,62,0,1,0,1,0
1006,64333,57470,0,0,78,78,0,1,0,1,0
1007,443,49988,0,0,82,82,0,1,0,1,0
1008,55468,445,0,0,70,70,0,1,0,1,0
1009,55469,445,0,0,70,70,0,1,0,1,0
1010,55467,445,0,0,70,70,0,1,0,1,0
1011,50867,445,0,0,66,66,0,1,0,1,0
1012,50863,445,0,0,66,66,0,1,0,1,0
1013,50869,445,0,0,66,66,0,1,0,1,0
1014,50865,445,0,0,66,66,0,1,0,1,0
1015,50870,445,0,0,66,66,0,1,0,1,0
1016,50868,445,0,0,66,66,0,1,0,1,0
1017,50866,445,0,0,66,66,0,1,0,1,0
1018,50864,445,0,0,66,66,0,1,0,1,0
1019,50779,445,0,0,70,70,0,1,0,1,0
1020,58229,50584,0,0,66,66,0,1,0,1,0
1021,60058,11392,0,0,66,66,0,1,0,1,0
1022,8889,63001,0,0,60,60,0,1,0,1,0
1023,11317,61248,0,0,143,143,0,1,0,1,0
1024,52044,44847,0,0,146,146,0,1,0,1,0
1025,56075,23,0,0,60,60,0,1,0,1,0
1026,25565,47158,0,0,60,60,0,1,0,1,0
1027,50774,445,0,0,70,70,0,1,0,1,0
1028,55463,445,0,0,70,70,0,1,0,1,0
1029,55567,53,51894,53,184,80,104,2,0,1,1
1030,55458,445,0,0,70,70,0,1,0,1,0
1031,55460,445,0,0,70,70,0,1,0,1,0
1032,55452,445,0,0,70,70,0,1,0,1,0
1033,56098,64147,0,0,66,66,0,1,0,1,0
1034,53120,25174,0,0,146,146,0,1,0,1,0
1035,57607,21247,0,0,66,66,0,1,0,1,0
1036,13168,35440,0,0,62,62,0,1,0,1,0
1037,50850,445,0,0,66,66,0,1,0,1,0
1038,50848,445,0,0,66,66,0,1,0,1,0
1039,50847,445,0,0,66,66,0,1,0,1,0
1040,58463,11392,0,0,66,66,0,1,0,1,0
1041,22981,15503,0,0,62,62,0,1,0,1,0
1042,0,0,0,0,98,98,0,1,0,1,0
1043,0,0,0,0,98,98,0,1,0,1,0
1044,0,0,0,0,98,98,0,1,0,1,0
1045,0,0,0,0,244,244,0,2,0,2,0
1046,0,0,0,0,98,98,0,1,0,1,0
1047,0,0,0,0,82,82,0,1,0,1,0
1048,0,0,0,0,98,98,0,1,0,1,0
1049,0,0,0,0,98,98,0,1,0,1,0
1050,62971,44847,0,0,62,62,0,1,0,1,0
1051,443,9863,0,0,60,60,0,1,0,1,0
1052,55448,445,0,0,70,70,0,1,0,1,0
1053,48706,23393,0,0,60,60,0,1,0,1,0
1054,32983,51221,0,0,66,66,0,1,0,1,0
1055,443,48056,0,0,135,135,0,1,0,1,0
1056,55043,57470,0,0,78,78,0,1,0,1,0
1057,55443,445,0,0,70,70,0,1,0,1,0
1058,55441,445,0,0,70,70,0,1,0,1,0
1059,55440,445,0,0,70,70,0,1,0,1,0
1060,50761,445,0,0,70,70,0,1,0,1,0
1061,5223,32965,0,0,220,220,0,1,0,1,0
1062,23031,22114,0,0,146,146,0,1,0,1,0
1063,53544,21247,0,0,66,66,0,1,0,1,0
1064,58758,22114,0,0,66,66,0,1,0,1,0
1065,26821,57866,0,0,62,62,0,1,0,1,0
1066,38565,51505,0,0,62,62,0,1,0,1,0
1067,50758,445,0,0,70,70,0,1,0,1,0
1068,45064,25174,0,0,62,62,0,1,0,1,0
1069,57793,37807,0,0,66,66,0,1,0,1,0
1070,1730,37965,0,0,145,145,0,1,0,1,0
1071,54131,57866,0,0,66,66,0,1,0,1,0
1072,57779,22114,0,0,146,146,0,1,0,1,0
1073,55430,445,0,0,70,70,0,1,0,1,0
1074,55427,445,0,0,70,70,0,1,0,1,0
1075,55423,445,0,0,70,70,0,1,0,1,0
1076,50754,445,0,0,70,70,0,1,0,1,0
1077,43571,26467,0,0,62,62,0,1,0,1,0
1078,58861,26467,0,0,66,66,0,1,0,1,0
1079,50752,445,0,0,70,70,0,1,0,1,0
1080,993,58185,0,0,129,129,0,1,0,1,0
1081,50837,445,0,0,66,66,0,1,0,1,0
1082,50750,445,0,0,70,70,0,1,0,1,0
1083,10467,25174,0,0,146,146,0,1,0,1,0
1084,7105,25174,0,0,66,66,0,1,0,1,0
1085,10430,22114,0,0,146,146,0,1,0,1,0
1086,18986,44847,0,0,66,66,0,1,0,1,0
1087,63765,51221,0,0,62,62,0,1,0,1,0
1088,39393,22114,0,0,62,62,0,1,0,1,0
1089,443,45788,0,0,332,332,0,1,0,1,0
1090,61637,25174,0,0,66,66,0,1,0,1,0
1091,55422,445,0,0,70,70,0,1,0,1,0
1092,64431,53,52524,53,170,87,83,2,31,1,1
1093,40932,8434,40932,8434,156,156,0,3,8,3,0
1094,49564,443,50036,443,180388,3938,176450,145,161,20,125
1095,64715,53,13561,53,770,102,668,2,30,1,1
1096,53276,80,53276,80,42664,1998,40666,53,27,20,33
1097,36712,53,0,0,138,69,69,2,30,1,1
1098,57171,3389,57171,3389,3428,1714,1714,16,33,8,8
1099,26249,7000,26249,7000,2269,815,1454,14,16,7,7
1100,49484,7000,49484,7000,2958,1567,1391,15,15,8,7
1101,51432,80,51432,80,42247,4067,38180,58,25,23,35
1102,64113,22211,60375,22211,312,132,180,6,7,3,3
1103,52274,443,52274,443,6679,2408,4271,23,20,10,13
1104,61443,443,44561,443,7832,1143,6689,19,26,9,10
1105,56807,443,49269,443,8020,2000,6020,20,16,11,9
1106,45315,80,28283,80,6087687,127446,5960241,5920,28,1981,3939
1107,62333,443,8530,443,4019,2219,1800,33,186,17,16
1108,38400,53,0,0,82,82,0,1,30,1,0
1109,56659,53,59706,53,711,87,624,2,30,1,1
1110,63738,443,63738,443,4349,1442,2907,19,27,11,8
1111,57424,53,35431,53,711,87,624,2,30,1,1
1112,56809,443,9000,443,7929,1909,6020,20,15,11,9
1113,56808,443,31717,443,7981,1961,6020,20,15,11,9
1114,49483,7000,49483,7000,755531,16955,738576,785,16,265,520
1115,8416,8416,61571,8416,66,66,0,1,30,1,0
1116,56838,53,49360,53,170,87,83,2,30,1,1
1117,57436,53,43639,53,733,85,648,2,30,1,1
1118,52246,52840,54967,52840,258,70,188,4,9,2,2
1119,56343,53,26546,53,170,87,83,2,30,1,1
1120,8415,8415,47085,8415,66,66,0,1,30,1,0
1121,52025,80,59666,80,87927,9680,78247,101,37,40,61
1122,52280,443,52280,443,1615,941,674,15,20,7,8
1123,17052,53,17052,53,235,90,145,2,32,1,1
1124,56275,53,11893,53,170,87,83,2,30,1,1
1125,41774,53,0,0,82,82,0,1,30,1,0
1126,8414,8414,6179,8414,66,66,0,1,30,1,0
1127,50190,53,51481,53,754,94,660,2,30,1,1
1128,55650,53,47564,53,174,89,85,2,30,1,1
1129,55797,53,58319,53,170,87,83,2,31,1,1
1130,50972,3544,45034,3544,258,107,151,2,31,1,1
1131,51443,53,51443,53,217,87,130,2,31,1,1
1132,55325,53,64305,53,711,87,624,2,31,1,1
1133,56663,53,34654,53,178,91,87,2,31,1,1
1134,56882,53,4292,53,87,87,0,2,61,2,0
1135,6881,64422,29110,64422,219,111,108,2,1201,1,1
1136,65284,53,18214,53,758,96,662,2,31,1,1
1137,26458,44847,0,0,146,146,0,1,0,1,0
1138,55420,445,0,0,70,70,0,1,0,1,0
1139,23383,64147,0,0,62,62,0,1,0,1,0
1140,50415,64147,0,0,66,66,0,1,0,1,0
1141,50743,445,0,0,70,70,0,1,0,1,0
1142,26906,22114,0,0,62,62,0,1,0,1,0
1143,65507,53,7082,53,229,102,127,2,30,1,1
1144,50822,443,34134,443,89322,8569,80753,102,316,31,71
1145,53197,80,29002,80,748,459,289,8,254,5,3
1146,53195,443,44058,443,2016,1160,856,17,46,9,8
1147,50183,443,52770,443,6348,1071,5277,18,42,10,8
1148,56841,53,54383,53,177,94,83,2,29,1,1
1149,50253,53,52044,53,167,86,81,2,29,1,1
1150,56838,53,18546,53,177,94,83,2,29,1,1
1151,64431,53,6973,53,177,94,83,2,30,1,1
1152,39636,80,39636,80,4774,553,4221,13,20,6,7
1153,62069,443,28586,443,38455,5252,33203,71,60,41,30
1154,51263,443,47905,443,143597,6963,136634,206,439,103,103
1155,55650,53,39411,53,179,94,85,2,29,1,1
1156,38280,80,34023,80,748,459,289,8,254,5,3
1157,50170,53,38281,53,260,86,174,2,29,1,1
1158,56755,443,63082,443,1327,918,409,10,26,6,4
1159,42441,123,34753,123,184,94,90,2,30,1,1
1160,50744,443,51827,443,6811,1923,4888,21,15,11,10
1161,56838,53,39774,53,177,94,83,2,30,1,1
1162,55590,53,49633,53,177,94,83,2,29,1,1
1163,50078,53,55714,53,177,94,83,2,29,1,1
1164,60017,443,62960,443,5291,2624,2667,28,145,15,13
1165,48783,53,0,0,86,86,0,1,30,1,0
1166,56285,443,32543,443,185763,7360,178403,201,120,68,133
1167,37786,443,52361,443,5544,2626,2918,28,145,15,13
1168,40074,443,9837,443,412322,17503,394819,466,140,167,299
1169,64431,53,36891,53,177,94,83,2,30,1,1
1170,51982,80,16574,80,2776,2091,685,9,47,5,4
1171,57038,53,18909,53,194,102,92,2,33,1,1
1172,45315,443,19700,443,56118,3429,52689,77,26,35,42
1173,50187,443,52959,443,6363,1073,5290,18,38,10,8
1174,50186,443,57350,443,6363,1073,5290,18,38,10,8
1175,61361,443,58250,443,7653,1226,6427,24,18,14,10
1176,52053,80,43263,80,27839,14036,13803,46,36,24,22
1177,56092,53,34391,53,177,94,83,2,30,1,1
1178,55594,53,43491,53,167,86,81,2,30,1,1
1179,56343,53,46504,53,177,94,83,2,30,1,1
1180,51684,80,23150,80,1515,481,1034,11,15,6,5
1181,55059,443,19056,443,32852,17447,15405,61,64,32,29
1182,50188,443,57063,443,6357,1079,5278,18,32,10,8
1183,50185,443,5992,443,6350,1071,5279,18,42,10,8
1184,50184,443,37537,443,6349,1071,5278,18,42,10,8
1185,35519,80,60080,80,841,715,126,5,15,3,2
1186,46587,443,46587,443,30701,1538,29163,40,16,14,26
1187,58589,80,4699,80,1360,900,460,10,515,6,4
1188,36535,443,34984,443,3319,2176,1143,21,15,11,10
1189,61362,443,23026,443,7653,1226,6427,24,18,14,10
1190,42117,443,44867,443,9999,4008,5991,33,345,18,15
1191,61364,443,17656,443,7653,1226,6427,24,18,14,10
1192,53168,23074,22420,23074,958,454,504,14,21,8,6
1193,56092,53,54654,53,177,94,83,2,30,1,1
1194,55915,53,47313,53,86,86,0,1,30,1,0
1195,55226,443,25011,443,711879,19394,692485,724,98,238,486
1196,65330,53,32414,53,733,94,639,2,30,1,1
1197,56343,53,54537,53,177,94,83,2,30,1,1
1198,55867,53,45353,53,178,94,84,2,30,1,1
1199,55963,53,19959,53,316,94,222,2,30,1,1
1200,57038,53,31637,53,194,102,92,2,30,1,1
1201,65520,53,2299,53,379,94,285,2,30,1,1
1202,64439,53,36419,53,359,134,225,2,30,1,1
1203,50698,5900,50698,5900,130,66,64,2,5,1,1
1204,8204,53,48850,53,86,86,0,1,30,1,0
1205,60376,443,40016,443,6608,1843,4765,44,120,23,21
1206,52101,443,56883,443,5706850,104758,5602092,5170,41,1379,3791
1207,60407,443,48240,443,308771,8699,300072,322,30,112,210
1208,56757,443,47194,443,6205,986,5219,16,25,10,6
1209,44250,443,49251,443,3374,2106,1268,19,15,10,9
1210,33119,80,62481,80,1638,1324,314,10,14,5,5
1211,32895,443,18670,443,76969,3534,73435,97,34,40,57
1212,53169,44707,23330,44707,1078,518,560,16,21,9,7
1213,53975,40978,50066,40978,1946,1019,927,10,15,6,4
1214,51120,587,51120,587,320,128,192,6,6,3,3
1215,43129,443,48108,443,4579,580,3999,13,22,5,8
1216,64996,53,37849,53,547,91,456,4,35,2,2
1217,52609,18081,52609,18081,66,66,0,1,5,1,0
1218,49250,80,27382,80,1623,629,994,8,75,5,3
1219,51324,465,51324,465,320,128,192,6,5,3,3
1220,50406,443,46416,443,6470,897,5573,24,55,9,15
1221,49485,7080,49485,7080,2960,432,2528,11,15,6,5
1222,50182,443,53780,443,6349,1071,5278,18,42,10,8
1223,52195,443,42007,443,3470,1776,1694,20,48,10,10
1224,55729,63805,38910,63805,70,70,0,2,8,2,0
1225,50181,443,22681,443,6350,1071,5279,18,42,10,8
1226,56407,53,58288,53,216,102,114,2,29,1,1
1227,33539,443,27903,443,3244,2042,1202,17,16,9,8
1228,56275,53,62167,53,177,94,83,2,29,1,1
1229,58174,443,55907,443,11141,2777,8364,33,58,14,19
1230,50078,53,19314,53,185,102,83,2,29,1,1
1231,55329,443,60850,443,18284,2468,15816,42,26,22,20
1232,49778,53,15143,53,255,102,153,2,29,1,1
1233,64067,53,52701,53,329,94,235,2,29,1,1
1234,59343,80,59343,80,32527,13068,19459,56,15,21,35
1235,49674,53,9150,53,211,102,109,2,29,1,1
1236,56343,53,52506,53,177,94,83,2,29,1,1
1237,61363,443,19587,443,7653,1226,6427,24,18,14,10
1238,61360,443,42103,443,7653,1226,6427,24,18,14,10
1239,26900,27017,38585,27017,6466,3520,2946,38,46,21,17
1240,49458,53,15275,53,280,94,186,2,30,1,1
1241,55745,443,5170,443,11503,3691,7812,30,240,14,16
1242,49364,53,17404,53,307,307,0,4,60,4,0
1243,59847,443,26253,443,11950,1590,10360,33,90,16,17
1244,55836,53,33356,53,177,94,83,2,30,1,1
1245,60590,443,17721,443,41114,1554,39560,49,120,18,31
1246,52100,80,3260,80,30068,3203,26865,43,35,19,24
1247,55732,45682,36442,45682,70,70,0,2,8,2,0
1248,49201,80,60094,80,2986,825,2161,10,135,6,4
1249,56492,53,4383,53,212,102,110,2,30,1,1
1250,34750,80,47643,80,111678,5254,106424,150,240,71,79
1251,50180,443,51713,443,6349,1071,5278,18,42,10,8
1252,55542,443,51637,443,58975,3359,55616,78,26,34,44
1253,56905,80,13949,80,78,78,0,2,8,2,0
1254,55731,36432,38455,36432,70,70,0,2,8,2,0
1255,37335,443,14228,443,130,70,60,3,5,2,1
1256,54104,443,3216,443,190,70,120,4,15,2,2
1257,56838,53,31421,53,327,87,240,4,50,2,2
1258,64709,53,11434,53,821,102,719,2,30,1,1
1259,55154,443,34870,443,2251,1098,1153,25,120,12,13
1260,50179,443,33699,443,5419,1080,4339,17,42,10,7
1261,62232,80,47630,80,1511,517,994,8,15,5,3
1262,62918,993,34205,993,8324,3635,4689,76,53,35,41
1263,9521,443,4635,443,7231,1442,5789,21,30,10,11
1264,52107,80,35011,80,9902,8772,1130,18,35,10,8
1265,55594,53,22728,53,167,86,81,2,30,1,1
1266,55066,443,25317,443,12715,3716,8999,28,62,16,12
1267,56515,53,36823,53,177,94,83,2,30,1,1
1268,49988,443,49988,443,2123,1050,1073,23,120,11,12
1269,55420,53,38783,53,177,94,83,2,30,1,1
1270,55053,53,47870,53,216,102,114,2,30,1,1
1271,55867,53,60176,53,178,94,84,2,31,1,1
1272,50641,443,27533,443,1473,890,583,13,140,7,6
1273,43199,5228,42030,5228,10588,2455,8133,46,5724,19,27
1274,56431,53,28557,53,177,94,83,2,31,1,1
1275,56586,53,32780,53,177,94,83,2,31,1,1
1276,64796,53,3205,53,184,94,90,2,31,1,1
1277,64431,53,35945,53,177,94,83,2,31,1,1
1278,64124,443,56676,443,1411,852,559,13,25,7,6
1279,55869,53,8327,53,196,102,94,2,31,1,1
1280,53251,53,53251,53,247,98,149,2,34,1,1
1281,31994,53,31994,53,244,98,146,2,33,1,1
1282,2099,53,2099,53,217,82,135,2,33,1,1
1283,49857,53,15096,53,173,94,79,2,30,1,1
1284,57840,53,57840,53,183,82,101,2,30,1,1
1285,55869,53,64090,53,196,102,94,2,30,1,1
1286,49396,53,60623,53,216,102,114,2,30,1,1
1287,55732,53,29178,53,177,94,83,2,30,1,1
1288,55797,53,36305,53,177,94,83,2,31,1,1
1289,34920,53,40562,53,168,78,90,2,31,1,1
1290,65289,53,7871,53,179,94,85,2,31,1,1
1291,56906,53,55216,53,167,86,81,2,31,1,1
1292,50741,445,0,0,70,70,0,1,0,1,0
1293,50821,445,0,0,66,66,0,1,0,1,0
1294,50818,445,0,0,66,66,0,1,0,1,0
1295,50740,445,0,0,70,70,0,1,0,1,0
1296,17408,8497,0,0,148,148,0,1,0,1,0
1297,57015,25174,0,0,66,66,0,1,0,1,0
1298,50739,445,0,0,70,70,0,1,0,1,0
1299,50738,445,0,0,70,70,0,1,0,1,0
1300,50735,445,0,0,70,70,0,1,0,1,0
1301,50732,445,0,0,70,70,0,1,0,1,0
1302,17002,22114,0,0,62,62,0,1,0,1,0
1303,63677,15503,0,0,66,66,0,1,0,1,0
1304,63508,62413,0,0,66,66,0,1,0,1,0
1305,55409,445,0,0,70,70,0,1,0,1,0
1306,55408,445,0,0,70,70,0,1,0,1,0
1307,55404,445,0,0,70,70,0,1,0,1,0
1308,55402,445,0,0,70,70,0,1,0,1,0
1309,10833,23,0,0,60,60,0,1,0,1,0
1310,50816,445,0,0,66,66,0,1,0,1,0
1311,56679,51505,0,0,62,62,0,1,0,1,0
1312,12645,22114,0,0,146,146,0,1,0,1,0
1313,50720,445,0,0,70,70,0,1,0,1,0
1314,50719,445,0,0,70,70,0,1,0,1,0
1315,18771,35440,0,0,62,62,0,1,0,1,0
1316,50717,445,0,0,70,70,0,1,0,1,0
1317,3976,25174,0,0,62,62,0,1,0,1,0
1318,50809,445,0,0,66,66,0,1,0,1,0
1319,50799,445,0,0,66,66,0,1,0,1,0
1320,50807,445,0,0,66,66,0,1,0,1,0
1321,50800,445,0,0,66,66,0,1,0,1,0
1322,50803,445,0,0,66,66,0,1,0,1,0
1323,50808,445,0,0,66,66,0,1,0,1,0
1324,50801,445,0,0,66,66,0,1,0,1,0
1325,50709,445,0,0,70,70,0,1,0,1,0
1326,50710,445,0,0,70,70,0,1,0,1,0
1327,68,67,0,0,346,346,0,1,0,1,0
1328,57297,51221,0,0,66,66,0,1,0,1,0
1329,10874,25174,0,0,62,62,0,1,0,1,0
1330,55395,445,0,0,70,70,0,1,0,1,0
1331,55392,445,0,0,70,70,0,1,0,1,0
1332,55389,445,0,0,70,70,0,1,0,1,0
1333,55388,445,0,0,70,70,0,1,0,1,0
1334,38959,25174,0,0,62,62,0,1,0,1,0
1335,50698,445,0,0,70,70,0,1,0,1,0
1336,1030,35776,0,0,139,139,0,1,0,1,0
1337,62952,35440,0,0,66,66,0,1,0,1,0
1338,55386,445,0,0,70,70,0,1,0,1,0
1339,55385,445,0,0,70,70,0,1,0,1,0
1340,55384,445,0,0,70,70,0,1,0,1,0
1341,50793,445,0,0,66,66,0,1,0,1,0
1342,55379,445,0,0,70,70,0,1,0,1,0
1343,14263,22114,0,0,62,62,0,1,0,1,0
1344,50790,445,0,0,66,66,0,1,0,1,0
1345,17146,57470,0,0,62,62,0,1,0,1,0
1346,1582,56205,0,0,62,62,0,1,0,1,0
1347,50789,445,0,0,66,66,0,1,0,1,0
1348,80,13987,0,0,66,66,0,1,0,1,0
1349,50787,445,0,0,66,66,0,1,0,1,0
1350,50694,445,0,0,70,70,0,1,0,1,0
1351,50786,445,0,0,66,66,0,1,0,1,0
1352,29719,22114,0,0,146,146,0,1,0,1,0
1353,20457,51185,0,0,72,72,0,1,0,1,0
1354,38852,37965,0,0,62,62,0,1,0,1,0
1355,50683,445,0,0,70,70,0,1,0,1,0
1356,50682,445,0,0,70,70,0,1,0,1,0
1357,50684,445,0,0,70,70,0,1,0,1,0
1358,50681,445,0,0,70,70,0,1,0,1,0
1359,55374,445,0,0,70,70,0,1,0,1,0
1360,50677,445,0,0,70,70,0,1,0,1,0
1361,60714,50584,0,0,66,66,0,1,0,1,0
1362,55370,445,0,0,70,70,0,1,0,1,0
1363,55363,445,0,0,70,70,0,1,0,1,0
1364,41213,25174,0,0,62,62,0,1,0,1,0
1365,28579,64147,0,0,62,62,0,1,0,1,0
1366,63988,22114,0,0,66,66,0,1,0,1,0
1367,57643,28189,0,0,60,60,0,1,0,1,0
1368,62080,54532,0,0,60,60,0,1,0,1,0
1369,50775,445,0,0,66,66,0,1,0,1,0
1370,48706,23393,0,0,60,60,0,1,0,1,0
1371,5610,37965,0,0,66,66,0,1,0,1,0
1372,15635,41182,0,0,66,66,0,1,0,1,0
1373,27419,23,0,0,60,60,0,1,0,1,0
1374,59088,57470,0,0,62,62,0,1,0,1,0
1375,59126,57470,0,0,66,66,0,1,0,1,0
1376,60193,53,20927,53,214,85,129,2,0,1,1
1377,54025,53,41690,53,578,286,292,9,0,5,4
1378,50672,445,0,0,70,70,0,1,0,1,0
1379,6796,50584,0,0,62,62,0,1,0,1,0
1380,45013,50584,0,0,62,62,0,1,0,1,0
1381,46760,50584,0,0,146,146,0,1,0,1,0
1382,25565,2216,0,0,60,60,0,1,0,1,0
1383,33912,25174,0,0,62,62,0,1,0,1,0
1384,993,49276,0,0,129,129,0,1,0,1,0
1385,50767,445,0,0,66,66,0,1,0,1,0
1386,29576,37807,0,0,66,66,0,1,0,1,0
1387,55351,445,0,0,70,70,0,1,0,1,0
1388,50594,25174,0,0,66,66,0,1,0,1,0
1389,6712,123,0,0,90,90,0,1,0,1,0
1390,61288,23,0,0,60,60,0,1,0,1,0
1391,443,35385,0,0,161,161,0,1,0,1,0
1392,50664,445,0,0,70,70,0,1,0,1,0
1393,27621,50584,0,0,62,62,0,1,0,1,0
1394,50661,445,0,0,70,70,0,1,0,1,0
1395,50764,445,0,0,66,66,0,1,0,1,0
1396,40394,67,0,0,60,60,0,1,0,1,0
1397,58593,57470,0,0,62,62,0,1,0,1,0
1398,50756,445,0,0,66,66,0,1,0,1,0
1399,50657,445,0,0,70,70,0,1,0,1,0
1400,50656,445,0,0,70,70,0,1,0,1,0
1401,50749,445,0,0,66,66,0,1,0,1,0
1402,50652,445,0,0,70,70,0,1,0,1,0
1403,28139,22114,0,0,62,62,0,1,0,1,0
1404,58440,22114,0,0,146,146,0,1,0,1,0
1405,5683,44847,0,0,66,66,0,1,0,1,0
1406,54051,28793,0,0,66,66,0,1,0,1,0
1407,64333,57470,0,0,78,78,0,1,0,1,0
1408,50650,445,0,0,70,70,0,1,0,1,0
1409,55341,445,0,0,70,70,0,1,0,1,0
1410,55340,445,0,0,70,70,0,1,0,1,0
1411,55339,445,0,0,70,70,0,1,0,1,0
1412,50738,445,0,0,66,66,0,1,0,1,0
1413,50735,445,0,0,66,66,0,1,0,1,0
1414,50741,445,0,0,66,66,0,1,0,1,0
1415,50742,445,0,0,66,66,0,1,0,1,0
1416,50737,445,0,0,66,66,0,1,0,1,0
1417,50740,445,0,0,66,66,0,1,0,1,0
1418,50736,445,0,0,66,66,0,1,0,1,0
1419,50734,445,0,0,66,66,0,1,0,1,0
1420,0,0,0,0,60,60,0,1,0,1,0
1421,0,0,0,0,98,98,0,1,0,1,0
1422,0,0,0,0,60,60,0,1,0,1,0
1423,0,0,0,0,60,60,0,1,0,1,0
1424,11775,25174,0,0,62,62,0,1,0,1,0
1425,64150,22114,0,0,66,66,0,1,0,1,0
1426,37959,3855,0,0,72,72,0,1,0,1,0
1427,51146,23117,0,0,66,66,0,1,0,1,0
1428,50646,445,0,0,70,70,0,1,0,1,0
1429,55043,57470,0,0,78,78,0,1,0,1,0
1430,14360,64147,0,0,62,62,0,1,0,1,0
1431,55427,64147,0,0,66,66,0,1,0,1,0
1432,55338,445,0,0,70,70,0,1,0,1,0
1433,55335,445,0,0,70,70,0,1,0,1,0
1434,55333,445,0,0,70,70,0,1,0,1,0
1435,55321,445,0,0,70,70,0,1,0,1,0
1436,50721,445,0,0,66,66,0,1,0,1,0
1437,50720,445,0,0,66,66,0,1,0,1,0
1438,50719,445,0,0,66,66,0,1,0,1,0
1439,57546,25174,0,0,66,66,0,1,0,1,0
1440,54502,34729,0,0,66,66,0,1,0,1,0
1441,32554,34729,0,0,62,62,0,1,0,1,0
1442,53626,30317,0,0,66,66,0,1,0,1,0
1443,7539,30317,0,0,62,62,0,1,0,1,0
1444,63640,57866,0,0,66,66,0,1,0,1,0
1445,50633,445,0,0,70,70,0,1,0,1,0
1446,55319,445,0,0,70,70,0,1,0,1,0
1447,58836,51505,0,0,66,66,0,1,0,1,0
1448,44710,25174,0,0,62,62,0,1,0,1,0
1449,55317,445,0,0,70,70,0,1,0,1,0
1450,55314,445,0,0,70,70,0,1,0,1,0
1451,55308,445,0,0,70,70,0,1,0,1,0
1452,50052,65008,0,0,60,60,0,1,0,1,0
1453,50630,445,0,0,70,70,0,1,0,1,0
1454,53260,36237,0,0,62,62,0,1,0,1,0
1455,53324,44847,0,0,66,66,0,1,0,1,0
1456,52564,15503,0,0,74,74,0,1,0,1,0
1457,58638,5900,58638,5900,156,62,94,2,10,1,1
1458,50147,443,13714,443,9915,1833,8082,22,46,13,9
1459,55109,53,12323,53,711,87,624,2,30,1,1
1460,23332,80,23332,80,490,264,226,8,26,5,3
1461,58638,5900,58638,5900,156,62,94,2,10,1,1
1462,59342,80,59342,80,107768,4073,103695,177,15,58,119
1463,8411,8411,36899,8411,66,66,0,1,30,1,0
1464,55869,53,59798,53,192,98,94,2,30,1,1
1465,27302,443,50050,443,9046,1414,7632,25,84,10,15
1466,22321,80,22321,80,490,264,226,8,26,5,3
1467,58957,80,23483,80,13330975,109486,13221489,10177,23,1394,8783
1468,56804,443,56989,443,8074,2054,6020,20,15,11,9
1469,55457,443,34189,443,130,70,60,3,5,2,1
1470,56083,53,60591,53,711,87,624,2,30,1,1
1471,56431,53,62997,53,170,87,83,2,30,1,1
1472,56806,443,15010,443,8072,2052,6020,20,15,11,9
1473,61054,53,61054,53,237,91,146,2,33,1,1
1474,54076,53,54076,53,243,94,149,2,32,1,1
1475,6527,53,6527,53,235,90,145,2,32,1,1
1476,52248,9323,44483,9323,210,70,140,4,8,2,2
1477,52270,443,52270,443,1615,941,674,15,20,7,8
1478,55867,53,58666,53,172,88,84,2,30,1,1
1479,56586,53,6320,53,170,87,83,2,30,1,1
1480,54898,443,54771,443,78537,4022,74515,120,386,55,65
1481,50823,443,50823,443,1210,637,573,14,25,7,7
1482,64796,53,48263,53,184,94,90,2,31,1,1
1483,58638,5900,58638,5900,156,62,94,2,10,1,1
1484,9519,443,34920,443,3910,370,3540,16,34,5,11
1485,9522,443,6233,443,6146,709,5437,18,29,8,10
1486,58638,5900,58638,5900,156,62,94,2,10,1,1
1487,52269,443,52269,443,1615,941,674,15,20,7,8
1488,58638,5900,58638,5900,156,62,94,2,10,1,1
1489,56805,443,33799,443,8022,2002,6020,20,15,11,9
1490,58638,5900,58638,5900,156,62,94,2,10,1,1
1491,65359,53,51803,53,731,91,640,2,30,1,1
1492,8413,8413,11663,8413,66,66,0,1,30,1,0
1493,56504,53,4684,53,196,100,96,2,30,1,1
1494,56919,53,26686,53,170,87,83,2,30,1,1
1495,8412,8412,23033,8412,66,66,0,1,30,1,0
1496,55491,443,47772,443,5123,2651,2472,15,123,8,7
1497,49506,53,26702,53,200,102,98,2,31,1,1
1498,65289,53,55084,53,174,89,85,2,31,1,1
1499,64722,53,22432,53,184,94,90,2,31,1,1
1500,50031,53,53719,53,178,91,87,2,31,1,1
1501,59086,53,59086,53,235,90,145,2,32,1,1
1502,50944,443,50944,443,1210,637,573,14,25,7,7
1503,51073,443,51073,443,1210,637,573,14,25,7,7
1504,64103,38976,24644,38976,66,66,0,2,8,2,0
1505,64105,6363,30786,6363,66,66,0,2,8,2,0
1506,40175,53,40175,53,235,90,145,2,32,1,1
1507,53976,52534,6002,52534,70,70,0,1,5,1,0
1508,28236,53,28236,53,235,90,145,2,32,1,1
1509,58638,5900,58638,5900,156,62,94,2,10,1,1
1510,64729,80,64729,80,40906,1105,39801,45,142,13,32
1511,9516,443,9863,443,3909,369,3540,16,35,5,11
1512,56733,53,47115,53,187,98,89,3,52,2,1
1513,37350,53,37350,53,213,87,126,2,30,1,1
1514,38104,443,51062,443,8884,4067,4817,24,19,11,13
1515,58254,80,49705,80,1151,711,440,10,15,5,5
1516,62160,53,62160,53,205,81,124,2,30,1,1
1517,5588,5588,0,0,3354,1792,1562,46,194,23,23
1518,55735,53,59032,53,256,93,163,2,30,1,1
1519,64171,53,19883,53,174,89,85,2,30,1,1
1520,53338,53,53532,53,168,78,90,2,30,1,1
1521,56262,53,64499,53,170,87,83,2,31,1,1
1522,56906,53,50869,53,166,85,81,2,31,1,1
1523,56322,53,0,0,166,73,93,2,31,1,1
1524,37965,56605,48626,56605,847,152,695,4,1201,2,2
1525,62825,443,8189,443,17772,2595,15177,25,122,12,13
1526,57033,53,60387,53,754,94,660,2,31,1,1
1527,56720,53,57762,53,916,86,830,2,31,1,1
1528,49321,53,16825,53,184,94,90,2,31,1,1
1529,27677,22114,0,0,146,146,0,1,0,1,0
1530,50547,22197,0,0,66,66,0,1,0,1,0
1531,51052,50584,0,0,66,66,0,1,0,1,0
1532,58230,64147,0,0,66,66,0,1,0,1,0
1533,30456,36237,0,0,62,62,0,1,0,1,0
1534,50625,445,0,0,70,70,0,1,0,1,0
1535,50624,445,0,0,70,70,0,1,0,1,0
1536,45269,50584,0,0,62,62,0,1,0,1,0
1537,55300,445,0,0,70,70,0,1,0,1,0
1538,55295,445,0,0,70,70,0,1,0,1,0
1539,35207,22114,0,0,62,62,0,1,0,1,0
1540,50622,445,0,0,70,70,0,1,0,1,0
1541,53127,443,41153,443,13914,7812,6102,52,69,28,24
1542,46568,443,33630,443,6407,984,5423,21,360,11,10
1543,42356,443,3759,443,276,70,206,5,26,2,3
1544,43900,443,13168,443,442,250,192,8,25,5,3
1545,56479,443,37707,443,3041,1995,1046,17,16,8,9
1546,52047,80,55413,80,27784,13980,13804,44,35,22,22
1547,53957,29970,1762,29970,552,366,186,9,17,6,3
1548,53951,80,8930,80,78,78,0,2,7,2,0
1549,38602,80,59364,80,2586,832,1754,14,16,7,7
1550,57410,443,21541,443,7435,2697,4738,23,30,13,10
1551,51136,443,51136,443,1210,637,573,14,25,7,7
1552,65131,53,28562,53,443,98,345,4,57,2,2
1553,4782,443,2792,443,1191,692,499,12,39,7,5
1554,49670,443,5760,443,886,541,345,11,15,6,5
1555,64082,43786,41878,43786,504,382,122,8,14,6,2
1556,21944,53,21944,53,217,82,135,2,32,1,1
1557,65053,53,65053,53,235,90,145,2,31,1,1
1558,53979,26308,29256,26308,70,70,0,1,4,1,0
1559,49188,53,58733,53,621,111,510,4,35,2,2
1560,52272,443,52272,443,1615,941,674,15,20,7,8
1561,39994,80,41282,80,2387,930,1457,14,16,7,7
1562,56515,53,8193,53,177,94,83,2,29,1,1
1563,57448,53,27842,53,177,94,83,2,29,1,1
1564,56906,53,48411,53,167,86,81,2,29,1,1
1565,50063,53,17752,53,173,94,79,2,29,1,1
1566,55650,53,4298,53,179,94,85,2,29,1,1
1567,61119,53,61119,53,217,90,127,2,29,1,1
1568,50063,53,53923,53,173,94,79,2,30,1,1
1569,55732,53,41995,53,177,94,83,2,29,1,1
1570,56176,53,13645,53,177,94,83,2,30,1,1
1571,51606,443,25122,443,5188,1096,4092,21,95,12,9
1572,48285,8080,0,0,184,78,106,3,10,2,1
1573,58638,5900,58638,5900,160,66,94,2,9,1,1
1574,62910,993,51747,993,9108,4045,5063,84,72,39,45
1575,63954,53,6162,53,289,102,187,2,30,1,1
1576,57152,53,57152,53,241,98,143,2,30,1,1
1577,49481,53,5935,53,232,102,130,2,30,1,1
1578,55061,443,38247,443,18682,8068,10614,42,62,22,20
1579,49482,7000,49482,7000,3098,1611,1487,16,15,9,7
1580,49364,443,26461,443,8376,2198,6178,25,81,14,11
1581,50972,3544,40157,3544,409,107,302,4,30,2,2
1582,56504,53,22416,53,198,102,96,2,33,1,1
1583,57035,80,15633,80,953,524,429,11,256,6,5
1584,51605,443,55829,443,8095,3030,5065,27,95,14,13
1585,65094,53,59382,53,630,204,426,6,64,3,3
1586,39892,443,8583,443,2186,1319,867,23,20,13,10
1587,51252,443,8705,443,9600,4628,4972,41,16,24,17
1588,64051,53,63556,53,275,102,173,2,30,1,1
1589,49837,53,3661,53,183,102,81,2,30,1,1
1590,65028,53,37363,53,79,79,0,2,33,2,0
1591,61544,53,18551,53,325,86,239,2,30,1,1
1592,64876,53,58020,53,737,94,643,2,30,1,1
1593,53500,443,64344,443,558,210,348,9,29,4,5
1594,64722,53,7575,53,184,94,90,2,30,1,1
1595,56262,53,63670,53,177,94,83,2,30,1,1
1596,45608,443,58506,443,8487,2231,6256,26,350,12,14
1597,56563,53,53188,53,292,126,166,2,30,1,1
1598,50031,53,15521,53,181,94,87,2,30,1,1
1599,64122,443,27502,443,5121090,119252,5001838,5000,55,1680,3320
1600,56431,53,59476,53,177,94,83,2,30,1,1
1601,21526,53,21526,53,230,90,140,2,30,1,1
1602,64796,53,58063,53,184,94,90,2,30,1,1
1603,49340,53,57846,53,387,134,253,2,30,1,1
1604,44839,443,42515,443,308,84,224,4,120,2,2
1605,40401,80,34965,80,1603,1179,424,10,124,6,4
1606,38135,80,24108,80,111328,4904,106424,145,240,66,79
1607,51377,443,25439,443,2838,944,1894,12,135,7,5
1608,57176,53,43366,53,178,94,84,2,30,1,1
1609,58991,443,64156,443,972647,20727,951920,916,263,245,671
1610,28441,23,28441,23,152,66,86,2,7,1,1
1611,60506,56243,34455,56243,70,70,0,2,8,2,0
1612,52569,80,52569,80,93783,3885,89898,105,167,37,68
1613,54388,53,31456,53,168,78,90,2,30,1,1
1614,64371,443,25379,443,5925,3462,2463,13,120,7,6
1615,51704,443,61850,443,7117,619,6498,19,34,6,13
1616,58975,80,4684,80,214,140,74,4,15,3,1
1617,53956,41578,43631,41578,492,306,186,8,17,5,3
1618,51251,443,24124,443,7950,2502,5448,38,16,22,16
1619,58855,80,59829,80,1601,902,699,8,387,5,3
1620,46201,443,55008,443,16666,4851,11815,58,150,27,31
1621,41249,443,56931,443,2080,1126,954,17,150,10,7
1622,59912,53,38804,53,168,78,90,2,30,1,1
1623,64926,53,0,0,371,77,294,2,30,1,1
1624,64171,53,47261,53,179,94,85,2,30,1,1
1625,46567,443,52746,443,6407,984,5423,21,360,11,10
1626,17750,6992,50842,6992,150,150,0,1,1200,1,0
1627,41325,443,55609,443,6015,4418,1597,38,246,22,16
1628,57356,443,8609,443,7644,3087,4557,26,46,15,11
1629,54030,443,52354,443,249900,26024,223876,450,167,183,267
1630,47152,443,10144,443,11278,2044,9234,32,178,17,15
1631,58856,443,60071,443,2694,1614,1080,14,386,8,6
1632,49224,53,4375,53,199,102,97,2,32,1,1
1633,52218,62004,11964,62004,136,136,0,3,12,3,0
1634,34331,443,11872,443,120,60,60,3,4,2,1
1635,43026,443,33561,443,138,78,60,2,4,1,1
1636,58638,5900,58638,5900,160,66,94,2,9,1,1
1637,58638,5900,58638,5900,160,66,94,2,9,1,1
1638,32515,443,32515,443,34885,6636,28249,74,51,38,36
1639,46822,3389,46822,3389,3457,1568,1889,17,21,10,7
1640,55867,53,49859,53,178,94,84,2,29,1,1
1641,36873,80,37820,80,1115,534,581,12,16,7,5
1642,60502,61473,62296,61473,1628,1037,591,14,16,8,6
1643,56919,53,21784,53,177,94,83,2,29,1,1
1644,50388,53,43330,53,94,94,0,1,29,1,0
1645,55797,53,20315,53,177,94,83,2,29,1,1
1646,56269,53,56636,53,326,126,200,2,30,1,1
1647,43830,443,46012,443,2257,461,1796,9,39,4,5
1648,55420,53,27651,53,177,94,83,2,29,1,1
1649,65290,53,22798,53,181,94,87,2,29,1,1
1650,40204,40017,36316,40017,156,94,62,2,30,1,1
1651,49506,53,12143,53,200,102,98,2,30,1,1
1652,65229,53,65530,53,443,182,261,6,30,3,3
1653,49837,53,9778,53,167,86,81,2,30,1,1
1654,65239,53,57855,53,489,185,304,6,73,3,3
1655,56586,53,54269,53,177,94,83,2,30,1,1
1656,64376,53,21911,53,210,94,116,2,30,1,1
1657,57448,53,10658,53,177,94,83,2,29,1,1
1658,56037,53,8318,53,246,102,144,2,30,1,1
1659,55797,53,21762,53,177,94,83,2,30,1,1
1660,56977,53,6420,53,322,102,220,2,30,1,1
1661,65290,53,6842,53,181,94,87,2,29,1,1
1662,49857,53,44627,53,165,86,79,2,29,1,1
1663,56919,53,40423,53,177,94,83,2,29,1,1
1664,56906,53,34993,53,167,86,81,2,31,1,1
1665,56307,53,55446,53,185,102,83,2,31,1,1
1666,56257,53,40578,53,177,94,83,2,31,1,1
1667,55605,53,12415,53,300,88,212,4,51,2,2
1668,49745,53,63902,53,1472,98,1374,4,54,2,2
1669,49603,53,34411,53,326,126,200,2,30,1,1
1670,55025,53,42219,53,183,94,89,2,30,1,1
1671,50031,53,40045,53,181,94,87,2,30,1,1
1672,56322,53,0,0,629,73,556,2,30,1,1
1673,58839,443,35385,443,8595,2118,6477,40,179,22,18
1674,49669,443,57280,443,6911,897,6014,22,28,10,12
1675,44246,5228,57956,5228,19678,4762,14916,98,9851,54,44
1676,62913,993,11946,993,9122,4055,5067,84,67,39,45
1677,45105,443,12616,443,3607,2257,1350,22,19,12,10
1678,33818,53,62977,53,168,78,90,2,30,1,1
1679,56176,53,54476,53,177,94,83,2,30,1,1
1680,55065,443,23726,443,13236,4421,8815,28,61,16,12
1681,64171,53,17588,53,179,94,85,2,30,1,1
1682,46569,443,56973,443,6409,984,5425,21,360,11,10
1683,59685,443,5373,443,2316,1353,963,17,276,9,8
1684,60508,55998,14688,55998,70,70,0,2,8,2,0
1685,52297,80,4278,80,1061,574,487,13,256,7,6
1686,49462,53,10345,53,86,86,0,1,30,1,0
1687,34484,53,27104,53,86,86,0,1,30,1,0
1688,65402,53,33102,53,297,110,187,2,30,1,1
1689,32185,53,63584,53,86,86,0,1,30,1,0
1690,49506,53,23058,53,200,102,98,2,30,1,1
1691,64722,53,27260,53,184,94,90,2,30,1,1
1692,56262,53,55550,53,177,94,83,2,31,1,1
1693,44191,443,19988,443,7151,1943,5208,30,25,17,13
1694,49231,443,44532,443,474745,13542,461203,502,17,189,313
1695,56663,53,10723,53,181,94,87,2,33,1,1
1696,58176,5223,41893,5223,15152,5747,9405,46,56,20,26
1697,53174,41442,13286,41442,70,70,0,1,5,1,0
1698,39538,80,23642,80,2191,1142,1049,21,370,9,12
1699,58974,80,55839,80,214,140,74,4,15,3,1
1700,65522,443,46739,443,399281,11940,387341,412,16,145,267
1701,45545,53,45545,53,178,82,96,2,30,1,1
1702,49293,53,22414,53,811,94,717,2,30,1,1
1703,64511,53,2785,53,305,102,203,2,30,1,1
1704,55025,53,22515,53,183,94,89,2,30,1,1
1705,65289,53,55210,53,179,94,85,2,30,1,1
1706,56919,53,56265,53,177,94,83,2,30,1,1
1707,56431,53,39797,53,177,94,83,2,30,1,1
1708,56572,53,63633,53,177,94,83,2,31,1,1
1709,56262,53,24636,53,177,94,83,2,30,1,1
1710,64917,53,41071,53,194,94,100,2,30,1,1
1711,51442,443,50943,443,15321,3760,11561,56,170,23,33
1712,49321,53,55835,53,184,94,90,2,31,1,1
1713,64370,443,23826,443,2783,692,2091,10,120,5,5
1714,49126,443,33194,443,3800867,77753,3723114,3263,625,478,2785
1715,60774,443,14767,443,29739,1164,28575,40,120,15,25
1716,49591,5228,57295,5228,18548,2772,15776,41,3957,17,24
1717,47963,443,46762,443,8903,3095,5808,31,121,16,15
1718,61445,443,34767,443,97211,3043,94168,109,121,37,72
1719,37142,443,20503,443,17201,10578,6623,57,145,27,30
1720,49160,33586,34033,33586,1377,300,1077,6,1200,3,3
1721,49506,53,52835,53,200,102,98,2,31,1,1
1722,64722,53,18980,53,384,94,290,4,42,2,2
1723,50740,443,2714,443,3108,1730,1378,16,16,9,7
1724,65066,80,65066,80,874843,22526,852317,878,44,304,574
1725,55053,443,17178,443,6906,1283,5623,29,248,14,15
1726,14446,443,21708,443,2616,1470,1146,18,16,8,10
1727,55869,53,49767,53,196,102,94,2,30,1,1
1728,64694,53,22388,53,289,82,207,4,46,2,2
1729,62922,993,33264,993,9484,4222,5262,86,45,40,46
1730,42354,443,60503,443,4181,998,3183,14,27,7,7
1731,59875,443,3172,443,12357,5182,7175,30,108,13,17
1732,54927,443,30686,443,7148,1924,5224,35,364,19,16
1733,42096,80,4456,80,1711,698,1013,14,17,6,8
1734,60503,53425,43534,53425,504,318,186,8,16,5,3
1735,54892,443,40724,443,602278,26008,576270,748,396,317,431
1736,33041,443,60563,443,12375,6777,5598,28,49,13,15
1737,65200,51050,0,0,62,62,0,1,0,1,0
1738,42417,22114,0,0,62,62,0,1,0,1,0
1739,50708,445,0,0,66,66,0,1,0,1,0
1740,55710,5555,0,0,60,60,0,1,0,1,0
1741,18652,64147,0,0,62,62,0,1,0,1,0
1742,11983,57470,0,0,62,62,0,1,0,1,0
1743,39588,25174,0,0,66,66,0,1,0,1,0
1744,443,35385,0,0,161,161,0,1,0,1,0
1745,55294,445,0,0,70,70,0,1,0,1,0
1746,43269,50584,0,0,66,66,0,1,0,1,0
1747,50615,445,0,0,70,70,0,1,0,1,0
1748,30966,44847,0,0,146,146,0,1,0,1,0
1749,61550,5529,0,0,145,145,0,1,0,1,0
1750,55293,445,0,0,70,70,0,1,0,1,0
1751,9518,1,0,0,100,100,0,1,0,1,0
1752,50613,445,0,0,70,70,0,1,0,1,0
1753,51598,56079,0,0,66,66,0,1,0,1,0
1754,47342,36237,0,0,62,62,0,1,0,1,0
1755,60676,57866,0,0,66,66,0,1,0,1,0
1756,50692,445,0,0,66,66,0,1,0,1,0
1757,50691,445,0,0,66,66,0,1,0,1,0
1758,50612,445,0,0,70,70,0,1,0,1,0
1759,26287,56205,0,0,62,62,0,1,0,1,0
1760,50611,445,0,0,70,70,0,1,0,1,0
1761,50610,445,0,0,70,70,0,1,0,1,0
1762,50606,445,0,0,70,70,0,1,0,1,0
1763,50604,445,0,0,70,70,0,1,0,1,0
1764,63421,44847,0,0,66,66,0,1,0,1,0
1765,58365,5900,0,0,60,60,0,1,0,1,0
1766,12909,47807,0,0,148,148,0,1,0,1,0
1767,6881,6881,0,0,62,62,0,1,0,1,0
1768,55283,445,0,0,70,70,0,1,0,1,0
1769,55280,445,0,0,70,70,0,1,0,1,0
1770,55277,445,0,0,70,70,0,1,0,1,0
1771,55275,445,0,0,70,70,0,1,0,1,0
1772,57539,44847,0,0,62,62,0,1,0,1,0
1773,40847,25174,0,0,146,146,0,1,0,1,0
1774,63346,37965,0,0,66,66,0,1,0,1,0
1775,56119,37965,0,0,62,62,0,1,0,1,0
1776,50592,445,0,0,70,70,0,1,0,1,0
1777,62949,37965,0,0,62,62,0,1,0,1,0
1778,43704,37965,0,0,66,66,0,1,0,1,0
1779,50591,445,0,0,70,70,0,1,0,1,0
1780,50689,445,0,0,66,66,0,1,0,1,0
1781,63050,57470,0,0,74,74,0,1,0,1,0
1782,50586,445,0,0,70,70,0,1,0,1,0
1783,50582,445,0,0,70,70,0,1,0,1,0
1784,50581,445,0,0,70,70,0,1,0,1,0
1785,50680,445,0,0,66,66,0,1,0,1,0
1786,50682,445,0,0,66,66,0,1,0,1,0
1787,50671,445,0,0,66,66,0,1,0,1,0
1788,50676,445,0,0,66,66,0,1,0,1,0
1789,50677,445,0,0,66,66,0,1,0,1,0
1790,50674,445,0,0,66,66,0,1,0,1,0
1791,50675,445,0,0,66,66,0,1,0,1,0
1792,55266,445,0,0,70,70,0,1,0,1,0
1793,48706,23393,0,0,60,60,0,1,0,1,0
1794,49786,25174,0,0,66,66,0,1,0,1,0
1795,55264,445,0,0,70,70,0,1,0,1,0
1796,55262,445,0,0,70,70,0,1,0,1,0
1797,55261,445,0,0,70,70,0,1,0,1,0
1798,36005,22,0,0,60,60,0,1,0,1,0
1799,65417,44847,0,0,66,66,0,1,0,1,0
1800,9231,3389,0,0,66,66,0,1,0,1,0
1801,39213,25174,0,0,62,62,0,1,0,1,0
1802,50570,445,0,0,70,70,0,1,0,1,0
1803,59096,8604,0,0,66,66,0,1,0,1,0
1804,57846,57866,0,0,66,66,0,1,0,1,0
1805,443,35385,0,0,66,66,0,1,0,1,0
1806,443,58101,0,0,60,60,0,1,0,1,0
1807,993,51747,0,0,66,66,0,1,0,1,0
1808,55259,445,0,0,70,70,0,1,0,1,0
1809,55256,445,0,0,70,70,0,1,0,1,0
1810,55253,445,0,0,70,70,0,1,0,1,0
1811,63002,22114,0,0,66,66,0,1,0,1,0
1812,50665,445,0,0,66,66,0,1,0,1,0
1813,55251,445,0,0,70,70,0,1,0,1,0
1814,57643,28189,0,0,60,60,0,1,0,1,0
1815,62080,54532,0,0,60,60,0,1,0,1,0
1816,50662,445,0,0,66,66,0,1,0,1,0
1817,50566,445,0,0,70,70,0,1,0,1,0
1818,443,50238,0,0,331,331,0,1,0,1,0
1819,10754,28793,0,0,62,62,0,1,0,1,0
1820,42973,57470,0,0,62,62,0,1,0,1,0
1821,50660,445,0,0,66,66,0,1,0,1,0
1822,50659,445,0,0,66,66,0,1,0,1,0
1823,3945,35440,0,0,66,66,0,1,0,1,0
1824,56428,30317,0,0,66,66,0,1,0,1,0
1825,50658,445,0,0,66,66,0,1,0,1,0
1826,58511,50584,0,0,146,146,0,1,0,1,0
1827,50557,445,0,0,70,70,0,1,0,1,0
1828,50556,445,0,0,70,70,0,1,0,1,0
1829,50555,445,0,0,70,70,0,1,0,1,0
1830,443,44683,0,0,83,83,0,1,0,1,0
1831,50552,445,0,0,70,70,0,1,0,1,0
1832,50550,445,0,0,70,70,0,1,0,1,0
1833,60861,25174,0,0,66,66,0,1,0,1,0
1834,60883,64147,0,0,70,70,0,1,0,1,0
1835,55246,445,0,0,70,70,0,1,0,1,0
1836,993,11946,0,0,66,66,0,1,0,1,0
1837,40772,15503,0,0,74,74,0,1,0,1,0
1838,443,35385,0,0,66,66,0,1,0,1,0
1839,443,35385,0,0,97,97,0,1,0,1,0
1840,443,35385,0,0,130,130,0,1,0,1,0
1841,55240,445,0,0,70,70,0,1,0,1,0
1842,55233,445,0,0,70,70,0,1,0,1,0
1843,47141,50584,0,0,62,62,0,1,0,1,0
1844,5151,50584,0,0,62,62,0,1,0,1,0
1845,50647,445,0,0,66,66,0,1,0,1,0
1846,50544,445,0,0,70,70,0,1,0,1,0
1847,34212,11392,0,0,62,62,0,1,0,1,0
1848,24127,23,0,0,60,60,0,1,0,1,0
1849,50506,10214,0,0,66,66,0,1,0,1,0
1850,45652,10214,0,0,62,62,0,1,0,1,0
1851,35610,37965,0,0,62,62,0,1,0,1,0
1852,57325,37965,0,0,62,62,0,1,0,1,0
1853,50639,445,0,0,66,66,0,1,0,1,0
1854,55223,445,0,0,70,70,0,1,0,1,0
1855,8889,3808,0,0,60,60,0,1,0,1,0
1856,50536,445,0,0,70,70,0,1,0,1,0
1857,55306,53,23236,53,170,87,83,2,0,1,1
1858,993,33264,0,0,66,66,0,1,0,1,0
1859,6666,2001,0,0,60,60,0,1,0,1,0
1860,50535,445,0,0,70,70,0,1,0,1,0
1861,50637,445,0,0,66,66,0,1,0,1,0
1862,61202,35894,0,0,66,66,0,1,0,1,0
1863,1024,35894,0,0,62,62,0,1,0,1,0
1864,13027,64147,0,0,62,62,0,1,0,1,0
1865,50530,445,0,0,70,70,0,1,0,1,0
1866,26424,27189,0,0,66,66,0,1,0,1,0
1867,53466,25174,0,0,146,146,0,1,0,1,0
1868,50528,445,0,0,70,70,0,1,0,1,0
1869,50360,37965,0,0,62,62,0,1,0,1,0
1870,50629,445,0,0,66,66,0,1,0,1,0
1871,6889,55108,0,0,143,143,0,1,0,1,0
1872,3117,37965,0,0,62,62,0,1,0,1,0
1873,50622,445,0,0,66,66,0,1,0,1,0
1874,50524,445,0,0,70,70,0,1,0,1,0
1875,53318,22114,0,0,66,66,0,1,0,1,0
1876,52033,50584,0,0,66,66,0,1,0,1,0
1877,31675,19473,0,0,62,62,0,1,0,1,0
1878,55043,57470,0,0,78,78,0,1,0,1,0
1879,45144,25174,0,0,146,146,0,1,0,1,0
1880,50523,445,0,0,70,70,0,1,0,1,0
1881,60453,22114,0,0,146,146,0,1,0,1,0
1882,20804,64147,0,0,145,145,0,1,0,1,0
1883,55216,445,0,0,70,70,0,1,0,1,0
1884,55212,445,0,0,70,70,0,1,0,1,0
1885,55211,445,0,0,70,70,0,1,0,1,0
1886,49677,25174,0,0,62,62,0,1,0,1,0
1887,55994,22114,0,0,66,66,0,1,0,1,0
1888,50607,445,0,0,66,66,0,1,0,1,0
1889,50614,445,0,0,66,66,0,1,0,1,0
1890,50609,445,0,0,66,66,0,1,0,1,0
1891,50610,445,0,0,66,66,0,1,0,1,0
1892,50613,445,0,0,66,66,0,1,0,1,0
1893,50608,445,0,0,66,66,0,1,0,1,0
1894,50606,445,0,0,66,66,0,1,0,1,0
1895,50612,445,0,0,66,66,0,1,0,1,0
1896,58055,56205,0,0,146,146,0,1,0,1,0
1897,50518,445,0,0,70,70,0,1,0,1,0
1898,45375,1900,0,0,139,139,0,1,0,1,0
1899,19136,64147,0,0,62,62,0,1,0,1,0
1900,63321,37807,0,0,66,66,0,1,0,1,0
1901,46417,22114,0,0,146,146,0,1,0,1,0
1902,41677,57470,0,0,62,62,0,1,0,1,0
1903,30303,56301,0,0,169,169,0,1,0,1,0
1904,49594,22114,0,0,66,66,0,1,0,1,0
1905,50655,26467,0,0,66,66,0,1,0,1,0
1906,2850,64147,0,0,62,62,0,1,0,1,0
1907,48071,25174,0,0,62,62,0,1,0,1,0
1908,6666,62078,0,0,60,60,0,1,0,1,0
1909,55209,445,0,0,70,70,0,1,0,1,0
1910,55204,445,0,0,70,70,0,1,0,1,0
1911,55203,445,0,0,70,70,0,1,0,1,0
1912,55199,445,0,0,70,70,0,1,0,1,0
1913,50594,445,0,0,66,66,0,1,0,1,0
1914,50593,445,0,0,66,66,0,1,0,1,0
1915,50591,445,0,0,66,66,0,1,0,1,0
1916,28875,51505,0,0,62,62,0,1,0,1,0
1917,50505,445,0,0,70,70,0,1,0,1,0
1918,55903,53,1701,53,170,87,83,2,30,1,1
1919,40204,40018,64999,40018,150,88,62,2,30,1,1
1920,52213,56682,55020,56682,66,66,0,1,5,1,0
1921,9515,443,54612,443,318,192,126,6,34,4,2
1922,55115,53,54899,53,758,96,662,2,31,1,1
1923,50687,443,7518,443,1199,618,581,13,29,6,7
1924,49476,7010,49476,7010,4215,2090,2125,15,16,8,7
1925,56803,443,62661,443,8020,2000,6020,20,15,11,9
1926,53971,18810,57788,18810,70,70,0,1,5,1,0
1927,64080,11801,41031,11801,66,66,0,1,5,1,0
1928,49722,443,18328,443,9698,3026,6672,54,618,27,27
1929,64681,53,5691,53,86,86,0,1,60,1,0
1930,56122,53,50294,53,731,91,640,2,30,1,1
1931,39023,443,14196,443,1017,705,312,9,20,4,5
1932,50686,443,4744,443,1199,618,581,13,29,6,7
1933,65130,80,61798,80,2500,531,1969,11,76,6,5
1934,50722,80,21337,80,3235,555,2680,13,20,6,7
1935,53171,11820,1212,11820,698,320,378,10,16,6,4
1936,50730,53,50730,53,228,97,131,2,30,1,1
1937,57047,53,47290,53,1426,98,1328,4,53,2,2
1938,49315,443,55462,443,160961,7302,153659,171,87,49,122
1939,29979,53,29979,53,215,80,135,2,33,1,1
1940,56801,443,16437,443,8022,2002,6020,20,15,11,9
1941,59799,443,59799,443,4666,1759,2907,19,28,11,8
1942,63431,443,3951,443,3182,1568,1614,8,120,4,4
1943,63217,443,63217,443,11907,1406,10501,25,22,11,14
1944,53964,24389,41775,24389,1473,842,631,12,15,7,5
1945,36103,443,46915,443,130,70,60,2,15,1,1
1946,53998,443,53998,443,4613,1706,2907,19,30,11,8
1947,56802,443,7219,443,8072,2052,6020,20,15,11,9
1948,52215,16937,53036,16937,136,136,0,3,12,3,0
1949,53967,54589,61471,54589,70,70,0,1,5,1,0
1950,9511,443,26929,443,318,192,126,6,34,4,2
1951,49477,7000,49477,7000,5910,4455,1455,19,15,11,8
1952,44884,443,1595,443,309,309,0,1,5,1,0
1953,56756,443,1855,443,7565,2187,5378,27,24,15,12
1954,54973,53,61675,53,711,87,624,2,30,1,1
1955,56265,53,18284,53,733,85,648,2,30,1,1
1956,55897,53,23504,53,770,102,668,2,30,1,1
1957,55975,53,49618,53,711,87,624,2,30,1,1
1958,56257,53,60774,53,170,87,83,2,31,1,1
1959,50134,53,40420,53,733,86,647,2,31,1,1
1960,56216,53,5035,53,170,87,83,2,31,1,1
1961,56272,443,56272,443,4550,1643,2907,19,28,11,8
1962,9514,443,6699,443,318,192,126,6,34,4,2
1963,49480,7000,49480,7000,3050,1659,1391,16,15,9,7
1964,46774,53,46774,53,235,90,145,2,33,1,1
1965,41614,5222,29157,5222,768,510,258,9,21,5,4
1966,59442,53,59442,53,235,90,145,2,33,1,1
1967,38698,443,26967,443,628,250,378,11,39,5,6
1968,56476,443,56476,443,4624,1717,2907,19,30,11,8
1969,54939,443,24418,443,13018,3066,9952,65,361,33,32
1970,55370,53,23288,53,711,87,624,2,30,1,1
1971,56800,443,17462,443,8074,2054,6020,20,16,11,9
1972,57176,53,30899,53,172,88,84,2,30,1,1
1973,55219,53,47738,53,91,91,0,1,30,1,0
1974,55806,53,53227,53,200,102,98,2,30,1,1
1975,55564,53,55564,53,215,88,127,2,30,1,1
1976,55349,53,28852,53,744,89,655,2,30,1,1
1977,55224,53,26209,53,711,87,624,2,31,1,1
1978,45205,443,55089,443,7221,3151,4070,20,162,9,11
1979,61077,443,19799,443,4970,2272,2698,12,121,6,6
1980,56255,53,37256,53,701,88,613,2,31,1,1
1981,49762,53,56822,53,184,94,90,2,31,1,1
1982,59513,53,0,0,82,82,0,1,31,1,0
1983,57237,443,44952,443,3283,1030,2253,16,136,8,8
1984,55647,53,53361,53,250,86,164,4,31,2,2
1985,56480,53,53765,53,755,94,661,2,31,1,1
1986,64124,53,26589,53,182,93,89,2,31,1,1
1987,57052,53,31599,53,711,87,624,2,31,1,1
1988,45154,53,45154,53,236,108,128,2,31,1,1
1989,55288,53,47176,53,192,98,94,2,31,1,1
1990,57374,53,45450,53,733,86,647,2,31,1,1
1991,56397,53,29734,53,174,89,85,2,31,1,1
1992,55082,53,13671,53,755,93,662,2,31,1,1
1993,5578,53,5578,53,288,83,205,2,31,1,1
1994,43056,443,9640,443,31297,21354,9943,55,363,28,27
1995,6881,16869,32052,16869,509,150,359,2,1200,1,1
1996,48706,23393,0,0,60,60,0,1,0,1,0
1997,18204,55160,0,0,146,146,0,1,0,1,0
1998,53189,62413,0,0,62,62,0,1,0,1,0
1999,13406,22114,0,0,62,62,0,1,0,1,0
2000,54256,123,0,0,234,234,0,1,0,1,0
2001,52863,50584,0,0,66,66,0,1,0,1,0
2002,55206,22114,0,0,66,66,0,1,0,1,0
2003,2075,19473,0,0,62,62,0,1,0,1,0
2004,55191,445,0,0,70,70,0,1,0,1,0
2005,23846,22114,0,0,146,146,0,1,0,1,0
2006,64878,26467,0,0,62,62,0,1,0,1,0
2007,50367,37965,0,0,66,66,0,1,0,1,0
2008,50502,445,0,0,70,70,0,1,0,1,0
2009,55190,445,0,0,70,70,0,1,0,1,0
2010,55183,445,0,0,70,70,0,1,0,1,0
2011,55180,445,0,0,70,70,0,1,0,1,0
2012,1638,25174,0,0,146,146,0,1,0,1,0
2013,46619,57470,0,0,62,62,0,1,0,1,0
2014,23353,25174,0,0,62,62,0,1,0,1,0
2015,50498,445,0,0,70,70,0,1,0,1,0
2016,9687,35440,0,0,66,66,0,1,0,1,0
2017,48144,21247,0,0,66,66,0,1,0,1,0
2018,50496,445,0,0,70,70,0,1,0,1,0
2019,43260,41615,0,0,145,145,0,1,0,1,0
2020,43260,41615,0,0,145,145,0,1,0,1,0
2021,51827,56205,0,0,66,66,0,1,0,1,0
2022,16425,15503,0,0,62,62,0,1,0,1,0
2023,25565,28739,0,0,60,60,0,1,0,1,0
2024,50494,445,0,0,70,70,0,1,0,1,0
2025,52819,15503,0,0,66,66,0,1,0,1,0
2026,55172,445,0,0,70,70,0,1,0,1,0
2027,30046,15503,0,0,62,62,0,1,0,1,0
2028,55168,445,0,0,70,70,0,1,0,1,0
2029,55167,445,0,0,70,70,0,1,0,1,0
2030,51954,57470,0,0,66,66,0,1,0,1,0
2031,33351,43890,0,0,146,146,0,1,0,1,0
2032,4862,37965,0,0,66,66,0,1,0,1,0
2033,50581,445,0,0,66,66,0,1,0,1,0
2034,7844,22114,0,0,66,66,0,1,0,1,0
2035,34500,23,0,0,60,60,0,1,0,1,0
2036,61701,15503,0,0,62,62,0,1,0,1,0
2037,993,4264,0,0,66,66,0,1,0,1,0
2038,61455,64147,0,0,66,66,0,1,0,1,0
2039,52745,25174,0,0,66,66,0,1,0,1,0
2040,26623,22114,0,0,146,146,0,1,0,1,0
2041,62721,56205,0,0,66,66,0,1,0,1,0
2042,1025,46776,0,0,62,62,0,1,0,1,0
2043,50487,445,0,0,70,70,0,1,0,1,0
2044,57348,25174,0,0,146,146,0,1,0,1,0
2045,24073,22114,0,0,62,62,0,1,0,1,0
2046,59107,25174,0,0,66,66,0,1,0,1,0
2047,55166,445,0,0,70,70,0,1,0,1,0
2048,59549,50584,0,0,66,66,0,1,0,1,0
2049,62183,57470,0,0,74,74,0,1,0,1,0
2050,34993,15503,0,0,62,62,0,1,0,1,0
2051,993,3979,0,0,129,129,0,1,0,1,0
2052,50485,445,0,0,70,70,0,1,0,1,0
2053,31859,33909,0,0,62,62,0,1,0,1,0
2054,55164,445,0,0,70,70,0,1,0,1,0
2055,60428,25174,0,0,66,66,0,1,0,1,0
2056,63190,35440,0,0,62,62,0,1,0,1,0
2057,50484,445,0,0,70,70,0,1,0,1,0
2058,55310,50584,0,0,66,66,0,1,0,1,0
2059,50483,445,0,0,70,70,0,1,0,1,0
2060,50482,445,0,0,70,70,0,1,0,1,0
2061,50476,445,0,0,70,70,0,1,0,1,0
2062,65216,53,28628,53,218,94,124,2,30,1,1
2063,56216,53,58788,53,177,94,83,2,30,1,1
2064,64592,443,64064,443,24682,1935,22747,36,17,17,19
2065,57607,443,42010,443,2614,1689,925,18,20,10,8
2066,37110,53,37110,53,247,98,149,2,33,1,1
2067,50674,80,2786,80,3325,598,2727,12,15,6,6
2068,55066,443,16494,443,39091,9981,29110,93,208,42,51
2069,53972,59089,19075,59089,70,70,0,1,4,1,0
2070,64078,54561,14823,54561,70,70,0,1,4,1,0
2071,56604,3389,56604,3389,3424,1710,1714,16,31,8,8
2072,42355,443,21738,443,4181,998,3183,14,26,7,7
2073,39890,443,4730,443,21106,2445,18661,45,20,24,21
2074,55051,443,30290,443,6975,1243,5732,29,254,14,15
2075,65523,443,11792,443,92518,4869,87649,109,15,44,65
2076,38783,443,19297,443,584,370,214,9,25,6,3
2077,53969,13156,32626,13156,70,70,0,1,4,1,0
2078,55806,53,52811,53,200,102,98,2,33,1,1
2079,53974,26108,47325,26108,70,70,0,1,4,1,0
2080,64079,20233,52835,20233,70,70,0,1,4,1,0
2081,64083,63666,39336,63666,70,70,0,1,4,1,0
2082,53173,25067,40514,25067,70,70,0,1,5,1,0
2083,56586,53,50469,53,177,94,83,2,29,1,1
2084,64618,53,13340,53,410,102,308,2,29,1,1
2085,49787,53,40556,53,258,110,148,2,29,1,1
2086,65289,53,50124,53,564,193,371,6,51,3,3
2087,56439,53,20721,53,177,94,83,2,29,1,1
2088,57176,53,54360,53,178,94,84,2,29,1,1
2089,64365,53,27467,53,341,110,231,2,29,1,1
2090,65511,53,46791,53,214,102,112,2,30,1,1
2091,50175,53,51711,53,819,102,717,2,30,1,1
2092,53461,443,61462,443,52988,3128,49860,67,48,26,41
2093,49344,53,20668,53,458,188,270,6,29,3,3
2094,57176,53,50437,53,178,94,84,2,29,1,1
2095,55339,53,49453,53,194,94,100,2,30,1,1
2096,55903,53,28482,53,177,94,83,2,30,1,1
2097,64009,53,32252,53,209,110,99,2,30,1,1
2098,40204,40003,21367,40003,156,94,62,2,30,1,1
2099,52212,51343,7428,51343,70,70,0,1,5,1,0
2100,49566,443,65424,443,1394,540,854,24,36,10,14
2101,9323,443,4707,443,26959,1764,25195,42,48,18,24
2102,49550,443,28578,443,2338,1407,931,18,200,10,8
2103,56068,53,60568,53,168,94,74,2,30,1,1
2104,14032,53,14032,53,235,90,145,2,32,1,1
2105,53194,443,6156,443,1478,918,560,12,44,6,6
2106,38002,49152,2185,49152,156,156,0,3,8,3,0
2107,9524,443,1427,443,1313,876,437,11,26,6,5
2108,46486,53,46486,53,414,268,146,3,34,2,1
2109,38785,443,33251,443,5206,3832,1374,23,25,13,10
2110,59131,53,59747,53,70,70,0,1,30,1,0
2111,55015,53,27863,53,733,94,639,2,30,1,1
2112,59899,3389,59899,3389,3624,1910,1714,19,32,11,8
2113,56892,53,40383,53,210,102,108,2,30,1,1
2114,61827,5223,22031,5223,10784,5831,4953,33,521,15,18
2115,55561,53,57871,53,313,102,211,2,30,1,1
2116,52111,53162,33838,53162,1330,706,624,10,33,6,4
2117,52124,443,40698,443,78269,5330,72939,127,313,57,70
2118,57284,53,57366,53,165,86,79,2,30,1,1
2119,58877,443,35023,443,183394,7389,176005,219,108,87,132
2120,49103,443,44063,443,6725,505,6220,20,181,5,15
2121,54658,443,29655,443,40096,3155,36941,50,135,19,31
2122,55288,53,5668,53,196,102,94,2,30,1,1
2123,46310,443,45813,443,10106,2096,8010,24,186,13,11
2124,56939,53,41233,53,322,134,188,2,30,1,1
2125,55845,443,55416,443,505207,16025,489182,464,139,97,367
2126,55138,53,34483,53,173,94,79,2,30,1,1
2127,56257,53,40161,53,177,94,83,2,30,1,1
2128,55219,53,51728,53,181,94,87,2,32,1,1
2129,25778,53,25778,53,235,90,145,2,33,1,1
2130,55774,8060,21425,8060,70,70,0,1,5,1,0
2131,52718,53,15399,53,164,78,86,2,30,1,1
2132,49321,53,46028,53,184,94,90,2,30,1,1
2133,56068,53,7794,53,152,78,74,2,30,1,1
2134,55070,53,15674,53,195,94,101,2,30,1,1
2135,40204,40018,24038,40018,566,86,480,2,30,1,1
2136,52214,27480,63759,27480,70,70,0,1,5,1,0
2137,62506,443,7984,443,1326,876,450,11,32,6,5
2138,40689,443,13371,443,4203,1564,2639,26,470,14,12
2139,35921,443,5709,443,5207,1058,4149,21,150,12,9
2140,55903,53,48648,53,177,94,83,2,30,1,1
2141,40204,40031,12730,40031,245,182,63,2,30,1,1
2142,43568,443,63608,443,9445,6593,2852,43,96,25,18
2143,56743,443,40694,443,7789,2275,5514,30,47,16,14
2144,54934,443,9475,443,11700,3386,8314,63,362,33,30
2145,34752,3389,34752,3389,3910,1805,2105,20,18,12,8
2146,49481,7000,49481,7000,3066,1675,1391,16,14,9,7
2147,57382,443,54714,443,5619,927,4692,17,15,10,7
2148,52046,80,15183,80,27904,14100,13804,46,34,24,22
2149,52113,443,33178,443,17710,1892,15818,37,24,17,20
2150,52216,8848,22408,8848,136,136,0,3,11,3,0
2151,14259,53,14259,53,247,98,149,2,33,1,1
2152,53304,80,56632,80,130,64,66,3,4,2,1
2153,60707,80,12418,80,144,78,66,2,5,1,1
2154,64077,20208,51700,20208,70,70,0,1,4,1,0
2155,62923,993,4264,993,9848,4639,5209,83,41,42,41
2156,37636,443,48056,443,9658,2602,7056,32,66,14,18
2157,36542,443,35325,443,31814,26657,5157,52,212,32,20
2158,56904,80,52022,80,25125,2681,22444,36,318,19,17
2159,123,123,26903,123,826,376,450,10,34,5,5
2160,58730,443,58122,443,5110,950,4160,21,48,10,11
2161,57923,443,34874,443,13736,1702,12034,26,15,12,14
2162,49573,443,25314,443,1820,1101,719,18,16,10,8
2163,56572,53,22035,53,177,94,83,2,29,1,1
2164,56307,53,24670,53,185,102,83,2,29,1,1
2165,50175,53,55281,53,196,102,94,2,30,1,1
2166,64425,53,6282,53,182,86,96,2,29,1,1
2167,64588,443,57526,443,9156,2109,7047,27,32,15,12
2168,56439,53,22707,53,177,94,83,2,29,1,1
2169,55795,53,50908,53,177,94,83,2,30,1,1
2170,40204,40035,37692,40035,156,94,62,2,30,1,1
2171,63847,443,1340,443,1786,172,1614,7,120,3,4
2172,64560,53,45431,53,807,94,713,2,30,1,1
2173,56397,53,62027,53,179,94,85,2,30,1,1
2174,64698,53,15508,53,763,102,661,2,30,1,1
2175,56143,53,11476,53,214,94,120,2,30,1,1
2176,36687,53,34461,53,168,78,90,2,31,1,1
2177,48731,443,18575,443,5959,1709,4250,27,1211,15,12
2178,56991,443,28802,443,20986,10828,10158,35,95,20,15
2179,49479,7000,49479,7000,5200,3745,1455,18,15,10,8
2180,62504,443,1666,443,10385,7051,3334,27,33,15,12
2181,56620,53,8741,53,214,102,112,2,30,1,1
2182,54020,443,45905,443,17529,8138,9391,39,31,17,22
2183,55871,53,54072,53,189,102,87,2,30,1,1
2184,55382,53,39381,53,226,110,116,2,30,1,1
2185,38001,49152,63633,49152,156,156,0,3,8,3,0
2186,62505,443,46992,443,14891,3970,10921,32,33,15,17
2187,60991,443,12084,443,15561,8186,7375,44,47,26,18
2188,56594,53,16703,53,167,86,81,2,30,1,1
2189,50031,53,6210,53,181,94,87,2,30,1,1
2190,56216,53,54561,53,177,94,83,2,30,1,1
2191,30434,53,30434,53,197,90,107,2,30,1,1
2192,56594,53,29488,53,167,86,81,2,30,1,1
2193,37052,53,37052,53,178,82,96,2,30,1,1
2194,56746,80,35139,80,876072,26350,849722,935,27,335,600
2195,50826,443,11870,443,6601,1120,5481,17,115,9,8
2196,60992,443,15020,443,3465,2532,933,20,47,12,8
2197,55795,53,49814,53,177,94,83,2,30,1,1
2198,55064,443,12029,443,12611,3681,8930,26,61,15,11
2199,55138,53,34113,53,165,86,79,2,30,1,1
2200,50478,445,0,0,70,70,0,1,0,1,0
2201,50564,445,0,0,66,66,0,1,0,1,0
2202,50562,445,0,0,66,66,0,1,0,1,0
2203,16518,64147,0,0,145,145,0,1,0,1,0
2204,1865,25174,0,0,146,146,0,1,0,1,0
2205,56152,56205,0,0,62,62,0,1,0,1,0
2206,63848,443,19599,443,3182,1568,1614,8,120,4,4
2207,6881,51413,34368,51413,207,118,89,2,1199,1,1
2208,49762,53,16917,53,184,94,90,2,30,1,1
2209,55107,53,13262,53,184,94,90,2,30,1,1
2210,55647,53,13562,53,168,86,82,2,31,1,1
2211,37322,53,64245,53,168,78,90,2,31,1,1
2212,49369,53,12483,53,168,86,82,2,31,1,1
2213,57470,31566,19027,31566,481,150,331,2,1199,1,1
2214,49369,53,65002,53,168,86,82,2,30,1,1
2215,49383,53,39251,53,758,102,656,2,30,1,1
2216,57431,53,3019,53,181,94,87,2,31,1,1
2217,57470,15564,5143,15564,1577,594,983,20,1624,10,10
2218,57169,53,55765,53,458,188,270,6,31,3,3
2219,56397,53,56445,53,179,94,85,2,31,1,1
2220,52245,53652,1791,53652,70,70,0,2,7,2,0
2221,55288,53,4599,53,196,102,94,2,30,1,1
2222,49760,53,59419,53,183,94,89,2,30,1,1
2223,57006,53,15142,53,819,102,717,2,30,1,1
2224,52210,15604,53741,15604,70,70,0,1,5,1,0
2225,62065,443,18237,443,21959,8954,13005,65,63,33,32
2226,49633,53,11968,53,168,86,82,2,30,1,1
2227,49590,53,5842,53,458,188,270,6,30,3,3
2228,55318,53,12855,53,167,86,81,2,30,1,1
2229,56442,53,53594,53,167,86,81,2,30,1,1
2230,19651,53,19651,53,216,90,126,2,30,1,1
2231,49225,80,23885,80,15343,3240,12103,23,81,9,14
2232,57355,443,46923,443,36265,3519,32746,55,46,27,28
2233,57304,53,49312,53,228,110,118,2,31,1,1
2234,55318,53,32183,53,167,86,81,2,31,1,1
2235,49946,443,3936,443,8725,3341,5384,25,136,12,13
2236,58535,30317,0,0,62,62,0,1,0,1,0
2237,54912,64147,0,0,66,66,0,1,0,1,0
2238,27507,25174,0,0,62,62,0,1,0,1,0
2239,25565,27942,0,0,60,60,0,1,0,1,0
2240,55155,445,0,0,70,70,0,1,0,1,0
2241,55154,445,0,0,70,70,0,1,0,1,0
2242,55151,445,0,0,70,70,0,1,0,1,0
2243,55146,445,0,0,70,70,0,1,0,1,0
2244,50464,445,0,0,70,70,0,1,0,1,0
2245,50463,445,0,0,70,70,0,1,0,1,0
2246,64199,50584,0,0,146,146,0,1,0,1,0
2247,50460,445,0,0,70,70,0,1,0,1,0
2248,26420,25174,0,0,66,66,0,1,0,1,0
2249,61583,64147,0,0,66,66,0,1,0,1,0
2250,20112,64147,0,0,62,62,0,1,0,1,0
2251,50453,445,0,0,70,70,0,1,0,1,0
2252,50454,445,0,0,70,70,0,1,0,1,0
2253,50561,445,0,0,66,66,0,1,0,1,0
2254,4328,7302,0,0,66,66,0,1,0,1,0
2255,50553,445,0,0,66,66,0,1,0,1,0
2256,50552,445,0,0,66,66,0,1,0,1,0
2257,50549,445,0,0,66,66,0,1,0,1,0
2258,50548,445,0,0,66,66,0,1,0,1,0
2259,50545,445,0,0,66,66,0,1,0,1,0
2260,50546,445,0,0,66,66,0,1,0,1,0
2261,50543,445,0,0,66,66,0,1,0,1,0
2262,57239,123,0,0,90,90,0,1,0,1,0
2263,52427,42873,0,0,66,66,0,1,0,1,0
2264,55140,445,0,0,70,70,0,1,0,1,0
2265,51348,25174,0,0,66,66,0,1,0,1,0
2266,57643,28189,0,0,60,60,0,1,0,1,0
2267,51550,11392,0,0,66,66,0,1,0,1,0
2268,62080,54532,0,0,60,60,0,1,0,1,0
2269,55136,445,0,0,70,70,0,1,0,1,0
2270,55133,445,0,0,70,70,0,1,0,1,0
2271,55132,445,0,0,70,70,0,1,0,1,0
2272,60248,46776,0,0,66,66,0,1,0,1,0
2273,53730,37965,0,0,66,66,0,1,0,1,0
2274,14717,64147,0,0,66,66,0,1,0,1,0
2275,50442,445,0,0,70,70,0,1,0,1,0
2276,42030,25,0,0,74,74,0,1,0,1,0
2277,2572,17546,0,0,62,62,0,1,0,1,0
2278,30784,30975,0,0,159,159,0,1,0,1,0
2279,55201,26467,0,0,62,62,0,1,0,1,0
2280,8102,57470,0,0,62,62,0,1,0,1,0
2281,18653,42707,0,0,66,66,0,1,0,1,0
2282,3093,62413,0,0,62,62,0,1,0,1,0
2283,42608,1,0,0,62,62,0,1,0,1,0
2284,62744,62413,0,0,66,66,0,1,0,1,0
2285,55130,445,0,0,70,70,0,1,0,1,0
2286,55131,445,0,0,70,70,0,1,0,1,0
2287,55128,445,0,0,70,70,0,1,0,1,0
2288,53194,35440,0,0,66,66,0,1,0,1,0
2289,50438,445,0,0,70,70,0,1,0,1,0
2290,50537,445,0,0,66,66,0,1,0,1,0
2291,55123,445,0,0,70,70,0,1,0,1,0
2292,50535,445,0,0,66,66,0,1,0,1,0
2293,50532,445,0,0,66,66,0,1,0,1,0
2294,50533,445,0,0,66,66,0,1,0,1,0
2295,50427,445,0,0,70,70,0,1,0,1,0
2296,50429,445,0,0,70,70,0,1,0,1,0
2297,50426,445,0,0,70,70,0,1,0,1,0
2298,8734,56205,0,0,66,66,0,1,0,1,0
2299,50530,445,0,0,66,66,0,1,0,1,0
2300,50423,445,0,0,70,70,0,1,0,1,0
2301,58229,50584,0,0,66,66,0,1,0,1,0
2302,40254,25174,0,0,62,62,0,1,0,1,0
2303,50421,445,0,0,70,70,0,1,0,1,0
2304,6546,37965,0,0,62,62,0,1,0,1,0
2305,44207,44847,0,0,62,62,0,1,0,1,0
2306,58799,30188,0,0,62,62,0,1,0,1,0
2307,35760,11392,0,0,146,146,0,1,0,1,0
2308,56182,53,55538,53,762,98,664,2,0,1,1
2309,22029,50584,0,0,66,66,0,1,0,1,0
2310,55118,445,0,0,70,70,0,1,0,1,0
2311,57762,25174,0,0,146,146,0,1,0,1,0
2312,26566,44847,0,0,66,66,0,1,0,1,0
2313,55817,36829,0,0,66,66,0,1,0,1,0
2314,55114,445,0,0,70,70,0,1,0,1,0
2315,55105,445,0,0,70,70,0,1,0,1,0
2316,26629,56079,0,0,62,62,0,1,0,1,0
2317,50415,445,0,0,70,70,0,1,0,1,0
2318,48025,44847,0,0,62,62,0,1,0,1,0
2319,11317,53563,0,0,143,143,0,1,0,1,0
2320,50518,445,0,0,66,66,0,1,0,1,0
2321,50408,445,0,0,70,70,0,1,0,1,0
2322,50511,445,0,0,66,66,0,1,0,1,0
2323,50406,445,0,0,70,70,0,1,0,1,0
2324,49380,21247,0,0,66,66,0,1,0,1,0
2325,55666,35440,0,0,60,60,0,1,0,1,0
2326,55095,445,0,0,70,70,0,1,0,1,0
2327,51575,9694,0,0,62,62,0,1,0,1,0
2328,9748,21247,0,0,66,66,0,1,0,1,0
2329,32983,51221,0,0,66,66,0,1,0,1,0
2330,61916,64097,0,0,62,62,0,1,0,1,0
2331,55043,57470,0,0,78,78,0,1,0,1,0
2332,50508,445,0,0,66,66,0,1,0,1,0
2333,58758,22114,0,0,66,66,0,1,0,1,0
2334,50402,445,0,0,70,70,0,1,0,1,0
2335,44079,10387,0,0,145,145,0,1,0,1,0
2336,50400,445,0,0,70,70,0,1,0,1,0
2337,53995,25174,0,0,66,66,0,1,0,1,0
2338,50502,445,0,0,66,66,0,1,0,1,0
2339,53928,15503,0,0,62,62,0,1,0,1,0
2340,50499,445,0,0,66,66,0,1,0,1,0
2341,50396,445,0,0,70,70,0,1,0,1,0
2342,6881,45378,0,0,146,146,0,1,0,1,0
2343,19875,30170,0,0,145,145,0,1,0,1,0
2344,50394,445,0,0,70,70,0,1,0,1,0
2345,44891,23,0,0,60,60,0,1,0,1,0
2346,52336,64097,0,0,62,62,0,1,0,1,0
2347,3730,17372,0,0,62,62,0,1,0,1,0
2348,55088,445,0,0,70,70,0,1,0,1,0
2349,55084,445,0,0,70,70,0,1,0,1,0
2350,55083,445,0,0,70,70,0,1,0,1,0
2351,36685,35440,0,0,62,62,0,1,0,1,0
2352,58453,50584,0,0,66,66,0,1,0,1,0
2353,36933,23117,0,0,62,62,0,1,0,1,0
2354,50485,445,0,0,66,66,0,1,0,1,0
2355,50486,445,0,0,66,66,0,1,0,1,0
2356,50481,445,0,0,66,66,0,1,0,1,0
2357,49828,53,40540,53,578,286,292,9,15,5,4
2358,45316,80,11125,80,3044854,64416,2980438,2968,19,997,1971
2359,53172,56013,23634,56013,70,70,0,1,5,1,0
2360,52247,49278,31090,49278,316,136,180,6,6,3,3
2361,55318,53,35151,53,166,85,81,2,30,1,1
2362,49552,53,59587,53,188,96,92,2,30,1,1
2363,56797,443,58873,443,8022,2002,6020,20,16,11,9
2364,49475,7000,49475,7000,3546,2043,1503,16,15,9,7
2365,48985,15000,20199,15000,130,70,60,2,5,1,1
2366,55445,53,56296,53,711,87,624,2,30,1,1
2367,49369,53,21699,53,168,86,82,2,30,1,1
2368,56748,53,43623,53,184,94,90,2,31,1,1
2369,56204,53,48985,53,168,86,82,2,30,1,1
2370,45017,443,13860,443,11771,2624,9147,50,20,25,25
2371,56799,443,47229,443,8021,2001,6020,20,15,11,9
2372,63459,443,63459,443,4506,1599,2907,19,28,11,8
2373,56822,53,60516,53,184,94,90,2,30,1,1
2374,53963,6882,6880,6882,70,70,0,1,5,1,0
2375,50295,3389,50295,3389,5936,2690,3246,25,20,15,10
2376,43906,443,43906,443,4792,2767,2025,38,255,20,18
2377,57896,7635,57896,7635,138,78,60,2,5,1,1
2378,56798,443,60246,443,8073,2053,6020,20,15,11,9
2379,64801,53,33594,53,728,96,632,2,30,1,1
2380,49474,7000,49474,7000,3100,783,2317,14,15,7,7
2381,6194,80,6194,80,3058,774,2284,11,16,6,5
2382,55638,53,11091,53,168,86,82,2,30,1,1
2383,49482,80,49482,80,2444,1148,1296,14,48,7,7
2384,42780,53,61676,53,198,93,105,2,30,1,1
2385,55774,53,26343,53,701,88,613,2,30,1,1
2386,57431,53,32621,53,178,91,87,2,31,1,1
2387,55088,53,52692,53,170,87,83,2,31,1,1
2388,57418,443,57418,443,4736,1759,2977,20,26,11,9
2389,56732,53,32710,53,701,88,613,2,30,1,1
2390,52242,3749,25339,3749,70,70,0,2,7,2,0
2391,37905,443,37905,443,4707,1800,2907,19,26,11,8
2392,57038,53,16760,53,188,96,92,2,30,1,1
2393,45287,53,10390,53,198,93,105,2,30,1,1
2394,49633,53,21391,53,168,86,82,2,30,1,1
2395,41317,53,41317,53,217,87,130,2,30,1,1
2396,48906,53,48906,53,217,87,130,2,30,1,1
2397,65336,53,30958,53,771,101,670,2,31,1,1
2398,55702,53,21809,53,761,100,661,2,31,1,1
2399,55469,53,16063,53,817,98,719,2,31,1,1
2400,37510,443,18789,443,8619,2288,6331,41,361,16,25
2401,55107,53,40259,53,184,94,90,2,30,1,1
2402,56677,53,20003,53,200,102,98,2,31,1,1
2403,56765,53,1940,53,188,96,92,2,31,1,1
2404,49332,53,39051,53,740,93,647,2,31,1,1
2405,35141,53,35141,53,288,83,205,2,31,1,1
2406,50793,443,16791,443,9721,3096,6625,30,122,13,17
2407,49870,53,21637,53,188,96,92,2,31,1,1
2408,55317,53,36634,53,711,87,624,2,31,1,1
2409,56439,53,38034,53,196,100,96,2,31,1,1
2410,56942,53,26338,53,170,87,83,2,31,1,1
2411,57269,53,41250,53,182,93,89,2,31,1,1
2412,56030,53,56239,53,815,95,720,2,31,1,1
2413,55478,53,12055,53,170,87,83,2,31,1,1
2414,56079,53,34259,53,740,93,647,2,31,1,1
2415,49480,53,59035,53,184,94,90,2,31,1,1
2416,65442,53,27260,53,760,97,663,2,31,1,1
2417,49540,53,42804,53,754,94,660,2,31,1,1
2418,55752,443,54224,443,11823,4029,7794,25,143,12,13
2419,50285,53,26837,53,760,97,663,2,31,1,1
2420,64941,53,34820,53,295,101,194,4,31,2,2
2421,54887,443,19441,443,4364,2141,2223,15,137,7,8
2422,64763,53,55818,53,212,108,104,2,31,1,1
2423,55877,54210,39473,54210,490,149,341,2,1200,1,1
2424,50479,445,0,0,66,66,0,1,0,1,0
2425,50480,445,0,0,66,66,0,1,0,1,0
2426,50482,445,0,0,66,66,0,1,0,1,0
2427,50484,445,0,0,66,66,0,1,0,1,0
2428,50478,445,0,0,66,66,0,1,0,1,0
2429,32722,25174,0,0,62,62,0,1,0,1,0
2430,28830,37965,0,0,62,62,0,1,0,1,0
2431,44044,23,0,0,60,60,0,1,0,1,0
2432,61250,42873,0,0,66,66,0,1,0,1,0
2433,61637,25174,0,0,66,66,0,1,0,1,0
2434,11112,43890,0,0,66,66,0,1,0,1,0
2435,59883,17637,0,0,66,66,0,1,0,1,0
2436,52363,123,30662,123,184,94,90,2,30,1,1
2437,55288,53,34566,53,196,102,94,2,30,1,1
2438,54996,53,14810,53,168,86,82,2,31,1,1
2439,64709,53,54232,53,338,110,228,2,29,1,1
2440,64683,53,62247,53,198,102,96,2,29,1,1
2441,64124,53,35184,53,183,94,89,2,30,1,1
2442,56442,53,30750,53,167,86,81,2,30,1,1
2443,55183,53,52172,53,177,94,83,2,30,1,1
2444,55107,53,25498,53,184,94,90,2,30,1,1
2445,56658,53,34980,53,458,188,270,6,30,3,3
2446,58036,443,9162,443,12752,5123,7629,39,90,18,21
2447,48935,443,24879,443,12753,6074,6679,44,88,23,21
2448,54136,80,25504,80,1585,863,722,12,15,6,6
2449,60498,55100,54000,55100,164,70,94,2,5,1,1
2450,35104,53,13881,53,168,78,90,2,29,1,1
2451,55903,53,64113,53,177,94,83,2,29,1,1
2452,50210,53,56208,53,756,94,662,2,29,1,1
2453,49321,53,38287,53,184,94,90,2,29,1,1
2454,64683,53,49305,53,821,102,719,2,29,1,1
2455,58961,80,48953,80,5412,4758,654,14,14,8,6
2456,55647,53,31412,53,168,86,82,2,29,1,1
2457,50524,53,52843,53,816,102,714,2,29,1,1
2458,52211,56648,11346,56648,70,70,0,1,4,1,0
2459,56677,53,7912,53,200,102,98,2,30,1,1
2460,49762,53,33292,53,184,94,90,2,30,1,1
2461,57297,53,52793,53,242,102,140,2,30,1,1
2462,49989,53,64218,53,755,94,661,2,29,1,1
2463,57284,53,33476,53,173,94,79,2,29,1,1
2464,54973,53,49914,53,811,94,717,2,29,1,1
2465,56204,53,61458,53,168,86,82,2,30,1,1
2466,57006,53,13462,53,196,102,94,2,29,1,1
2467,50524,53,62327,53,193,102,91,2,30,1,1
2468,63012,443,56934,443,3707,1245,2462,11,119,6,5
2469,64560,53,36010,53,184,94,90,2,29,1,1
2470,56688,53,13604,53,196,102,94,2,29,1,1
2471,49948,53,30662,53,214,94,120,2,30,1,1
2472,56041,53,5205,53,183,94,89,2,30,1,1
2473,55233,53,15536,53,215,102,113,2,30,1,1
2474,60499,51413,63354,51413,70,70,0,1,5,1,0
2475,36515,80,38433,80,51571,48786,2785,74,19,38,36
2476,56822,53,28434,53,184,94,90,2,30,1,1
2477,43564,53,37702,53,199,94,105,2,30,1,1
2478,56041,53,23370,53,183,94,89,2,30,1,1
2479,49368,443,53544,443,14412,3279,11133,33,19,17,16
2480,54382,53,54382,53,414,268,146,3,33,2,1
2481,35699,443,53038,443,2060,1106,954,17,150,10,7
2482,57228,53,50397,53,344,94,250,2,30,1,1
2483,56677,53,47518,53,200,102,98,2,30,1,1
2484,49552,53,25565,53,194,102,92,2,30,1,1
2485,56942,53,38411,53,177,94,83,2,30,1,1
2486,57431,53,54427,53,181,94,87,2,30,1,1
2487,55088,53,34841,53,177,94,83,2,30,1,1
2488,48095,53,40439,53,199,94,105,2,30,1,1
2489,56942,53,55677,53,177,94,83,2,30,1,1
2490,55823,53,52028,53,210,102,108,2,30,1,1
2491,52948,48482,33406,48482,5180,2470,2710,49,339,25,24
2492,60501,40829,17093,40829,70,70,0,1,5,1,0
2493,52209,37241,61696,37241,136,136,0,3,14,3,0
2494,56191,53,1757,53,177,94,83,2,30,1,1
2495,60863,53,60863,53,298,114,184,2,30,1,1
2496,55075,443,61643,443,2459,1608,851,17,25,9,8
2497,64122,53,46704,53,255,102,153,2,30,1,1
2498,56531,53,17376,53,309,94,215,2,30,1,1
2499,10963,53,10963,53,216,90,126,2,30,1,1
2500,56205,53,15763,53,240,110,130,2,30,1,1
2501,10061,443,5696,443,4984,892,4092,18,185,9,9
2502,58330,443,54762,443,7353,2840,4513,33,107,18,15
2503,52207,4637,29875,4637,136,136,0,3,14,3,0
2504,52208,47300,63479,47300,70,70,0,1,5,1,0
2505,55753,53,0,0,82,82,0,2,40,2,0
2506,49563,80,54340,80,1515,481,1034,11,15,6,5
2507,49762,53,65280,53,184,94,90,2,30,1,1
2508,49552,53,34956,53,194,102,92,2,30,1,1
2509,56617,53,38232,53,228,110,118,2,30,1,1
2510,57432,443,22941,443,26468,3325,23143,41,147,16,25
2511,51116,80,26188,80,14873,8100,6773,36,32,19,17
2512,51117,80,26474,80,5040,3914,1126,19,32,12,7
2513,50421,443,23778,443,562,222,340,9,26,4,5
2514,49369,53,34405,53,324,86,238,4,47,2,2
2515,55647,53,8145,53,168,86,82,2,30,1,1
2516,64124,53,4238,53,183,94,89,2,30,1,1
2517,63948,53,52448,53,366,102,264,4,60,2,2
2518,55638,53,63082,53,168,86,82,2,30,1,1
2519,56204,53,36998,53,168,86,82,2,30,1,1
2520,57122,53,58221,53,198,94,104,2,30,1,1
2521,56111,53,27769,53,227,110,117,2,30,1,1
2522,49480,53,58009,53,184,94,90,2,31,1,1
2523,55062,443,36502,443,14701,3640,11061,29,60,16,13
2524,49671,53,50695,53,335,117,218,4,36,2,2
2525,57288,443,50391,443,840,420,420,14,39,7,7
2526,55089,80,46073,80,1558,452,1106,11,15,6,5
2527,14445,443,55284,443,2589,1443,1146,18,15,8,10
2528,58061,80,39603,80,5571,2637,2934,23,75,12,11
2529,44155,53,24482,53,168,78,90,2,29,1,1
2530,43552,443,10231,443,4680,2873,1807,26,53,15,11
2531,56872,53,25005,53,443,182,261,6,29,3,3
2532,52049,80,61901,80,34695,17472,17223,55,33,28,27
2533,56688,53,52079,53,196,102,94,2,31,1,1
2534,60808,40010,35600,40010,316,136,180,6,6,3,3
2535,50672,80,28058,80,1515,481,1034,11,16,6,5
2536,60507,53830,57450,53830,320,140,180,6,6,3,3
2537,56748,53,55168,53,184,94,90,2,30,1,1
2538,52244,58774,22208,58774,70,70,0,2,6,2,0
2539,55056,443,30880,443,5233,3384,1849,21,62,11,10
2540,60213,80,45825,80,70,70,0,1,4,1,0
2541,55088,53,21749,53,177,94,83,2,30,1,1
2542,64124,53,27285,53,294,93,201,4,42,2,2
2543,49272,53,53692,53,198,102,96,2,30,1,1
2544,49366,443,23124,443,14668,3601,11067,34,19,19,15
2545,53959,39097,20337,39097,1450,761,689,14,15,8,6
2546,38715,443,52129,443,403299,12717,390582,439,16,171,268
2547,49743,443,50508,443,2372,1143,1229,21,82,10,11
2548,55871,53,26416,53,181,94,87,2,29,1,1
2549,62170,53,16163,53,234,94,140,2,29,1,1
2550,50279,53,54207,53,749,94,655,2,29,1,1
2551,56216,53,35008,53,177,94,83,2,29,1,1
2552,49760,53,45249,53,183,94,89,2,29,1,1
2553,55183,53,35427,53,177,94,83,2,29,1,1
2554,56257,53,40398,53,177,94,83,2,29,1,1
2555,39556,443,12327,443,7469,2547,4922,18,135,8,10
2556,55836,53,17348,53,177,94,83,2,30,1,1
2557,19366,53,39850,53,300,209,91,3,30,2,1
2558,57422,53,31757,53,821,102,719,2,30,1,1
2559,30188,56962,59522,56962,2746,1487,1259,21,2495,14,7
2560,49272,53,44204,53,198,102,96,2,30,1,1
2561,64072,80,14418,80,314,192,122,6,15,4,2
2562,56252,53,39340,53,228,110,118,2,30,1,1
2563,48443,53,3585,53,168,78,90,2,30,1,1
2564,56191,53,27279,53,177,94,83,2,30,1,1
2565,56748,53,15879,53,184,94,90,2,30,1,1
2566,56765,53,6433,53,194,102,92,2,30,1,1
2567,65240,53,35636,53,755,102,653,2,30,1,1
2568,32871,53,29403,53,199,94,105,2,30,1,1
2569,55556,53,41769,53,224,94,130,2,30,1,1
2570,52071,80,35224,80,1284,780,504,12,360,7,5
2571,43439,443,4737,443,13482,3731,9751,40,500,17,23
2572,49495,53,39798,53,758,102,656,2,31,1,1
2573,55053,80,18063,80,162010,4343,157667,170,98,61,109
2574,20727,53,20727,53,217,82,135,2,32,1,1
2575,49724,53,30037,53,470,131,339,4,32,2,2
2576,60500,44739,7471,44739,70,70,0,1,5,1,0
2577,55097,53,3886,53,324,102,222,4,42,2,2
2578,42947,443,14067,443,11377,7703,3674,26,161,19,7
2579,50548,443,50022,443,9277,2865,6412,31,200,18,13
2580,61920,53,61920,53,298,114,184,2,30,1,1
2581,52686,53,56390,53,199,94,105,2,30,1,1
2582,57409,53,41368,53,232,94,138,2,30,1,1
2583,56982,53,26329,53,193,94,99,2,30,1,1
2584,49264,443,65214,443,2424,258,2166,9,120,4,5
2585,58955,80,51848,80,3037,2276,761,12,28,7,5
2586,39994,80,39994,80,2919,1492,1427,10,15,6,4
2587,51129,80,6520,80,2794,2075,719,15,30,9,6
2588,52243,35643,17676,35643,70,70,0,2,6,2,0
2589,57038,53,63930,53,194,102,92,2,33,1,1
2590,9337,443,53921,443,428,128,300,8,47,3,5
2591,49216,53,56828,53,274,94,180,2,30,1,1
2592,55836,53,6468,53,177,94,83,2,30,1,1
2593,56678,53,49059,53,240,110,130,2,30,1,1
2594,55478,53,56587,53,177,94,83,2,30,1,1
2595,56822,53,60070,53,184,94,90,2,30,1,1
2596,57384,53,57923,53,228,110,118,2,30,1,1
2597,49821,53,3854,53,265,94,171,2,30,1,1
2598,56147,53,61785,53,258,110,148,2,30,1,1
2599,57422,53,42352,53,198,102,96,2,30,1,1
2600,49356,53,31993,53,763,102,661,2,31,1,1
2601,42727,443,63558,443,4813,970,3843,12,135,6,6
2602,57575,443,3355,443,707158,36853,670305,902,148,310,592
2603,57269,53,5905,53,183,94,89,2,30,1,1
2604,64128,53,31311,53,193,102,91,2,31,1,1
2605,49710,443,63933,443,7691,1797,5894,22,137,12,10
2606,56020,53,55046,53,168,86,82,2,30,1,1
2607,56506,53,36137,53,227,102,125,2,30,1,1
2608,55478,53,54641,53,177,94,83,2,30,1,1
2609,49969,53,53673,53,789,102,687,2,30,1,1
2610,56863,53,12002,53,177,94,83,2,31,1,1
2611,56397,53,11047,53,179,94,85,2,30,1,1
2612,51173,443,28678,443,13341,4805,8536,88,378,42,46
2613,6881,6881,38605,6881,502,150,352,2,1199,1,1
2614,48817,27294,48817,27294,150,150,0,1,1200,1,0
2615,56942,53,10682,53,177,94,83,2,31,1,1
2616,34014,80,56105,80,1951,731,1220,11,150,6,5
2617,57470,36670,48397,36670,3570,1126,2444,28,1465,16,12
2618,56020,53,24675,53,168,86,82,2,31,1,1
2619,56439,53,35642,53,198,102,96,2,31,1,1
2620,49224,53,51489,53,199,102,97,2,34,1,1
2621,37672,5223,15708,5223,110,110,0,1,5,1,0
2622,57269,53,43829,53,183,94,89,2,30,1,1
2623,64095,1976,59947,1976,66,66,0,2,8,2,0
2624,64098,10096,39565,10096,66,66,0,2,8,2,0
2625,55058,443,16741,443,12435,4022,8413,27,62,15,12
2626,49245,80,49245,80,378,180,198,7,54,4,3
2627,64094,1024,11634,1024,66,66,0,2,8,2,0
2628,57426,443,14949,443,832,268,564,14,37,5,9
2629,59845,15503,0,0,66,66,0,1,0,1,0
2630,45964,2225,0,0,60,60,0,1,0,1,0
2631,3986,17372,0,0,66,66,0,1,0,1,0
2632,61963,6881,0,0,146,146,0,1,0,1,0
2633,55082,445,0,0,70,70,0,1,0,1,0
2634,55081,445,0,0,70,70,0,1,0,1,0
2635,55075,445,0,0,70,70,0,1,0,1,0
2636,55067,445,0,0,70,70,0,1,0,1,0
2637,25565,1726,0,0,60,60,0,1,0,1,0
2638,45064,25174,0,0,62,62,0,1,0,1,0
2639,443,44683,0,0,83,83,0,1,0,1,0
2640,51922,44847,0,0,62,62,0,1,0,1,0
2641,50466,445,0,0,66,66,0,1,0,1,0
2642,50465,445,0,0,66,66,0,1,0,1,0
2643,50463,445,0,0,66,66,0,1,0,1,0
2644,50377,445,0,0,70,70,0,1,0,1,0
2645,63508,62413,0,0,66,66,0,1,0,1,0
2646,59068,49813,0,0,70,70,0,1,0,1,0
2647,55393,44512,0,0,66,66,0,1,0,1,0
2648,50354,56205,0,0,66,66,0,1,0,1,0
2649,63677,15503,0,0,66,66,0,1,0,1,0
2650,22981,15503,0,0,62,62,0,1,0,1,0
2651,50372,445,0,0,70,70,0,1,0,1,0
2652,55063,445,0,0,70,70,0,1,0,1,0
2653,19718,37965,0,0,66,66,0,1,0,1,0
2654,55059,445,0,0,70,70,0,1,0,1,0
2655,55055,445,0,0,70,70,0,1,0,1,0
2656,55056,445,0,0,70,70,0,1,0,1,0
2657,10874,25174,0,0,62,62,0,1,0,1,0
2658,57297,51221,0,0,66,66,0,1,0,1,0
2659,63765,51221,0,0,62,62,0,1,0,1,0
2660,49220,22,0,0,60,60,0,1,0,1,0
2661,26124,56205,0,0,146,146,0,1,0,1,0
2662,50367,445,0,0,70,70,0,1,0,1,0
2663,65287,36829,0,0,146,146,0,1,0,1,0
2664,1025,57470,0,0,62,62,0,1,0,1,0
2665,50366,445,0,0,70,70,0,1,0,1,0
2666,47632,25174,0,0,146,146,0,1,0,1,0
2667,25679,27189,0,0,62,62,0,1,0,1,0
2668,50364,445,0,0,70,70,0,1,0,1,0
2669,38959,25174,0,0,62,62,0,1,0,1,0
2670,10306,44847,0,0,62,62,0,1,0,1,0
2671,55045,445,0,0,70,70,0,1,0,1,0
2672,55044,445,0,0,70,70,0,1,0,1,0
2673,55039,445,0,0,70,70,0,1,0,1,0
2674,54280,3398,0,0,60,60,0,1,0,1,0
2675,34086,25174,0,0,66,66,0,1,0,1,0
2676,40086,22114,0,0,146,146,0,1,0,1,0
2677,3576,8305,0,0,145,145,0,1,0,1,0
2678,50453,445,0,0,66,66,0,1,0,1,0
2679,1814,62413,0,0,66,66,0,1,0,1,0
2680,26821,57866,0,0,62,62,0,1,0,1,0
2681,48258,37965,0,0,62,62,0,1,0,1,0
2682,51356,22114,0,0,62,62,0,1,0,1,0
2683,45908,33330,0,0,60,60,0,1,0,1,0
2684,50357,445,0,0,70,70,0,1,0,1,0
2685,14263,22114,0,0,62,62,0,1,0,1,0
2686,50355,445,0,0,70,70,0,1,0,1,0
2687,65270,3855,0,0,78,78,0,1,0,1,0
2688,55038,445,0,0,70,70,0,1,0,1,0
2689,50354,445,0,0,70,70,0,1,0,1,0
2690,55037,445,0,0,70,70,0,1,0,1,0
2691,50353,445,0,0,70,70,0,1,0,1,0
2692,50352,445,0,0,70,70,0,1,0,1,0
2693,64605,25174,0,0,66,66,0,1,0,1,0
2694,50346,445,0,0,70,70,0,1,0,1,0
2695,50347,445,0,0,70,70,0,1,0,1,0
2696,57726,37965,0,0,62,62,0,1,0,1,0
2697,60714,50584,0,0,66,66,0,1,0,1,0
2698,61085,37965,0,0,62,62,0,1,0,1,0
2699,56688,25174,0,0,66,66,0,1,0,1,0
2700,50436,445,0,0,66,66,0,1,0,1,0
2701,50437,445,0,0,66,66,0,1,0,1,0
2702,63988,22114,0,0,66,66,0,1,0,1,0
2703,57643,28189,0,0,60,60,0,1,0,1,0
2704,62080,54532,0,0,60,60,0,1,0,1,0
2705,3410,17372,0,0,62,62,0,1,0,1,0
2706,58724,43890,0,0,66,66,0,1,0,1,0
2707,50334,445,0,0,70,70,0,1,0,1,0
2708,59965,36237,0,0,62,62,0,1,0,1,0
2709,50333,445,0,0,70,70,0,1,0,1,0
2710,5610,37965,0,0,66,66,0,1,0,1,0
2711,50331,445,0,0,70,70,0,1,0,1,0
2712,49529,21247,0,0,62,62,0,1,0,1,0
2713,57015,42707,0,0,62,62,0,1,0,1,0
2714,46842,25174,0,0,146,146,0,1,0,1,0
2715,50324,445,0,0,70,70,0,1,0,1,0
2716,50323,445,0,0,70,70,0,1,0,1,0
2717,15635,41182,0,0,66,66,0,1,0,1,0
2718,55027,445,0,0,70,70,0,1,0,1,0
2719,55026,445,0,0,70,70,0,1,0,1,0
2720,55024,445,0,0,70,70,0,1,0,1,0
2721,55020,445,0,0,70,70,0,1,0,1,0
2722,3406,17372,0,0,62,62,0,1,0,1,0
2723,31410,25174,0,0,146,146,0,1,0,1,0
2724,4545,1900,0,0,136,136,0,1,0,1,0
2725,45013,50584,0,0,62,62,0,1,0,1,0
2726,44774,22114,0,0,146,146,0,1,0,1,0
2727,50432,445,0,0,66,66,0,1,0,1,0
2728,44774,22114,0,0,62,62,0,1,0,1,0
2729,39586,22114,0,0,66,66,0,1,0,1,0
2730,29576,37807,0,0,66,66,0,1,0,1,0
2731,4323,64147,0,0,66,66,0,1,0,1,0
2732,50426,445,0,0,66,66,0,1,0,1,0
2733,50427,445,0,0,66,66,0,1,0,1,0
2734,50425,445,0,0,66,66,0,1,0,1,0
2735,50422,445,0,0,66,66,0,1,0,1,0
2736,50421,445,0,0,66,66,0,1,0,1,0
2737,50418,445,0,0,66,66,0,1,0,1,0
2738,50415,445,0,0,66,66,0,1,0,1,0
2739,40772,15503,0,0,74,74,0,1,0,1,0
2740,63593,22114,0,0,62,62,0,1,0,1,0
2741,58129,26467,0,0,62,62,0,1,0,1,0
2742,55010,445,0,0,70,70,0,1,0,1,0
2743,50312,445,0,0,70,70,0,1,0,1,0
2744,55008,445,0,0,70,70,0,1,0,1,0
2745,55006,445,0,0,70,70,0,1,0,1,0
2746,55004,445,0,0,70,70,0,1,0,1,0
2747,53771,57470,0,0,66,66,0,1,0,1,0
2748,56679,51505,0,0,62,62,0,1,0,1,0
2749,50308,445,0,0,70,70,0,1,0,1,0
2750,60416,37965,0,0,66,66,0,1,0,1,0
2751,45941,23386,0,0,60,60,0,1,0,1,0
2752,3976,25174,0,0,62,62,0,1,0,1,0
2753,55003,445,0,0,70,70,0,1,0,1,0
2754,54997,445,0,0,70,70,0,1,0,1,0
2755,54996,445,0,0,70,70,0,1,0,1,0
2756,64808,62413,0,0,66,66,0,1,0,1,0
2757,61802,23,0,0,60,60,0,1,0,1,0
2758,50409,445,0,0,66,66,0,1,0,1,0
2759,43155,35440,0,0,62,62,0,1,0,1,0
2760,54995,445,0,0,70,70,0,1,0,1,0
2761,34335,23,0,0,60,60,0,1,0,1,0
2762,17171,22114,0,0,66,66,0,1,0,1,0
2763,50298,445,0,0,70,70,0,1,0,1,0
2764,50297,445,0,0,70,70,0,1,0,1,0
2765,50299,445,0,0,70,70,0,1,0,1,0
2766,50407,445,0,0,66,66,0,1,0,1,0
2767,5683,44847,0,0,66,66,0,1,0,1,0
2768,50293,445,0,0,70,70,0,1,0,1,0
2769,64150,22114,0,0,66,66,0,1,0,1,0
2770,24160,37807,0,0,62,62,0,1,0,1,0
2771,50405,445,0,0,66,66,0,1,0,1,0
2772,50403,445,0,0,66,66,0,1,0,1,0
2773,64737,53,51522,53,757,98,659,2,0,1,1
2774,50291,445,0,0,70,70,0,1,0,1,0
2775,11101,22114,0,0,146,146,0,1,0,1,0
2776,44528,5900,0,0,60,60,0,1,0,1,0
2777,58925,25174,0,0,66,66,0,1,0,1,0
2778,50402,445,0,0,66,66,0,1,0,1,0
2779,30129,37965,0,0,72,72,0,1,0,1,0
2780,0,0,0,0,124,64,60,2,0,1,1
2781,11775,25174,0,0,62,62,0,1,0,1,0
2782,56906,50584,0,0,62,62,0,1,0,1,0
2783,59031,25174,0,0,62,62,0,1,0,1,0
2784,51146,23117,0,0,66,66,0,1,0,1,0
2785,6778,50584,0,0,66,66,0,1,0,1,0
2786,12632,25174,0,0,146,146,0,1,0,1,0
2787,54990,445,0,0,70,70,0,1,0,1,0
2788,35507,15503,0,0,62,62,0,1,0,1,0
2789,25363,22114,0,0,66,66,0,1,0,1,0
2790,54981,445,0,0,70,70,0,1,0,1,0
2791,54977,445,0,0,70,70,0,1,0,1,0
2792,28579,64147,0,0,62,62,0,1,0,1,0
2793,50285,445,0,0,70,70,0,1,0,1,0
2794,8040,44847,0,0,66,66,0,1,0,1,0
2795,55427,64147,0,0,66,66,0,1,0,1,0
2796,52838,37965,0,0,66,66,0,1,0,1,0
2797,17146,57470,0,0,62,62,0,1,0,1,0
2798,55043,57470,0,0,78,78,0,1,0,1,0
2799,50391,445,0,0,66,66,0,1,0,1,0
2800,45269,50584,0,0,62,62,0,1,0,1,0
2801,57546,25174,0,0,66,66,0,1,0,1,0
2802,50277,445,0,0,70,70,0,1,0,1,0
2803,50407,62413,0,0,62,62,0,1,0,1,0
2804,59822,56205,0,0,62,62,0,1,0,1,0
2805,50274,445,0,0,70,70,0,1,0,1,0
2806,57613,42707,0,0,66,66,0,1,0,1,0
2807,53985,30188,0,0,66,66,0,1,0,1,0
2808,59345,25174,0,0,62,62,0,1,0,1,0
2809,58836,51505,0,0,66,66,0,1,0,1,0
2810,63640,57866,0,0,66,66,0,1,0,1,0
2811,50383,445,0,0,66,66,0,1,0,1,0
2812,7539,30317,0,0,62,62,0,1,0,1,0
2813,443,44683,0,0,83,83,0,1,0,1,0
2814,54967,445,0,0,70,70,0,1,0,1,0
2815,8080,37965,0,0,62,62,0,1,0,1,0
2816,44710,25174,0,0,62,62,0,1,0,1,0
2817,50270,445,0,0,70,70,0,1,0,1,0
2818,6999,2310,0,0,143,143,0,1,0,1,0
2819,50269,445,0,0,70,70,0,1,0,1,0
2820,59076,25174,0,0,62,62,0,1,0,1,0
2821,50381,445,0,0,66,66,0,1,0,1,0
2822,18398,21247,0,0,66,66,0,1,0,1,0
2823,23310,22114,0,0,62,62,0,1,0,1,0
2824,52564,15503,0,0,74,74,0,1,0,1,0
2825,7561,43890,0,0,62,62,0,1,0,1,0
2826,50265,445,0,0,70,70,0,1,0,1,0
2827,50372,445,0,0,66,66,0,1,0,1,0
2828,51052,50584,0,0,66,66,0,1,0,1,0
2829,58230,64147,0,0,66,66,0,1,0,1,0
2830,64797,53,54337,53,182,93,89,2,30,1,1
2831,52892,443,17240,443,41925,30922,11003,68,186,38,30
2832,49685,80,12171,80,1548,847,701,10,16,5,5
2833,49240,8080,49240,8080,22799,6835,15964,35,56,20,15
2834,57571,443,57571,443,881747,19604,862143,728,175,144,584
2835,55727,43736,4643,43736,70,70,0,2,8,2,0
2836,49243,80,49243,80,378,180,198,7,53,4,3
2837,49238,8080,49238,8080,378,180,198,7,53,4,3
2838,49242,80,49242,80,378,180,198,7,53,4,3
2839,57572,443,57572,443,181333,21870,159463,187,175,65,122
2840,49272,53,7753,53,196,100,96,2,30,1,1
2841,55095,53,54084,53,783,96,687,2,30,1,1
2842,50630,53,37346,53,754,94,660,2,30,1,1
2843,56368,53,19580,53,711,87,624,2,30,1,1
2844,60494,33709,52651,33709,504,318,186,8,16,5,3
2845,52240,52893,59916,52893,70,70,0,2,6,2,0
2846,52194,22674,61715,22674,66,66,0,1,5,1,0
2847,1380,53,1380,53,235,90,145,2,32,1,1
2848,64099,55470,5838,55470,66,66,0,2,8,2,0
2849,27296,443,26053,443,10243,1659,8584,29,83,13,16
2850,56795,443,62237,443,8021,2001,6020,20,15,11,9
2851,55893,53,33227,53,267,94,173,4,56,2,2
2852,55072,53,45639,53,170,87,83,2,31,1,1
2853,57134,53,30351,53,190,97,93,2,30,1,1
2854,3755,443,3755,443,12079,1344,10735,24,17,10,14
2855,31925,53,31925,53,237,91,146,2,33,1,1
2856,56794,443,16368,443,8073,2053,6020,20,15,11,9
2857,55526,53,26801,53,749,94,655,2,30,1,1
2858,64128,53,32109,53,186,95,91,2,30,1,1
2859,43212,443,25002,443,7476,2192,5284,27,316,13,14
2860,26831,443,14363,443,7283,2586,4697,22,19,11,11
2861,49239,8080,49239,8080,378,180,198,7,53,4,3
2862,53984,57077,13402,57077,70,70,0,2,8,2,0
2863,57436,53,31842,53,182,93,89,2,30,1,1
2864,50600,53,50600,53,257,101,156,2,34,1,1
2865,26742,53,26742,53,237,91,146,2,33,1,1
2866,57120,53,16635,53,761,100,661,2,30,1,1
2867,5643,53,5643,53,237,91,146,2,33,1,1
2868,47042,443,19544,443,2809,1884,925,19,25,11,8
2869,57139,53,57139,53,235,90,145,2,32,1,1
2870,55642,53,4187,53,711,87,624,2,30,1,1
2871,55633,53,54670,53,816,97,719,2,30,1,1
2872,60860,443,28548,443,11687,2565,9122,46,66,25,21
2873,49686,80,54142,80,2611,1811,800,13,15,7,6
2874,56688,53,38230,53,192,98,94,2,30,1,1
2875,56796,443,60351,443,8074,2054,6020,20,15,11,9
2876,58035,53,58035,53,237,91,146,2,32,1,1
2877,64092,14447,3904,14447,66,66,0,2,8,2,0
2878,50819,443,24202,443,11217,3882,7335,42,164,19,23
2879,52203,1024,52908,1024,136,136,0,3,14,3,0
2880,43032,443,42506,443,2940,1721,1219,17,361,9,8
2881,64779,53,1103,53,810,108,702,2,30,1,1
2882,56793,443,4192,443,8022,2002,6020,20,16,11,9
2883,39683,443,12229,443,101895,6430,95465,152,175,66,86
2884,56487,53,25181,53,788,108,680,2,31,1,1
2885,32299,40019,6627,40019,261,175,86,2,31,1,1
2886,49364,53,25963,53,307,307,0,4,61,4,0
2887,51848,443,16596,443,5788,3446,2342,22,135,11,11
2888,57470,1500,26703,1500,528,528,0,9,1200,9,0
2889,55025,53,8549,53,93,93,0,1,31,1,0
2890,56424,53,11596,53,170,87,83,2,31,1,1
2891,56163,53,27486,53,188,96,92,2,31,1,1
2892,56020,53,48606,53,168,86,82,2,31,1,1
2893,55617,53,30754,53,212,108,104,2,31,1,1
2894,49929,53,57396,53,212,108,104,2,31,1,1
2895,6882,30499,61301,30499,150,150,0,1,1200,1,0
2896,64712,53,32542,53,181,98,83,2,31,1,1
2897,123,123,4169,123,184,94,90,2,31,1,1
2898,57144,53,3454,53,172,88,84,2,31,1,1
2899,54998,53,2972,53,196,100,96,2,31,1,1
2900,50375,1,0,0,74,74,0,1,91,1,0
2901,56603,53,10898,53,174,89,85,2,31,1,1
2902,53124,443,9153,443,64407,55712,8695,92,364,58,34
2903,51414,22,0,0,60,60,0,1,0,1,0
2904,51414,22,0,0,60,60,0,1,0,1,0
2905,4162,21532,0,0,146,146,0,1,0,1,0
2906,52128,37807,0,0,66,66,0,1,0,1,0
2907,50367,445,0,0,66,66,0,1,0,1,0
2908,33912,25174,0,0,62,62,0,1,0,1,0
2909,50264,445,0,0,70,70,0,1,0,1,0
2910,65228,53,0,0,88,88,0,1,0,1,0
2911,62208,37965,0,0,66,66,0,1,0,1,0
2912,42417,22114,0,0,62,62,0,1,0,1,0
2913,45964,2225,0,0,60,60,0,1,0,1,0
2914,50259,445,0,0,70,70,0,1,0,1,0
2915,55725,14704,2998,14704,70,70,0,2,8,2,0
2916,35422,443,43455,443,154,94,60,2,5,1,1
2917,9487,443,35248,443,5179,2934,2245,25,32,13,12
2918,53496,443,54389,443,3155,2234,921,15,16,8,7
2919,58481,15503,0,0,146,146,0,1,0,1,0
2920,54955,445,0,0,70,70,0,1,0,1,0
2921,54957,445,0,0,70,70,0,1,0,1,0
2922,54956,445,0,0,70,70,0,1,0,1,0
2923,1025,50584,0,0,62,62,0,1,0,1,0
2924,50350,445,0,0,66,66,0,1,0,1,0
2925,50357,445,0,0,66,66,0,1,0,1,0
2926,50352,445,0,0,66,66,0,1,0,1,0
2927,50356,445,0,0,66,66,0,1,0,1,0
2928,50354,445,0,0,66,66,0,1,0,1,0
2929,50358,445,0,0,66,66,0,1,0,1,0
2930,50353,445,0,0,66,66,0,1,0,1,0
2931,50351,445,0,0,66,66,0,1,0,1,0
2932,443,4512,0,0,60,60,0,1,0,1,0
2933,11337,25773,0,0,159,159,0,1,0,1,0
2934,60676,57866,0,0,66,66,0,1,0,1,0
2935,5685,35440,0,0,66,66,0,1,0,1,0
2936,29742,50584,0,0,62,62,0,1,0,1,0
2937,63627,26296,0,0,159,159,0,1,0,1,0
2938,19427,23,0,0,60,60,0,1,0,1,0
2939,49607,25174,0,0,62,62,0,1,0,1,0
2940,3456,11392,0,0,66,66,0,1,0,1,0
2941,54951,445,0,0,70,70,0,1,0,1,0
2942,54947,445,0,0,70,70,0,1,0,1,0
2943,54942,445,0,0,70,70,0,1,0,1,0
2944,54940,445,0,0,70,70,0,1,0,1,0
2945,51993,25174,0,0,62,62,0,1,0,1,0
2946,50246,445,0,0,70,70,0,1,0,1,0
2947,37609,15503,0,0,146,146,0,1,0,1,0
2948,14656,36237,0,0,62,62,0,1,0,1,0
2949,50337,445,0,0,66,66,0,1,0,1,0
2950,50338,445,0,0,66,66,0,1,0,1,0
2951,50335,445,0,0,66,66,0,1,0,1,0
2952,61273,25174,0,0,146,146,0,1,0,1,0
2953,50243,445,0,0,70,70,0,1,0,1,0
2954,6892,36949,0,0,159,159,0,1,0,1,0
2955,62183,57470,0,0,74,74,0,1,0,1,0
2956,56039,50584,0,0,66,66,0,1,0,1,0
2957,58357,62413,0,0,146,146,0,1,0,1,0
2958,54936,445,0,0,70,70,0,1,0,1,0
2959,57236,53733,0,0,62,62,0,1,0,1,0
2960,54934,445,0,0,70,70,0,1,0,1,0
2961,54930,445,0,0,70,70,0,1,0,1,0
2962,54926,445,0,0,70,70,0,1,0,1,0
2963,33453,64147,0,0,62,62,0,1,0,1,0
2964,443,44683,0,0,83,83,0,1,0,1,0
2965,59977,30188,0,0,66,66,0,1,0,1,0
2966,50238,445,0,0,70,70,0,1,0,1,0
2967,58873,443,27496,443,1855088,42017,1813071,1821,49,531,1290
2968,49323,53,12095,53,790,110,680,2,30,1,1
2969,56652,53,23903,53,821,102,719,2,30,1,1
2970,64941,53,8617,53,199,102,97,2,30,1,1
2971,64797,53,56821,53,183,94,89,2,30,1,1
2972,49742,53,44369,53,199,94,105,2,30,1,1
2973,64763,53,53321,53,214,110,104,2,30,1,1
2974,56526,443,31407,443,5082,973,4109,18,60,9,9
2975,49247,80,49247,80,378,180,198,7,53,4,3
2976,64075,1026,24378,1026,70,70,0,1,4,1,0
2977,55893,53,24260,53,267,94,173,4,55,2,2
2978,55318,53,26417,53,167,86,81,2,29,1,1
2979,55465,443,38707,443,12399,3942,8457,83,615,42,41
2980,63433,443,29608,443,1950,1231,719,20,15,12,8
2981,51433,80,51433,80,12796,1635,11161,21,15,8,13
2982,56525,443,34500,443,5022,973,4049,17,60,9,8
2983,65234,53,35438,53,193,102,91,2,30,1,1
2984,38714,443,54689,443,90043,3609,86434,97,15,33,64
2985,50080,443,5025,443,15595,3264,12331,26,35,14,12
2986,49272,53,2689,53,198,102,96,2,29,1,1
2987,53960,61038,13704,61038,552,306,246,9,14,5,4
2988,53985,26515,51989,26515,70,70,0,2,7,2,0
2989,57431,53,12541,53,181,94,87,2,29,1,1
2990,46719,443,39379,443,7261,3272,3989,22,45,13,9
2991,52227,27904,24192,27904,316,136,180,6,9,3,3
2992,56971,53,24481,53,195,102,93,2,30,1,1
2993,53983,40500,52248,40500,70,70,0,2,7,2,0
2994,52205,24416,50314,24416,136,136,0,3,13,3,0
2995,49714,53,19961,53,490,101,389,4,45,2,2
2996,58785,53,54759,53,211,86,125,2,30,1,1
2997,50332,53,15195,53,193,102,91,2,29,1,1
2998,49402,53,62978,53,214,110,104,2,30,1,1
2999,52200,42430,15926,42430,66,66,0,2,10,2,0
3000,57631,443,64255,443,154,94,60,2,5,1,1
3001,53273,443,62514,443,17169,6566,10603,52,37,24,28
3002,43829,443,59022,443,368,160,208,6,33,3,3
3003,50544,53,6922,53,193,102,91,2,30,1,1
3004,57269,53,63044,53,183,94,89,2,30,1,1
3005,49480,53,47457,53,184,94,90,2,30,1,1
3006,64750,53,43856,53,193,102,91,2,30,1,1
3007,49003,53,49003,53,262,106,156,2,32,1,1
3008,56750,80,10595,80,194,128,66,4,25,3,1
3009,65294,53,7465,53,184,102,82,2,30,1,1
3010,44724,443,7111,443,4383,2829,1554,27,80,14,13
3011,55049,443,10286,443,12851,3808,9043,30,61,16,14
3012,9463,443,40374,443,8952,5576,3376,35,38,21,14
3013,39915,443,9924,443,15058,8409,6649,40,271,21,19
3014,50544,53,48893,53,816,102,714,2,30,1,1
3015,42947,53,42947,53,260,106,154,2,33,1,1
3016,64640,53,17711,53,249,94,155,2,30,1,1
3017,37653,5223,53311,5223,70,70,0,1,5,1,0
3018,55726,32463,13679,32463,70,70,0,2,8,2,0
3019,52050,80,59091,80,20868,10484,10384,34,32,17,17
3020,65389,53,2887,53,215,102,113,2,30,1,1
3021,9334,443,58101,443,674,128,546,12,46,3,9
3022,51506,443,39609,443,4869,699,4170,14,15,8,6
3023,56652,53,12784,53,198,102,96,2,30,1,1
3024,55053,443,38835,443,23234,3906,19328,40,61,19,21
3025,65294,53,37568,53,168,86,82,2,30,1,1
3026,64268,53,55887,53,679,179,500,6,69,3,3
3027,65461,53,60419,53,226,94,132,2,30,1,1
3028,56688,53,20462,53,196,102,94,2,30,1,1
3029,64685,53,55702,53,193,102,91,2,30,1,1
3030,55490,443,55467,443,3080,1018,2062,10,120,5,5
3031,50241,53,51739,53,184,102,82,2,30,1,1
3032,52204,36387,46788,36387,136,136,0,3,13,3,0
3033,51995,443,36323,443,9966,5049,4917,41,15,25,16
3034,51121,443,8150,443,5553,2844,2709,21,30,11,10
3035,57134,53,41374,53,195,102,93,2,30,1,1
3036,55478,53,55747,53,177,94,83,2,30,1,1
3037,55072,53,59629,53,177,94,83,2,30,1,1
3038,19573,53,49198,53,183,78,105,2,30,1,1
3039,49480,53,12824,53,184,94,90,2,30,1,1
3040,57436,53,46375,53,183,94,89,2,30,1,1
3041,55958,53,32998,53,177,94,83,2,30,1,1
3042,64128,53,26433,53,193,102,91,2,30,1,1
3043,57436,53,1607,53,183,94,89,2,30,1,1
3044,49402,53,18505,53,214,110,104,2,30,1,1
3045,57063,53,34748,53,177,94,83,2,30,1,1
3046,52202,64241,19062,64241,250,66,184,4,9,2,2
3047,52195,50930,54222,50930,70,70,0,1,5,1,0
3048,57512,443,32314,443,4265,2639,1626,34,31,16,18
3049,9464,443,61543,443,9340,5582,3758,36,38,21,15
3050,9477,443,41654,443,7461,1448,6013,22,35,11,11
3051,52930,443,25439,443,4596,1029,3567,15,26,9,6
3052,49701,53,45217,53,523,92,431,4,48,2,2
3053,55050,443,4346,443,7372,2875,4497,23,61,13,10
3054,55958,53,17152,53,177,94,83,2,30,1,1
3055,58306,443,35402,443,5995,3536,2459,31,20,17,14
3056,52432,443,37828,443,330,190,140,6,15,4,2
3057,36433,80,4245,80,1585,863,722,12,15,6,6
3058,49237,8080,49237,8080,4451,1329,3122,13,53,7,6
3059,55062,53,27959,53,194,94,100,2,31,1,1
3060,57574,443,57574,443,164451,18310,146141,163,175,52,111
3061,50425,443,27749,443,4600,667,3933,14,17,7,7
3062,39550,80,36745,80,1598,731,867,17,362,8,9
3063,56747,80,7383,80,194,128,66,4,25,3,1
3064,53953,34661,36111,34661,552,306,246,9,15,5,4
3065,56748,80,43315,80,194,128,66,4,25,3,1
3066,53986,54070,21018,54070,70,70,0,2,7,2,0
3067,50420,443,27192,443,648,210,438,10,27,4,6
3068,49236,8080,49236,8080,4458,1336,3122,13,53,7,6
3069,49246,80,49246,80,378,180,198,7,53,4,3
3070,52241,51717,30281,51717,70,70,0,2,5,2,0
3071,49241,8080,49241,8080,12477,3635,8842,23,55,13,10
3072,55893,53,45153,53,267,94,173,4,56,2,2
3073,52239,1172,16970,1172,256,136,120,5,5,3,2
3074,56204,53,64652,53,168,86,82,2,29,1,1
3075,64093,64828,28561,64828,66,66,0,2,7,2,0
3076,3470,53,3470,53,217,82,135,2,32,1,1
3077,56822,53,57328,53,184,94,90,2,29,1,1
3078,52160,443,26040,443,956,420,536,15,26,7,8
3079,53982,24226,50334,24226,70,70,0,2,7,2,0
3080,55107,53,60741,53,184,94,90,2,29,1,1
3081,52198,12727,50505,12727,66,66,0,2,10,2,0
3082,55724,45682,40719,45682,70,70,0,2,8,2,0
3083,65070,53,12563,53,198,102,96,2,30,1,1
3084,64044,21989,15782,21989,816,508,308,12,27,7,5
3085,53987,16571,41017,16571,70,70,0,2,7,2,0
3086,52398,443,30861,443,323437,18923,304514,544,252,276,268
3087,58755,53,43262,53,277,102,175,2,30,1,1
3088,64815,53,31191,53,214,110,104,2,30,1,1
3089,52199,35549,28334,35549,66,66,0,2,10,2,0
3090,56765,53,25229,53,194,102,92,2,29,1,1
3091,59897,443,39118,443,9919,4495,5424,53,118,30,23
3092,55088,53,51001,53,177,94,83,2,29,1,1
3093,52931,443,64191,443,416,210,206,7,26,4,3
3094,50332,53,12740,53,193,102,91,2,29,1,1
3095,56748,53,37401,53,184,94,90,2,30,1,1
3096,49775,80,50741,80,254,128,126,5,16,3,2
3097,56439,53,49648,53,198,102,96,2,29,1,1
3098,65258,53,18646,53,763,102,661,2,30,1,1
3099,56677,53,61027,53,200,102,98,2,30,1,1
3100,56863,53,37391,53,177,94,83,2,30,1,1
3101,64797,53,6795,53,183,94,89,2,30,1,1
3102,49870,53,17515,53,194,102,92,2,30,1,1
3103,57436,53,48007,53,183,94,89,2,30,1,1
3104,49418,53,2882,53,165,86,79,2,30,1,1
3105,65229,53,28081,53,195,102,93,2,30,1,1
3106,50369,53,47601,53,166,86,80,2,30,1,1
3107,37574,123,51434,123,184,94,90,2,30,1,1
3108,49308,53,30302,53,195,102,93,2,31,1,1
3109,64941,53,17276,53,199,102,97,2,30,1,1
3110,55072,53,7801,53,177,94,83,2,30,1,1
3111,49254,53,47857,53,173,94,79,2,30,1,1
3112,55072,53,28531,53,177,94,83,2,30,1,1
3113,57398,53,40796,53,196,94,102,2,31,1,1
3114,32299,40021,3069,40021,148,86,62,2,31,1,1
3115,53259,443,6892,443,5513,929,4584,20,360,10,10
3116,52434,80,48898,80,1647,481,1166,13,15,6,7
3117,52193,33027,51097,33027,70,70,0,1,5,1,0
3118,56971,53,47465,53,195,102,93,2,30,1,1
3119,64763,53,14685,53,214,110,104,2,30,1,1
3120,56765,53,28041,53,194,102,92,2,30,1,1
3121,64797,53,38007,53,183,94,89,2,30,1,1
3122,65465,53,62433,53,372,126,246,2,30,1,1
3123,57063,53,54503,53,177,94,83,2,30,1,1
3124,57134,53,42837,53,195,102,93,2,30,1,1
3125,49402,53,34826,53,214,110,104,2,30,1,1
3126,57396,53,7718,53,184,94,90,2,30,1,1
3127,51714,123,49877,123,184,94,90,2,30,1,1
3128,55879,53,59038,53,184,94,90,2,30,1,1
3129,51391,443,62057,443,9973,1941,8032,38,121,19,19
3130,15503,63093,6070,63093,481,150,331,2,1200,1,1
3131,56163,53,47774,53,194,102,92,2,30,1,1
3132,57588,443,14769,443,7629,3270,4359,34,337,17,17
3133,56749,80,24129,80,194,128,66,4,25,3,1
3134,52201,44054,12966,44054,66,66,0,2,9,2,0
3135,55722,26192,51333,26192,70,70,0,1,5,1,0
3136,35516,80,25484,80,841,715,126,5,15,3,2
3137,64815,53,51366,53,214,110,104,2,30,1,1
3138,49870,53,59356,53,194,102,92,2,30,1,1
3139,64599,53,27573,53,398,102,296,2,30,1,1
3140,56439,53,18376,53,198,102,96,2,30,1,1
3141,34107,443,34100,443,11976,5066,6910,83,2475,43,40
3142,65181,53,41975,53,421,96,325,4,42,2,2
3143,9444,443,26906,443,7353,1570,5783,22,39,11,11
3144,9443,443,55182,443,7398,1480,5918,24,39,12,12
3145,60990,443,42071,443,212824,12881,199943,244,49,101,143
3146,52425,443,14303,443,64135,3588,60547,88,40,38,50
3147,65070,53,45301,53,821,102,719,2,30,1,1
3148,64748,53,54658,53,212,102,110,2,30,1,1
3149,64941,53,15219,53,199,102,97,2,30,1,1
3150,50241,53,32622,53,184,102,82,2,30,1,1
3151,56341,53,11727,53,243,94,149,2,30,1,1
3152,65229,53,50271,53,195,102,93,2,30,1,1
3153,57396,53,20662,53,807,94,713,2,30,1,1
3154,64685,53,47182,53,193,102,91,2,30,1,1
3155,49308,53,4514,53,195,102,93,2,30,1,1
3156,49703,53,62145,53,228,110,118,2,30,1,1
3157,64980,53,1256,53,199,102,97,2,31,1,1
3158,54998,53,21655,53,198,102,96,2,31,1,1
3159,44889,443,7395,443,9982,2062,7920,37,120,19,18
3160,49499,443,1804,443,5541,2623,2918,28,144,15,13
3161,57470,40794,36042,40794,132,132,0,3,1199,3,0
3162,57072,53,34434,53,193,102,91,2,30,1,1
3163,56332,53,17265,53,193,102,91,2,30,1,1
3164,55025,53,14358,53,183,94,89,2,31,1,1
3165,56332,53,36197,53,193,102,91,2,31,1,1
3166,65234,53,58797,53,193,102,91,2,31,1,1
3167,64710,53,45310,53,195,102,93,2,31,1,1
3168,37334,443,47156,443,6592,1735,4857,23,360,11,12
3169,44847,37005,6154,37005,150,150,0,1,1200,1,0
3170,50584,6881,26330,6881,502,150,352,2,1200,1,1
3171,56226,53,55576,53,512,187,325,6,58,3,3
3172,52189,24190,59596,24190,70,70,0,1,5,1,0
3173,52236,15313,56383,15313,70,70,0,2,5,2,0
3174,37673,443,65454,443,3226,2225,1001,18,47,11,7
3175,52217,36746,31872,36746,316,136,180,6,9,3,3
3176,53955,3290,25446,3290,70,70,0,1,5,1,0
3177,52054,80,38291,80,41406,4176,37230,57,32,25,32
3178,51992,443,50696,443,1083,596,487,11,16,7,4
3179,57914,80,49885,80,6527,1210,5317,15,18,8,7
3180,49998,443,24613,443,24410,6698,17712,32,16,13,19
3181,52223,11979,36766,11979,70,70,0,2,9,2,0
3182,51993,443,1370,443,1209,656,553,13,16,8,5
3183,6897,48817,0,0,139,139,0,1,0,1,0
3184,50237,445,0,0,70,70,0,1,0,1,0
3185,32424,25174,0,0,146,146,0,1,0,1,0
3186,26762,22114,0,0,62,62,0,1,0,1,0
3187,60141,30188,0,0,66,66,0,1,0,1,0
3188,65417,44847,0,0,66,66,0,1,0,1,0
3189,50235,445,0,0,70,70,0,1,0,1,0
3190,52812,25174,0,0,66,66,0,1,0,1,0
3191,63050,57470,0,0,74,74,0,1,0,1,0
3192,11983,57470,0,0,62,62,0,1,0,1,0
3193,59096,8604,0,0,66,66,0,1,0,1,0
3194,57846,57866,0,0,66,66,0,1,0,1,0
3195,32484,2323,0,0,60,60,0,1,0,1,0
3196,54916,445,0,0,70,70,0,1,0,1,0
3197,54913,445,0,0,70,70,0,1,0,1,0
3198,54911,445,0,0,70,70,0,1,0,1,0
3199,50325,445,0,0,66,66,0,1,0,1,0
3200,50228,445,0,0,70,70,0,1,0,1,0
3201,53260,36237,0,0,62,62,0,1,0,1,0
3202,50226,445,0,0,70,70,0,1,0,1,0
3203,58148,43890,0,0,62,62,0,1,0,1,0
3204,50225,445,0,0,70,70,0,1,0,1,0
3205,36357,25174,0,0,66,66,0,1,0,1,0
3206,50224,445,0,0,70,70,0,1,0,1,0
3207,54910,445,0,0,70,70,0,1,0,1,0
3208,50223,445,0,0,70,70,0,1,0,1,0
3209,443,44683,0,0,83,83,0,1,0,1,0
3210,50219,445,0,0,70,70,0,1,0,1,0
3211,50217,445,0,0,70,70,0,1,0,1,0
3212,60861,25174,0,0,66,66,0,1,0,1,0
3213,56876,11392,0,0,66,66,0,1,0,1,0
3214,54909,445,0,0,70,70,0,1,0,1,0
3215,40772,15503,0,0,74,74,0,1,0,1,0
3216,52340,22114,0,0,66,66,0,1,0,1,0
3217,50310,445,0,0,66,66,0,1,0,1,0
3218,50308,445,0,0,66,66,0,1,0,1,0
3219,62919,9694,0,0,146,146,0,1,0,1,0
3220,50198,445,0,0,70,70,0,1,0,1,0
3221,50205,445,0,0,70,70,0,1,0,1,0
3222,50204,445,0,0,70,70,0,1,0,1,0
3223,30303,22530,0,0,169,169,0,1,0,1,0
3224,50195,445,0,0,70,70,0,1,0,1,0
3225,50194,445,0,0,70,70,0,1,0,1,0
3226,52518,35440,0,0,62,62,0,1,0,1,0
3227,54898,445,0,0,70,70,0,1,0,1,0
3228,54899,445,0,0,70,70,0,1,0,1,0
3229,54895,445,0,0,70,70,0,1,0,1,0
3230,54892,445,0,0,70,70,0,1,0,1,0
3231,53721,62413,0,0,62,62,0,1,0,1,0
3232,6889,34962,0,0,143,143,0,1,0,1,0
3233,52969,44847,0,0,62,62,0,1,0,1,0
3234,50303,445,0,0,66,66,0,1,0,1,0
3235,11494,51505,0,0,146,146,0,1,0,1,0
3236,443,44683,0,0,83,83,0,1,0,1,0
3237,64406,25174,0,0,66,66,0,1,0,1,0
3238,50291,445,0,0,66,66,0,1,0,1,0
3239,50296,445,0,0,66,66,0,1,0,1,0
3240,50293,445,0,0,66,66,0,1,0,1,0
3241,50288,445,0,0,66,66,0,1,0,1,0
3242,50295,445,0,0,66,66,0,1,0,1,0
3243,50297,445,0,0,66,66,0,1,0,1,0
3244,50287,445,0,0,66,66,0,1,0,1,0
3245,50183,445,0,0,70,70,0,1,0,1,0
3246,443,62514,0,0,66,66,0,1,0,1,0
3247,54882,445,0,0,70,70,0,1,0,1,0
3248,54598,37965,0,0,62,62,0,1,0,1,0
3249,54880,445,0,0,70,70,0,1,0,1,0
3250,54879,445,0,0,70,70,0,1,0,1,0
3251,54876,445,0,0,70,70,0,1,0,1,0
3252,56067,25174,0,0,62,62,0,1,0,1,0
3253,50990,23884,0,0,62,62,0,1,0,1,0
3254,50127,64147,0,0,66,66,0,1,0,1,0
3255,0,0,0,0,480,244,236,4,0,2,2
3256,62902,32468,0,0,66,66,0,1,0,1,0
3257,50179,445,0,0,70,70,0,1,0,1,0
3258,54874,445,0,0,70,70,0,1,0,1,0
3259,54869,445,0,0,70,70,0,1,0,1,0
3260,54868,445,0,0,70,70,0,1,0,1,0
3261,443,50238,0,0,331,331,0,1,0,1,0
3262,50169,445,0,0,70,70,0,1,0,1,0
3263,50167,445,0,0,70,70,0,1,0,1,0
3264,50170,445,0,0,70,70,0,1,0,1,0
3265,50280,445,0,0,66,66,0,1,0,1,0
3266,50164,445,0,0,70,70,0,1,0,1,0
3267,54867,445,0,0,70,70,0,1,0,1,0
3268,52033,50584,0,0,66,66,0,1,0,1,0
3269,443,45788,0,0,332,332,0,1,0,1,0
3270,50162,445,0,0,70,70,0,1,0,1,0
3271,50279,445,0,0,66,66,0,1,0,1,0
3272,58253,25174,0,0,146,146,0,1,0,1,0
3273,7701,23,0,0,60,60,0,1,0,1,0
3274,50277,445,0,0,66,66,0,1,0,1,0
3275,50276,445,0,0,66,66,0,1,0,1,0
3276,35610,37965,0,0,62,62,0,1,0,1,0
3277,443,44683,0,0,83,83,0,1,0,1,0
3278,50274,445,0,0,66,66,0,1,0,1,0
3279,53318,22114,0,0,66,66,0,1,0,1,0
3280,33132,123,0,0,234,234,0,1,0,1,0
3281,34993,15503,0,0,62,62,0,1,0,1,0
3282,43671,17372,0,0,62,62,0,1,0,1,0
3283,50156,445,0,0,70,70,0,1,0,1,0
3284,49594,22114,0,0,66,66,0,1,0,1,0
3285,54857,445,0,0,70,70,0,1,0,1,0
3286,27745,50584,0,0,62,62,0,1,0,1,0
3287,54849,445,0,0,70,70,0,1,0,1,0
3288,27448,22114,0,0,62,62,0,1,0,1,0
3289,443,9986,0,0,669,669,0,1,0,1,0
3290,50263,445,0,0,66,66,0,1,0,1,0
3291,50149,445,0,0,70,70,0,1,0,1,0
3292,30270,37965,0,0,62,62,0,1,0,1,0
3293,50146,445,0,0,70,70,0,1,0,1,0
3294,44784,443,49876,443,12834,7868,4966,60,463,38,22
3295,56790,443,12015,443,8073,2053,6020,20,16,11,9
3296,52221,33166,34754,33166,70,70,0,2,8,2,0
3297,57468,2258,57468,2258,156,156,0,3,8,3,0
3298,53961,13067,4497,13067,70,70,0,1,5,1,0
3299,59339,80,59339,80,107838,4143,103695,178,15,59,119
3300,50337,53,56473,53,762,97,665,2,30,1,1
3301,64710,53,31226,53,190,97,93,2,30,1,1
3302,47598,443,10751,443,22048,16451,5597,47,18,21,26
3303,38537,443,38537,443,4662,1755,2907,19,30,11,8
3304,60884,443,1605,443,6505,2038,4467,26,46,15,11
3305,5588,5588,0,0,3354,1792,1562,46,194,23,23
3306,65234,53,64779,53,186,95,91,2,31,1,1
3307,49459,53,24594,53,198,101,97,2,30,1,1
3308,49308,53,20210,53,190,97,93,2,30,1,1
3309,7968,53,7968,53,407,261,146,3,32,2,1
3310,8082,53,8082,53,237,91,146,2,33,1,1
3311,64883,53,13274,53,184,94,90,2,31,1,1
3312,59340,80,59340,80,24437,12718,11719,41,15,16,25
3313,52186,57609,42161,57609,66,66,0,1,5,1,0
3314,56792,443,43093,443,8074,2054,6020,20,15,11,9
3315,56791,443,55063,443,8021,2001,6020,20,15,11,9
3316,36551,443,34195,443,8674,2101,6573,25,15,13,12
3317,51754,7000,51754,7000,4727,2346,2381,19,16,12,7
3318,10436,53,10436,53,237,91,146,2,32,1,1
3319,56247,53,34021,53,751,95,656,2,30,1,1
3320,64089,20260,49240,20260,66,66,0,2,8,2,0
3321,52225,31985,22878,31985,70,70,0,2,8,2,0
3322,55879,53,40028,53,184,94,90,2,30,1,1
3323,48471,443,48471,443,4381,1474,2907,19,26,11,8
3324,5588,5588,0,0,3354,1792,1562,46,193,23,23
3325,57115,53,47701,53,172,88,84,2,30,1,1
3326,36499,53,58408,53,302,208,94,3,30,2,1
3327,42982,443,14998,443,7467,1522,5945,26,16,14,12
3328,49941,53,34590,53,186,95,91,2,31,1,1
3329,64242,53,44715,53,176,90,86,2,31,1,1
3330,43718,53,43718,53,209,77,132,2,34,1,1
3331,7975,53,7975,53,237,91,146,2,33,1,1
3332,64684,53,19854,53,184,94,90,2,31,1,1
3333,58077,36653,28921,36653,268,128,140,5,10,3,2
3334,52184,57262,17429,57262,66,66,0,1,5,1,0
3335,64685,53,52958,53,186,95,91,2,30,1,1
3336,58653,53,0,0,82,82,0,1,30,1,0
3337,57288,53,62463,53,770,101,669,2,30,1,1
3338,56332,53,50254,53,186,95,91,2,30,1,1
3339,65408,53,61605,53,764,99,665,2,30,1,1
3340,56606,53,17065,53,762,97,665,2,31,1,1
3341,49370,443,17640,443,350,210,140,6,16,4,2
3342,65206,53,9006,53,762,98,664,2,30,1,1
3343,55161,53,9497,53,732,89,643,2,30,1,1
3344,55579,53,14828,53,172,88,84,2,30,1,1
3345,51808,443,64378,443,3871,1166,2705,13,136,6,7
3346,39895,443,43258,443,10727,3308,7419,33,503,15,18
3347,53625,53,53625,53,643,88,555,2,31,1,1
3348,55273,53,3281,53,764,99,665,2,31,1,1
3349,64770,53,63194,53,93,93,0,1,31,1,0
3350,64639,53,5053,53,198,101,97,2,31,1,1
3351,57181,53,16955,53,753,96,657,2,31,1,1
3352,50334,443,29587,443,3193,346,2847,12,121,5,7
3353,5588,5588,0,0,3354,1792,1562,46,194,23,23
3354,50455,53,22933,53,756,95,661,2,30,1,1
3355,57378,53,2616,53,756,95,661,2,31,1,1
3356,55799,53,31223,53,752,93,659,2,31,1,1
3357,64283,53,28343,53,186,95,91,2,31,1,1
3358,59777,443,22920,443,19311,2432,16879,55,417,24,31
3359,56864,53,65006,53,200,102,98,2,31,1,1
3360,55265,53,47317,53,198,101,97,2,31,1,1
3361,10151,27949,13472,27949,469,149,320,2,1200,1,1
3362,54596,443,49824,443,4510,2210,2300,14,136,7,7
3363,59537,443,51089,443,3351,841,2510,13,136,6,7
3364,56622,53,51149,53,757,98,659,2,31,1,1
3365,56446,443,1598,443,16401,10833,5568,32,362,18,14
3366,53125,443,24442,443,3358,1952,1406,16,360,8,8
3367,18574,56205,0,0,62,62,0,1,0,1,0
3368,53089,24211,0,0,66,66,0,1,0,1,0
3369,50255,445,0,0,66,66,0,1,0,1,0
3370,52863,50584,0,0,66,66,0,1,0,1,0
3371,50143,445,0,0,70,70,0,1,0,1,0
3372,54839,445,0,0,70,70,0,1,0,1,0
3373,50141,445,0,0,70,70,0,1,0,1,0
3374,57325,37965,0,0,62,62,0,1,0,1,0
3375,50367,37965,0,0,66,66,0,1,0,1,0
3376,18745,64147,0,0,66,66,0,1,0,1,0
3377,28999,37807,0,0,62,62,0,1,0,1,0
3378,64949,44847,0,0,62,62,0,1,0,1,0
3379,56775,9200,31796,9200,8223,3066,5157,30,33,15,15
3380,55879,53,11765,53,184,94,90,2,30,1,1
3381,38690,443,27226,443,8871,3470,5401,24,123,13,11
3382,56603,53,24241,53,179,94,85,2,30,1,1
3383,51848,443,58021,443,68198,5503,62695,102,40,43,59
3384,51596,443,63040,443,4638384,61757,4576627,3641,280,309,3332
3385,52190,29765,59554,29765,70,70,0,1,4,1,0
3386,52187,38153,27552,38153,70,70,0,1,4,1,0
3387,64041,53,28808,53,380,92,288,4,37,2,2
3388,57354,53,64428,53,198,94,104,2,29,1,1
3389,49929,53,44359,53,214,110,104,2,29,1,1
3390,57134,53,24003,53,195,102,93,2,29,1,1
3391,60473,22170,57823,22170,1599,743,856,13,36,7,6
3392,53944,23280,32203,23280,1740,834,906,16,16,10,6
3393,52188,13182,17024,13182,70,70,0,1,4,1,0
3394,51994,443,26093,443,330,190,140,6,15,4,2
3395,64685,53,12212,53,534,193,341,6,78,3,3
3396,64997,53,32660,53,771,102,669,2,29,1,1
3397,64856,53,25050,53,451,124,327,4,45,2,2
3398,49459,53,5838,53,199,102,97,2,29,1,1
3399,49254,53,63665,53,173,94,79,2,29,1,1
3400,60914,53,60914,53,180,82,98,2,29,1,1
3401,52219,37398,8768,37398,316,136,180,6,8,3,3
3402,52185,13269,13389,13269,70,70,0,1,4,1,0
3403,57072,53,31261,53,816,102,714,2,29,1,1
3404,53962,16251,51780,16251,70,70,0,1,4,1,0
3405,49586,53,25001,53,212,94,118,2,29,1,1
3406,52226,48784,24421,48784,70,70,0,2,8,2,0
3407,54998,53,23774,53,198,102,96,2,29,1,1
3408,64088,39650,57206,39650,66,66,0,2,7,2,0
3409,52237,16801,36529,16801,70,70,0,2,4,2,0
3410,64883,53,48996,53,184,94,90,2,30,1,1
3411,55255,53,4437,53,282,94,188,2,29,1,1
3412,50369,53,17923,53,166,86,80,2,29,1,1
3413,56424,53,45965,53,177,94,83,2,29,1,1
3414,64885,53,14280,53,261,102,159,2,29,1,1
3415,48982,53,28037,53,306,212,94,3,29,2,1
3416,55462,53,64670,53,214,110,104,2,29,1,1
3417,64980,53,27979,53,199,102,97,2,29,1,1
3418,123,123,40397,123,184,94,90,2,30,1,1
3419,44945,80,24197,80,1729,1287,442,7,15,5,2
3420,51911,443,51829,443,4456,2972,1484,38,211,20,18
3421,47831,443,18559,443,180582,6020,174562,196,200,70,126
3422,64641,53,5011,53,260,102,158,2,30,1,1
3423,64968,53,62769,53,767,102,665,2,30,1,1
3424,55372,53,44494,53,199,102,97,2,30,1,1
3425,49907,53,22787,53,199,102,97,2,30,1,1
3426,49342,53,2621,53,200,102,98,2,30,1,1
3427,47665,443,4370,443,214,140,74,4,15,3,1
3428,64490,53,23595,53,280,118,162,2,30,1,1
3429,64175,53,22231,53,453,100,353,4,57,2,2
3430,50700,80,7989,80,142,142,0,1,5,1,0
3431,64495,53,28201,53,243,94,149,2,30,1,1
3432,64988,53,6131,53,360,110,250,2,30,1,1
3433,55723,80,12672,80,70,70,0,2,8,2,0
3434,50709,80,40115,80,1658,1247,411,8,15,5,3
3435,65344,53,6284,53,211,102,109,2,30,1,1
3436,57381,443,25601,443,4645,700,3945,12,15,8,4
3437,65366,53,65366,53,244,98,146,2,33,1,1
3438,49853,53,4793,53,291,102,189,2,30,1,1
3439,41741,443,63716,443,20594,4629,15965,46,317,29,17
3440,50755,80,64278,80,1783,1346,437,7,15,5,2
3441,56424,53,21857,53,177,94,83,2,30,1,1
3442,62054,443,20146,443,10596,3874,6722,30,62,17,13
3443,56163,53,9366,53,194,102,92,2,30,1,1
3444,55617,53,46139,53,214,110,104,2,30,1,1
3445,64883,53,2709,53,184,94,90,2,30,1,1
3446,49437,53,49111,53,498,204,294,6,30,3,3
3447,64712,53,1546,53,177,94,83,2,30,1,1
3448,51812,443,55280,443,10741,7368,3373,32,135,16,16
3449,57144,53,45834,53,178,94,84,2,30,1,1
3450,57411,443,31872,443,214,140,74,4,15,3,1
3451,64096,1127,15786,1127,312,132,180,6,6,3,3
3452,47832,443,4961,443,130090,7064,123026,184,200,92,92
3453,41298,443,14805,443,2974,1378,1596,28,34,15,13
3454,49764,443,46462,443,114197,7285,106912,177,77,85,92
3455,55516,53,62536,53,211,102,109,2,30,1,1
3456,28280,53,52004,53,168,78,90,2,30,1,1
3457,50079,443,34341,443,7274,2208,5066,26,255,14,12
3458,49326,53,31358,53,193,102,91,2,31,1,1
3459,60805,20010,5973,20010,70,70,0,1,5,1,0
3460,39537,8245,49028,8245,280,214,66,2,30,1,1
3461,55579,53,62219,53,178,94,84,2,30,1,1
3462,49941,53,13341,53,193,102,91,2,30,1,1
3463,48994,443,64205,443,46452,6817,39635,103,299,45,58
3464,51001,443,45191,443,5841,1986,3855,19,18,11,8
3465,53949,42301,56593,42301,1396,719,677,15,15,8,7
3466,52222,11516,64024,11516,70,70,0,2,8,2,0
3467,60496,56871,22838,56871,504,318,186,8,15,5,3
3468,52191,32843,31336,32843,70,70,0,1,4,1,0
3469,50699,80,24288,80,7292,3171,4121,19,21,11,8
3470,37694,80,28033,80,1190,591,599,8,15,5,3
3471,52220,65128,43562,65128,70,70,0,2,8,2,0
3472,52238,48996,6858,48996,70,70,0,2,4,2,0
3473,43586,443,62166,443,2328,1429,899,18,33,10,8
3474,43701,3389,43701,3389,3910,1805,2105,20,19,12,8
3475,55893,53,44273,53,267,94,173,4,55,2,2
3476,44320,443,32394,443,154,94,60,2,4,1,1
3477,64750,53,24687,53,193,102,91,2,29,1,1
3478,52701,443,13239,443,130,70,60,3,5,2,1
3479,49352,53,51513,53,216,102,114,2,29,1,1
3480,55071,53,30463,53,356,118,238,2,29,1,1
3481,46593,28678,34181,28678,1806,1806,0,22,224,22,0
3482,56424,53,8677,53,177,94,83,2,29,1,1
3483,57409,443,54706,443,1054,567,487,10,15,6,4
3484,55462,53,19938,53,214,110,104,2,29,1,1
3485,51688,123,9497,123,184,94,90,2,29,1,1
3486,64242,53,3579,53,180,94,86,2,30,1,1
3487,55144,53,13694,53,316,94,222,2,29,1,1
3488,57115,53,18402,53,178,94,84,2,30,1,1
3489,44517,53,22276,53,306,212,94,3,29,2,1
3490,55879,53,9895,53,184,94,90,2,29,1,1
3491,49418,53,32330,53,165,86,79,2,29,1,1
3492,57115,53,57243,53,178,94,84,2,29,1,1
3493,32299,40019,4671,40019,148,86,62,2,30,1,1
3494,49929,53,53934,53,214,110,104,2,30,1,1
3495,64710,53,1727,53,195,102,93,2,29,1,1
3496,64684,53,47246,53,184,94,90,2,30,1,1
3497,55617,53,20605,53,214,110,104,2,30,1,1
3498,64684,53,48311,53,184,94,90,2,30,1,1
3499,64171,53,30410,53,94,94,0,1,30,1,0
3500,49459,53,33594,53,199,102,97,2,30,1,1
3501,123,123,12424,123,184,94,90,2,30,1,1
3502,57144,53,55905,53,178,94,84,2,30,1,1
3503,65236,53,5620,53,758,102,656,2,30,1,1
3504,55372,53,36344,53,199,102,97,2,30,1,1
3505,49342,53,62127,53,200,102,98,2,30,1,1
3506,64522,53,42718,53,230,102,128,2,31,1,1
3507,55786,53,43858,53,177,94,83,2,31,1,1
3508,37965,48167,49022,48167,490,149,341,3,1199,2,1
3509,49941,53,58431,53,193,102,91,2,30,1,1
3510,49469,53,2393,53,185,102,83,2,30,1,1
3511,56603,53,17293,53,179,94,85,2,30,1,1
3512,65075,53,5602,53,164,86,78,2,31,1,1
3513,49459,53,35212,53,199,102,97,2,31,1,1
3514,53723,443,51817,443,70,70,0,1,5,1,0
3515,51910,443,32865,443,308,188,120,4,15,2,2
3516,45109,443,9498,443,190,70,120,4,15,2,2
3517,51051,443,1978,443,7712,2203,5509,24,516,14,10
3518,50627,443,54044,443,5427,3497,1930,23,141,13,10
3519,64568,53,24682,53,388,134,254,2,30,1,1
3520,54815,3389,54815,3389,3424,1710,1714,16,31,8,8
3521,50316,53,18070,53,816,102,714,2,30,1,1
3522,65518,53,59686,53,211,102,109,2,30,1,1
3523,49277,53,14856,53,230,102,128,2,30,1,1
3524,32914,80,9670,80,1542,831,711,7,15,5,2
3525,47663,443,61725,443,214,140,74,4,15,3,1
3526,44228,443,32223,443,7352,1790,5562,24,263,12,12
3527,49374,53,26527,53,199,94,105,2,30,1,1
3528,55617,53,11638,53,214,110,104,2,30,1,1
3529,64242,53,41761,53,180,94,86,2,30,1,1
3530,65028,53,13338,53,763,102,661,2,30,1,1
3531,55579,53,12007,53,178,94,84,2,30,1,1
3532,50316,53,39379,53,193,102,91,2,30,1,1
3533,56008,53,22150,53,230,86,144,2,30,1,1
3534,56603,53,28698,53,179,94,85,2,30,1,1
3535,49342,53,56835,53,200,102,98,2,30,1,1
3536,51913,443,51764,443,190,70,120,4,15,2,2
3537,58959,80,58892,80,5481,4758,723,15,15,8,7
3538,52174,43106,3385,43106,160,70,90,2,8,1,1
3539,9335,443,4512,443,674,128,546,12,45,3,9
3540,64046,18318,32519,18318,3197,1526,1671,19,26,12,7
3541,37952,80,16690,80,1372,868,504,13,35,8,5
3542,63464,443,19526,443,8543,1114,7429,26,93,11,15
3543,44227,443,19248,443,7491,1930,5561,26,263,14,12
3544,57115,53,1229,53,178,94,84,2,30,1,1
3545,65154,53,12899,53,196,94,102,2,30,1,1
3546,42315,443,13240,443,13090,9437,3653,43,188,14,29
3547,55820,53,19644,53,194,102,92,2,30,1,1
3548,49941,53,57941,53,193,102,91,2,31,1,1
3549,64283,53,30888,53,193,102,91,2,31,1,1
3550,40672,443,9807,443,9150,2155,6995,38,295,15,23
3551,56882,53,12251,53,87,87,0,2,60,2,0
3552,50992,443,14898,443,49212,42366,6846,109,147,59,50
3553,54526,443,1853,443,33625519,489773,33135746,29877,243,6803,23074
3554,65322,53,59723,53,235,94,141,2,30,1,1
3555,55866,443,45291,443,53845,7300,46545,80,31,38,42
3556,42121,53,52822,53,199,94,105,2,31,1,1
3557,65090,53,63161,53,230,102,128,2,31,1,1
3558,50294,53,23372,53,178,94,84,2,30,1,1
3559,65515,53,18245,53,195,102,93,2,31,1,1
3560,49469,53,45496,53,177,94,83,2,30,1,1
3561,64639,53,49663,53,199,102,97,2,31,1,1
3562,58381,53,27908,53,199,94,105,2,31,1,1
3563,57793,53,34542,53,168,78,90,2,31,1,1
3564,64684,53,15819,53,184,94,90,2,31,1,1
3565,64724,53,50975,53,195,102,93,2,31,1,1
3566,56332,53,61425,53,193,102,91,2,31,1,1
3567,54998,53,27657,53,198,102,96,2,31,1,1
3568,46899,443,58934,443,9085,2222,6863,39,125,19,20
3569,65234,53,47492,53,193,102,91,2,31,1,1
3570,51638,443,56586,443,8176,2082,6094,26,360,12,14
3571,56079,53,14640,53,199,102,97,2,31,1,1
3572,52334,443,32129,443,96091,8340,87751,159,205,75,84
3573,62241,443,33164,443,7205,2250,4955,16,120,7,9
3574,50191,53,52829,53,182,102,80,2,30,1,1
3575,54889,443,50379,443,4600,2214,2386,13,134,7,6
3576,30188,33365,39784,33365,42329,18517,23812,241,2378,116,125
3577,51221,51413,53021,51413,460,150,310,2,1200,1,1
3578,49512,53,60222,53,195,102,93,2,31,1,1
3579,37912,443,31339,443,130,70,60,3,5,2,1
3580,49913,53,48535,53,493,94,399,4,40,2,2
3581,38914,443,38914,443,4644,1737,2907,19,28,11,8
3582,49982,53,15818,53,322,94,228,4,49,2,2
3583,55820,53,60004,53,194,102,92,2,31,1,1
3584,51880,8000,15502,8000,750,360,390,10,60,5,5
3585,53122,443,25117,443,23067,5901,17166,43,73,21,22
3586,58638,5900,58638,5900,130,66,64,2,5,1,1
3587,58638,5900,58638,5900,66,66,0,1,5,1,0
3588,58638,5900,58638,5900,130,66,64,2,5,1,1
3589,58638,5900,58638,5900,130,66,64,2,5,1,1
3590,45732,443,54582,443,6558,2131,4427,26,262,10,16
3591,50730,443,7850,443,1323,738,585,10,16,6,4
3592,50252,445,0,0,66,66,0,1,0,1,0
3593,50137,445,0,0,70,70,0,1,0,1,0
3594,53750,25174,0,0,66,66,0,1,0,1,0
3595,53275,21247,0,0,66,66,0,1,0,1,0
3596,58835,17372,0,0,66,66,0,1,0,1,0
3597,64622,36829,0,0,62,62,0,1,0,1,0
3598,53667,22114,0,0,66,66,0,1,0,1,0
3599,50246,445,0,0,66,66,0,1,0,1,0
3600,50136,445,0,0,70,70,0,1,0,1,0
3601,48144,21247,0,0,66,66,0,1,0,1,0
3602,5223,32965,0,0,220,220,0,1,0,1,0
3603,21294,21247,0,0,146,146,0,1,0,1,0
3604,50239,445,0,0,66,66,0,1,0,1,0
3605,53376,22114,0,0,146,146,0,1,0,1,0
3606,46619,57470,0,0,62,62,0,1,0,1,0
3607,51954,57470,0,0,66,66,0,1,0,1,0
3608,11585,56205,0,0,62,62,0,1,0,1,0
3609,54633,36237,0,0,66,66,0,1,0,1,0
3610,32679,37965,0,0,62,62,0,1,0,1,0
3611,3117,37965,0,0,62,62,0,1,0,1,0
3612,4862,37965,0,0,66,66,0,1,0,1,0
3613,18739,23,0,0,60,60,0,1,0,1,0
3614,56818,60043,0,0,66,66,0,1,0,1,0
3615,50131,445,0,0,70,70,0,1,0,1,0
3616,7844,22114,0,0,66,66,0,1,0,1,0
3617,61455,64147,0,0,66,66,0,1,0,1,0
3618,13027,64147,0,0,62,62,0,1,0,1,0
3619,53305,50584,0,0,66,66,0,1,0,1,0
3620,63495,50584,0,0,66,66,0,1,0,1,0
3621,52745,25174,0,0,66,66,0,1,0,1,0
3622,54830,445,0,0,70,70,0,1,0,1,0
3623,54828,445,0,0,70,70,0,1,0,1,0
3624,54827,445,0,0,70,70,0,1,0,1,0
3625,62721,56205,0,0,66,66,0,1,0,1,0
3626,48706,23393,0,0,60,60,0,1,0,1,0
3627,49590,57470,0,0,78,78,0,1,0,1,0
3628,50229,445,0,0,66,66,0,1,0,1,0
3629,50230,445,0,0,66,66,0,1,0,1,0
3630,50226,445,0,0,66,66,0,1,0,1,0
3631,50225,445,0,0,66,66,0,1,0,1,0
3632,50228,445,0,0,66,66,0,1,0,1,0
3633,50222,445,0,0,66,66,0,1,0,1,0
3634,50224,445,0,0,66,66,0,1,0,1,0
3635,50223,445,0,0,66,66,0,1,0,1,0
3636,24073,22114,0,0,62,62,0,1,0,1,0
3637,61550,5529,0,0,145,145,0,1,0,1,0
3638,62183,57470,0,0,74,74,0,1,0,1,0
3639,60428,25174,0,0,66,66,0,1,0,1,0
3640,12531,22114,0,0,146,146,0,1,0,1,0
3641,50828,23,0,0,60,60,0,1,0,1,0
3642,63488,22114,0,0,62,62,0,1,0,1,0
3643,50118,445,0,0,70,70,0,1,0,1,0
3644,52018,22114,0,0,146,146,0,1,0,1,0
3645,54821,445,0,0,70,70,0,1,0,1,0
3646,54816,445,0,0,70,70,0,1,0,1,0
3647,54814,445,0,0,70,70,0,1,0,1,0
3648,54811,445,0,0,70,70,0,1,0,1,0
3649,4752,30188,0,0,62,62,0,1,0,1,0
3650,32796,37965,0,0,62,62,0,1,0,1,0
3651,51474,14914,0,0,139,139,0,1,0,1,0
3652,58535,30317,0,0,62,62,0,1,0,1,0
3653,54912,64147,0,0,66,66,0,1,0,1,0
3654,19136,64147,0,0,62,62,0,1,0,1,0
3655,50115,445,0,0,70,70,0,1,0,1,0
3656,50210,445,0,0,66,66,0,1,0,1,0
3657,50208,445,0,0,66,66,0,1,0,1,0
3658,50207,445,0,0,66,66,0,1,0,1,0
3659,19623,25174,0,0,62,62,0,1,0,1,0
3660,20741,64147,0,0,62,62,0,1,0,1,0
3661,1027,57866,0,0,62,62,0,1,0,1,0
3662,57523,25174,0,0,146,146,0,1,0,1,0
3663,54808,445,0,0,70,70,0,1,0,1,0
3664,443,4205,0,0,320,320,0,1,0,1,0
3665,57325,60043,0,0,66,66,0,1,0,1,0
3666,59497,64097,0,0,66,66,0,1,0,1,0
3667,50111,445,0,0,70,70,0,1,0,1,0
3668,54803,445,0,0,70,70,0,1,0,1,0
3669,54797,445,0,0,70,70,0,1,0,1,0
3670,54795,445,0,0,70,70,0,1,0,1,0
3671,29177,44847,0,0,62,62,0,1,0,1,0
3672,50109,445,0,0,70,70,0,1,0,1,0
3673,61711,35440,0,0,62,62,0,1,0,1,0
3674,16979,56205,0,0,62,62,0,1,0,1,0
3675,36419,50584,0,0,146,146,0,1,0,1,0
3676,36120,57470,0,0,145,145,0,1,0,1,0
3677,50107,445,0,0,70,70,0,1,0,1,0
3678,19068,37965,0,0,62,62,0,1,0,1,0
3679,51550,11392,0,0,66,66,0,1,0,1,0
3680,4328,7302,0,0,66,66,0,1,0,1,0
3681,65270,3855,0,0,78,78,0,1,0,1,0
3682,17038,36829,0,0,146,146,0,1,0,1,0
3683,52459,33890,0,0,60,60,0,1,0,1,0
3684,56719,37807,0,0,62,62,0,1,0,1,0
3685,43747,22114,0,0,62,62,0,1,0,1,0
3686,62838,44847,0,0,66,66,0,1,0,1,0
3687,12503,25174,0,0,146,146,0,1,0,1,0
3688,56102,53,3387,53,757,98,659,2,0,1,1
3689,54788,445,0,0,70,70,0,1,0,1,0
3690,54787,445,0,0,70,70,0,1,0,1,0
3691,54783,445,0,0,70,70,0,1,0,1,0
3692,8889,2117,0,0,60,60,0,1,0,1,0
3693,50100,445,0,0,70,70,0,1,0,1,0
3694,62744,62413,0,0,66,66,0,1,0,1,0
3695,24560,51050,0,0,146,146,0,1,0,1,0
3696,24376,50584,0,0,62,62,0,1,0,1,0
3697,50198,445,0,0,66,66,0,1,0,1,0
3698,50098,445,0,0,70,70,0,1,0,1,0
3699,23353,25174,0,0,62,62,0,1,0,1,0
3700,8734,56205,0,0,66,66,0,1,0,1,0
3701,23353,25174,0,0,146,146,0,1,0,1,0
3702,31660,35440,0,0,62,62,0,1,0,1,0
3703,50097,445,0,0,70,70,0,1,0,1,0
3704,50096,445,0,0,70,70,0,1,0,1,0
3705,11692,25174,0,0,62,62,0,1,0,1,0
3706,50095,445,0,0,70,70,0,1,0,1,0
3707,50089,445,0,0,70,70,0,1,0,1,0
3708,50092,445,0,0,70,70,0,1,0,1,0
3709,40254,25174,0,0,62,62,0,1,0,1,0
3710,54782,445,0,0,70,70,0,1,0,1,0
3711,54781,445,0,0,70,70,0,1,0,1,0
3712,55817,36829,0,0,66,66,0,1,0,1,0
3713,52596,17372,0,0,62,62,0,1,0,1,0
3714,26566,44847,0,0,66,66,0,1,0,1,0
3715,50076,445,0,0,70,70,0,1,0,1,0
3716,50075,445,0,0,70,70,0,1,0,1,0
3717,40418,25174,0,0,66,66,0,1,0,1,0
3718,50070,445,0,0,70,70,0,1,0,1,0
3719,50065,445,0,0,70,70,0,1,0,1,0
3720,50066,445,0,0,70,70,0,1,0,1,0
3721,50182,445,0,0,66,66,0,1,0,1,0
3722,50180,445,0,0,66,66,0,1,0,1,0
3723,52745,57866,0,0,62,62,0,1,0,1,0
3724,30181,61689,0,0,62,62,0,1,0,1,0
3725,64923,25174,0,0,66,66,0,1,0,1,0
3726,48025,44847,0,0,62,62,0,1,0,1,0
3727,56098,64147,0,0,66,66,0,1,0,1,0
3728,57607,21247,0,0,66,66,0,1,0,1,0
3729,42542,25174,0,0,146,146,0,1,0,1,0
3730,54768,445,0,0,70,70,0,1,0,1,0
3731,54767,445,0,0,70,70,0,1,0,1,0
3732,54766,445,0,0,70,70,0,1,0,1,0
3733,54760,445,0,0,70,70,0,1,0,1,0
3734,53844,22114,0,0,62,62,0,1,0,1,0
3735,47179,53733,0,0,146,146,0,1,0,1,0
3736,58463,11392,0,0,66,66,0,1,0,1,0
3737,0,0,0,0,134,64,70,2,0,1,1
3738,58543,6881,0,0,146,146,0,1,0,1,0
3739,50174,445,0,0,66,66,0,1,0,1,0
3740,50054,445,0,0,70,70,0,1,0,1,0
3741,54539,26467,0,0,62,62,0,1,0,1,0
3742,49380,21247,0,0,66,66,0,1,0,1,0
3743,46640,9002,0,0,60,60,0,1,0,1,0
3744,50164,445,0,0,66,66,0,1,0,1,0
3745,50169,445,0,0,66,66,0,1,0,1,0
3746,50171,445,0,0,66,66,0,1,0,1,0
3747,50168,445,0,0,66,66,0,1,0,1,0
3748,50162,445,0,0,66,66,0,1,0,1,0
3749,50161,445,0,0,66,66,0,1,0,1,0
3750,50159,445,0,0,66,66,0,1,0,1,0
3751,62971,44847,0,0,66,66,0,1,0,1,0
3752,53353,26467,0,0,62,62,0,1,0,1,0
3753,443,14315,0,0,158,158,0,1,0,1,0
3754,54757,445,0,0,70,70,0,1,0,1,0
3755,13168,35440,0,0,66,66,0,1,0,1,0
3756,443,59890,0,0,60,60,0,1,0,1,0
3757,54752,445,0,0,70,70,0,1,0,1,0
3758,54749,445,0,0,70,70,0,1,0,1,0
3759,54748,445,0,0,70,70,0,1,0,1,0
3760,38565,51505,0,0,66,66,0,1,0,1,0
3761,46180,1433,0,0,60,60,0,1,0,1,0
3762,50050,445,0,0,70,70,0,1,0,1,0
3763,53995,25174,0,0,66,66,0,1,0,1,0
3764,57793,37807,0,0,66,66,0,1,0,1,0
3765,50041,445,0,0,70,70,0,1,0,1,0
3766,50040,445,0,0,70,70,0,1,0,1,0
3767,50039,445,0,0,70,70,0,1,0,1,0
3768,23379,57866,0,0,62,62,0,1,0,1,0
3769,50035,445,0,0,70,70,0,1,0,1,0
3770,28064,36237,0,0,62,62,0,1,0,1,0
3771,54740,445,0,0,70,70,0,1,0,1,0
3772,54745,445,0,0,70,70,0,1,0,1,0
3773,54743,445,0,0,70,70,0,1,0,1,0
3774,50033,445,0,0,70,70,0,1,0,1,0
3775,50153,445,0,0,66,66,0,1,0,1,0
3776,54739,445,0,0,70,70,0,1,0,1,0
3777,50151,445,0,0,66,66,0,1,0,1,0
3778,7105,25174,0,0,66,66,0,1,0,1,0
3779,50149,445,0,0,66,66,0,1,0,1,0
3780,50148,445,0,0,66,66,0,1,0,1,0
3781,50146,445,0,0,66,66,0,1,0,1,0
3782,59845,15503,0,0,66,66,0,1,0,1,0
3783,3381,44847,0,0,78,78,0,1,0,1,0
3784,56258,53,45112,53,166,85,81,2,31,1,1
3785,37669,443,48889,443,24415,3924,20491,45,48,22,23
3786,37152,443,20347,443,7794,2670,5124,27,316,14,13
3787,58638,5900,58638,5900,126,62,64,2,5,1,1
3788,58638,5900,58638,5900,126,62,64,2,5,1,1
3789,58638,5900,58638,5900,126,62,64,2,5,1,1
3790,58638,5900,58638,5900,62,62,0,1,5,1,0
3791,58638,5900,58638,5900,62,62,0,1,5,1,0
3792,58638,5900,58638,5900,62,62,0,1,5,1,0
3793,57002,53,38861,53,731,85,646,2,30,1,1
3794,47643,443,8942,443,11108,3774,7334,28,230,13,15
3795,58638,5900,58638,5900,62,62,0,1,5,1,0
3796,53954,57868,29520,57868,70,70,0,1,5,1,0
3797,49514,53,50895,53,780,93,687,2,30,1,1
3798,40159,443,53282,443,5360,4048,1312,22,265,11,11
3799,50624,443,1028,443,12712,3662,9050,32,140,17,15
3800,30945,53,30945,53,237,91,146,2,32,1,1
3801,55325,53,12048,53,762,101,661,2,30,1,1
3802,57265,53,26246,53,762,98,664,2,30,1,1
3803,48171,443,3704,443,10420,3506,6914,33,274,18,15
3804,47276,443,9154,443,9503,5267,4236,56,218,31,25
3805,56079,53,63600,53,198,101,97,2,31,1,1
3806,64724,53,10875,53,190,97,93,2,31,1,1
3807,64789,53,3910,53,198,101,97,2,30,1,1
3808,64454,3389,64454,3389,4350,2261,2089,21,18,11,10
3809,9189,80,9189,80,13456,880,12576,21,16,9,12
3810,56786,443,23041,443,7929,1940,5989,20,16,11,9
3811,51969,443,9113,443,15609,5649,9960,58,76,31,27
3812,53134,443,53110,443,8361,2182,6179,26,40,15,11
3813,58638,5900,58638,5900,62,62,0,1,5,1,0
3814,58638,5900,58638,5900,62,62,0,1,5,1,0
3815,58638,5900,58638,5900,126,62,64,2,5,1,1
3816,51880,8000,29097,8000,270,270,0,4,33,4,0
3817,58638,5900,58638,5900,126,62,64,2,5,1,1
3818,49882,80,49056,80,2560,599,1961,13,75,7,6
3819,58638,5900,58638,5900,62,62,0,1,5,1,0
3820,58638,5900,58638,5900,62,62,0,1,5,1,0
3821,55048,443,61796,443,12799,3662,9137,40,50,22,18
3822,65006,53,31072,53,793,101,692,2,30,1,1
3823,39462,80,39462,80,1058,497,561,10,16,6,4
3824,50935,80,12497,80,40645,6133,34512,66,274,33,33
3825,58638,5900,58638,5900,62,62,0,1,5,1,0
3826,56788,443,39724,443,7929,1940,5989,20,15,11,9
3827,58638,5900,58638,5900,62,62,0,1,5,1,0
3828,58638,5900,58638,5900,62,62,0,1,5,1,0
3829,54234,53,54234,53,237,91,146,2,33,1,1
3830,58638,5900,58638,5900,126,62,64,2,5,1,1
3831,49512,53,53127,53,190,97,93,2,31,1,1
3832,58638,5900,58638,5900,126,62,64,2,5,1,1
3833,38520,53,38520,53,231,88,143,2,34,1,1
3834,64149,53,35596,53,301,108,193,4,50,2,2
3835,56789,443,8502,443,7877,1888,5989,20,15,11,9
3836,63607,53,63607,53,643,88,555,2,30,1,1
3837,56787,443,7195,443,7877,1888,5989,20,15,11,9
3838,60495,6882,21325,6882,70,70,0,1,5,1,0
3839,49342,53,37970,53,200,102,98,2,30,1,1
3840,56812,53,46886,53,767,102,665,2,30,1,1
3841,58725,443,25110,443,9279,5062,4217,56,259,25,31
3842,51179,443,22561,443,13708,1734,11974,25,31,12,13
3843,64937,53,10087,53,182,93,89,2,31,1,1
3844,64937,53,22410,53,182,93,89,2,31,1,1
3845,64332,53,28123,53,166,85,81,2,31,1,1
3846,57470,867,17411,867,330,330,0,6,1200,6,0
3847,57470,1024,34451,1024,132,132,0,3,1200,3,0
3848,49160,6881,22368,6881,490,150,340,2,1200,1,1
3849,55711,53,33941,53,733,93,640,2,31,1,1
3850,64217,53,58721,53,186,95,91,2,31,1,1
3851,57411,53,22912,53,192,98,94,2,31,1,1
3852,48229,53,48229,53,213,87,126,2,31,1,1
3853,57470,53380,4441,53380,330,330,0,6,1200,6,0
3854,55820,53,24388,53,188,96,92,2,31,1,1
3855,64815,123,8798,123,184,94,90,2,31,1,1
3856,50636,53,31294,53,772,100,672,2,31,1,1
3857,49907,53,44048,53,198,101,97,2,31,1,1
3858,55646,53,23408,53,182,93,89,2,31,1,1
3859,56724,53,16788,53,190,97,93,2,31,1,1
3860,64723,443,61032,443,7978900,79979,7898921,6464,210,644,5820
3861,55615,53,23565,53,772,100,672,2,31,1,1
3862,19473,51413,49212,51413,459,149,310,2,1200,1,1
3863,57131,35776,0,0,145,145,0,1,0,1,0
3864,16490,25174,0,0,62,62,0,1,0,1,0
3865,50591,22114,0,0,146,146,0,1,0,1,0
3866,55973,25174,0,0,62,62,0,1,0,1,0
3867,50027,445,0,0,70,70,0,1,0,1,0
3868,443,56513,0,0,78,78,0,1,0,1,0
3869,18130,25174,0,0,62,62,0,1,0,1,0
3870,63136,42873,0,0,66,66,0,1,0,1,0
3871,61250,42873,0,0,66,66,0,1,0,1,0
3872,49308,22114,0,0,62,62,0,1,0,1,0
3873,54735,445,0,0,70,70,0,1,0,1,0
3874,54727,445,0,0,70,70,0,1,0,1,0
3875,54721,445,0,0,70,70,0,1,0,1,0
3876,13718,23,0,0,60,60,0,1,0,1,0
3877,26906,22114,0,0,66,66,0,1,0,1,0
3878,50020,445,0,0,70,70,0,1,0,1,0
3879,11112,43890,0,0,66,66,0,1,0,1,0
3880,50018,445,0,0,70,70,0,1,0,1,0
3881,56258,53,19240,53,167,86,81,2,30,1,1
3882,56745,80,35194,80,214,140,74,4,25,3,1
3883,58769,22114,0,0,146,146,0,1,0,1,0
3884,50135,445,0,0,66,66,0,1,0,1,0
3885,25565,50263,0,0,60,60,0,1,0,1,0
3886,63469,64147,0,0,62,62,0,1,0,1,0
3887,57015,25174,0,0,66,66,0,1,0,1,0
3888,50014,445,0,0,70,70,0,1,0,1,0
3889,50012,445,0,0,70,70,0,1,0,1,0
3890,50354,56205,0,0,66,66,0,1,0,1,0
3891,50127,445,0,0,66,66,0,1,0,1,0
3892,54711,445,0,0,70,70,0,1,0,1,0
3893,10425,23,0,0,60,60,0,1,0,1,0
3894,18771,35440,0,0,66,66,0,1,0,1,0
3895,26629,56079,0,0,62,62,0,1,0,1,0
3896,50008,445,0,0,70,70,0,1,0,1,0
3897,33352,50584,0,0,146,146,0,1,0,1,0
3898,51865,61689,0,0,62,62,0,1,0,1,0
3899,50125,445,0,0,66,66,0,1,0,1,0
3900,50007,445,0,0,70,70,0,1,0,1,0
3901,64322,53,60744,53,273,90,183,4,33,2,2
3902,46987,443,53868,443,8688,3211,5477,24,343,11,13
3903,64307,53,35303,53,241,94,147,2,30,1,1
3904,49880,53,5726,53,194,102,92,2,30,1,1
3905,55265,53,4151,53,199,102,97,2,30,1,1
3906,56115,53,60323,53,167,86,81,2,30,1,1
3907,56115,53,18486,53,167,86,81,2,30,1,1
3908,65452,53,19191,53,196,102,94,2,30,1,1
3909,34732,53,8209,53,86,86,0,1,30,1,0
3910,64789,53,27915,53,199,102,97,2,30,1,1
3911,63773,443,33011,443,9693,2010,7683,18,130,9,9
3912,64116,443,49764,443,7439,1156,6283,19,75,11,8
3913,51880,8000,24485,8000,582,270,312,8,32,4,4
3914,123,123,14772,123,184,94,90,2,29,1,1
3915,65515,53,18334,53,195,102,93,2,29,1,1
3916,64882,53,29551,53,230,102,128,2,29,1,1
3917,65076,53,51472,53,215,94,121,2,29,1,1
3918,57054,53,52774,53,241,94,147,2,29,1,1
3919,56131,53,35553,53,199,94,105,2,29,1,1
3920,49939,53,35198,53,231,102,129,2,29,1,1
3921,49166,53,17612,53,322,102,220,2,30,1,1
3922,64789,53,49397,53,199,102,97,2,30,1,1
3923,57884,443,11734,443,7668,2540,5128,22,155,12,10
3924,56400,53,1687,53,196,102,94,2,30,1,1
3925,56538,53,20855,53,401,95,306,4,57,2,2
3926,64149,53,6477,53,301,108,193,4,49,2,2
3927,36660,443,25642,443,25051,3368,21683,50,313,26,24
3928,53136,80,42745,80,23974,12718,11256,37,36,19,18
3929,64930,53,11667,53,317,96,221,4,32,2,2
3930,58638,5900,58638,5900,130,66,64,2,4,1,1
3931,49279,53,50429,53,199,102,97,2,29,1,1
3932,53951,8999,52530,8999,70,70,0,1,4,1,0
3933,58638,5900,58638,5900,66,66,0,1,4,1,0
3934,49929,53,22603,53,214,110,104,2,29,1,1
3935,64283,53,44589,53,193,102,91,2,29,1,1
3936,49177,443,40595,443,840,700,140,13,59,11,2
3937,64710,53,5594,53,195,102,93,2,29,1,1
3938,49836,53,26222,53,889,404,485,10,29,5,5
3939,64935,53,15324,53,193,102,91,2,31,1,1
3940,65199,53,15810,53,215,94,121,2,30,1,1
3941,64606,53,12951,53,290,102,188,2,30,1,1
3942,37672,443,48728,443,3338,2337,1001,18,45,11,7
3943,38320,53,38320,53,260,106,154,2,32,1,1
3944,61343,443,57856,443,1784740,34746,1749994,1769,331,357,1412
3945,55598,53,62889,53,186,102,84,2,30,1,1
3946,65220,53,21177,53,184,94,90,2,30,1,1
3947,57137,53,46999,53,279,96,183,4,32,2,2
3948,52101,64162,42746,64162,1200,576,624,8,31,4,4
3949,64404,53,7876,53,251,110,141,2,30,1,1
3950,49965,53,10762,53,226,110,116,2,30,1,1
3951,49280,53,63122,53,167,86,81,2,30,1,1
3952,55273,53,48247,53,197,94,103,2,30,1,1
3953,55265,53,44071,53,199,102,97,2,30,1,1
3954,49448,53,38995,53,195,94,101,2,30,1,1
3955,64789,53,51641,53,199,102,97,2,30,1,1
3956,49280,53,8666,53,167,86,81,2,30,1,1
3957,50011,53,47474,53,1398,98,1300,4,31,2,2
3958,49291,53,30701,53,759,102,657,2,30,1,1
3959,64217,53,23995,53,193,102,91,2,30,1,1
3960,50622,443,10440,443,9215,1795,7420,32,140,16,16
3961,37586,443,60764,443,19675,10416,9259,53,81,30,23
3962,64283,53,27743,53,193,102,91,2,30,1,1
3963,55040,443,51805,443,36648,3634,33014,51,62,23,28
3964,52075,443,32298,443,18579,9266,9313,49,198,25,24
3965,50681,80,59849,80,318,192,126,6,26,4,2
3966,64639,53,21872,53,199,102,97,2,30,1,1
3967,64719,53,55102,53,263,118,145,2,30,1,1
3968,64149,53,17311,53,301,108,193,4,49,2,2
3969,55797,53,43104,53,194,102,92,2,30,1,1
3970,64724,53,43750,53,195,102,93,2,30,1,1
3971,33892,53,0,0,86,86,0,1,30,1,0
3972,55797,53,58246,53,817,102,715,2,30,1,1
3973,56258,53,24780,53,167,86,81,2,30,1,1
3974,57255,443,53541,443,4769,2622,2147,14,135,7,7
3975,57309,53,4070,53,197,102,95,2,30,1,1
3976,64603,53,49089,53,269,110,159,2,30,1,1
3977,49228,443,55799,443,842887,22143,820744,866,19,314,552
3978,53101,443,16538,443,27964,15805,12159,204,904,120,84
3979,42686,53,42686,53,262,106,156,2,32,1,1
3980,40826,443,36041,443,4125,2847,1278,18,255,10,8
3981,64854,53,54158,53,260,102,158,2,30,1,1
3982,63965,53,1139,53,214,102,112,2,30,1,1
3983,55100,53,15692,53,182,102,80,2,30,1,1
3984,55094,53,35029,53,244,94,150,2,30,1,1
3985,65452,53,12771,53,819,102,717,2,30,1,1
3986,56864,53,28207,53,200,102,98,2,30,1,1
3987,65260,53,63253,53,184,94,90,2,30,1,1
3988,49512,53,36100,53,195,102,93,2,30,1,1
3989,53028,443,47549,443,12081,2070,10011,33,620,12,21
3990,49326,53,56607,53,193,102,91,2,31,1,1
3991,57883,443,38550,443,5932,1264,4668,21,155,11,10
3992,38639,443,56279,443,10556,3559,6997,38,82,21,17
3993,49554,53,46723,53,541,201,340,6,64,3,3
3994,50682,80,30834,80,5036,4332,704,11,25,6,5
3995,56754,443,40687,443,9868,2027,7841,24,20,12,12
3996,63985,53,11526,53,351,103,248,4,46,2,2
3997,55044,443,65434,443,14427,4574,9853,34,61,18,16
3998,55254,53,23493,53,195,102,93,2,30,1,1
3999,65075,53,61185,53,172,94,78,2,30,1,1
4000,7536,53,7536,53,198,90,108,2,30,1,1
4001,55254,53,12306,53,195,102,93,2,30,1,1
4002,55026,53,51536,53,164,86,78,2,30,1,1
4003,53946,27426,37838,27426,612,306,306,10,14,5,5
4004,51880,8000,42444,8000,582,270,312,8,32,4,4
4005,51880,4000,30933,4000,270,270,0,4,32,4,0
4006,58020,80,26488,80,2312,1094,1218,25,89,13,12
4007,51880,51880,39901,51880,582,270,312,8,32,4,4
4008,53980,36153,5182,36153,258,70,188,4,7,2,2
4009,48495,443,14805,443,3108,1711,1397,24,813,11,13
4010,53950,32057,54034,32057,70,70,0,1,4,1,0
4011,65176,53,19712,53,299,99,200,4,45,2,2
4012,58638,5900,58638,5900,130,66,64,2,4,1,1
4013,58638,5900,58638,5900,66,66,0,1,4,1,0
4014,58638,5900,58638,5900,66,66,0,1,4,1,0
4015,58638,5900,58638,5900,66,66,0,1,4,1,0
4016,58638,5900,58638,5900,66,66,0,1,4,1,0
4017,58638,5900,58638,5900,130,66,64,2,4,1,1
4018,58638,5900,58638,5900,66,66,0,1,4,1,0
4019,64883,53,45539,53,292,94,198,4,57,2,2
4020,58638,5900,58638,5900,66,66,0,1,4,1,0
4021,58638,5900,58638,5900,66,66,0,1,4,1,0
4022,58638,5900,58638,5900,66,66,0,1,4,1,0
4023,58638,5900,58638,5900,130,66,64,2,4,1,1
4024,58638,5900,58638,5900,130,66,64,2,4,1,1
4025,58638,5900,58638,5900,66,66,0,1,4,1,0
4026,58638,5900,58638,5900,66,66,0,1,4,1,0
4027,55579,53,24866,53,178,94,84,2,29,1,1
4028,58638,5900,58638,5900,130,66,64,2,4,1,1
4029,10059,443,58839,443,70553,6471,64082,141,182,69,72
4030,58638,5900,58638,5900,66,66,0,1,4,1,0
4031,49308,53,35422,53,320,97,223,4,50,2,2
4032,53952,26973,7961,26973,70,70,0,1,4,1,0
4033,50191,53,41237,53,182,102,80,2,29,1,1
4034,56775,53,62594,53,200,94,106,2,29,1,1
4035,64550,53,62266,53,221,94,127,2,29,1,1
4036,33161,80,27979,80,604,530,74,7,15,6,1
4037,47935,443,5335,443,12403,2139,10264,38,22,19,19
4038,50294,53,34116,53,178,94,84,2,29,1,1
4039,55754,53,55090,53,199,102,97,2,30,1,1
4040,56079,53,40631,53,199,102,97,2,29,1,1
4041,56864,53,5721,53,200,102,98,2,30,1,1
4042,57144,53,1605,53,178,94,84,2,29,1,1
4043,55348,53,24176,53,498,204,294,6,30,3,3
4044,56864,53,8861,53,200,102,98,2,30,1,1
4045,56020,53,56318,53,168,86,82,2,29,1,1
4046,55598,53,46757,53,186,102,84,2,30,1,1
4047,56332,53,33283,53,199,102,97,2,29,1,1
4048,50316,53,38175,53,753,94,659,2,29,1,1
4049,64895,53,61625,53,199,102,97,2,30,1,1
4050,49407,53,19099,53,209,102,107,2,30,1,1
4051,49248,53,8891,53,211,102,109,2,30,1,1
4052,65063,53,59913,53,340,94,246,2,30,1,1
4053,49697,53,43942,53,195,94,101,2,30,1,1
4054,55087,53,1147,53,183,94,89,2,31,1,1
4055,49337,443,47623,443,5483,2770,2713,30,361,15,15
4056,59103,443,44683,443,2192,1049,1143,24,119,11,13
4057,56127,443,17365,443,6103,2710,3393,58,212,28,30
4058,57262,443,38202,443,43771,18333,25438,105,126,49,56
4059,42484,443,62904,443,79507,72433,7074,96,415,60,36
4060,65377,53,44573,53,193,102,91,2,31,1,1
4061,49223,2710,26016,2710,3492,3432,60,12,36,11,1
4062,35515,80,62151,80,841,715,126,5,15,3,2
4063,49880,53,16831,53,817,102,715,2,30,1,1
4064,59119,53,4964,53,168,78,90,2,30,1,1
4065,57411,53,7355,53,196,102,94,2,30,1,1
4066,37833,53,37833,53,222,90,132,2,30,1,1
4067,38633,443,28633,443,4393,1151,3242,22,165,13,9
4068,38640,443,50053,443,6171,1091,5080,22,82,12,10
4069,36841,443,46092,443,7293,1544,5749,22,256,11,11
4070,49585,53,39603,53,732,86,646,2,30,1,1
4071,64639,53,46471,53,199,102,97,2,30,1,1
4072,55786,53,44397,53,177,94,83,2,30,1,1
4073,45899,53,19119,53,168,78,90,2,30,1,1
4074,65201,53,5254,53,288,94,194,2,30,1,1
4075,49974,53,0,0,86,86,0,1,30,1,0
4076,49907,53,32516,53,199,102,97,2,30,1,1
4077,55265,53,65356,53,199,102,97,2,30,1,1
4078,55044,53,38715,53,196,102,94,2,30,1,1
4079,38634,443,59310,443,9741,4687,5054,36,165,21,15
4080,53170,20259,55641,20259,70,70,0,1,5,1,0
4081,53165,18504,40263,18504,444,192,252,8,17,4,4
4082,49840,443,49840,443,4645,1738,2907,19,30,11,8
4083,49314,53,60410,53,214,94,120,2,30,1,1
4084,54816,53,4342,53,168,78,90,2,30,1,1
4085,36245,53,44289,53,168,78,90,2,30,1,1
4086,55100,53,34612,53,182,102,80,2,30,1,1
4087,44505,53,44505,53,216,90,126,2,30,1,1
4088,56400,53,12520,53,819,102,717,2,30,1,1
4089,65377,53,29691,53,193,102,91,2,30,1,1
4090,45676,123,45676,123,184,94,90,2,30,1,1
4091,50290,443,41228,443,6662,3336,3326,37,142,17,20
4092,56660,53,55953,53,183,94,89,2,31,1,1
4093,49198,53,18910,53,164,78,86,2,31,1,1
4094,55044,53,10792,53,196,102,94,2,31,1,1
4095,43463,443,25009,443,6919,1449,5470,21,186,12,9
4096,6881,56867,6114,56867,150,150,0,1,1199,1,0
4097,53497,443,53212,443,17187157,553524,16633633,18453,352,6098,12355
4098,52160,443,34670,443,6679,3424,3255,19,138,10,9
4099,57470,80,24424,80,230,82,148,4,1199,2,2
4100,64724,53,63918,53,319,97,222,4,31,2,2
4101,56079,53,1064,53,199,102,97,2,31,1,1
4102,57137,53,9212,53,279,96,183,4,32,2,2
4103,53281,80,26227,80,124,64,60,3,5,2,1
4104,49217,53,30696,53,282,93,189,4,45,2,2
4105,49260,53,23458,53,199,86,113,2,30,1,1
4106,65496,53,1852,53,198,94,104,2,31,1,1
4107,61829,443,61829,443,280243,73972,206271,309,206,142,167
4108,40072,80,29014,80,1298,370,928,12,15,6,6
4109,49217,53,45409,53,282,93,189,4,45,2,2
4110,49217,53,50933,53,282,93,189,4,45,2,2
4111,49420,80,13977,80,1985,657,1328,11,21,6,5
4112,64149,53,19971,53,301,108,193,4,49,2,2
4113,64961,53,7551,53,243,110,133,2,30,1,1
4114,64758,53,8387,53,734,94,640,2,30,1,1
4115,65260,53,12231,53,184,94,90,2,30,1,1
4116,64332,53,6045,53,167,86,81,2,30,1,1
4117,59883,17637,0,0,66,66,0,1,0,1,0
4118,25679,27189,0,0,62,62,0,1,0,1,0
4119,10333,22114,0,0,146,146,0,1,0,1,0
4120,50116,445,0,0,66,66,0,1,0,1,0
4121,52791,25174,0,0,66,66,0,1,0,1,0
4122,50113,445,0,0,66,66,0,1,0,1,0
4123,54280,3398,0,0,60,60,0,1,0,1,0
4124,56381,51505,0,0,146,146,0,1,0,1,0
4125,50002,445,0,0,70,70,0,1,0,1,0
4126,54976,10387,0,0,159,159,0,1,0,1,0
4127,1814,62413,0,0,66,66,0,1,0,1,0
4128,25583,2323,0,0,60,60,0,1,0,1,0
4129,54701,445,0,0,70,70,0,1,0,1,0
4130,54702,445,0,0,70,70,0,1,0,1,0
4131,54699,445,0,0,70,70,0,1,0,1,0
4132,50102,445,0,0,66,66,0,1,0,1,0
4133,50098,445,0,0,66,66,0,1,0,1,0
4134,50101,445,0,0,66,66,0,1,0,1,0
4135,50100,445,0,0,66,66,0,1,0,1,0
4136,50095,445,0,0,66,66,0,1,0,1,0
4137,50099,445,0,0,66,66,0,1,0,1,0
4138,50097,445,0,0,66,66,0,1,0,1,0
4139,50094,445,0,0,66,66,0,1,0,1,0
4140,20706,23718,0,0,62,62,0,1,0,1,0
4141,9696,16010,0,0,60,60,0,1,0,1,0
4142,50326,46824,0,0,66,66,0,1,0,1,0
4143,34086,25174,0,0,66,66,0,1,0,1,0
4144,64605,25174,0,0,66,66,0,1,0,1,0
4145,45952,22114,0,0,62,62,0,1,0,1,0
4146,49989,445,0,0,70,70,0,1,0,1,0
4147,55666,35440,0,0,66,66,0,1,0,1,0
4148,38852,37965,0,0,62,62,0,1,0,1,0
4149,12980,26296,0,0,145,145,0,1,0,1,0
4150,63690,64147,0,0,62,62,0,1,0,1,0
4151,20487,50584,0,0,62,62,0,1,0,1,0
4152,32381,50584,0,0,66,66,0,1,0,1,0
4153,49986,445,0,0,70,70,0,1,0,1,0
4154,54695,445,0,0,70,70,0,1,0,1,0
4155,54689,445,0,0,70,70,0,1,0,1,0
4156,54688,445,0,0,70,70,0,1,0,1,0
4157,54683,445,0,0,70,70,0,1,0,1,0
4158,59326,57470,0,0,74,74,0,1,0,1,0
4159,56688,25174,0,0,66,66,0,1,0,1,0
4160,36685,35440,0,0,62,62,0,1,0,1,0
4161,50080,445,0,0,66,66,0,1,0,1,0
4162,50082,445,0,0,66,66,0,1,0,1,0
4163,50079,445,0,0,66,66,0,1,0,1,0
4164,65216,35440,0,0,66,66,0,1,0,1,0
4165,65270,3855,0,0,78,78,0,1,0,1,0
4166,44913,36866,0,0,148,148,0,1,0,1,0
4167,49981,445,0,0,70,70,0,1,0,1,0
4168,44774,22114,0,0,62,62,0,1,0,1,0
4169,35974,23,0,0,60,60,0,1,0,1,0
4170,39586,22114,0,0,66,66,0,1,0,1,0
4171,54679,445,0,0,70,70,0,1,0,1,0
4172,49980,445,0,0,70,70,0,1,0,1,0
4173,1687,25174,0,0,146,146,0,1,0,1,0
4174,4323,64147,0,0,66,66,0,1,0,1,0
4175,54678,445,0,0,70,70,0,1,0,1,0
4176,54675,445,0,0,70,70,0,1,0,1,0
4177,54667,445,0,0,70,70,0,1,0,1,0
4178,49978,445,0,0,70,70,0,1,0,1,0
4179,443,50238,0,0,331,331,0,1,0,1,0
4180,41653,21247,0,0,62,62,0,1,0,1,0
4181,49590,57470,0,0,78,78,0,1,0,1,0
4182,49971,445,0,0,70,70,0,1,0,1,0
4183,63010,57470,0,0,145,145,0,1,0,1,0
4184,56039,50584,0,0,66,66,0,1,0,1,0
4185,54660,445,0,0,70,70,0,1,0,1,0
4186,54657,445,0,0,70,70,0,1,0,1,0
4187,54655,445,0,0,70,70,0,1,0,1,0
4188,49969,445,0,0,70,70,0,1,0,1,0
4189,58593,57470,0,0,62,62,0,1,0,1,0
4190,29009,25174,0,0,146,146,0,1,0,1,0
4191,59223,17500,0,0,66,66,0,1,0,1,0
4192,64808,62413,0,0,66,66,0,1,0,1,0
4193,61280,26467,0,0,62,62,0,1,0,1,0
4194,50068,445,0,0,66,66,0,1,0,1,0
4195,59225,57587,0,0,66,66,0,1,0,1,0
4196,8889,29421,0,0,60,60,0,1,0,1,0
4197,54555,25174,0,0,62,62,0,1,0,1,0
4198,2064,22114,0,0,62,62,0,1,0,1,0
4199,49968,445,0,0,70,70,0,1,0,1,0
4200,17171,22114,0,0,66,66,0,1,0,1,0
4201,49967,445,0,0,70,70,0,1,0,1,0
4202,49966,445,0,0,70,70,0,1,0,1,0
4203,54051,28793,0,0,66,66,0,1,0,1,0
4204,49961,445,0,0,70,70,0,1,0,1,0
4205,49960,445,0,0,70,70,0,1,0,1,0
4206,9327,57470,0,0,62,62,0,1,0,1,0
4207,49908,56205,0,0,62,62,0,1,0,1,0
4208,56713,25174,0,0,62,62,0,1,0,1,0
4209,56909,50584,0,0,62,62,0,1,0,1,0
4210,10004,57470,0,0,145,145,0,1,0,1,0
4211,58925,25174,0,0,66,66,0,1,0,1,0
4212,30129,37965,0,0,72,72,0,1,0,1,0
4213,54654,445,0,0,70,70,0,1,0,1,0
4214,59031,25174,0,0,62,62,0,1,0,1,0
4215,54650,445,0,0,70,70,0,1,0,1,0
4216,56906,50584,0,0,62,62,0,1,0,1,0
4217,27321,25174,0,0,62,62,0,1,0,1,0
4218,49948,445,0,0,70,70,0,1,0,1,0
4219,25363,22114,0,0,66,66,0,1,0,1,0
4220,49945,445,0,0,70,70,0,1,0,1,0
4221,1024,48817,0,0,145,145,0,1,0,1,0
4222,49938,445,0,0,70,70,0,1,0,1,0
4223,49937,445,0,0,70,70,0,1,0,1,0
4224,6778,50584,0,0,66,66,0,1,0,1,0
4225,49529,21247,0,0,62,62,0,1,0,1,0
4226,5787,44847,0,0,66,66,0,1,0,1,0
4227,50055,445,0,0,66,66,0,1,0,1,0
4228,50050,445,0,0,66,66,0,1,0,1,0
4229,9745,26467,0,0,62,62,0,1,0,1,0
4230,52838,37965,0,0,66,66,0,1,0,1,0
4231,52929,43890,0,0,62,62,0,1,0,1,0
4232,64882,43890,0,0,66,66,0,1,0,1,0
4233,49531,26467,0,0,62,62,0,1,0,1,0
4234,52604,25174,0,0,62,62,0,1,0,1,0
4235,50974,11392,0,0,66,66,0,1,0,1,0
4236,52318,22114,0,0,146,146,0,1,0,1,0
4237,54642,445,0,0,70,70,0,1,0,1,0
4238,54640,445,0,0,70,70,0,1,0,1,0
4239,54639,445,0,0,70,70,0,1,0,1,0
4240,54633,445,0,0,70,70,0,1,0,1,0
4241,51414,22,0,0,60,60,0,1,0,1,0
4242,49926,445,0,0,70,70,0,1,0,1,0
4243,50047,445,0,0,66,66,0,1,0,1,0
4244,53985,30188,0,0,66,66,0,1,0,1,0
4245,57015,42707,0,0,62,62,0,1,0,1,0
4246,57613,42707,0,0,66,66,0,1,0,1,0
4247,50033,445,0,0,66,66,0,1,0,1,0
4248,50043,445,0,0,66,66,0,1,0,1,0
4249,50031,445,0,0,66,66,0,1,0,1,0
4250,50036,445,0,0,66,66,0,1,0,1,0
4251,50040,445,0,0,66,66,0,1,0,1,0
4252,50038,445,0,0,66,66,0,1,0,1,0
4253,50035,445,0,0,66,66,0,1,0,1,0
4254,51544,44847,0,0,146,146,0,1,0,1,0
4255,58129,26467,0,0,62,62,0,1,0,1,0
4256,44414,23718,0,0,62,62,0,1,0,1,0
4257,54629,445,0,0,70,70,0,1,0,1,0
4258,19875,30170,0,0,145,145,0,1,0,1,0
4259,24160,37807,0,0,62,62,0,1,0,1,0
4260,54624,445,0,0,70,70,0,1,0,1,0
4261,54621,445,0,0,70,70,0,1,0,1,0
4262,54620,445,0,0,70,70,0,1,0,1,0
4263,59076,25174,0,0,62,62,0,1,0,1,0
4264,23122,26296,0,0,159,159,0,1,0,1,0
4265,49922,445,0,0,70,70,0,1,0,1,0
4266,45461,25174,0,0,146,146,0,1,0,1,0
4267,47063,15503,0,0,62,62,0,1,0,1,0
4268,49911,445,0,0,70,70,0,1,0,1,0
4269,49910,445,0,0,70,70,0,1,0,1,0
4270,49913,445,0,0,70,70,0,1,0,1,0
4271,32496,48817,0,0,148,148,0,1,0,1,0
4272,49476,443,31371,443,7254,1183,6071,19,152,9,10
4273,59336,80,59336,80,24437,12718,11719,41,15,16,25
4274,53981,29500,46111,29500,320,140,180,6,7,3,3
4275,58932,80,50607,80,2424,529,1895,11,75,6,5
4276,56785,443,49634,443,7905,1916,5989,20,15,11,9
4277,49774,80,42910,80,254,128,126,5,15,3,2
4278,64818,53,5282,53,174,89,85,2,30,1,1
4279,57309,53,11380,53,194,99,95,2,30,1,1
4280,59335,80,59335,80,107776,4213,103563,177,16,60,117
4281,26882,443,64713,443,10633,2672,7961,31,20,16,15
4282,55646,53,12583,53,780,93,687,2,30,1,1
4283,52025,443,47252,443,8034,2692,5342,15,16,8,7
4284,64322,53,46348,53,273,90,183,4,32,2,2
4285,54610,443,15531,443,19810,7047,12763,54,438,28,26
4286,56664,80,24275,80,1056,682,374,10,15,6,4
4287,43518,443,43518,443,4691,1784,2907,19,29,11,8
4288,64944,53,44996,53,749,89,660,2,30,1,1
4289,54601,443,45945,443,28386,15864,12522,59,471,31,28
4290,53976,52534,48449,52534,70,70,0,2,7,2,0
4291,44503,1433,44503,1433,150,60,90,2,9,1,1
4292,64701,53,64701,53,265,111,154,2,30,1,1
4293,53978,27091,3798,27091,320,140,180,6,7,3,3
4294,47904,443,37875,443,2766,1907,859,17,24,10,7
4295,53948,7370,62549,7370,70,70,0,1,5,1,0
4296,55856,53,9134,53,1410,93,1317,4,59,2,2
4297,49477,443,62857,443,8416,1247,7169,21,152,10,11
4298,61401,443,65147,443,33774,1880,31894,58,195,19,39
4299,49326,53,16602,53,186,95,91,2,30,1,1
4300,49224,53,33872,53,198,101,97,2,30,1,1
4301,55564,53,50276,53,775,103,672,2,30,1,1
4302,49582,53,42965,53,775,103,672,2,30,1,1
4303,60247,443,21929,443,12256,5443,6813,33,437,18,15
4304,56784,443,32848,443,7957,1968,5989,20,15,11,9
4305,62218,53,62218,53,253,99,154,2,33,1,1
4306,63855,80,40243,80,4529,1221,3308,14,75,8,6
4307,53947,867,6908,867,70,70,0,1,5,1,0
4308,56783,443,28364,443,7904,1915,5989,20,16,11,9
4309,49478,443,45550,443,4241,1161,3080,17,152,9,8
4310,5588,5588,0,0,3354,1792,1562,46,195,23,23
4311,48204,443,48204,443,4743,1836,2907,19,26,11,8
4312,41803,53,41803,53,243,104,139,2,30,1,1
4313,50497,53,25431,53,747,93,654,2,30,1,1
4314,55044,53,9273,53,192,98,94,2,30,1,1
4315,44125,53,44125,53,209,79,130,2,30,1,1
4316,64895,53,11867,53,198,101,97,2,30,1,1
4317,65220,53,41846,53,184,94,90,2,30,1,1
4318,63560,53,63560,53,209,79,130,2,30,1,1
4319,52487,443,29392,443,13734,3206,10528,26,150,13,13
4320,55257,53,9976,53,749,89,660,2,30,1,1
4321,65260,53,38236,53,184,94,90,2,30,1,1
4322,49901,53,54026,53,776,102,674,2,30,1,1
4323,65224,53,48832,53,758,93,665,2,30,1,1
4324,55087,53,55975,53,182,93,89,2,31,1,1
4325,64935,53,11961,53,186,95,91,2,31,1,1
4326,17119,53,17119,53,217,87,130,2,30,1,1
4327,55646,53,54569,53,182,93,89,2,30,1,1
4328,57188,53,44023,53,186,95,91,2,30,1,1
4329,57130,53,10466,53,778,103,675,2,31,1,1
4330,55530,53,3862,53,758,93,665,2,31,1,1
4331,36017,53,46700,53,198,93,105,2,31,1,1
4332,45459,53,25942,53,198,93,105,2,31,1,1
4333,54994,53,24459,53,202,103,99,2,31,1,1
4334,57956,443,29445,443,7842,2164,5678,48,5441,20,28
4335,21133,11342,54289,11342,478,149,329,2,1200,1,1
4336,55627,53,20054,53,174,89,85,2,31,1,1
4337,64930,53,64696,53,186,95,91,2,31,1,1
4338,65377,53,42499,53,186,95,91,2,31,1,1
4339,55377,53,47893,53,190,97,93,2,31,1,1
4340,55654,53,20360,53,726,85,641,2,31,1,1
4341,55932,53,16236,53,202,103,99,2,31,1,1
4342,56389,53,11725,53,774,101,673,2,31,1,1
4343,49237,53,49766,53,735,88,647,2,31,1,1
4344,49629,53,36000,53,196,100,96,2,31,1,1
4345,51444,443,39755,443,3283,951,2332,13,135,6,7
4346,56790,53,5516,53,747,92,655,2,31,1,1
4347,57577,443,27380,443,39421,4980,34441,57,144,23,34
4348,35722,443,40129,443,13035,2590,10445,27,125,14,13
4349,56180,53,32734,53,200,102,98,2,31,1,1
4350,49343,53,32839,53,202,103,99,2,31,1,1
4351,6881,6882,26617,6882,231,111,120,2,1200,1,1
4352,44290,53,27070,53,240,76,164,2,31,1,1
4353,19037,53,19037,53,227,89,138,2,31,1,1
4354,55005,53,54882,53,182,93,89,2,31,1,1
4355,55637,53,24847,53,202,103,99,2,31,1,1
4356,55675,53,42703,53,196,100,96,2,31,1,1
4357,56002,53,4276,53,771,101,670,2,31,1,1
4358,55014,53,9068,53,716,95,621,2,31,1,1
4359,57051,53,27315,53,170,87,83,2,31,1,1
4360,64752,53,55237,53,190,97,93,2,31,1,1
4361,56317,53,55686,53,182,93,89,2,31,1,1
4362,56569,53,23106,53,182,93,89,2,31,1,1
4363,57137,53,2649,53,279,96,183,4,31,2,2
4364,65373,53,60314,53,194,99,95,2,31,1,1
4365,57401,53,41706,53,174,89,85,2,31,1,1
4366,65257,443,11599,443,4019,708,3311,16,137,7,9
4367,49909,445,0,0,70,70,0,1,0,1,0
4368,52128,37807,0,0,66,66,0,1,0,1,0
4369,48016,57470,0,0,62,62,0,1,0,1,0
4370,49905,445,0,0,70,70,0,1,0,1,0
4371,60645,35440,0,0,62,62,0,1,0,1,0
4372,1712,23,0,0,60,60,0,1,0,1,0
4373,4545,1900,0,0,136,136,0,1,0,1,0
4374,4545,1900,0,0,136,136,0,1,0,1,0
4375,14360,64147,0,0,62,62,0,1,0,1,0
4376,9226,57470,0,0,66,66,0,1,0,1,0
4377,54619,445,0,0,70,70,0,1,0,1,0
4378,54615,445,0,0,70,70,0,1,0,1,0
4379,54612,445,0,0,70,70,0,1,0,1,0
4380,65200,51050,0,0,66,66,0,1,0,1,0
4381,54611,445,0,0,70,70,0,1,0,1,0
4382,13020,26467,0,0,62,62,0,1,0,1,0
4383,59347,57470,0,0,62,62,0,1,0,1,0
4384,50023,445,0,0,66,66,0,1,0,1,0
4385,65530,53,49295,53,381,88,293,4,31,2,2
4386,42753,443,38036,443,10114,3154,6960,27,20,16,11
4387,56660,53,34940,53,183,94,89,2,30,1,1
4388,64712,53,32713,53,210,102,108,2,30,1,1
4389,53871,443,15841,443,7797,1807,5990,15,135,7,8
4390,64469,53,32950,53,342,97,245,4,42,2,2
4391,53935,42874,31408,42874,1973,1021,952,10,15,6,4
4392,49907,53,54297,53,199,102,97,2,29,1,1
4393,55044,53,52145,53,196,102,94,2,29,1,1
4394,64146,53,19064,53,212,102,110,2,29,1,1
4395,57188,53,20332,53,193,102,91,2,30,1,1
4396,64332,53,46508,53,167,86,81,2,30,1,1
4397,56724,53,52473,53,195,102,93,2,30,1,1
4398,53938,15926,50841,15926,492,306,186,8,15,5,3
4399,34687,443,63653,443,3120,1862,1258,18,15,11,7
4400,49504,7275,25597,7275,8962,1625,7337,28,16,15,13
4401,45195,80,65375,80,1115,534,581,12,15,7,5
4402,64322,53,46298,53,273,90,183,4,32,2,2
4403,49430,53,28668,53,332,99,233,4,45,2,2
4404,49548,443,63354,443,8912,2297,6615,43,255,20,23
4405,65186,53,51165,53,521,90,431,4,43,2,2
4406,57188,53,35661,53,193,102,91,2,29,1,1
4407,60807,40010,25177,40010,316,136,180,6,5,3,3
4408,64217,53,31853,53,193,102,91,2,29,1,1
4409,51418,443,51418,443,4742,1835,2907,19,30,11,8
4410,63957,53,44993,53,214,94,120,2,29,1,1
4411,56258,53,14638,53,167,86,81,2,29,1,1
4412,123,123,46819,123,184,94,90,2,29,1,1
4413,64930,53,29648,53,193,102,91,2,29,1,1
4414,57411,53,32246,53,196,102,94,2,29,1,1
4415,49512,53,26273,53,195,102,93,2,30,1,1
4416,56724,53,34585,53,308,97,211,4,45,2,2
4417,36897,443,23482,443,6351,4202,2149,35,94,18,17
4418,49472,443,5541,443,3897,1306,2591,17,158,9,8
4419,55122,443,57128,443,17936,14273,3663,59,122,33,26
4420,17824,53,17824,53,244,98,146,2,32,1,1
4421,46102,80,6915,80,70,70,0,2,5,2,0
4422,38524,443,15396,443,5846879,177697,5669182,6043,41,2261,3782
4423,64846,53,55957,53,785,110,675,2,30,1,1
4424,64895,53,65185,53,199,102,97,2,30,1,1
4425,49475,443,44120,443,10402,1945,8457,24,158,11,13
4426,49655,53,33441,53,209,110,99,2,30,1,1
4427,51443,443,11818,443,4773,2454,2319,14,135,7,7
4428,55005,53,64520,53,183,94,89,2,30,1,1
4429,43357,443,61952,443,146374,13143,133231,238,131,116,122
4430,38143,443,25496,443,84884,5896,78988,128,36,66,62
4431,49256,443,30277,443,10619,3257,7362,29,361,13,16
4432,64978,53,11316,53,198,102,96,2,30,1,1
4433,36022,443,7743,443,7257,1619,5638,22,275,11,11
4434,64816,123,36690,123,184,94,90,2,30,1,1
4435,57309,53,8457,53,197,102,95,2,30,1,1
4436,9166,53,9166,53,244,98,146,2,32,1,1
4437,65220,53,17734,53,303,94,209,4,32,2,2
4438,52165,80,35107,80,1945,1002,943,11,19,7,4
4439,10014,40026,21058,40026,156,94,62,2,30,1,1
4440,55087,53,26632,53,183,94,89,2,30,1,1
4441,64685,53,47486,53,785,110,675,2,30,1,1
4442,52082,80,6337,80,4560,3934,626,11,29,6,5
4443,53931,55300,33330,55300,492,306,186,8,15,5,3
4444,51651,80,41220,80,8100,4781,3319,23,166,12,11
4445,49872,443,65245,443,3120,1862,1258,18,15,11,7
4446,49950,443,56465,443,6770,2219,4551,21,89,11,10
4447,10008,40004,11500,40004,156,94,62,2,30,1,1
4448,64978,53,20864,53,198,102,96,2,30,1,1
4449,64818,53,60686,53,179,94,85,2,30,1,1
4450,49520,53,1147,53,209,110,99,2,30,1,1
4451,55043,443,10001,443,36707,3750,32957,54,60,24,30
4452,53937,28506,44986,28506,492,306,186,8,15,5,3
4453,65144,53,32702,53,653,86,567,4,46,2,2
4454,51329,443,55771,443,2019,1219,800,15,17,8,7
4455,65521,443,8234,443,92427,4519,87908,105,15,39,66
4456,57137,53,36481,53,279,96,183,4,31,2,2
4457,60803,80,16464,80,254,128,126,5,15,3,2
4458,46101,80,15092,80,70,70,0,2,5,2,0
4459,53939,9504,53453,9504,492,306,186,8,15,5,3
4460,49491,53,15104,53,492,94,398,4,45,2,2
4461,65520,443,22541,443,438102,12780,425322,449,15,157,292
4462,49196,53,15790,53,181,94,87,2,33,1,1
4463,53979,26308,39677,26308,70,70,0,2,7,2,0
4464,49888,53,58972,53,363,97,266,4,34,2,2
4465,43495,5223,36493,5223,142,142,0,1,4,1,0
4466,38474,28678,45201,28678,1806,1806,0,22,224,22,0
4467,49443,443,17566,443,70988,47020,23968,152,652,79,73
4468,49474,443,32026,443,10315,2018,8297,24,158,12,12
4469,50132,443,60688,443,8162,1364,6798,22,16,11,11
4470,49480,443,58193,443,1160,638,522,13,113,7,6
4471,65220,53,7048,53,184,94,90,2,29,1,1
4472,49473,443,31044,443,3990,1296,2694,17,158,9,8
4473,56724,53,41138,53,195,102,93,2,29,1,1
4474,49629,53,2341,53,198,102,96,2,29,1,1
4475,59005,443,56215,443,6306,1780,4526,28,33,14,14
4476,64895,53,23891,53,199,102,97,2,29,1,1
4477,55026,53,39957,53,164,86,78,2,29,1,1
4478,49483,53,61034,53,319,94,225,2,29,1,1
4479,57309,53,6657,53,197,102,95,2,29,1,1
4480,65496,53,50374,53,183,94,89,2,30,1,1
4481,64937,53,43310,53,183,94,89,2,29,1,1
4482,55646,53,3427,53,183,94,89,2,30,1,1
4483,10013,40024,56811,40024,156,94,62,2,30,1,1
4484,58868,443,58939,443,239435,36478,202957,319,111,133,186
4485,64355,53,3739,53,213,102,111,2,30,1,1
4486,65496,53,50300,53,183,94,89,2,30,1,1
4487,39886,443,46428,443,315567,15410,300157,404,46,189,215
4488,55600,53,4581,53,209,110,99,2,30,1,1
4489,55939,53,57194,53,193,102,91,2,31,1,1
4490,50137,53,53286,53,448,184,264,6,31,3,3
4491,54979,53,64417,53,183,94,89,2,30,1,1
4492,33264,53,24560,53,164,78,86,2,30,1,1
4493,57375,53,3463,53,198,102,96,2,30,1,1
4494,55637,53,12301,53,209,110,99,2,30,1,1
4495,65373,53,2835,53,197,102,95,2,30,1,1
4496,57270,53,64569,53,200,102,98,2,30,1,1
4497,64930,53,28381,53,193,102,91,2,31,1,1
4498,55477,53,61973,53,183,94,89,2,31,1,1
4499,55087,53,19901,53,183,94,89,2,31,1,1
4500,64578,53,31792,53,193,102,91,2,31,1,1
4501,57067,53,21723,53,183,94,89,2,31,1,1
4502,55675,53,21127,53,198,102,96,2,30,1,1
4503,50522,443,12346,443,13347,4662,8685,40,202,24,16
4504,39343,443,19498,443,8562,1634,6928,27,26,13,14
4505,46103,80,5613,80,70,70,0,2,5,2,0
4506,65260,53,28900,53,184,94,90,2,30,1,1
4507,54979,53,11444,53,183,94,89,2,30,1,1
4508,55060,53,22947,53,195,102,93,2,30,1,1
4509,56317,53,35779,53,183,94,89,2,31,1,1
4510,49326,53,62713,53,193,102,91,2,30,1,1
4511,61226,443,29248,443,3135,1603,1532,22,632,7,15
4512,49224,53,25602,53,199,102,97,2,30,1,1
4513,64332,53,40499,53,167,86,81,2,30,1,1
4514,55224,53,5980,53,209,110,99,2,30,1,1
4515,35550,53,45606,53,164,78,86,2,30,1,1
4516,55224,53,33137,53,209,110,99,2,30,1,1
4517,49376,53,19245,53,209,110,99,2,30,1,1
4518,55346,443,44978,443,13181,6041,7140,60,410,27,33
4519,57401,53,56934,53,179,94,85,2,31,1,1
4520,36926,53,54098,53,164,78,86,2,30,1,1
4521,52092,80,65314,80,3163,716,2447,12,28,7,5
4522,21432,53,21432,53,244,98,146,2,32,1,1
4523,14950,53,14950,53,414,268,146,3,32,2,1
4524,65462,53,20337,53,196,102,94,2,33,1,1
4525,53174,41442,6472,41442,70,70,0,2,8,2,0
4526,46099,80,56104,80,70,70,0,2,5,2,0
4527,65350,53,8382,53,390,105,285,4,42,2,2
4528,49479,443,58848,443,4591,2492,2099,20,113,11,9
4529,43151,443,30299,443,9462,4488,4974,28,96,13,15
4530,49949,443,7206,443,4712,908,3804,18,89,9,9
4531,50676,80,23134,80,13054,6885,6169,27,26,13,14
4532,56660,53,40707,53,183,94,89,2,30,1,1
4533,10009,40008,62477,40008,156,94,62,2,30,1,1
4534,49782,53,28643,53,228,86,142,2,30,1,1
4535,49269,53,11598,53,254,102,152,2,30,1,1
4536,49655,53,32746,53,209,110,99,2,30,1,1
4537,64911,53,65363,53,232,86,146,2,30,1,1
4538,46902,123,43333,123,184,94,90,2,30,1,1
4539,57411,53,35330,53,196,102,94,2,30,1,1
4540,64217,53,33943,53,193,102,91,2,30,1,1
4541,55820,53,49367,53,194,102,92,2,30,1,1
4542,56317,53,26526,53,183,94,89,2,30,1,1
4543,55377,53,41334,53,195,102,93,2,30,1,1
4544,49734,53,51597,53,259,110,149,2,30,1,1
4545,52859,53,16412,53,164,78,86,2,30,1,1
4546,55477,53,62006,53,183,94,89,2,30,1,1
4547,64637,53,39523,53,194,102,92,2,31,1,1
4548,46273,5228,19288,5228,5239,1558,3681,27,4020,9,18
4549,49277,53,15554,53,199,102,97,2,31,1,1
4550,49488,53,28678,53,194,102,92,2,31,1,1
4551,62547,443,41349,443,54095,6413,47682,151,450,61,90
4552,40590,443,36504,443,2965,1650,1315,24,275,12,12
4553,49376,53,53542,53,209,110,99,2,30,1,1
4554,65519,443,19659,443,436359,12780,423579,448,16,157,291
4555,50296,53,13683,53,183,94,89,2,30,1,1
4556,57037,443,39402,443,6847,1658,5189,21,25,12,9
4557,42060,53,44916,53,164,78,86,2,30,1,1
4558,55675,53,47376,53,198,102,96,2,30,1,1
4559,57375,53,63119,53,198,102,96,2,30,1,1
4560,49546,53,30362,53,193,102,91,2,30,1,1
4561,55060,53,16844,53,195,102,93,2,30,1,1
4562,57270,53,53677,53,200,102,98,2,31,1,1
4563,43093,53,41079,53,242,78,164,2,30,1,1
4564,65385,53,41370,53,259,110,149,2,30,1,1
4565,64869,53,31516,53,195,94,101,2,30,1,1
4566,65373,53,50644,53,197,102,95,2,31,1,1
4567,56754,53,50250,53,209,110,99,2,30,1,1
4568,2321,53,2321,53,216,98,118,2,30,1,1
4569,65356,53,60802,53,197,94,103,2,31,1,1
4570,54994,53,25626,53,209,110,99,2,31,1,1
4571,65106,53,25747,53,772,102,670,2,30,1,1
4572,64899,53,5067,53,199,102,97,2,31,1,1
4573,6881,6881,40398,6881,238,118,120,2,1199,1,1
4574,41459,80,32156,80,1866,1032,834,11,150,6,5
4575,37965,61085,23932,61085,132,132,0,3,1199,3,0
4576,37475,443,1375,443,4403,2160,2243,14,136,7,7
4577,55627,53,32877,53,179,94,85,2,30,1,1
4578,65336,53,55246,53,200,102,98,2,30,1,1
4579,56754,53,42272,53,209,110,99,2,30,1,1
4580,64899,53,16096,53,199,102,97,2,30,1,1
4581,59366,53,31679,53,242,78,164,2,30,1,1
4582,59951,53,55881,53,237,86,151,2,30,1,1
4583,50437,53,50192,53,413,170,243,6,30,3,3
4584,55377,53,45027,53,195,102,93,2,30,1,1
4585,49907,53,52196,53,199,102,97,2,30,1,1
4586,55763,53,36537,53,197,94,103,2,31,1,1
4587,64957,53,39699,53,196,102,94,2,30,1,1
4588,49294,53,26484,53,723,102,621,2,30,1,1
4589,49680,53,31932,53,749,94,655,2,30,1,1
4590,65403,53,11897,53,199,102,97,2,31,1,1
4591,49629,53,65217,53,198,102,96,2,31,1,1
4592,38149,53,54452,53,199,94,105,2,31,1,1
4593,55932,53,30562,53,209,110,99,2,31,1,1
4594,49539,53,54919,53,198,94,104,2,31,1,1
4595,64957,53,56586,53,196,102,94,2,31,1,1
4596,63465,443,3023,443,3942,1406,2536,18,135,8,10
4597,53974,26108,3464,26108,70,70,0,2,8,2,0
4598,64083,63666,21856,63666,66,66,0,2,8,2,0
4599,10007,40005,19403,40005,148,86,62,2,31,1,1
4600,64322,53,37052,53,273,90,183,4,32,2,2
4601,64077,20208,16294,20208,66,66,0,2,8,2,0
4602,50711,443,37437,443,2952,1548,1404,18,16,9,9
4603,65377,53,64134,53,404,95,309,4,49,2,2
4604,50021,445,0,0,66,66,0,1,0,1,0
4605,50019,445,0,0,66,66,0,1,0,1,0
4606,31130,30188,0,0,62,62,0,1,0,1,0
4607,50018,445,0,0,66,66,0,1,0,1,0
4608,1025,50584,0,0,62,62,0,1,0,1,0
4609,49900,445,0,0,70,70,0,1,0,1,0
4610,64035,25174,0,0,146,146,0,1,0,1,0
4611,15998,36829,0,0,62,62,0,1,0,1,0
4612,54610,445,0,0,70,70,0,1,0,1,0
4613,29742,50584,0,0,62,62,0,1,0,1,0
4614,54602,445,0,0,70,70,0,1,0,1,0
4615,54594,445,0,0,70,70,0,1,0,1,0
4616,49892,445,0,0,70,70,0,1,0,1,0
4617,5685,35440,0,0,66,66,0,1,0,1,0
4618,59018,22114,0,0,146,146,0,1,0,1,0
4619,47342,36237,0,0,66,66,0,1,0,1,0
4620,49890,445,0,0,70,70,0,1,0,1,0
4621,26287,56205,0,0,66,66,0,1,0,1,0
4622,50007,445,0,0,66,66,0,1,0,1,0
4623,443,45788,0,0,332,332,0,1,0,1,0
4624,49885,445,0,0,70,70,0,1,0,1,0
4625,52236,25174,0,0,62,62,0,1,0,1,0
4626,49884,445,0,0,70,70,0,1,0,1,0
4627,17306,25174,0,0,66,66,0,1,0,1,0
4628,49999,445,0,0,66,66,0,1,0,1,0
4629,54583,445,0,0,70,70,0,1,0,1,0
4630,3456,11392,0,0,66,66,0,1,0,1,0
4631,49880,445,0,0,70,70,0,1,0,1,0
4632,62642,25174,0,0,62,62,0,1,0,1,0
4633,11136,19910,0,0,62,62,0,1,0,1,0
4634,59977,30188,0,0,66,66,0,1,0,1,0
4635,49997,445,0,0,66,66,0,1,0,1,0
4636,49879,445,0,0,70,70,0,1,0,1,0
4637,37008,42707,0,0,62,62,0,1,0,1,0
4638,26762,22114,0,0,62,62,0,1,0,1,0
4639,60141,30188,0,0,66,66,0,1,0,1,0
4640,57539,44847,0,0,62,62,0,1,0,1,0
4641,52812,25174,0,0,66,66,0,1,0,1,0
4642,22263,30188,0,0,66,66,0,1,0,1,0
4643,37959,3855,0,0,72,72,0,1,0,1,0
4644,46516,80,0,0,60,60,0,1,0,1,0
4645,49990,445,0,0,66,66,0,1,0,1,0
4646,57410,25174,0,0,62,62,0,1,0,1,0
4647,49982,445,0,0,66,66,0,1,0,1,0
4648,9231,3389,0,0,66,66,0,1,0,1,0
4649,40054,62413,0,0,62,62,0,1,0,1,0
4650,59345,25174,0,0,62,62,0,1,0,1,0
4651,49874,445,0,0,70,70,0,1,0,1,0
4652,18173,25174,0,0,62,62,0,1,0,1,0
4653,63208,30975,0,0,148,148,0,1,0,1,0
4654,45941,23386,0,0,60,60,0,1,0,1,0
4655,63002,22114,0,0,66,66,0,1,0,1,0
4656,49786,25174,0,0,66,66,0,1,0,1,0
4657,5611,25174,0,0,146,146,0,1,0,1,0
4658,18652,64147,0,0,62,62,0,1,0,1,0
4659,10754,28793,0,0,66,66,0,1,0,1,0
4660,27824,51505,0,0,146,146,0,1,0,1,0
4661,39617,50584,0,0,146,146,0,1,0,1,0
4662,54573,445,0,0,70,70,0,1,0,1,0
4663,54572,445,0,0,70,70,0,1,0,1,0
4664,54571,445,0,0,70,70,0,1,0,1,0
4665,49966,445,0,0,66,66,0,1,0,1,0
4666,49973,445,0,0,66,66,0,1,0,1,0
4667,49971,445,0,0,66,66,0,1,0,1,0
4668,49972,445,0,0,66,66,0,1,0,1,0
4669,49968,445,0,0,66,66,0,1,0,1,0
4670,49974,445,0,0,66,66,0,1,0,1,0
4671,49970,445,0,0,66,66,0,1,0,1,0
4672,49969,445,0,0,66,66,0,1,0,1,0
4673,42973,57470,0,0,62,62,0,1,0,1,0
4674,36357,25174,0,0,66,66,0,1,0,1,0
4675,53579,42707,0,0,66,66,0,1,0,1,0
4676,56876,11392,0,0,66,66,0,1,0,1,0
4677,49861,445,0,0,70,70,0,1,0,1,0
4678,60883,64147,0,0,74,74,0,1,0,1,0
4679,9731,64147,0,0,62,62,0,1,0,1,0
4680,30046,15503,0,0,62,62,0,1,0,1,0
4681,49858,445,0,0,70,70,0,1,0,1,0
4682,52340,22114,0,0,66,66,0,1,0,1,0
4683,48706,23393,0,0,60,60,0,1,0,1,0
4684,48706,23393,0,0,60,60,0,1,0,1,0
4685,65270,3855,0,0,78,78,0,1,0,1,0
4686,49182,21247,0,0,62,62,0,1,0,1,0
4687,54569,445,0,0,70,70,0,1,0,1,0
4688,54567,445,0,0,70,70,0,1,0,1,0
4689,54563,445,0,0,70,70,0,1,0,1,0
4690,54559,445,0,0,70,70,0,1,0,1,0
4691,43645,39004,0,0,145,145,0,1,0,1,0
4692,49954,445,0,0,66,66,0,1,0,1,0
4693,49952,445,0,0,66,66,0,1,0,1,0
4694,49953,445,0,0,66,66,0,1,0,1,0
4695,49853,445,0,0,70,70,0,1,0,1,0
4696,49852,445,0,0,70,70,0,1,0,1,0
4697,34212,11392,0,0,66,66,0,1,0,1,0
4698,49850,445,0,0,70,70,0,1,0,1,0
4699,36770,56205,0,0,62,62,0,1,0,1,0
4700,54551,445,0,0,70,70,0,1,0,1,0
4701,64406,25174,0,0,66,66,0,1,0,1,0
4702,54550,445,0,0,70,70,0,1,0,1,0
4703,54547,445,0,0,70,70,0,1,0,1,0
4704,54539,445,0,0,70,70,0,1,0,1,0
4705,49356,50584,0,0,62,62,0,1,0,1,0
4706,34993,15503,0,0,62,62,0,1,0,1,0
4707,50360,37965,0,0,66,66,0,1,0,1,0
4708,49590,57470,0,0,78,78,0,1,0,1,0
4709,7342,22114,0,0,62,62,0,1,0,1,0
4710,12785,2323,0,0,60,60,0,1,0,1,0
4711,49843,445,0,0,70,70,0,1,0,1,0
4712,50127,64147,0,0,66,66,0,1,0,1,0
4713,33453,64147,0,0,62,62,0,1,0,1,0
4714,35589,25174,0,0,66,66,0,1,0,1,0
4715,49841,445,0,0,70,70,0,1,0,1,0
4716,54531,445,0,0,70,70,0,1,0,1,0
4717,54529,445,0,0,70,70,0,1,0,1,0
4718,54530,445,0,0,70,70,0,1,0,1,0
4719,37749,15503,0,0,62,62,0,1,0,1,0
4720,5223,32965,0,0,66,66,0,1,0,1,0
4721,49840,445,0,0,70,70,0,1,0,1,0
4722,19933,35440,0,0,62,62,0,1,0,1,0
4723,52819,15503,0,0,66,66,0,1,0,1,0
4724,23578,2323,0,0,60,60,0,1,0,1,0
4725,49839,445,0,0,70,70,0,1,0,1,0
4726,49940,445,0,0,66,66,0,1,0,1,0
4727,49838,445,0,0,70,70,0,1,0,1,0
4728,10248,21247,0,0,146,146,0,1,0,1,0
4729,49832,445,0,0,70,70,0,1,0,1,0
4730,49834,445,0,0,70,70,0,1,0,1,0
4731,56067,25174,0,0,62,62,0,1,0,1,0
4732,12290,22114,0,0,62,62,0,1,0,1,0
4733,55994,22114,0,0,66,66,0,1,0,1,0
4734,49677,25174,0,0,66,66,0,1,0,1,0
4735,49820,445,0,0,70,70,0,1,0,1,0
4736,49818,445,0,0,70,70,0,1,0,1,0
4737,49164,25174,0,0,146,146,0,1,0,1,0
4738,54526,445,0,0,70,70,0,1,0,1,0
4739,49813,445,0,0,70,70,0,1,0,1,0
4740,49809,445,0,0,70,70,0,1,0,1,0
4741,49808,445,0,0,70,70,0,1,0,1,0
4742,35949,31573,0,0,146,146,0,1,0,1,0
4743,54525,445,0,0,70,70,0,1,0,1,0
4744,41677,57470,0,0,66,66,0,1,0,1,0
4745,31675,19473,0,0,62,62,0,1,0,1,0
4746,21322,25174,0,0,62,62,0,1,0,1,0
4747,60245,25174,0,0,62,62,0,1,0,1,0
4748,27745,50584,0,0,62,62,0,1,0,1,0
4749,25565,62979,0,0,60,60,0,1,0,1,0
4750,49927,445,0,0,66,66,0,1,0,1,0
4751,49924,445,0,0,66,66,0,1,0,1,0
4752,6889,65473,0,0,143,143,0,1,0,1,0
4753,2850,64147,0,0,66,66,0,1,0,1,0
4754,60571,26467,0,0,62,62,0,1,0,1,0
4755,27448,22114,0,0,62,62,0,1,0,1,0
4756,57677,57470,0,0,62,62,0,1,0,1,0
4757,49797,445,0,0,70,70,0,1,0,1,0
4758,54516,445,0,0,70,70,0,1,0,1,0
4759,54510,445,0,0,70,70,0,1,0,1,0
4760,54506,445,0,0,70,70,0,1,0,1,0
4761,54508,445,0,0,70,70,0,1,0,1,0
4762,58399,56205,0,0,62,62,0,1,0,1,0
4763,49920,445,0,0,66,66,0,1,0,1,0
4764,23873,30188,0,0,62,62,0,1,0,1,0
4765,40780,80,6352,80,1155,781,374,10,16,6,4
4766,38753,443,17390,443,29887852,586245,29301607,27419,299,7975,19444
4767,50038,443,53552,443,2652,1566,1086,15,86,9,6
4768,52370,443,22287,443,7058,2421,4637,21,17,11,10
4769,64080,11801,22050,11801,66,66,0,2,8,2,0
4770,54280,3396,54280,3396,60,60,0,1,5,1,0
4771,64117,80,61513,80,5827,773,5054,16,73,9,7
4772,56781,443,59501,443,7870,1881,5989,20,15,11,9
4773,55999,53,41388,53,774,101,673,2,30,1,1
4774,53751,53,53289,53,578,286,292,9,16,5,4
4775,45123,15000,48758,15000,130,70,60,2,6,1,1
4776,34079,443,61674,443,14068,7909,6159,37,82,23,14
4777,55046,443,8809,443,23425,10763,12662,57,48,31,26
4778,52172,80,27126,80,362,240,122,7,17,5,2
4779,64957,53,47584,53,192,98,94,2,30,1,1
4780,57067,53,57189,53,182,93,89,2,30,1,1
4781,56780,443,59581,443,7922,1933,5989,20,16,11,9
4782,40039,80,57862,80,1155,781,374,10,15,6,4
4783,41620,53,41620,53,257,101,156,2,32,1,1
4784,59924,443,2445,443,682,310,372,12,68,6,6
4785,47169,15000,52806,15000,130,70,60,2,5,1,1
4786,63993,17866,56109,17866,4607,2045,2562,24,45,14,10
4787,52169,80,44471,80,362,240,122,7,17,5,2
4788,34964,80,34964,80,2889,1482,1407,10,15,6,4
4789,50014,443,7099,443,5644,3210,2434,22,86,13,9
4790,52213,56682,21348,56682,70,70,0,2,6,2,0
4791,48276,15000,65405,15000,130,70,60,2,5,1,1
4792,58288,443,58288,443,4661,1754,2907,19,26,11,8
4793,55555,53,19089,53,778,103,675,2,30,1,1
4794,50336,53,11367,53,240,76,164,2,30,1,1
4795,49618,53,25113,53,774,101,673,2,30,1,1
4796,56330,53,9857,53,271,95,176,4,48,2,2
4797,64899,53,35861,53,198,101,97,2,30,1,1
4798,10005,40022,7541,40022,151,89,62,2,30,1,1
4799,56715,53,5613,53,1384,88,1296,4,32,2,2
4800,53971,18810,62225,18810,70,70,0,2,8,2,0
4801,57750,15000,45543,15000,130,70,60,2,5,1,1
4802,52181,1038,36423,1038,66,66,0,1,5,1,0
4803,52169,59681,49857,59681,66,66,0,1,5,1,0
4804,51619,15000,21734,15000,130,70,60,2,6,1,1
4805,49248,80,49248,80,163556,12140,151416,207,22,97,110
4806,49996,443,63041,443,19523,5346,14177,37,87,17,20
4807,52170,45144,10407,45144,66,66,0,1,5,1,0
4808,57452,53,53868,53,776,102,674,2,30,1,1
4809,56385,53,50019,53,249,85,164,4,56,2,2
4810,64559,53,6054,53,196,100,96,2,31,1,1
4811,64578,53,53350,53,186,95,91,2,31,1,1
4812,49246,80,49246,80,133699,9415,124284,169,23,77,92
4813,52170,80,60754,80,362,240,122,7,17,5,2
4814,41958,5222,34545,5222,2380,1500,880,24,130,13,11
4815,52173,80,40738,80,362,240,122,7,17,5,2
4816,55652,443,55652,443,141647,19296,122351,203,55,102,101
4817,44048,443,44048,443,4401,1494,2907,19,29,11,8
4818,56782,443,26053,443,7956,1967,5989,20,15,11,9
4819,49323,443,62942,443,9802,2846,6956,33,79,15,18
4820,64340,53,64340,53,237,91,146,2,33,1,1
4821,53967,54589,5598,54589,70,70,0,2,8,2,0
4822,49247,80,49247,80,135755,6750,129005,160,22,68,92
4823,36586,3142,36586,3142,138,78,60,2,6,1,1
4824,53839,15000,61295,15000,130,70,60,2,5,1,1
4825,47276,443,53172,443,190,70,120,4,15,2,2
4826,20689,53,20689,53,237,91,146,2,33,1,1
4827,61822,53,61822,53,237,91,146,2,33,1,1
4828,49249,80,49249,80,265842,14126,251716,311,22,136,175
4829,11295,40002,55023,40002,209,85,124,4,54,2,2
4830,60252,443,61357,443,5169,790,4379,16,72,8,8
4831,52173,44632,6542,44632,156,66,90,2,5,1,1
4832,50040,443,40234,443,1097,654,443,12,86,7,5
4833,50041,443,57357,443,1097,654,443,12,86,7,5
4834,57356,53,60821,53,198,101,97,2,30,1,1
4835,53417,443,8874,443,9193,6294,2899,27,121,14,13
4836,57727,443,62460,443,54944,4374,50570,88,361,44,44
4837,65370,53,60115,53,186,95,91,2,31,1,1
4838,65346,53,45745,53,182,93,89,2,31,1,1
4839,64204,53,3889,53,186,95,91,2,31,1,1
4840,55933,53,2538,53,180,92,88,2,30,1,1
4841,51052,53,0,0,82,82,0,1,30,1,0
4842,50356,53,7944,53,176,90,86,2,31,1,1
4843,49382,53,52485,53,200,102,98,2,31,1,1
4844,49671,53,37210,53,182,93,89,2,31,1,1
4845,65127,53,25987,53,780,104,676,2,31,1,1
4846,55436,53,43899,53,774,101,673,2,30,1,1
4847,56672,53,28355,53,198,101,97,2,31,1,1
4848,64569,53,10194,53,182,93,89,2,31,1,1
4849,57035,53,19895,53,198,101,97,2,31,1,1
4850,49798,53,59206,53,192,98,94,2,31,1,1
4851,50265,44822,26867,44822,149,149,0,1,1200,1,0
4852,64048,53,43444,53,202,103,99,2,31,1,1
4853,49869,53,53726,53,202,103,99,2,31,1,1
4854,55951,53,2710,53,780,104,676,2,31,1,1
4855,56951,53,25007,53,198,101,97,2,31,1,1
4856,63278,443,14519,443,11570,3553,8017,24,134,10,14
4857,57574,443,28846,443,3595,1957,1638,17,361,9,8
4858,59012,443,51105,443,6278,3531,2747,23,122,12,11
4859,56941,53,4680,53,192,98,94,2,31,1,1
4860,65292,53,23690,53,190,97,93,2,31,1,1
4861,49380,53,10250,53,198,101,97,2,31,1,1
4862,65526,53,17062,53,198,101,97,2,31,1,1
4863,64288,53,10803,53,182,93,89,2,31,1,1
4864,49331,53,64999,53,180,92,88,2,31,1,1
4865,53089,24211,0,0,66,66,0,1,0,1,0
4866,40787,57470,0,0,62,62,0,1,0,1,0
4867,17232,22114,0,0,62,62,0,1,0,1,0
4868,65228,53,0,0,88,88,0,1,0,1,0
4869,2075,19473,0,0,66,66,0,1,0,1,0
4870,49911,445,0,0,66,66,0,1,0,1,0
4871,49909,445,0,0,66,66,0,1,0,1,0
4872,49914,445,0,0,66,66,0,1,0,1,0
4873,49910,445,0,0,66,66,0,1,0,1,0
4874,49905,445,0,0,66,66,0,1,0,1,0
4875,49908,445,0,0,66,66,0,1,0,1,0
4876,49903,445,0,0,66,66,0,1,0,1,0
4877,18745,64147,0,0,66,66,0,1,0,1,0
4878,38503,25,0,0,60,60,0,1,0,1,0
4879,57484,30317,0,0,62,62,0,1,0,1,0
4880,54501,445,0,0,70,70,0,1,0,1,0
4881,53256,5900,0,0,60,60,0,1,0,1,0
4882,49793,445,0,0,70,70,0,1,0,1,0
4883,65530,53,21720,53,167,86,81,2,30,1,1
4884,10004,40014,64871,40014,156,94,62,2,30,1,1
4885,56569,53,13010,53,183,94,89,2,30,1,1
4886,44062,443,52650,443,8998,1684,7314,24,170,12,12
4887,58958,80,41174,80,6969,6315,654,15,15,9,6
4888,50594,443,48288,443,4337,3026,1311,21,141,12,9
4889,34783,5222,34830,5222,482,210,272,8,15,4,4
4890,5588,5588,0,0,3498,1872,1626,48,204,24,24
4891,56385,53,3618,53,249,85,164,4,55,2,2
4892,49277,53,20518,53,199,102,97,2,30,1,1
4893,64752,53,29277,53,195,102,93,2,30,1,1
4894,64276,53,2363,53,354,102,252,2,30,1,1
4895,55933,53,42992,53,182,94,88,2,30,1,1
4896,54994,53,3788,53,209,110,99,2,30,1,1
4897,49437,53,23949,53,199,102,97,2,30,1,1
4898,57356,53,19968,53,199,102,97,2,30,1,1
4899,55004,443,35617,443,27629,9041,18588,88,271,46,42
4900,52175,1101,27107,1101,70,70,0,1,5,1,0
4901,55600,53,6191,53,209,110,99,2,29,1,1
4902,53373,53,58629,53,242,78,164,2,29,1,1
4903,57067,53,18004,53,183,94,89,2,29,1,1
4904,65403,53,40925,53,199,102,97,2,29,1,1
4905,49546,53,27218,53,193,102,91,2,30,1,1
4906,64238,53,6347,53,215,102,113,2,30,1,1
4907,56330,53,48374,53,271,95,176,4,47,2,2
4908,49437,53,10171,53,199,102,97,2,30,1,1
4909,52128,80,31768,80,366,240,126,7,26,5,2
4910,54139,80,14592,80,1515,481,1034,11,15,6,5
4911,33970,443,28633,443,2586,832,1754,14,15,7,7
4912,52124,80,5847,80,366,240,126,7,26,5,2
4913,35514,80,18032,80,841,715,126,5,14,3,2
4914,64078,54561,7261,54561,66,66,0,2,7,2,0
4915,52206,59077,23195,59077,316,136,180,6,9,3,3
4916,50043,443,32430,443,6551,2085,4466,25,85,14,11
4917,36145,443,14544,443,1439,878,561,15,17,10,5
4918,53969,13156,38324,13156,70,70,0,2,7,2,0
4919,53972,59089,65256,59089,70,70,0,2,7,2,0
4920,64079,20233,31225,20233,66,66,0,2,7,2,0
4921,38011,443,55120,443,6732,885,5847,24,368,7,17
4922,49176,443,57308,443,10225,3155,7070,28,57,19,9
4923,49479,53,55939,53,213,94,119,2,29,1,1
4924,54207,443,5893,443,4788,785,4003,15,70,8,7
4925,55005,53,24549,53,183,94,89,2,30,1,1
4926,65339,53,4097,53,775,102,673,2,30,1,1
4927,64559,53,8772,53,198,102,96,2,30,1,1
4928,64048,53,38443,53,209,110,99,2,30,1,1
4929,52102,80,29370,80,22495,1895,20600,33,27,15,18
4930,51880,8001,9632,8001,86,86,0,1,30,1,0
4931,52176,17572,9912,17572,70,70,0,1,5,1,0
4932,52171,63033,25728,63033,70,70,0,1,5,1,0
4933,49382,53,23594,53,200,102,98,2,30,1,1
4934,49552,53,39720,53,102,102,0,1,30,1,0
4935,49869,53,64308,53,209,110,99,2,30,1,1
4936,50708,80,26997,80,1658,1247,411,8,15,5,3
4937,41157,443,35776,443,78535,3648,74887,94,30,41,53
4938,58737,443,61229,443,16417,13221,3196,50,74,31,19
4939,37602,53,37602,53,260,106,154,2,32,1,1
4940,10019,443,53412,443,1497912,26236,1471676,1321,121,299,1022
4941,58739,443,43331,443,22751,17995,4756,67,73,42,25
4942,35985,443,7017,443,6250,1312,4938,23,28,12,11
4943,55939,53,43027,53,193,102,91,2,30,1,1
4944,56330,53,40178,53,271,95,176,4,48,2,2
4945,36101,53,61383,53,168,78,90,2,30,1,1
4946,55749,53,21707,53,413,170,243,6,30,3,3
4947,55637,53,58251,53,209,110,99,2,30,1,1
4948,56569,53,53689,53,183,94,89,2,30,1,1
4949,55932,53,22197,53,209,110,99,2,30,1,1
4950,55653,53,34737,53,199,102,97,2,30,1,1
4951,64559,53,63710,53,198,102,96,2,30,1,1
4952,49629,53,5781,53,198,102,96,2,30,1,1
4953,57295,53,34997,53,448,184,264,6,30,3,3
4954,56941,53,63824,53,196,102,94,2,30,1,1
4955,56941,53,56569,53,193,102,91,2,30,1,1
4956,55675,53,48589,53,198,102,96,2,30,1,1
4957,55182,53,17791,53,199,102,97,2,30,1,1
4958,65292,53,4110,53,195,102,93,2,30,1,1
4959,55182,53,55293,53,199,102,97,2,30,1,1
4960,56941,53,44223,53,196,102,94,2,30,1,1
4961,65260,53,8952,53,199,102,97,2,30,1,1
4962,64976,53,35202,53,229,102,127,2,30,1,1
4963,56672,53,28150,53,199,102,97,2,30,1,1
4964,52168,62118,28732,62118,70,70,0,1,5,1,0
4965,41322,53,41322,53,244,98,146,2,32,1,1
4966,58902,5223,20774,5223,308,86,222,4,13,1,3
4967,49229,8112,22492,8112,2049,1276,773,15,15,8,7
4968,33098,443,57667,443,6044,780,5264,16,66,8,8
4969,48286,443,48286,443,4621,1714,2907,19,26,11,8
4970,47310,443,33854,443,3541,616,2925,19,165,8,11
4971,56180,53,31487,53,200,102,98,2,30,1,1
4972,54106,53,53865,53,164,78,86,2,30,1,1
4973,55933,53,60713,53,182,94,88,2,30,1,1
4974,57401,53,48123,53,179,94,85,2,30,1,1
4975,57356,53,26396,53,199,102,97,2,30,1,1
4976,55932,53,3248,53,209,110,99,2,30,1,1
4977,65260,53,3983,53,199,102,97,2,30,1,1
4978,55764,53,63898,53,250,94,156,2,30,1,1
4979,49666,443,64744,443,14531,7971,6560,36,190,20,16
4980,52212,51343,6977,51343,70,70,0,2,6,2,0
4981,52179,14354,22942,14354,70,70,0,1,5,1,0
4982,52172,7353,21812,7353,70,70,0,1,5,1,0
4983,50934,443,28821,443,9989,3003,6986,30,46,17,13
4984,32962,443,9560,443,3935,1010,2925,20,165,9,11
4985,54994,53,62711,53,209,110,99,2,30,1,1
4986,55377,53,33641,53,195,102,93,2,30,1,1
4987,56180,53,37696,53,200,102,98,2,30,1,1
4988,49343,53,1518,53,209,110,99,2,30,1,1
4989,65513,53,51212,53,216,102,114,2,30,1,1
4990,49284,53,41000,53,195,86,109,2,30,1,1
4991,56180,53,15802,53,200,102,98,2,30,1,1
4992,49650,53,58699,53,539,97,442,4,58,2,2
4993,55948,5223,3545,5223,10038,5272,4766,36,196,20,16
4994,50045,443,55393,443,5661,1526,4135,22,85,12,10
4995,56330,53,41814,53,271,95,176,4,47,2,2
4996,50047,443,14680,443,4612,947,3665,18,85,10,8
4997,50658,443,64697,443,4876,2522,2354,22,83,13,9
4998,6881,6881,3673,6881,237,118,119,2,1200,1,1
4999,50608,443,24048,443,4758,2811,1947,22,140,12,10
5000,50578,80,35081,80,367162,17367,349795,470,143,214,256
5001,39194,53,39194,53,414,268,146,3,32,2,1
5002,52211,56648,57880,56648,70,70,0,2,8,2,0
5003,52232,35126,34717,35126,70,70,0,1,5,1,0
5004,65518,443,8967,443,92157,4519,87638,105,15,39,66
5005,50612,443,9041,443,6782,3367,3415,25,139,15,10
5006,60729,443,20106,443,5737,1929,3808,19,201,11,8
5007,52208,47300,20128,47300,70,70,0,2,9,2,0
5008,38977,53,0,0,82,82,0,2,40,2,0
5009,64132,53,20663,53,381,102,279,4,42,2,2
5010,44060,443,59243,443,9734,1614,8120,24,170,11,13
5011,55774,8060,26633,8060,70,70,0,2,8,2,0
5012,52178,30922,2429,30922,70,70,0,1,5,1,0
5013,43304,443,10226,443,4389,797,3592,15,70,8,7
5014,52180,20121,7972,20121,70,70,0,1,5,1,0
5015,57188,53,28885,53,193,102,91,2,29,1,1
5016,49520,53,8068,53,209,110,99,2,29,1,1
5017,55637,53,5558,53,209,110,99,2,29,1,1
5018,64935,53,54508,53,193,102,91,2,29,1,1
5019,50296,53,43204,53,183,94,89,2,29,1,1
5020,38608,80,62728,80,1289,303,986,12,16,5,7
5021,55005,53,53050,53,183,94,89,2,29,1,1
5022,49662,53,29879,53,211,102,109,2,29,1,1
5023,60591,80,30981,80,1364,860,504,13,17,8,5
5024,65336,53,9283,53,200,102,98,2,29,1,1
5025,64686,53,47974,53,214,102,112,2,29,1,1
5026,65196,53,54719,53,392,90,302,4,55,2,2
5027,38948,53,19233,53,242,78,164,2,29,1,1
5028,56385,53,22600,53,249,85,164,4,55,2,2
5029,64752,53,50636,53,195,102,93,2,30,1,1
5030,51880,51881,42143,51881,86,86,0,1,30,1,0
5031,57258,53,33746,53,215,102,113,2,30,1,1
5032,51880,8001,32545,8001,86,86,0,1,30,1,0
5033,65370,53,23524,53,193,102,91,2,30,1,1
5034,50401,53,50401,53,200,90,110,2,30,1,1
5035,56544,53,54094,53,224,102,122,2,30,1,1
5036,64637,53,52362,53,194,102,92,2,30,1,1
5037,56951,53,9479,53,199,102,97,2,30,1,1
5038,56805,53,39519,53,178,94,84,2,30,1,1
5039,49331,53,5900,53,182,94,88,2,31,1,1
5040,56884,53,35715,53,199,102,97,2,30,1,1
5041,49382,53,23586,53,200,102,98,2,30,1,1
5042,65292,53,3636,53,195,102,93,2,30,1,1
5043,56186,53,56186,53,233,98,135,2,30,1,1
5044,56739,443,22996,443,795,795,0,2,169,2,0
5045,54367,443,60704,443,5892088,193411,5698677,6287,213,2098,4189
5046,54438,443,22711,443,8198,1975,6223,24,361,11,13
5047,17750,18866,37630,18866,150,150,0,1,1200,1,0
5048,45860,443,61779,443,12852,3554,9298,35,24,19,16
5049,36146,443,34524,443,1147,660,487,11,17,7,4
5050,5011,53,5011,53,244,98,146,2,32,1,1
5051,53173,25067,13422,25067,70,70,0,2,8,2,0
5052,52183,13503,58173,13503,70,70,0,1,5,1,0
5053,55933,53,55116,53,330,92,238,4,43,2,2
5054,38713,443,14389,443,90241,3033,87208,89,16,24,65
5055,49543,53,24051,53,880,189,691,6,75,3,3
5056,56941,53,56687,53,193,102,91,2,30,1,1
5057,55653,53,53327,53,199,102,97,2,30,1,1
5058,64569,53,17459,53,183,94,89,2,30,1,1
5059,51446,53,21490,53,168,78,90,2,30,1,1
5060,64066,80,28023,80,314,192,122,6,15,4,2
5061,53101,443,12106,443,1287,800,487,13,16,9,4
5062,52210,15604,53868,15604,70,70,0,2,8,2,0
5063,52182,60769,21483,60769,70,70,0,1,5,1,0
5064,38712,443,31171,443,382972,9177,373795,378,16,120,258
5065,44061,443,59659,443,8551,1685,6866,24,170,12,12
5066,56385,53,50438,53,249,85,164,4,56,2,2
5067,55201,53,9810,53,168,78,90,2,30,1,1
5068,49343,53,21551,53,209,110,99,2,30,1,1
5069,57051,53,56096,53,185,102,83,2,30,1,1
5070,64821,53,30415,53,775,102,673,2,30,1,1
5071,50234,53,63121,53,720,94,626,2,30,1,1
5072,49488,53,56220,53,194,102,92,2,31,1,1
5073,60661,53,54714,53,278,102,176,2,31,1,1
5074,65526,53,37729,53,199,102,97,2,30,1,1
5075,52056,80,64858,80,4562,3936,626,11,28,6,5
5076,53102,443,27329,443,983,496,487,9,16,5,4
5077,52214,27480,12479,27480,70,70,0,2,6,2,0
5078,44065,443,13980,443,6114,862,5252,17,71,9,8
5079,44059,443,60027,443,9730,1613,8117,24,170,11,13
5080,44893,53,32339,53,199,94,105,2,30,1,1
5081,56569,53,42369,53,183,94,89,2,30,1,1
5082,64578,53,30124,53,193,102,91,2,30,1,1
5083,56672,53,60163,53,199,102,97,2,30,1,1
5084,64055,53,3603,53,233,94,139,2,30,1,1
5085,65258,53,62928,53,178,94,84,2,30,1,1
5086,64569,53,45660,53,183,94,89,2,30,1,1
5087,50356,53,30610,53,180,94,86,2,30,1,1
5088,57067,53,11799,53,183,94,89,2,30,1,1
5089,64288,53,3103,53,183,94,89,2,31,1,1
5090,56725,53,48111,53,180,94,86,2,31,1,1
5091,49869,53,29655,53,209,110,99,2,30,1,1
5092,56317,53,15827,53,183,94,89,2,30,1,1
5093,65258,53,21767,53,178,94,84,2,30,1,1
5094,65370,53,10592,53,193,102,91,2,30,1,1
5095,56005,53,10080,53,199,102,97,2,30,1,1
5096,64935,53,65195,53,193,102,91,2,30,1,1
5097,55078,53,15054,53,246,94,152,2,30,1,1
5098,49610,53,51833,53,212,102,110,2,30,1,1
5099,49380,53,58826,53,199,102,97,2,31,1,1
5100,65346,53,19469,53,183,94,89,2,30,1,1
5101,49671,53,47128,53,183,94,89,2,30,1,1
5102,57401,53,55696,53,179,94,85,2,31,1,1
5103,64957,53,58925,53,196,102,94,2,30,1,1
5104,57035,53,3817,53,199,102,97,2,30,1,1
5105,49838,53,52067,53,183,94,89,2,31,1,1
5106,64204,53,35802,53,193,102,91,2,30,1,1
5107,64204,53,37090,53,193,102,91,2,31,1,1
5108,51325,443,32371,443,2959,793,2166,10,120,5,5
5109,57035,53,5245,53,199,102,97,2,30,1,1
5110,49382,53,52583,53,200,102,98,2,31,1,1
5111,56805,53,61616,53,178,94,84,2,31,1,1
5112,65370,53,21172,53,193,102,91,2,30,1,1
5113,50694,443,18706,443,3097,1708,1389,15,19,9,6
5114,50018,53,63073,53,350,91,259,4,41,2,2
5115,49869,53,17507,53,414,103,311,4,31,2,2
5116,53923,25267,60857,25267,1724,1157,567,14,17,9,5
5117,52525,80,56526,80,3951,3437,514,13,15,8,5
5118,57446,443,49278,443,9642,3343,6299,37,16,17,20
5119,49364,53,13056,53,307,307,0,4,60,4,0
5120,62112,443,29747,443,505589,13504,492085,462,345,91,371
5121,50607,443,33073,443,3947,2271,1676,22,140,13,9
5122,37898,53,37898,53,244,98,146,2,33,1,1
5123,5480,53,5480,53,244,98,146,2,33,1,1
5124,52167,61948,3341,61948,70,70,0,1,5,1,0
5125,49991,80,28668,80,2095,1010,1085,11,87,6,5
5126,62149,22114,0,0,66,66,0,1,0,1,0
5127,13589,22114,0,0,146,146,0,1,0,1,0
5128,54496,445,0,0,70,70,0,1,0,1,0
5129,54492,445,0,0,70,70,0,1,0,1,0
5130,54493,445,0,0,70,70,0,1,0,1,0
5131,443,36576,0,0,60,60,0,1,0,1,0
5132,53275,21247,0,0,66,66,0,1,0,1,0
5133,63487,129,0,0,60,60,0,1,0,1,0
5134,53750,25174,0,0,66,66,0,1,0,1,0
5135,49781,445,0,0,70,70,0,1,0,1,0
5136,49784,445,0,0,70,70,0,1,0,1,0
5137,49782,445,0,0,70,70,0,1,0,1,0
5138,53667,22114,0,0,66,66,0,1,0,1,0
5139,20544,5223,0,0,148,148,0,1,0,1,0
5140,49780,445,0,0,70,70,0,1,0,1,0
5141,53721,62413,0,0,62,62,0,1,0,1,0
5142,64005,26467,0,0,66,66,0,1,0,1,0
5143,49777,445,0,0,70,70,0,1,0,1,0
5144,9687,35440,0,0,66,66,0,1,0,1,0
5145,16425,15503,0,0,62,62,0,1,0,1,0
5146,51414,22,0,0,60,60,0,1,0,1,0
5147,43671,17372,0,0,62,62,0,1,0,1,0
5148,58835,17372,0,0,66,66,0,1,0,1,0
5149,54491,445,0,0,70,70,0,1,0,1,0
5150,54488,445,0,0,70,70,0,1,0,1,0
5151,54485,445,0,0,70,70,0,1,0,1,0
5152,63495,50584,0,0,66,66,0,1,0,1,0
5153,49897,445,0,0,66,66,0,1,0,1,0
5154,54483,445,0,0,70,70,0,1,0,1,0
5155,49894,445,0,0,66,66,0,1,0,1,0
5156,12164,22114,0,0,146,146,0,1,0,1,0
5157,12338,64147,0,0,66,66,0,1,0,1,0
5158,17213,22114,0,0,62,62,0,1,0,1,0
5159,61701,15503,0,0,66,66,0,1,0,1,0
5160,49893,445,0,0,66,66,0,1,0,1,0
5161,49891,445,0,0,66,66,0,1,0,1,0
5162,49769,445,0,0,70,70,0,1,0,1,0
5163,53305,50584,0,0,66,66,0,1,0,1,0
5164,62348,50584,0,0,62,62,0,1,0,1,0
5165,64878,26467,0,0,62,62,0,1,0,1,0
5166,49889,445,0,0,66,66,0,1,0,1,0
5167,49938,57470,0,0,62,62,0,1,0,1,0
5168,23753,25174,0,0,62,62,0,1,0,1,0
5169,64013,57470,0,0,74,74,0,1,0,1,0
5170,49761,445,0,0,70,70,0,1,0,1,0
5171,40821,41615,0,0,157,157,0,1,0,1,0
5172,31859,33909,0,0,66,66,0,1,0,1,0
5173,54478,445,0,0,70,70,0,1,0,1,0
5174,49760,445,0,0,70,70,0,1,0,1,0
5175,31691,50584,0,0,62,62,0,1,0,1,0
5176,58751,51221,0,0,62,62,0,1,0,1,0
5177,50488,22114,0,0,62,62,0,1,0,1,0
5178,1025,46776,0,0,62,62,0,1,0,1,0
5179,54471,445,0,0,70,70,0,1,0,1,0
5180,54465,445,0,0,70,70,0,1,0,1,0
5181,29064,23,0,0,60,60,0,1,0,1,0
5182,9552,22114,0,0,146,146,0,1,0,1,0
5183,49196,25174,0,0,62,62,0,1,0,1,0
5184,49754,445,0,0,70,70,0,1,0,1,0
5185,49878,445,0,0,66,66,0,1,0,1,0
5186,56152,56205,0,0,66,66,0,1,0,1,0
5187,49753,445,0,0,70,70,0,1,0,1,0
5188,6899,48817,0,0,139,139,0,1,0,1,0
5189,1048,25174,0,0,62,62,0,1,0,1,0
5190,48478,49903,0,0,62,62,0,1,0,1,0
5191,53194,26467,0,0,66,66,0,1,0,1,0
5192,49749,445,0,0,70,70,0,1,0,1,0
5193,49871,445,0,0,66,66,0,1,0,1,0
5194,59497,64097,0,0,66,66,0,1,0,1,0
5195,54455,445,0,0,70,70,0,1,0,1,0
5196,57325,60043,0,0,66,66,0,1,0,1,0
5197,443,50238,0,0,331,331,0,1,0,1,0
5198,443,23220,0,0,100,100,0,1,0,1,0
5199,51046,25174,0,0,62,62,0,1,0,1,0
5200,49748,445,0,0,70,70,0,1,0,1,0
5201,443,45788,0,0,332,332,0,1,0,1,0
5202,49869,445,0,0,66,66,0,1,0,1,0
5203,62838,44847,0,0,66,66,0,1,0,1,0
5204,61784,49903,0,0,66,66,0,1,0,1,0
5205,22350,25174,0,0,62,62,0,1,0,1,0
5206,14717,64147,0,0,66,66,0,1,0,1,0
5207,18642,42707,0,0,62,62,0,1,0,1,0
5208,53730,37965,0,0,66,66,0,1,0,1,0
5209,60248,46776,0,0,66,66,0,1,0,1,0
5210,49862,445,0,0,66,66,0,1,0,1,0
5211,49743,445,0,0,70,70,0,1,0,1,0
5212,55201,26467,0,0,66,66,0,1,0,1,0
5213,49853,445,0,0,66,66,0,1,0,1,0
5214,22240,22114,0,0,146,146,0,1,0,1,0
5215,2572,17546,0,0,66,66,0,1,0,1,0
5216,18653,42707,0,0,66,66,0,1,0,1,0
5217,15899,37807,0,0,62,62,0,1,0,1,0
5218,28999,37807,0,0,62,62,0,1,0,1,0
5219,34360,25174,0,0,62,62,0,1,0,1,0
5220,58118,22114,0,0,62,62,0,1,0,1,0
5221,64811,51221,0,0,62,62,0,1,0,1,0
5222,54446,445,0,0,70,70,0,1,0,1,0
5223,54443,445,0,0,70,70,0,1,0,1,0
5224,54444,445,0,0,70,70,0,1,0,1,0
5225,50784,50584,0,0,146,146,0,1,0,1,0
5226,49844,445,0,0,66,66,0,1,0,1,0
5227,49842,445,0,0,66,66,0,1,0,1,0
5228,49846,445,0,0,66,66,0,1,0,1,0
5229,49845,445,0,0,66,66,0,1,0,1,0
5230,49840,445,0,0,66,66,0,1,0,1,0
5231,49843,445,0,0,66,66,0,1,0,1,0
5232,49841,445,0,0,66,66,0,1,0,1,0
5233,49838,445,0,0,66,66,0,1,0,1,0
5234,58799,30188,0,0,66,66,0,1,0,1,0
5235,49730,445,0,0,70,70,0,1,0,1,0
5236,17230,25174,0,0,146,146,0,1,0,1,0
5237,11006,23117,0,0,146,146,0,1,0,1,0
5238,65270,3855,0,0,78,78,0,1,0,1,0
5239,44207,44847,0,0,66,66,0,1,0,1,0
5240,55893,45711,0,0,78,78,0,1,0,1,0
5241,49727,445,0,0,70,70,0,1,0,1,0
5242,42608,1,0,0,62,62,0,1,0,1,0
5243,40418,25174,0,0,66,66,0,1,0,1,0
5244,63488,22114,0,0,62,62,0,1,0,1,0
5245,52745,57866,0,0,62,62,0,1,0,1,0
5246,11676,25174,0,0,146,146,0,1,0,1,0
5247,38629,25174,0,0,62,62,0,1,0,1,0
5248,54441,445,0,0,70,70,0,1,0,1,0
5249,54434,445,0,0,70,70,0,1,0,1,0
5250,54432,445,0,0,70,70,0,1,0,1,0
5251,54428,445,0,0,70,70,0,1,0,1,0
5252,64334,25174,0,0,62,62,0,1,0,1,0
5253,51430,25174,0,0,146,146,0,1,0,1,0
5254,5222,7493,0,0,66,66,0,1,0,1,0
5255,56098,64147,0,0,66,66,0,1,0,1,0
5256,1594,44847,0,0,62,62,0,1,0,1,0
5257,57607,21247,0,0,66,66,0,1,0,1,0
5258,60485,22114,0,0,62,62,0,1,0,1,0
5259,49723,445,0,0,70,70,0,1,0,1,0
5260,49826,445,0,0,66,66,0,1,0,1,0
5261,49825,445,0,0,66,66,0,1,0,1,0
5262,49824,445,0,0,66,66,0,1,0,1,0
5263,6666,5000,0,0,60,60,0,1,0,1,0
5264,3765,64147,0,0,62,62,0,1,0,1,0
5265,49721,445,0,0,70,70,0,1,0,1,0
5266,51313,25174,0,0,62,62,0,1,0,1,0
5267,13285,29892,0,0,145,145,0,1,0,1,0
5268,58463,11392,0,0,66,66,0,1,0,1,0
5269,62716,23,0,0,60,60,0,1,0,1,0
5270,49719,445,0,0,70,70,0,1,0,1,0
5271,56377,51505,0,0,66,66,0,1,0,1,0
5272,12457,57866,0,0,62,62,0,1,0,1,0
5273,51456,45680,0,0,139,139,0,1,0,1,0
5274,28792,22,0,0,60,60,0,1,0,1,0
5275,54423,445,0,0,70,70,0,1,0,1,0
5276,51575,9694,0,0,66,66,0,1,0,1,0
5277,44398,50584,0,0,146,146,0,1,0,1,0
5278,54418,445,0,0,70,70,0,1,0,1,0
5279,54419,445,0,0,70,70,0,1,0,1,0
5280,54415,445,0,0,70,70,0,1,0,1,0
5281,54043,36237,0,0,62,62,0,1,0,1,0
5282,60830,50584,0,0,62,62,0,1,0,1,0
5283,62971,44847,0,0,66,66,0,1,0,1,0
5284,9748,21247,0,0,66,66,0,1,0,1,0
5285,38565,51505,0,0,66,66,0,1,0,1,0
5286,61916,64097,0,0,66,66,0,1,0,1,0
5287,3580,25174,0,0,62,62,0,1,0,1,0
5288,34262,23,0,0,60,60,0,1,0,1,0
5289,49712,445,0,0,70,70,0,1,0,1,0
5290,57761,15503,0,0,62,62,0,1,0,1,0
5291,13168,35440,0,0,66,66,0,1,0,1,0
5292,22916,25174,0,0,62,62,0,1,0,1,0
5293,49710,445,0,0,70,70,0,1,0,1,0
5294,19623,25174,0,0,62,62,0,1,0,1,0
5295,57793,37807,0,0,66,66,0,1,0,1,0
5296,22528,25174,0,0,146,146,0,1,0,1,0
5297,49709,445,0,0,70,70,0,1,0,1,0
5298,1027,57866,0,0,62,62,0,1,0,1,0
5299,54404,445,0,0,70,70,0,1,0,1,0
5300,54403,445,0,0,70,70,0,1,0,1,0
5301,54399,445,0,0,70,70,0,1,0,1,0
5302,49708,445,0,0,70,70,0,1,0,1,0
5303,10627,23117,0,0,62,62,0,1,0,1,0
5304,49707,445,0,0,70,70,0,1,0,1,0
5305,23379,57866,0,0,62,62,0,1,0,1,0
5306,49701,445,0,0,70,70,0,1,0,1,0
5307,49702,445,0,0,70,70,0,1,0,1,0
5308,49812,445,0,0,66,66,0,1,0,1,0
5309,52336,64097,0,0,66,66,0,1,0,1,0
5310,58453,50584,0,0,66,66,0,1,0,1,0
5311,37075,48817,0,0,62,62,0,1,0,1,0
5312,49689,445,0,0,70,70,0,1,0,1,0
5313,49687,445,0,0,70,70,0,1,0,1,0
5314,49686,445,0,0,70,70,0,1,0,1,0
5315,7105,25174,0,0,66,66,0,1,0,1,0
5316,49678,445,0,0,70,70,0,1,0,1,0
5317,49679,445,0,0,70,70,0,1,0,1,0
5318,49488,53,14006,53,188,96,92,2,30,1,1
5319,56805,53,35322,53,172,88,84,2,30,1,1
5320,65448,443,34387,443,3224,2373,851,17,23,9,8
5321,55043,443,34590,443,37068,4085,32983,66,48,33,33
5322,49703,443,4967,443,421435,16499,404936,388,210,95,293
5323,64637,53,50285,53,188,96,92,2,30,1,1
5324,49931,443,64224,443,92352,5699,86653,105,134,35,70
5325,49984,53,41486,53,172,88,84,2,30,1,1
5326,41545,443,41545,443,4719,1812,2907,19,29,11,8
5327,50005,80,43332,80,2088,1160,928,10,86,6,4
5328,57470,24409,44348,24409,870,330,540,12,1501,6,6
5329,40033,80,40033,80,424,198,226,7,142,4,3
5330,40080,80,40080,80,424,198,226,7,142,4,3
5331,39943,80,39943,80,424,198,226,7,142,4,3
5332,50749,443,38979,443,4749,1897,2852,16,124,8,8
5333,49035,443,36911,443,4299,2327,1972,23,315,11,12
5334,49709,443,24927,443,523518,15431,508087,466,210,109,357
5335,18381,53,18381,53,237,91,146,2,32,1,1
5336,51260,80,28140,80,2339,1680,659,11,17,6,5
5337,50015,443,26548,443,59858,24345,35513,148,612,78,70
5338,49319,53,3849,53,198,101,97,2,30,1,1
5339,58036,443,28433,443,10454,1724,8730,28,525,12,16
5340,49242,443,58883,443,638,70,568,10,203,2,8
5341,38536,443,1919,443,33980,7386,26594,51,121,22,29
5342,53927,37828,58314,37828,552,306,246,9,16,5,4
5343,50006,80,59669,80,2087,1159,928,10,86,6,4
5344,49707,443,44929,443,593578,18531,575047,531,210,128,403
5345,53172,56013,19244,56013,70,70,0,2,8,2,0
5346,53936,5915,56119,5915,70,70,0,1,5,1,0
5347,52166,57975,20041,57975,66,66,0,1,5,1,0
5348,53932,27258,53010,27258,70,70,0,1,5,1,0
5349,58178,443,51468,443,8000,1760,6240,32,43,16,16
5350,57451,443,58507,443,19175423,168230,19007193,15129,313,2298,12831
5351,42956,53,20926,53,168,78,90,2,30,1,1
5352,56725,53,37417,53,176,90,86,3,55,2,1
5353,48290,443,64782,443,7920,2731,5189,27,82,15,12
5354,49838,53,8093,53,182,93,89,2,31,1,1
5355,41936,443,58038,443,7118,2386,4732,18,133,10,8
5356,50007,80,25590,80,2089,1161,928,10,86,6,4
5357,49704,443,41533,443,513839,16341,497498,453,210,104,349
5358,57570,443,12758,443,21267,5407,15860,36,361,17,19
5359,49930,443,24713,443,16631,7072,9559,50,134,29,21
5360,57447,443,62052,443,7847,1377,6470,27,15,12,15
5361,55796,53,55796,53,253,99,154,2,32,1,1
5362,58179,443,33593,443,7883,1768,6115,30,36,14,16
5363,58666,53,58666,53,235,90,145,2,32,1,1
5364,53963,6882,44227,6882,70,70,0,2,8,2,0
5365,53968,17904,18186,17904,320,140,180,6,7,3,3
5366,47092,15000,12405,15000,138,78,60,2,5,1,1
5367,50017,443,54344,443,51055,17321,33734,147,612,77,70
5368,53245,80,62504,80,2071,1305,766,10,256,6,4
5369,65530,53,20818,53,166,85,81,2,30,1,1
5370,43934,53,43934,53,310,94,216,2,30,1,1
5371,57319,53,22543,53,176,90,86,2,30,1,1
5372,56100,53,56100,53,265,111,154,2,30,1,1
5373,65189,53,20195,53,176,90,86,2,31,1,1
5374,64143,53,9554,53,174,89,85,2,31,1,1
5375,32843,443,63526,443,6444,2640,3804,18,122,9,9
5376,64727,443,24002,443,18620,15824,2796,31,129,18,13
5377,39802,80,39802,80,424,198,226,7,142,4,3
5378,6882,46440,39998,46440,324,150,174,2,1200,1,1
5379,55704,53,48604,53,186,95,91,2,31,1,1
5380,39852,80,39852,80,576,272,304,9,142,5,4
5381,54440,26467,0,0,62,62,0,1,0,1,0
5382,3730,17372,0,0,62,62,0,1,0,1,0
5383,54539,26467,0,0,62,62,0,1,0,1,0
5384,36933,23117,0,0,66,66,0,1,0,1,0
5385,54398,445,0,0,70,70,0,1,0,1,0
5386,9504,25174,0,0,62,62,0,1,0,1,0
5387,53928,15503,0,0,62,62,0,1,0,1,0
5388,54397,445,0,0,70,70,0,1,0,1,0
5389,48706,23393,0,0,60,60,0,1,0,1,0
5390,57557,64147,0,0,62,62,0,1,0,1,0
5391,31780,11392,0,0,62,62,0,1,0,1,0
5392,443,14591,0,0,131,131,0,1,0,1,0
5393,46275,23,0,0,60,60,0,1,0,1,0
5394,443,45788,0,0,332,332,0,1,0,1,0
5395,49797,445,0,0,66,66,0,1,0,1,0
5396,49795,445,0,0,66,66,0,1,0,1,0
5397,3986,17372,0,0,66,66,0,1,0,1,0
5398,443,18177,0,0,66,66,0,1,0,1,0
5399,65442,80,64392,80,366,180,186,7,28,4,3
5400,42318,443,52319,443,10723,2046,8677,29,116,10,19
5401,49380,53,47715,53,199,102,97,2,30,1,1
5402,56805,53,60553,53,178,94,84,2,30,1,1
5403,26906,22114,0,0,66,66,0,1,0,1,0
5404,49001,22114,0,0,62,62,0,1,0,1,0
5405,49667,445,0,0,70,70,0,1,0,1,0
5406,53838,36829,0,0,62,62,0,1,0,1,0
5407,28830,37965,0,0,62,62,0,1,0,1,0
5408,57015,25174,0,0,66,66,0,1,0,1,0
5409,54387,445,0,0,70,70,0,1,0,1,0
5410,54383,445,0,0,70,70,0,1,0,1,0
5411,54376,445,0,0,70,70,0,1,0,1,0
5412,26239,25174,0,0,62,62,0,1,0,1,0
5413,36484,67,0,0,60,60,0,1,0,1,0
5414,49790,445,0,0,66,66,0,1,0,1,0
5415,55246,31573,0,0,62,62,0,1,0,1,0
5416,59068,49813,0,0,74,74,0,1,0,1,0
5417,55393,44512,0,0,66,66,0,1,0,1,0
5418,15018,37965,0,0,62,62,0,1,0,1,0
5419,46162,25174,0,0,62,62,0,1,0,1,0
5420,61550,5529,0,0,145,145,0,1,0,1,0
5421,49785,445,0,0,66,66,0,1,0,1,0
5422,49784,445,0,0,66,66,0,1,0,1,0
5423,49783,445,0,0,66,66,0,1,0,1,0
5424,49776,445,0,0,66,66,0,1,0,1,0
5425,49779,445,0,0,66,66,0,1,0,1,0
5426,49777,445,0,0,66,66,0,1,0,1,0
5427,49778,445,0,0,66,66,0,1,0,1,0
5428,49662,445,0,0,70,70,0,1,0,1,0
5429,18771,35440,0,0,66,66,0,1,0,1,0
5430,51922,44847,0,0,66,66,0,1,0,1,0
5431,15981,23117,0,0,146,146,0,1,0,1,0
5432,54371,445,0,0,70,70,0,1,0,1,0
5433,54367,445,0,0,70,70,0,1,0,1,0
5434,54365,445,0,0,70,70,0,1,0,1,0
5435,54364,445,0,0,70,70,0,1,0,1,0
5436,49652,445,0,0,70,70,0,1,0,1,0
5437,49653,445,0,0,70,70,0,1,0,1,0
5438,49654,445,0,0,70,70,0,1,0,1,0
5439,63593,22114,0,0,66,66,0,1,0,1,0
5440,48706,23393,0,0,60,60,0,1,0,1,0
5441,42558,64147,0,0,62,62,0,1,0,1,0
5442,49650,445,0,0,70,70,0,1,0,1,0
5443,54189,64147,0,0,66,66,0,1,0,1,0
5444,49646,445,0,0,70,70,0,1,0,1,0
5445,49984,53,22558,53,178,94,84,2,30,1,1
5446,30188,51403,44357,51403,502,150,352,2,1200,1,1
5447,64637,53,26983,53,194,102,92,2,31,1,1
5448,53933,20801,53397,20801,70,70,0,1,4,1,0
5449,50927,80,64147,80,876,519,357,10,75,6,4
5450,52524,80,48631,80,3224,2776,448,11,15,7,4
5451,50688,80,9336,80,27391,3550,23841,36,20,15,21
5452,50599,443,63618,443,11301,5604,5697,29,139,17,12
5453,56403,53,56403,53,244,98,146,2,32,1,1
5454,53399,53,53399,53,414,268,146,3,32,2,1
5455,33017,443,34545,443,130,70,60,3,4,2,1
5456,51986,443,52647,443,7567,3038,4529,35,15,21,14
5457,49772,53,51587,53,531,188,343,6,58,3,3
5458,65222,53,38822,53,197,94,103,2,29,1,1
5459,56078,53,50373,53,178,94,84,2,29,1,1
5460,56884,53,20649,53,199,102,97,2,29,1,1
5461,64048,53,43496,53,209,110,99,2,29,1,1
5462,49671,53,11585,53,183,94,89,2,29,1,1
5463,65346,53,42988,53,183,94,89,2,29,1,1
5464,55485,53,55524,53,720,94,626,2,29,1,1
5465,65373,53,10645,53,197,102,95,2,29,1,1
5466,64288,53,49667,53,183,94,89,2,29,1,1
5467,57319,53,20750,53,180,94,86,2,29,1,1
5468,64107,53,23798,53,212,102,110,2,29,1,1
5469,35585,53,60283,53,168,78,90,2,29,1,1
5470,56951,53,31350,53,199,102,97,2,30,1,1
5471,52163,14181,27565,14181,70,70,0,1,5,1,0
5472,52522,80,14593,80,3290,2776,514,12,15,7,5
5473,65443,80,29432,80,366,180,186,7,28,4,3
5474,56725,53,45081,53,262,90,172,4,53,2,2
5475,60290,53,35403,53,213,86,127,2,30,1,1
5476,49433,53,51324,53,278,94,184,2,30,1,1
5477,52237,53,52237,53,220,90,130,2,30,1,1
5478,49380,53,64533,53,199,102,97,2,30,1,1
5479,38911,443,33015,443,13187,2075,11112,35,420,11,24
5480,53572,443,49621,443,5935,342,5593,12,120,5,7
5481,40368,123,25473,123,184,94,90,2,30,1,1
5482,65189,53,27284,53,180,94,86,2,30,1,1
5483,64266,53,14538,53,255,102,153,2,30,1,1
5484,52520,80,54295,80,3224,2776,448,11,15,7,4
5485,49838,53,33413,53,183,94,89,2,30,1,1
5486,47886,80,46758,80,1767,751,1016,10,15,6,4
5487,49798,53,8655,53,196,102,94,2,30,1,1
5488,50928,80,36754,80,875,518,357,10,75,6,4
5489,60499,51413,3005,51413,70,70,0,2,8,2,0
5490,60500,44739,45783,44739,70,70,0,2,8,2,0
5491,65430,80,47649,80,306,180,126,6,29,4,2
5492,52093,80,65106,80,366,240,126,7,26,5,2
5493,44962,8802,46440,8802,4014,2342,1672,42,386,21,21
5494,65441,80,26203,80,366,180,186,7,28,4,3
5495,49331,53,35223,53,182,94,88,2,30,1,1
5496,56440,80,38855,80,17008,1379,15629,22,25,7,15
5497,60384,80,50302,80,1420,715,705,12,16,7,5
5498,49174,53,10035,53,264,110,154,2,30,1,1
5499,56941,53,42543,53,196,102,94,2,30,1,1
5500,56725,53,46910,53,262,90,172,4,59,2,2
5501,56951,53,23495,53,199,102,97,2,30,1,1
5502,50547,53,45838,53,210,110,100,2,30,1,1
5503,41950,53,0,0,86,86,0,1,30,1,0
5504,58771,53,46484,53,168,78,90,2,30,1,1
5505,49798,53,43543,53,196,102,94,2,30,1,1
5506,64569,53,30065,53,183,94,89,2,30,1,1
5507,64143,53,33110,53,179,94,85,2,30,1,1
5508,32966,53,20380,53,199,94,105,2,30,1,1
5509,65346,53,64945,53,183,94,89,2,30,1,1
5510,54402,53,53139,53,291,86,205,2,30,1,1
5511,49184,53,41219,53,199,94,105,2,30,1,1
5512,52165,49740,12957,49740,70,70,0,1,5,1,0
5513,65440,80,8468,80,366,180,186,7,28,4,3
5514,52521,80,12951,80,3676,3228,448,11,15,7,4
5515,46532,3389,46532,3389,4145,1976,2169,22,20,13,9
5516,35337,443,49436,443,6550678,172191,6378487,6426,82,2117,4309
5517,16403,16385,45121,16385,182,62,120,4,30,2,2
5518,49798,53,23227,53,196,102,94,2,30,1,1
5519,57035,53,29329,53,199,102,97,2,30,1,1
5520,49984,53,7504,53,178,94,84,2,30,1,1
5521,65428,80,59063,80,366,180,186,7,29,4,3
5522,50547,53,5293,53,210,110,100,2,30,1,1
5523,49319,53,62578,53,199,102,97,2,30,1,1
5524,65189,53,45878,53,180,94,86,2,30,1,1
5525,63759,443,31179,443,7995,2096,5899,18,120,8,10
5526,49672,443,34216,443,10080,2728,7352,28,188,14,14
5527,34155,443,22614,443,11294,2234,9060,23,139,12,11
5528,52644,6881,4484,6881,719,413,306,10,14,5,5
5529,58172,80,64584,80,12618,1038,11580,28,50,13,15
5530,53970,1024,11868,1024,260,140,120,5,6,3,2
5531,53941,53739,17149,53739,70,70,0,1,4,1,0
5532,60498,55100,34970,55100,258,70,188,4,8,2,2
5533,56661,443,57675,443,334,70,264,5,17,1,4
5534,65432,80,46367,80,486,240,246,9,28,5,4
5535,56005,53,33914,53,199,102,97,2,29,1,1
5536,65530,53,20918,53,167,86,81,2,29,1,1
5537,53724,53,53724,53,268,114,154,2,29,1,1
5538,65526,53,17627,53,199,102,97,2,29,1,1
5539,61291,53,61291,53,261,106,155,2,29,1,1
5540,37639,53,37639,53,245,106,139,2,29,1,1
5541,64578,53,11531,53,193,102,91,2,30,1,1
5542,51726,3389,51726,3389,3444,1730,1714,16,33,8,8
5543,57356,53,7268,53,199,102,97,2,29,1,1
5544,56078,53,48093,53,178,94,84,2,29,1,1
5545,64048,53,15990,53,209,110,99,2,30,1,1
5546,65526,53,9344,53,199,102,97,2,30,1,1
5547,56672,53,24787,53,199,102,97,2,29,1,1
5548,16403,16386,51369,16386,122,62,60,2,29,1,1
5549,54835,443,32514,443,15578,7071,8507,69,140,33,36
5550,64899,53,12836,53,199,102,97,2,29,1,1
5551,49488,53,29306,53,194,102,92,2,30,1,1
5552,49554,53,40462,53,210,110,100,2,31,1,1
5553,65425,80,38267,80,366,180,186,7,29,4,3
5554,52158,443,56576,443,2149,1549,600,14,45,8,6
5555,51988,443,46112,443,10492,3167,7325,40,15,24,16
5556,52110,80,18812,80,422,240,182,8,26,5,3
5557,52106,80,35207,80,422,240,182,8,26,5,3
5558,50013,53,57171,53,258,102,156,2,30,1,1
5559,57001,53,34470,53,210,110,100,2,30,1,1
5560,64143,53,3333,53,179,94,85,2,30,1,1
5561,65292,53,37185,53,195,102,93,2,30,1,1
5562,58755,443,6984,443,4827,2244,2583,16,135,8,8
5563,65429,80,58851,80,366,180,186,7,29,4,3
5564,60501,40829,11084,40829,70,70,0,2,8,2,0
5565,65444,80,16519,80,486,240,246,9,28,5,4
5566,65433,80,53822,80,486,240,246,9,28,5,4
5567,52116,80,18216,80,422,240,182,8,26,5,3
5568,49242,443,26105,443,4528,803,3725,14,15,8,6
5569,52120,80,3357,80,366,240,126,7,26,5,2
5570,52109,80,35580,80,422,240,182,8,26,5,3
5571,52105,80,43976,80,422,240,182,8,26,5,3
5572,63143,16884,9026,16884,618,318,300,10,16,5,5
5573,16403,16384,41860,16384,122,62,60,2,30,1,1
5574,58087,53,39920,53,168,78,90,2,30,1,1
5575,49319,53,9038,53,199,102,97,2,30,1,1
5576,57001,53,50963,53,210,110,100,2,30,1,1
5577,65438,443,60459,443,572,320,252,10,28,6,4
5578,52523,80,47280,80,4302,3722,580,14,15,8,6
5579,64770,53,5158,53,360,93,267,3,37,2,1
5580,52802,80,4743,80,1465,729,736,12,16,7,5
5581,49414,443,6061,443,3427,2159,1268,20,17,11,9
5582,51125,80,6897,80,2880,815,2065,12,25,7,5
5583,64950,53,37238,53,725,277,448,8,61,4,4
5584,49331,53,37708,53,182,94,88,2,30,1,1
5585,49806,53,64642,53,331,102,229,2,30,1,1
5586,57452,443,52384,443,6990,2193,4797,15,120,7,8
5587,58614,53,27670,53,218,78,140,2,31,1,1
5588,58661,443,49876,443,2956,790,2166,10,120,5,5
5589,40364,443,43021,443,20594,14251,6343,40,361,22,18
5590,60731,443,42232,443,12669,5297,7372,31,188,18,13
5591,37965,51413,49792,51413,789,152,637,4,1199,2,2
5592,6881,51184,15075,51184,324,150,174,2,1203,1,1
5593,43464,443,26785,443,8198,656,7542,19,327,5,14
5594,49447,443,57996,443,11281,5398,5883,21,125,11,10
5595,57470,53250,48963,53250,491,150,341,2,1199,1,1
5596,50584,29040,20008,29040,509,150,359,2,1200,1,1
5597,44847,58839,4824,58839,501,150,351,2,1200,1,1
5598,56549,443,22340,443,13979,2593,11386,29,114,11,18
5599,49838,53,31499,53,183,94,89,2,31,1,1
5600,47809,53,47809,53,260,106,154,2,32,1,1
5601,64652,443,64652,443,6792,1521,5271,18,26,11,7
5602,61740,443,6060,443,92202,65396,26806,193,3454,68,125
5603,36535,443,64497,443,6805,1662,5143,25,17,13,12
5604,46326,443,42575,443,430,152,278,7,32,3,4
5605,51134,3389,51134,3389,4213,2429,1784,18,32,9,9
5606,49690,443,64449,443,9107,2174,6933,29,187,14,15
5607,45964,2225,0,0,60,60,0,1,0,1,0
5608,9969,2323,0,0,60,60,0,1,0,1,0
5609,52934,35776,0,0,159,159,0,1,0,1,0
5610,11030,17372,0,0,62,62,0,1,0,1,0
5611,42939,48817,0,0,156,156,0,1,0,1,0
5612,10306,44847,0,0,66,66,0,1,0,1,0
5613,54361,445,0,0,70,70,0,1,0,1,0
5614,54360,445,0,0,70,70,0,1,0,1,0
5615,54358,445,0,0,70,70,0,1,0,1,0
5616,53353,26467,0,0,62,62,0,1,0,1,0
5617,52459,33890,0,0,60,60,0,1,0,1,0
5618,16824,11119,0,0,148,148,0,1,0,1,0
5619,49769,445,0,0,66,66,0,1,0,1,0
5620,54355,445,0,0,70,70,0,1,0,1,0
5621,49641,445,0,0,70,70,0,1,0,1,0
5622,54011,22114,0,0,62,62,0,1,0,1,0
5623,49767,445,0,0,66,66,0,1,0,1,0
5624,5223,14446,0,0,220,220,0,1,0,1,0
5625,41577,53,41577,53,265,111,154,2,0,1,1
5626,51356,22114,0,0,66,66,0,1,0,1,0
5627,22150,6881,0,0,62,62,0,1,0,1,0
5628,443,7387,0,0,60,60,0,1,0,1,0
5629,49765,445,0,0,66,66,0,1,0,1,0
5630,49764,445,0,0,66,66,0,1,0,1,0
5631,48258,37965,0,0,62,62,0,1,0,1,0
5632,49761,445,0,0,66,66,0,1,0,1,0
5633,443,45788,0,0,332,332,0,1,0,1,0
5634,49633,445,0,0,70,70,0,1,0,1,0
5635,59535,25174,0,0,146,146,0,1,0,1,0
5636,49631,445,0,0,70,70,0,1,0,1,0
5637,54351,445,0,0,70,70,0,1,0,1,0
5638,45952,22114,0,0,62,62,0,1,0,1,0
5639,55666,35440,0,0,66,66,0,1,0,1,0
5640,54343,445,0,0,70,70,0,1,0,1,0
5641,54339,445,0,0,70,70,0,1,0,1,0
5642,57726,37965,0,0,62,62,0,1,0,1,0
5643,443,50238,0,0,331,331,0,1,0,1,0
5644,57131,35776,0,0,145,145,0,1,0,1,0
5645,49627,445,0,0,70,70,0,1,0,1,0
5646,14185,48637,0,0,60,60,0,1,0,1,0
5647,49625,445,0,0,70,70,0,1,0,1,0
5648,58724,43890,0,0,66,66,0,1,0,1,0
5649,53692,44512,0,0,66,66,0,1,0,1,0
5650,56604,17372,0,0,66,66,0,1,0,1,0
5651,49750,445,0,0,66,66,0,1,0,1,0
5652,3410,17372,0,0,62,62,0,1,0,1,0
5653,59965,36237,0,0,66,66,0,1,0,1,0
5654,10532,26672,0,0,60,60,0,1,0,1,0
5655,63873,44847,0,0,62,62,0,1,0,1,0
5656,59508,65348,0,0,148,148,0,1,0,1,0
5657,3406,17372,0,0,66,66,0,1,0,1,0
5658,56219,22114,0,0,62,62,0,1,0,1,0
5659,49621,445,0,0,70,70,0,1,0,1,0
5660,42973,57470,0,0,62,62,0,1,0,1,0
5661,18130,25174,0,0,62,62,0,1,0,1,0
5662,49743,445,0,0,66,66,0,1,0,1,0
5663,49620,445,0,0,70,70,0,1,0,1,0
5664,443,45788,0,0,199,199,0,1,0,1,0
5665,54327,445,0,0,70,70,0,1,0,1,0
5666,49741,445,0,0,66,66,0,1,0,1,0
5667,50708,22114,0,0,146,146,0,1,0,1,0
5668,49615,445,0,0,70,70,0,1,0,1,0
5669,45837,25174,0,0,62,62,0,1,0,1,0
5670,40845,64147,0,0,62,62,0,1,0,1,0
5671,43155,35440,0,0,66,66,0,1,0,1,0
5672,49734,445,0,0,66,66,0,1,0,1,0
5673,62197,22114,0,0,62,62,0,1,0,1,0
5674,41653,21247,0,0,62,62,0,1,0,1,0
5675,49726,445,0,0,66,66,0,1,0,1,0
5676,61085,37965,0,0,62,62,0,1,0,1,0
5677,443,45788,0,0,199,199,0,1,0,1,0
5678,14869,44847,0,0,62,62,0,1,0,1,0
5679,59155,39004,0,0,74,74,0,1,0,1,0
5680,51558,37965,0,0,72,72,0,1,0,1,0
5681,2064,22114,0,0,62,62,0,1,0,1,0
5682,54051,28793,0,0,66,66,0,1,0,1,0
5683,49602,445,0,0,70,70,0,1,0,1,0
5684,54319,445,0,0,70,70,0,1,0,1,0
5685,54315,445,0,0,70,70,0,1,0,1,0
5686,54316,445,0,0,70,70,0,1,0,1,0
5687,18843,25174,0,0,146,146,0,1,0,1,0
5688,49716,445,0,0,66,66,0,1,0,1,0
5689,49714,445,0,0,66,66,0,1,0,1,0
5690,49718,445,0,0,66,66,0,1,0,1,0
5691,49715,445,0,0,66,66,0,1,0,1,0
5692,49713,445,0,0,66,66,0,1,0,1,0
5693,49712,445,0,0,66,66,0,1,0,1,0
5694,49711,445,0,0,66,66,0,1,0,1,0
5695,49710,445,0,0,66,66,0,1,0,1,0
5696,49908,56205,0,0,62,62,0,1,0,1,0
5697,38852,37965,0,0,62,62,0,1,0,1,0
5698,65270,3855,0,0,78,78,0,1,0,1,0
5699,58421,30188,0,0,66,66,0,1,0,1,0
5700,50334,64147,0,0,66,66,0,1,0,1,0
5701,8560,50584,0,0,62,62,0,1,0,1,0
5702,41885,25174,0,0,62,62,0,1,0,1,0
5703,55998,15503,0,0,146,146,0,1,0,1,0
5704,0,0,0,0,244,244,0,2,0,2,0
5705,49599,445,0,0,70,70,0,1,0,1,0
5706,5826,26467,0,0,62,62,0,1,0,1,0
5707,27321,25174,0,0,62,62,0,1,0,1,0
5708,14333,51050,0,0,62,62,0,1,0,1,0
5709,54314,445,0,0,70,70,0,1,0,1,0
5710,54306,445,0,0,70,70,0,1,0,1,0
5711,54307,445,0,0,70,70,0,1,0,1,0
5712,54302,445,0,0,70,70,0,1,0,1,0
5713,8116,25773,0,0,157,157,0,1,0,1,0
5714,49594,445,0,0,70,70,0,1,0,1,0
5715,49593,445,0,0,70,70,0,1,0,1,0
5716,49695,445,0,0,66,66,0,1,0,1,0
5717,49698,445,0,0,66,66,0,1,0,1,0
5718,49696,445,0,0,66,66,0,1,0,1,0
5719,49591,445,0,0,70,70,0,1,0,1,0
5720,39646,44847,0,0,146,146,0,1,0,1,0
5721,51533,44847,0,0,62,62,0,1,0,1,0
5722,20682,57470,0,0,62,62,0,1,0,1,0
5723,6666,138,0,0,60,60,0,1,0,1,0
5724,48706,23393,0,0,60,60,0,1,0,1,0
5725,50396,62413,0,0,66,66,0,1,0,1,0
5726,59822,56205,0,0,66,66,0,1,0,1,0
5727,60416,37965,0,0,66,66,0,1,0,1,0
5728,52280,44847,0,0,62,62,0,1,0,1,0
5729,54295,445,0,0,70,70,0,1,0,1,0
5730,1101,11119,0,0,146,146,0,1,0,1,0
5731,54293,445,0,0,70,70,0,1,0,1,0
5732,54289,445,0,0,70,70,0,1,0,1,0
5733,54288,445,0,0,70,70,0,1,0,1,0
5734,5223,32965,0,0,66,66,0,1,0,1,0
5735,5223,32965,0,0,119,119,0,1,0,1,0
5736,5223,32965,0,0,167,167,0,1,0,1,0
5737,49584,445,0,0,70,70,0,1,0,1,0
5738,18398,21247,0,0,66,66,0,1,0,1,0
5739,8080,37965,0,0,62,62,0,1,0,1,0
5740,49582,445,0,0,70,70,0,1,0,1,0
5741,23310,22114,0,0,66,66,0,1,0,1,0
5742,12567,23,0,0,60,60,0,1,0,1,0
5743,7561,43890,0,0,66,66,0,1,0,1,0
5744,49581,445,0,0,70,70,0,1,0,1,0
5745,50272,53,9644,53,744,95,649,2,30,1,1
5746,35526,443,57074,443,4566,3317,1249,21,23,12,9
5747,9431,443,45231,443,8693,2545,6148,26,34,13,13
5748,62627,7000,62627,7000,2990,1599,1391,15,15,8,7
5749,52096,80,38227,80,366,240,126,7,25,5,2
5750,56238,80,56238,80,44951,1019,43932,48,15,15,33
5751,56246,80,56246,80,101654,1739,99915,95,15,25,70
5752,56241,80,56241,80,101607,1692,99915,94,15,24,70
5753,51422,80,51422,80,9962,3379,6583,26,26,13,13
5754,51427,80,51427,80,22364,4125,18239,41,26,19,22
5755,56778,443,16345,443,8654,2150,6504,20,15,11,9
5756,27164,53,27164,53,208,94,114,2,30,1,1
5757,52076,80,2859,80,366,240,126,7,26,5,2
5758,52077,80,35958,80,366,240,126,7,26,5,2
5759,55047,443,3031,443,7069,2512,4557,25,46,14,11
5760,21187,53,21187,53,208,94,114,2,30,1,1
5761,64670,53,38301,53,186,95,91,2,31,1,1
5762,54865,443,54865,443,125282,21435,103847,162,20,80,82
5763,9440,443,42891,443,7573,1528,6045,22,33,11,11
5764,56507,80,59986,80,1583,712,871,10,136,6,4
5765,58836,443,33212,443,383990,15580,368410,490,212,192,298
5766,52167,80,36480,80,1734,800,934,10,16,6,4
5767,56242,80,56242,80,101354,1343,100011,89,15,19,70
5768,53532,8569,14217,8569,546,306,240,9,143,5,4
5769,56777,443,21273,443,8654,2150,6504,20,16,11,9
5770,60415,53,0,0,82,82,0,1,30,1,0
5771,56245,80,56245,80,101179,1296,99883,88,15,18,70
5772,49023,5223,46497,5223,70,70,0,2,5,2,0
5773,123,123,44084,123,184,94,90,2,30,1,1
5774,56244,80,56244,80,101473,1494,99979,91,15,21,70
5775,44013,53,44013,53,197,76,121,2,30,1,1
5776,58255,123,13070,123,184,94,90,2,30,1,1
5777,52876,443,52876,443,5045,2187,2858,16,136,8,8
5778,46508,80,61419,80,1056,682,374,10,15,6,4
5779,52193,443,39804,443,8868,4111,4757,24,16,12,12
5780,51424,80,51424,80,4995,3443,1552,23,26,13,10
5781,49325,443,26750,443,5749,3401,2348,29,76,15,14
5782,60490,62336,7987,62336,504,318,186,8,15,5,3
5783,9478,443,35302,443,6092,775,5317,17,28,9,8
5784,49326,443,59214,443,5514,3341,2173,31,75,15,16
5785,41753,443,5130,443,11570,3005,8565,43,255,20,23
5786,38961,443,38961,443,4425,1518,2907,19,29,11,8
5787,56239,80,56239,80,101707,1824,99883,96,15,26,70
5788,55609,443,14768,443,13039,4388,8651,93,1191,47,46
5789,56240,80,56240,80,101524,1673,99851,94,15,24,70
5790,44675,53,44675,53,197,76,121,2,30,1,1
5791,49554,53,13063,53,204,104,100,2,30,1,1
5792,56739,53,56739,53,825,99,726,2,30,1,1
5793,63318,443,32091,443,8451,2698,5753,21,129,9,12
5794,57487,443,7890,443,17065,11570,5495,76,218,39,37
5795,50265,41198,60886,41198,330,330,0,6,1200,6,0
5796,34230,53,34230,53,823,98,725,2,31,1,1
5797,40471,53,40471,53,194,87,107,2,31,1,1
5798,32161,53,32161,53,823,98,725,2,31,1,1
5799,3229,53,3229,53,244,98,146,2,31,1,1
5800,29791,53,29791,53,213,87,126,2,31,1,1
5801,27888,53,27888,53,240,96,144,2,31,1,1
5802,54595,443,41142,443,5692,2502,3190,24,131,12,12
5803,55516,5228,12835,5228,2769,1694,1075,20,3600,10,10
5804,38891,443,20514,443,3489,636,2853,16,143,7,9
5805,50265,63104,28604,63104,330,330,0,6,1200,6,0
5806,56400,35440,0,0,66,66,0,1,0,1,0
5807,49580,445,0,0,70,70,0,1,0,1,0
5808,49579,445,0,0,70,70,0,1,0,1,0
5809,49577,445,0,0,70,70,0,1,0,1,0
5810,49576,445,0,0,70,70,0,1,0,1,0
5811,43642,48817,0,0,134,134,0,1,0,1,0
5812,54278,445,0,0,70,70,0,1,0,1,0
5813,54275,445,0,0,70,70,0,1,0,1,0
5814,54277,445,0,0,70,70,0,1,0,1,0
5815,443,50238,0,0,331,331,0,1,0,1,0
5816,65228,53,0,0,88,88,0,1,0,1,0
5817,62208,37965,0,0,66,66,0,1,0,1,0
5818,54677,443,30863,443,72676,12694,59982,144,127,64,80
5819,9420,443,29951,443,9308,2125,7183,27,34,13,14
5820,53928,47287,32055,47287,612,306,306,10,14,5,5
5821,49683,443,27198,443,11301,2219,9082,29,187,14,15
5822,38568,443,10055,443,11418,1999,9419,28,22,13,15
5823,41581,443,9229,443,6816,1197,5619,24,269,12,12
5824,49984,53,11243,53,373,88,285,4,58,2,2
5825,49986,443,64470,443,11626,1206,10420,31,74,13,18
5826,37666,443,8330,443,3354,2353,1001,18,45,11,7
5827,52518,80,48144,80,3290,2776,514,12,15,7,5
5828,55722,26192,12187,26192,70,70,0,2,8,2,0
5829,39648,443,15824,443,5663,4227,1436,27,47,16,11
5830,9471,443,58396,443,8533,1544,6989,22,30,11,11
5831,60806,40010,25471,40010,316,136,180,6,6,3,3
5832,65045,53,38314,53,339,105,234,4,53,2,2
5833,60219,53,60219,53,414,268,146,3,32,2,1
5834,7532,53,7532,53,228,90,138,2,31,1,1
5835,65189,53,46273,53,328,93,235,4,29,2,2
5836,49319,53,39564,53,199,102,97,2,29,1,1
5837,33768,53,59037,53,168,78,90,2,29,1,1
5838,56174,443,38355,443,18931,4924,14007,46,139,20,26
5839,49681,443,29652,443,7074,2016,5058,26,187,13,13
5840,48817,51414,48817,51414,150,150,0,1,1200,1,0
5841,64670,53,60367,53,193,102,91,2,30,1,1
5842,51423,80,51423,80,7610,2737,4873,23,26,12,11
5843,49684,445,0,0,66,66,0,1,0,1,0
5844,18415,37965,0,0,62,62,0,1,0,1,0
5845,65200,51050,0,0,66,66,0,1,0,1,0
5846,49561,445,0,0,70,70,0,1,0,1,0
5847,61785,64147,0,0,62,62,0,1,0,1,0
5848,49560,445,0,0,70,70,0,1,0,1,0
5849,54268,443,64525,443,10173,1548,8625,25,41,14,11
5850,51135,80,13103,80,366,240,126,7,21,5,2
5851,59808,53,0,0,86,86,0,1,30,1,0
5852,49719,53,33096,53,209,110,99,2,30,1,1
5853,55036,443,33915,443,36364,9639,26725,62,53,31,31
5854,51426,80,51426,80,114697,3049,111648,114,26,35,79
5855,55717,13517,54958,13517,70,70,0,1,5,1,0
5856,55049,443,34090,443,13661,4451,9210,32,46,18,14
5857,49519,443,20384,443,7086,1913,5173,29,270,16,13
5858,64670,53,24174,53,193,102,91,2,30,1,1
5859,63142,443,9605,443,4994,379,4615,9,15,4,5
5860,49554,53,50726,53,210,110,100,2,30,1,1
5861,52164,42271,32377,42271,70,70,0,1,5,1,0
5862,53136,5228,42128,5228,26821,4295,22526,95,5045,40,55
5863,55877,55153,7894,55153,481,150,331,2,1200,1,1
5864,49603,443,57719,443,11841,1700,10141,37,195,16,21
5865,34980,443,26995,443,8211,2165,6046,25,361,13,12
5866,52514,80,2585,80,3224,2776,448,11,15,7,4
5867,52517,80,63047,80,4297,3719,578,14,15,8,6
5868,56251,80,56251,80,101529,1646,99883,94,15,24,70
5869,56243,80,56243,80,101477,1626,99851,93,15,23,70
5870,65253,53,35458,53,321,150,171,2,30,1,1
5871,57619,443,40662,443,9315,2153,7162,23,127,6,17
5872,35570,443,64379,443,3221,705,2516,15,135,7,8
5873,52062,80,7748,80,366,240,126,7,26,5,2
5874,51136,80,1499,80,366,240,126,7,21,5,2
5875,34572,443,63392,443,52330,13948,38382,131,129,71,60
5876,54115,443,7544,443,6840,1394,5446,29,270,14,15
5877,53231,443,26059,443,11825,4129,7696,39,40,21,18
5878,56607,443,33013,443,21604,12969,8635,49,112,28,21
5879,56681,443,64351,443,19154,11130,8024,40,102,24,16
5880,52063,80,12503,80,366,240,126,7,26,5,2
5881,51972,5222,10197,5222,5410,2343,3067,42,53,24,18
5882,55711,10480,9991,10480,564,318,246,9,18,5,4
5883,52043,80,36469,80,4185,3462,723,14,15,7,7
5884,52519,80,46745,80,3771,3257,514,12,14,7,5
5885,57270,443,35956,443,9415,3482,5933,57,16,29,28
5886,65534,53,65534,53,414,268,146,3,31,2,1
5887,40932,443,14613,443,4435,2949,1486,25,80,14,11
5888,64075,1026,16814,1026,66,66,0,2,7,2,0
5889,41399,443,26251,443,8512,2563,5949,27,24,15,12
5890,52336,443,7480,443,134,60,74,3,10,2,1
5891,55720,51610,5460,51610,70,70,0,1,5,1,0
5892,52108,80,27420,80,182,60,122,4,25,2,2
5893,46093,443,55794,443,14746,3097,11649,34,19,19,15
5894,52516,80,41641,80,3224,2776,448,11,15,7,4
5895,55718,16805,50581,16805,70,70,0,1,5,1,0
5896,52515,80,55752,80,4183,3603,580,14,15,8,6
5897,57606,443,30554,443,2614,1689,925,18,22,10,8
5898,52085,80,49733,80,360,240,120,7,25,5,2
5899,37508,443,44640,443,8586,1714,6872,25,43,14,11
5900,57863,443,39260,443,2342,1341,1001,15,19,8,7
5901,52073,80,46138,80,482,300,182,9,26,6,3
5902,36828,53,40804,53,168,78,90,2,30,1,1
5903,64714,53,41976,53,212,102,110,2,30,1,1
5904,57061,53,24920,53,197,94,103,2,29,1,1
5905,64143,53,3615,53,179,94,85,2,30,1,1
5906,49357,53,3200,53,211,102,109,2,30,1,1
5907,39297,443,49533,443,9320,3888,5432,21,119,10,11
5908,50265,45589,64355,45589,132,132,0,3,1200,3,0
5909,50265,54145,30228,54145,858,858,0,14,1200,14,0
5910,52016,80,20046,80,8551,5933,2618,18,26,12,6
5911,123,123,41547,123,184,94,90,2,30,1,1
5912,58734,443,17024,443,8758,3850,4908,26,330,14,12
5913,52092,80,44323,80,426,240,186,8,25,5,3
5914,51973,5222,53843,5222,9184,4142,5042,72,53,40,32
5915,51425,80,51425,80,11369,3404,7965,28,26,14,14
5916,60290,443,20487,443,6753,2052,4701,25,15,13,12
5917,53272,443,50136,443,5544,1703,3841,19,31,11,8
5918,52190,443,60064,443,570322,21029,549293,569,46,181,388
5919,55704,53,57746,53,193,102,91,2,30,1,1
5920,61353,443,57410,443,4401,1654,2747,10,120,5,5
5921,55719,13302,2915,13302,70,70,0,1,5,1,0
5922,52072,80,26468,80,482,300,182,9,26,6,3
5923,123,123,58588,123,184,94,90,2,30,1,1
5924,55704,53,41998,53,193,102,91,2,30,1,1
5925,55704,53,62671,53,193,102,91,2,30,1,1
5926,64596,53,7572,53,237,110,127,2,30,1,1
5927,56687,53,1087,53,225,110,115,2,30,1,1
5928,35140,123,7443,123,184,94,90,2,30,1,1
5929,59787,443,23637,443,276238,23971,252267,482,138,188,294
5930,33939,443,3295,443,3191,1047,2144,13,135,6,7
5931,39536,80,4904,80,2749,1732,1017,21,361,12,9
5932,50265,18183,50480,18183,966,464,502,14,1200,7,7
5933,57470,31373,26422,31373,1386,1386,0,22,1798,22,0
5934,45706,443,50703,443,512213,34626,477587,741,147,283,458
5935,56906,443,9378,443,1712418,88847,1623571,2014,149,715,1299
5936,58956,80,51257,80,2493,1830,663,12,15,6,6
5937,49518,443,29100,443,6602,1573,5029,25,271,11,14
5938,52875,443,52875,443,3133,814,2319,13,136,6,7
5939,52065,80,44925,80,692,300,392,9,26,6,3
5940,52066,80,29968,80,692,300,392,9,26,6,3
5941,52074,80,8248,80,422,240,182,8,26,5,3
5942,33043,443,21466,443,11414,6355,5059,30,40,15,15
5943,53930,19831,55247,19831,70,70,0,1,5,1,0
5944,57910,80,25307,80,6453,1210,5243,14,24,8,6
5945,49554,445,0,0,70,70,0,1,0,1,0
5946,49551,445,0,0,70,70,0,1,0,1,0
5947,49550,445,0,0,70,70,0,1,0,1,0
5948,54270,445,0,0,70,70,0,1,0,1,0
5949,41176,64147,0,0,145,145,0,1,0,1,0
5950,21522,80,0,0,60,60,0,1,0,1,0
5951,65332,56205,0,0,62,62,0,1,0,1,0
5952,54268,445,0,0,70,70,0,1,0,1,0
5953,45286,62413,0,0,146,146,0,1,0,1,0
5954,45981,51505,0,0,146,146,0,1,0,1,0
5955,14409,7363,0,0,145,145,0,1,0,1,0
5956,47342,36237,0,0,66,66,0,1,0,1,0
5957,49671,445,0,0,66,66,0,1,0,1,0
5958,49670,445,0,0,66,66,0,1,0,1,0
5959,56713,25174,0,0,62,62,0,1,0,1,0
5960,49539,445,0,0,70,70,0,1,0,1,0
5961,6881,57470,0,0,146,146,0,1,0,1,0
5962,26287,56205,0,0,66,66,0,1,0,1,0
5963,51993,25174,0,0,66,66,0,1,0,1,0
5964,16862,21247,0,0,62,62,0,1,0,1,0
5965,443,4205,0,0,320,320,0,1,0,1,0
5966,14656,36237,0,0,66,66,0,1,0,1,0
5967,10390,26467,0,0,62,62,0,1,0,1,0
5968,54259,445,0,0,70,70,0,1,0,1,0
5969,54252,445,0,0,70,70,0,1,0,1,0
5970,54251,445,0,0,70,70,0,1,0,1,0
5971,54249,445,0,0,70,70,0,1,0,1,0
5972,59874,22114,0,0,66,66,0,1,0,1,0
5973,17306,25174,0,0,66,66,0,1,0,1,0
5974,59587,25174,0,0,146,146,0,1,0,1,0
5975,64013,57470,0,0,74,74,0,1,0,1,0
5976,49664,445,0,0,66,66,0,1,0,1,0
5977,50169,25174,0,0,62,62,0,1,0,1,0
5978,49534,445,0,0,70,70,0,1,0,1,0
5979,53108,22114,0,0,146,146,0,1,0,1,0
5980,6881,6881,0,0,62,62,0,1,0,1,0
5981,32090,43890,0,0,146,146,0,1,0,1,0
5982,49648,445,0,0,66,66,0,1,0,1,0
5983,49656,445,0,0,66,66,0,1,0,1,0
5984,49654,445,0,0,66,66,0,1,0,1,0
5985,49653,445,0,0,66,66,0,1,0,1,0
5986,49652,445,0,0,66,66,0,1,0,1,0
5987,49659,445,0,0,66,66,0,1,0,1,0
5988,49649,445,0,0,66,66,0,1,0,1,0
5989,57236,53733,0,0,66,66,0,1,0,1,0
5990,49525,445,0,0,70,70,0,1,0,1,0
5991,49524,445,0,0,70,70,0,1,0,1,0
5992,49523,445,0,0,70,70,0,1,0,1,0
5993,54243,445,0,0,70,70,0,1,0,1,0
5994,49520,445,0,0,70,70,0,1,0,1,0
5995,54240,445,0,0,70,70,0,1,0,1,0
5996,54238,445,0,0,70,70,0,1,0,1,0
5997,54236,445,0,0,70,70,0,1,0,1,0
5998,49518,445,0,0,70,70,0,1,0,1,0
5999,38565,51505,0,0,62,62,0,1,0,1,0
6000,57410,25174,0,0,62,62,0,1,0,1,0
6001,29512,30188,0,0,62,62,0,1,0,1,0
6002,44674,25174,0,0,146,146,0,1,0,1,0
6003,50637,36237,0,0,62,62,0,1,0,1,0
6004,54598,37965,0,0,66,66,0,1,0,1,0
6005,57539,44847,0,0,62,62,0,1,0,1,0
6006,49512,445,0,0,70,70,0,1,0,1,0
6007,54234,445,0,0,70,70,0,1,0,1,0
6008,54231,445,0,0,70,70,0,1,0,1,0
6009,54228,445,0,0,70,70,0,1,0,1,0
6010,49640,445,0,0,66,66,0,1,0,1,0
6011,49607,25174,0,0,66,66,0,1,0,1,0
6012,54227,445,0,0,70,70,0,1,0,1,0
6013,63002,22114,0,0,66,66,0,1,0,1,0
6014,443,50238,0,0,331,331,0,1,0,1,0
6015,14185,48637,0,0,60,60,0,1,0,1,0
6016,49639,445,0,0,66,66,0,1,0,1,0
6017,9231,3389,0,0,66,66,0,1,0,1,0
6018,49637,445,0,0,66,66,0,1,0,1,0
6019,49635,445,0,0,66,66,0,1,0,1,0
6020,13840,37965,0,0,146,146,0,1,0,1,0
6021,10754,28793,0,0,66,66,0,1,0,1,0
6022,49505,445,0,0,70,70,0,1,0,1,0
6023,49634,445,0,0,66,66,0,1,0,1,0
6024,10532,26672,0,0,60,60,0,1,0,1,0
6025,7686,25174,0,0,62,62,0,1,0,1,0
6026,49502,445,0,0,70,70,0,1,0,1,0
6027,14023,37965,0,0,62,62,0,1,0,1,0
6028,58148,43890,0,0,66,66,0,1,0,1,0
6029,25031,25174,0,0,146,146,0,1,0,1,0
6030,52819,15503,0,0,66,66,0,1,0,1,0
6031,49786,25174,0,0,66,66,0,1,0,1,0
6032,30046,15503,0,0,62,62,0,1,0,1,0
6033,60883,64147,0,0,74,74,0,1,0,1,0
6034,14360,64147,0,0,62,62,0,1,0,1,0
6035,54225,445,0,0,70,70,0,1,0,1,0
6036,49499,445,0,0,70,70,0,1,0,1,0
6037,54216,445,0,0,70,70,0,1,0,1,0
6038,54210,445,0,0,70,70,0,1,0,1,0
6039,49497,445,0,0,70,70,0,1,0,1,0
6040,56213,26467,0,0,62,62,0,1,0,1,0
6041,1038,37965,0,0,62,62,0,1,0,1,0
6042,17842,22114,0,0,62,62,0,1,0,1,0
6043,49622,445,0,0,66,66,0,1,0,1,0
6044,18652,64147,0,0,62,62,0,1,0,1,0
6045,49493,445,0,0,70,70,0,1,0,1,0
6046,52518,35440,0,0,66,66,0,1,0,1,0
6047,24931,25174,0,0,62,62,0,1,0,1,0
6048,49491,445,0,0,70,70,0,1,0,1,0
6049,61762,44847,0,0,62,62,0,1,0,1,0
6050,40054,62413,0,0,62,62,0,1,0,1,0
6051,13285,29892,0,0,145,145,0,1,0,1,0
6052,1190,25174,0,0,146,146,0,1,0,1,0
6053,15998,36829,0,0,62,62,0,1,0,1,0
6054,52969,44847,0,0,66,66,0,1,0,1,0
6055,49615,445,0,0,66,66,0,1,0,1,0
6056,34212,11392,0,0,66,66,0,1,0,1,0
6057,54201,445,0,0,70,70,0,1,0,1,0
6058,41315,11392,0,0,146,146,0,1,0,1,0
6059,36770,56205,0,0,62,62,0,1,0,1,0
6060,2932,44847,0,0,62,62,0,1,0,1,0
6061,18725,35440,0,0,62,62,0,1,0,1,0
6062,49613,445,0,0,66,66,0,1,0,1,0
6063,49487,445,0,0,70,70,0,1,0,1,0
6064,8889,16164,0,0,60,60,0,1,0,1,0
6065,50360,37965,0,0,66,66,0,1,0,1,0
6066,443,50238,0,0,60,60,0,1,0,1,0
6067,50990,23884,0,0,66,66,0,1,0,1,0
6068,49606,445,0,0,66,66,0,1,0,1,0
6069,443,50238,0,0,99,99,0,1,0,1,0
6070,443,50238,0,0,286,286,0,1,0,1,0
6071,0,0,0,0,94,94,0,1,0,1,0
6072,49598,445,0,0,66,66,0,1,0,1,0
6073,62902,32468,0,0,66,66,0,1,0,1,0
6074,17232,22114,0,0,62,62,0,1,0,1,0
6075,52462,25174,0,0,62,62,0,1,0,1,0
6076,19933,35440,0,0,62,62,0,1,0,1,0
6077,40479,35993,0,0,62,62,0,1,0,1,0
6078,37959,3855,0,0,72,72,0,1,0,1,0
6079,65270,3855,0,0,78,78,0,1,0,1,0
6080,49474,445,0,0,70,70,0,1,0,1,0
6081,54192,445,0,0,70,70,0,1,0,1,0
6082,54189,445,0,0,70,70,0,1,0,1,0
6083,54187,445,0,0,70,70,0,1,0,1,0
6084,49584,445,0,0,66,66,0,1,0,1,0
6085,49589,445,0,0,66,66,0,1,0,1,0
6086,49590,445,0,0,66,66,0,1,0,1,0
6087,49588,445,0,0,66,66,0,1,0,1,0
6088,49585,445,0,0,66,66,0,1,0,1,0
6089,49583,445,0,0,66,66,0,1,0,1,0
6090,49586,445,0,0,66,66,0,1,0,1,0
6091,49582,445,0,0,66,66,0,1,0,1,0
6092,41677,57470,0,0,66,66,0,1,0,1,0
6093,49471,445,0,0,70,70,0,1,0,1,0
6094,55994,22114,0,0,66,66,0,1,0,1,0
6095,49677,25174,0,0,66,66,0,1,0,1,0
6096,26697,37965,0,0,66,66,0,1,0,1,0
6097,44378,995,0,0,60,60,0,1,0,1,0
6098,56451,995,0,0,60,60,0,1,0,1,0
6099,35201,25174,0,0,62,62,0,1,0,1,0
6100,25197,1433,0,0,60,60,0,1,0,1,0
6101,10462,25174,0,0,146,146,0,1,0,1,0
6102,60245,25174,0,0,62,62,0,1,0,1,0
6103,19875,30170,0,0,145,145,0,1,0,1,0
6104,49467,445,0,0,70,70,0,1,0,1,0
6105,1058,36866,0,0,136,136,0,1,0,1,0
6106,49465,445,0,0,70,70,0,1,0,1,0
6107,2850,64147,0,0,66,66,0,1,0,1,0
6108,54184,445,0,0,70,70,0,1,0,1,0
6109,54178,445,0,0,70,70,0,1,0,1,0
6110,54179,445,0,0,70,70,0,1,0,1,0
6111,54172,445,0,0,70,70,0,1,0,1,0
6112,22547,48817,0,0,72,72,0,1,0,1,0
6113,49463,445,0,0,70,70,0,1,0,1,0
6114,63398,25174,0,0,66,66,0,1,0,1,0
6115,49568,445,0,0,66,66,0,1,0,1,0
6116,49570,445,0,0,66,66,0,1,0,1,0
6117,49567,445,0,0,66,66,0,1,0,1,0
6118,18574,56205,0,0,66,66,0,1,0,1,0
6119,51143,443,51143,443,33565,5938,27627,60,128,24,36
6120,49288,80,52653,80,1056,682,374,10,15,6,4
6121,57490,443,55071,443,1778,1219,559,13,26,8,5
6122,6666,3493,6666,3493,60,60,0,1,5,1,0
6123,52070,80,7371,80,362,240,122,7,25,5,2
6124,51077,443,51077,443,32010,3207,28803,52,128,20,32
6125,58895,443,55555,443,148,82,66,2,10,1,1
6126,56233,80,56233,80,44955,1023,43932,48,15,15,33
6127,9381,53,9381,53,200,90,110,2,30,1,1
6128,33733,443,7805,443,6998,2361,4637,20,17,10,10
6129,50693,443,50693,443,19125,2345,16780,37,128,15,22
6130,60106,443,61992,443,7243,4797,2446,42,136,23,19
6131,56230,80,56230,80,44881,949,43932,47,15,14,33
6132,56234,80,56234,80,44817,885,43932,46,15,13,33
6133,52071,80,35794,80,362,240,122,7,25,5,2
6134,38663,15000,54810,15000,138,78,60,2,5,1,1
6135,52067,80,33886,80,362,240,122,7,25,5,2
6136,60524,443,60524,443,1088,641,447,10,26,6,4
6137,44714,443,14525,443,7389,2124,5265,26,316,12,14
6138,13084,53,13084,53,224,88,136,2,30,1,1
6139,57493,443,46334,443,1778,1219,559,13,27,8,5
6140,56928,53,56928,53,823,98,725,2,30,1,1
6141,52078,80,58261,80,366,240,126,7,25,5,2
6142,56231,80,56231,80,44747,815,43932,45,15,12,33
6143,56236,80,56236,80,44755,823,43932,45,15,12,33
6144,49324,443,63452,443,6586,3686,2900,35,75,17,18
6145,52079,80,61511,80,366,240,126,7,25,5,2
6146,52069,80,30929,80,362,240,122,7,25,5,2
6147,52068,80,54676,80,362,240,122,7,25,5,2
6148,49886,7000,49886,7000,1236,676,560,13,15,7,6
6149,61488,443,29110,443,7036,2247,4789,39,141,19,20
6150,49509,443,10156,443,8248,2508,5740,31,271,13,18
6151,32317,53,32317,53,823,98,725,2,30,1,1
6152,56232,80,56232,80,44752,820,43932,45,15,12,33
6153,56235,80,56235,80,44756,824,43932,45,15,12,33
6154,53961,13067,41847,13067,70,70,0,2,8,2,0
6155,64064,29856,32936,29856,66,66,0,1,5,1,0
6156,56237,80,56237,80,44949,1017,43932,48,15,15,33
6157,51544,4545,51544,4545,156,156,0,3,8,3,0
6158,51142,443,51142,443,261206,9686,251520,308,128,121,187
6159,60525,443,60525,443,1088,641,447,10,26,6,4
6160,28549,53,28549,53,194,87,107,2,30,1,1
6161,36672,53,36672,53,234,93,141,2,30,1,1
6162,47674,53,47674,53,200,90,110,2,30,1,1
6163,50313,53,50313,53,202,91,111,2,30,1,1
6164,41389,443,45580,443,280,140,140,5,131,3,2
6165,51414,22,0,0,60,60,0,1,0,1,0
6166,30456,36237,0,0,146,146,0,1,0,1,0
6167,54167,445,0,0,70,70,0,1,0,1,0
6168,5222,21212,0,0,66,66,0,1,0,1,0
6169,2075,19473,0,0,66,66,0,1,0,1,0
6170,31675,19473,0,0,62,62,0,1,0,1,0
6171,16429,56205,0,0,146,146,0,1,0,1,0
6172,65228,53,0,0,88,88,0,1,0,1,0
6173,54166,445,0,0,70,70,0,1,0,1,0
6174,54162,445,0,0,70,70,0,1,0,1,0
6175,54157,445,0,0,70,70,0,1,0,1,0
6176,49456,445,0,0,70,70,0,1,0,1,0
6177,12465,9823,0,0,146,146,0,1,0,1,0
6178,61550,5529,0,0,145,145,0,1,0,1,0
6179,31675,19473,0,0,145,145,0,1,0,1,0
6180,65228,53,0,0,88,88,0,1,0,1,0
6181,59068,57470,0,0,74,74,0,1,0,1,0
6182,49454,445,0,0,70,70,0,1,0,1,0
6183,60805,20010,40863,20010,70,70,0,2,8,2,0
6184,52030,443,43838,443,9090,1914,7176,24,25,13,11
6185,39442,443,24613,443,6420,1513,4907,25,26,14,11
6186,52001,80,20376,80,8117874,148550,7969324,7318,25,2033,5285
6187,55020,443,57548,443,3533,1045,2488,17,147,8,9
6188,55457,53,65037,53,372,126,246,2,29,1,1
6189,62717,443,23146,443,3129,782,2347,17,134,8,9
6190,49440,443,48823,443,3721809,103604,3618205,3808,156,1281,2527
6191,52060,80,41226,80,366,240,126,7,25,5,2
6192,62349,443,37822,443,3942042,47512,3894530,3167,53,526,2641
6193,40122,443,13389,443,8235,2076,6159,24,330,11,13
6194,64560,53,40808,53,578,179,399,6,56,3,3
6195,52059,80,19994,80,426,240,186,8,25,5,3
6196,52166,80,3955,80,2110,1066,1044,12,15,7,5
6197,13554,53,13554,53,404,259,145,3,33,2,1
6198,53955,3290,40369,3290,70,70,0,2,7,2,0
6199,52061,80,7969,80,366,240,126,7,25,5,2
6200,64381,53,4400,53,168,86,82,2,32,1,1
6201,36628,80,34664,80,78,78,0,1,4,1,0
6202,44907,5900,44907,5900,130,66,64,2,4,1,1
6203,55267,53,45498,53,168,78,90,2,29,1,1
6204,65084,53,19424,53,215,102,113,2,29,1,1
6205,1100,27540,42086,27540,132,70,62,2,29,1,1
6206,51156,53,46247,53,168,78,90,2,29,1,1
6207,52043,80,5658,80,1484,805,679,11,25,7,4
6208,52100,443,42530,443,14433889,278906,14154983,13633,66,4079,9554
6209,56750,53,18998,53,279,118,161,2,30,1,1
6210,20850,53,20850,53,245,98,147,2,30,1,1
6211,56102,53,33083,53,199,94,105,2,30,1,1
6212,20826,53,20826,53,228,90,138,2,32,1,1
6213,64074,34067,2832,34067,312,132,180,6,6,3,3
6214,53723,443,52693,443,70,70,0,2,8,2,0
6215,61526,443,1145,443,13977,5303,8674,48,152,20,28
6216,60522,443,60522,443,1088,641,447,10,25,6,4
6217,60523,443,60523,443,1088,641,447,10,25,6,4
6218,52005,443,38700,443,4802,866,3936,19,26,10,9
6219,48163,53,27599,53,199,94,105,2,30,1,1
6220,34352,53,34352,53,240,98,142,2,30,1,1
6221,50680,80,61821,80,23386,2375,21011,30,21,12,18
6222,39537,80,22901,80,903,482,421,10,360,5,5
6223,49378,53,26888,53,210,94,116,2,30,1,1
6224,65066,53,65066,53,240,98,142,2,30,1,1
6225,52039,80,39126,80,366,240,126,7,25,5,2
6226,41207,80,55374,80,79441,3092,76349,103,16,48,55
6227,51132,80,62444,80,426,240,186,8,21,5,3
6228,57509,443,8553,443,5150,3987,1163,18,38,11,7
6229,35797,53,35797,53,217,90,127,2,30,1,1
6230,17734,53,17734,53,217,90,127,2,30,1,1
6231,49488,53,49488,53,823,98,725,2,30,1,1
6232,49171,53,63019,53,301,102,199,2,30,1,1
6233,57445,66,60334,66,70,70,0,1,5,1,0
6234,52000,80,36562,80,416,210,206,7,26,4,3
6235,58921,443,58921,443,4627,1720,2907,19,28,11,8
6236,50884,443,50884,443,187790,7733,180057,229,128,90,139
6237,46370,443,36990,443,11035,8438,2597,39,95,23,16
6238,51671,53,51671,53,200,90,110,2,30,1,1
6239,43303,443,47473,443,6448,1982,4466,22,16,11,11
6240,52064,80,33091,80,692,300,392,9,25,6,3
6241,52075,80,29185,80,422,240,182,8,25,5,3
6242,49927,80,6147,80,1141,636,505,10,45,6,4
6243,43834,443,19453,443,4824,671,4153,13,29,7,6
6244,52057,80,6987,80,422,240,182,8,25,5,3
6245,52058,80,14075,80,362,240,122,7,25,5,2
6246,62640,53,62640,53,414,268,146,3,32,2,1
6247,64063,37832,22712,37832,70,70,0,1,4,1,0
6248,53962,16251,40390,16251,70,70,0,2,7,2,0
6249,55182,443,46108,443,2970,1689,1281,24,18,13,11
6250,47311,443,49307,443,3398,2096,1302,19,16,10,9
6251,52042,443,63896,443,8740,1799,6941,25,25,13,12
6252,51078,443,51078,443,71902,4007,67895,98,127,40,58
6253,56363,53,60359,53,269,94,175,2,30,1,1
6254,64670,53,61851,53,193,102,91,2,29,1,1
6255,36665,443,51014,443,5814771,76275,5738496,4959,154,976,3983
6256,64849,53,44145,53,216,102,114,2,29,1,1
6257,2077,53,2077,53,212,98,114,2,30,1,1
6258,57492,53,57492,53,218,90,128,2,30,1,1
6259,40711,53,40711,53,200,90,110,2,30,1,1
6260,55155,53,55155,53,240,98,142,2,30,1,1
6261,49346,53,28098,53,212,102,110,2,30,1,1
6262,48424,53,48424,53,220,90,130,2,30,1,1
6263,53477,443,34084,443,21476,1330,20146,32,137,12,20
6264,10461,53,10461,53,220,90,130,2,30,1,1
6265,56644,53,3506,53,199,94,105,2,30,1,1
6266,27988,40011,54890,40011,253,190,63,2,30,1,1
6267,13871,53,13871,53,240,98,142,2,30,1,1
6268,58045,443,63795,443,3296,1329,1967,14,135,7,7
6269,1725,80,3568,80,254,128,126,5,16,3,2
6270,38384,443,38384,443,4609,1702,2907,19,29,11,8
6271,1666,53,1666,53,217,90,127,2,30,1,1
6272,64049,53,41804,53,209,102,107,2,30,1,1
6273,38784,443,14395,443,9185,3854,5331,23,16,13,10
6274,55657,443,55657,443,30650,11103,19547,66,51,40,26
6275,36536,53,36536,53,414,268,146,3,32,2,1
6276,60492,11339,45509,11339,70,70,0,1,5,1,0
6277,60489,53151,11462,53151,70,70,0,1,5,1,0
6278,56808,53,42088,53,180,94,86,2,35,1,1
6279,56662,443,10328,443,318,192,126,6,15,4,2
6280,52090,64823,30736,64823,634,568,66,8,29,7,1
6281,55812,443,35991,443,9398,2478,6920,26,82,14,12
6282,52003,80,22055,80,16479,1820,14659,31,26,17,14
6283,52490,53,52490,53,240,98,142,2,30,1,1
6284,52004,443,64314,443,4804,866,3938,19,26,10,9
6285,47518,53,47518,53,414,268,146,3,32,2,1
6286,56645,443,24912,443,37030,24937,12093,83,1286,30,53
6287,51615,53,53355,53,207,86,121,2,30,1,1
6288,63139,53,41966,53,78,78,0,1,30,1,0
6289,55628,53,53766,53,199,94,105,2,30,1,1
6290,28998,53,28998,53,220,90,130,2,30,1,1
6291,38905,53,58412,53,86,86,0,1,30,1,0
6292,63384,53,63384,53,198,90,108,2,30,1,1
6293,65172,53,3984,53,211,102,109,2,30,1,1
6294,34441,53,34441,53,314,98,216,2,30,1,1
6295,54118,443,16400,443,3182,1568,1614,8,120,4,4
6296,49445,443,22095,443,462587,17396,445191,527,130,198,329
6297,6881,51719,22526,51719,324,150,174,2,1199,1,1
6298,65498,443,58734,443,3874,1587,2287,17,143,9,8
6299,15503,57141,65001,57141,481,150,331,2,1200,1,1
6300,49539,443,38043,443,5106,1861,3245,21,143,10,11
6301,61187,443,13311,443,4862,1820,3042,14,120,7,7
6302,53952,26973,12520,26973,70,70,0,2,8,2,0
6303,52021,80,35964,80,422,240,182,8,25,5,3
6304,33507,443,18740,443,194174,11657,182517,258,31,124,134
6305,52162,15104,24399,15104,70,70,0,1,5,1,0
6306,50678,80,52506,80,1549,1097,452,9,21,5,4
6307,52034,80,60212,80,366,240,126,7,25,5,2
6308,52479,443,31867,443,9326,1833,7493,24,131,12,12
6309,53924,45212,17906,45212,70,70,0,1,5,1,0
6310,30629,46783,0,0,145,145,0,1,0,1,0
6311,49453,445,0,0,70,70,0,1,0,1,0
6312,10126,57470,0,0,62,62,0,1,0,1,0
6313,64622,36829,0,0,66,66,0,1,0,1,0
6314,49452,445,0,0,70,70,0,1,0,1,0
6315,49451,445,0,0,70,70,0,1,0,1,0
6316,64949,44847,0,0,66,66,0,1,0,1,0
6317,49445,445,0,0,70,70,0,1,0,1,0
6318,9687,35440,0,0,66,66,0,1,0,1,0
6319,59966,37965,0,0,66,66,0,1,0,1,0
6320,1138,57470,0,0,146,146,0,1,0,1,0
6321,54148,445,0,0,70,70,0,1,0,1,0
6322,54146,445,0,0,70,70,0,1,0,1,0
6323,54144,445,0,0,70,70,0,1,0,1,0
6324,27078,25174,0,0,146,146,0,1,0,1,0
6325,49433,445,0,0,70,70,0,1,0,1,0
6326,49432,445,0,0,70,70,0,1,0,1,0
6327,54633,36237,0,0,66,66,0,1,0,1,0
6328,49427,445,0,0,70,70,0,1,0,1,0
6329,49558,445,0,0,66,66,0,1,0,1,0
6330,49423,445,0,0,70,70,0,1,0,1,0
6331,49422,445,0,0,70,70,0,1,0,1,0
6332,11585,56205,0,0,66,66,0,1,0,1,0
6333,17213,22114,0,0,62,62,0,1,0,1,0
6334,16862,21247,0,0,146,146,0,1,0,1,0
6335,16425,15503,0,0,62,62,0,1,0,1,0
6336,61701,15503,0,0,66,66,0,1,0,1,0
6337,54142,445,0,0,70,70,0,1,0,1,0
6338,9212,51505,0,0,146,146,0,1,0,1,0
6339,64013,57470,0,0,74,74,0,1,0,1,0
6340,54141,445,0,0,70,70,0,1,0,1,0
6341,12881,20082,0,0,146,146,0,1,0,1,0
6342,31859,33909,0,0,66,66,0,1,0,1,0
6343,23753,25174,0,0,62,62,0,1,0,1,0
6344,8760,22114,0,0,62,62,0,1,0,1,0
6345,49411,445,0,0,70,70,0,1,0,1,0
6346,31691,50584,0,0,62,62,0,1,0,1,0
6347,31691,50584,0,0,146,146,0,1,0,1,0
6348,49543,445,0,0,66,66,0,1,0,1,0
6349,49542,445,0,0,66,66,0,1,0,1,0
6350,63380,23,0,0,60,60,0,1,0,1,0
6351,32796,37965,0,0,66,66,0,1,0,1,0
6352,27502,50584,0,0,62,62,0,1,0,1,0
6353,56152,56205,0,0,66,66,0,1,0,1,0
6354,54132,445,0,0,70,70,0,1,0,1,0
6355,54129,445,0,0,70,70,0,1,0,1,0
6356,54127,445,0,0,70,70,0,1,0,1,0
6357,54120,445,0,0,70,70,0,1,0,1,0
6358,49407,445,0,0,70,70,0,1,0,1,0
6359,4752,30188,0,0,62,62,0,1,0,1,0
6360,61392,50584,0,0,146,146,0,1,0,1,0
6361,49535,445,0,0,66,66,0,1,0,1,0
6362,21322,25174,0,0,62,62,0,1,0,1,0
6363,42228,51050,0,0,66,66,0,1,0,1,0
6364,58435,64631,0,0,74,74,0,1,0,1,0
6365,49398,445,0,0,70,70,0,1,0,1,0
6366,49395,445,0,0,70,70,0,1,0,1,0
6367,49396,445,0,0,70,70,0,1,0,1,0
6368,49522,445,0,0,66,66,0,1,0,1,0
6369,49520,445,0,0,66,66,0,1,0,1,0
6370,49530,445,0,0,66,66,0,1,0,1,0
6371,49531,445,0,0,66,66,0,1,0,1,0
6372,49527,445,0,0,66,66,0,1,0,1,0
6373,49524,445,0,0,66,66,0,1,0,1,0
6374,52640,64147,0,0,62,62,0,1,0,1,0
6375,49393,445,0,0,70,70,0,1,0,1,0
6376,49391,445,0,0,70,70,0,1,0,1,0
6377,63334,37807,0,0,66,66,0,1,0,1,0
6378,29177,44847,0,0,66,66,0,1,0,1,0
6379,54115,445,0,0,70,70,0,1,0,1,0
6380,14185,48637,0,0,60,60,0,1,0,1,0
6381,61711,35440,0,0,66,66,0,1,0,1,0
6382,57782,57470,0,0,66,66,0,1,0,1,0
6383,16979,56205,0,0,66,66,0,1,0,1,0
6384,54112,445,0,0,70,70,0,1,0,1,0
6385,54108,445,0,0,70,70,0,1,0,1,0
6386,54110,445,0,0,70,70,0,1,0,1,0
6387,60248,46776,0,0,66,66,0,1,0,1,0
6388,14717,64147,0,0,66,66,0,1,0,1,0
6389,53730,37965,0,0,66,66,0,1,0,1,0
6390,10532,26672,0,0,60,60,0,1,0,1,0
6391,1025,46776,0,0,62,62,0,1,0,1,0
6392,18642,42707,0,0,62,62,0,1,0,1,0
6393,56719,37807,0,0,66,66,0,1,0,1,0
6394,18653,42707,0,0,66,66,0,1,0,1,0
6395,56562,44847,0,0,62,62,0,1,0,1,0
6396,55201,26467,0,0,66,66,0,1,0,1,0
6397,43747,22114,0,0,66,66,0,1,0,1,0
6398,49384,445,0,0,70,70,0,1,0,1,0
6399,64878,26467,0,0,62,62,0,1,0,1,0
6400,2572,17546,0,0,66,66,0,1,0,1,0
6401,54104,445,0,0,70,70,0,1,0,1,0
6402,54106,445,0,0,70,70,0,1,0,1,0
6403,54101,445,0,0,70,70,0,1,0,1,0
6404,19068,37965,0,0,62,62,0,1,0,1,0
6405,49513,445,0,0,66,66,0,1,0,1,0
6406,24376,50584,0,0,66,66,0,1,0,1,0
6407,54099,445,0,0,70,70,0,1,0,1,0
6408,25457,25604,0,0,62,62,0,1,0,1,0
6409,49511,445,0,0,66,66,0,1,0,1,0
6410,8884,2323,0,0,60,60,0,1,0,1,0
6411,49377,445,0,0,70,70,0,1,0,1,0
6412,49508,445,0,0,66,66,0,1,0,1,0
6413,49507,445,0,0,66,66,0,1,0,1,0
6414,49375,445,0,0,70,70,0,1,0,1,0
6415,31660,35440,0,0,66,66,0,1,0,1,0
6416,49505,445,0,0,66,66,0,1,0,1,0
6417,11692,25174,0,0,66,66,0,1,0,1,0
6418,64847,22114,0,0,66,66,0,1,0,1,0
6419,443,54507,0,0,82,82,0,1,0,1,0
6420,52596,17372,0,0,66,66,0,1,0,1,0
6421,40078,44847,0,0,146,146,0,1,0,1,0
6422,49371,445,0,0,70,70,0,1,0,1,0
6423,44207,44847,0,0,66,66,0,1,0,1,0
6424,49369,445,0,0,70,70,0,1,0,1,0
6425,54094,445,0,0,70,70,0,1,0,1,0
6426,56639,48817,0,0,62,62,0,1,0,1,0
6427,54088,445,0,0,70,70,0,1,0,1,0
6428,54084,445,0,0,70,70,0,1,0,1,0
6429,58799,30188,0,0,66,66,0,1,0,1,0
6430,49365,445,0,0,70,70,0,1,0,1,0
6431,20741,64147,0,0,62,62,0,1,0,1,0
6432,13035,25174,0,0,146,146,0,1,0,1,0
6433,49494,445,0,0,66,66,0,1,0,1,0
6434,64923,25174,0,0,66,66,0,1,0,1,0
6435,44453,1433,0,0,60,60,0,1,0,1,0
6436,49363,445,0,0,70,70,0,1,0,1,0
6437,60337,30188,0,0,66,66,0,1,0,1,0
6438,11951,45026,0,0,60,60,0,1,0,1,0
6439,53844,22114,0,0,66,66,0,1,0,1,0
6440,58163,20005,0,0,60,60,0,1,0,1,0
6441,7619,50584,0,0,146,146,0,1,0,1,0
6442,3875,25174,0,0,62,62,0,1,0,1,0
6443,60049,25174,0,0,66,66,0,1,0,1,0
6444,49487,445,0,0,66,66,0,1,0,1,0
6445,54071,445,0,0,70,70,0,1,0,1,0
6446,25543,22114,0,0,62,62,0,1,0,1,0
6447,51575,9694,0,0,66,66,0,1,0,1,0
6448,49359,445,0,0,70,70,0,1,0,1,0
6449,60830,50584,0,0,62,62,0,1,0,1,0
6450,9748,21247,0,0,66,66,0,1,0,1,0
6451,49484,445,0,0,66,66,0,1,0,1,0
6452,56309,22114,0,0,146,146,0,1,0,1,0
6453,5228,3434,0,0,345,345,0,1,0,1,0
6454,25009,35440,0,0,62,62,0,1,0,1,0
6455,49476,445,0,0,66,66,0,1,0,1,0
6456,6121,51505,0,0,62,62,0,1,0,1,0
6457,49470,445,0,0,66,66,0,1,0,1,0
6458,61916,64097,0,0,66,66,0,1,0,1,0
6459,1048,25174,0,0,62,62,0,1,0,1,0
6460,30181,61689,0,0,62,62,0,1,0,1,0
6461,54011,22114,0,0,62,62,0,1,0,1,0
6462,6486,64147,0,0,62,62,0,1,0,1,0
6463,52336,64097,0,0,66,66,0,1,0,1,0
6464,49346,445,0,0,70,70,0,1,0,1,0
6465,54189,22114,0,0,66,66,0,1,0,1,0
6466,58101,46314,0,0,72,72,0,1,0,1,0
6467,39839,22114,0,0,62,62,0,1,0,1,0
6468,49343,445,0,0,70,70,0,1,0,1,0
6469,58079,50584,0,0,62,62,0,1,0,1,0
6470,54063,445,0,0,70,70,0,1,0,1,0
6471,2310,8305,0,0,145,145,0,1,0,1,0
6472,54059,445,0,0,70,70,0,1,0,1,0
6473,58453,50584,0,0,66,66,0,1,0,1,0
6474,54060,445,0,0,70,70,0,1,0,1,0
6475,49454,445,0,0,66,66,0,1,0,1,0
6476,49461,445,0,0,66,66,0,1,0,1,0
6477,49462,445,0,0,66,66,0,1,0,1,0
6478,49457,445,0,0,66,66,0,1,0,1,0
6479,49458,445,0,0,66,66,0,1,0,1,0
6480,49455,445,0,0,66,66,0,1,0,1,0
6481,49456,445,0,0,66,66,0,1,0,1,0
6482,49460,445,0,0,66,66,0,1,0,1,0
6483,54542,25604,0,0,62,62,0,1,0,1,0
6484,36933,23117,0,0,66,66,0,1,0,1,0
6485,31780,11392,0,0,62,62,0,1,0,1,0
6486,9504,25174,0,0,62,62,0,1,0,1,0
6487,30583,25174,0,0,62,62,0,1,0,1,0
6488,55973,25174,0,0,62,62,0,1,0,1,0
6489,54420,80,23681,80,1596,511,1085,10,15,5,5
6490,34671,443,52492,443,8904,1058,7846,18,31,9,9
6491,54014,5228,26717,5228,2493,1541,952,16,3601,8,8
6492,55181,53,13217,53,711,87,624,2,30,1,1
6493,52012,80,40658,80,366,240,126,7,25,5,2
6494,56232,443,31381,443,9920,3980,5940,24,40,12,12
6495,60068,443,30976,443,2227,1018,1209,17,16,8,9
6496,22,51051,22,51051,109,109,0,1,5,1,0
6497,52037,80,5136,80,366,240,126,7,25,5,2
6498,52194,22674,46846,22674,70,70,0,2,8,2,0
6499,52186,57609,20882,57609,70,70,0,2,9,2,0
6500,63107,443,39326,443,3272,800,2472,10,120,5,5
6501,63108,443,56013,443,4609,2177,2432,11,120,6,5
6502,64338,443,59182,443,1786,172,1614,7,120,3,4
6503,61828,443,61828,443,317388,25904,291484,338,200,128,210
6504,26922,443,5779,443,7647,2890,4757,23,20,11,12
6505,40200,5222,30344,5222,8250,3928,4322,80,296,44,36
6506,52038,80,27418,80,366,240,126,7,25,5,2
6507,53954,57868,45044,57868,70,70,0,2,8,2,0
6508,48788,443,25045,443,6254,1075,5179,22,34,10,12
6509,55963,443,55963,443,8882,1866,7016,24,148,13,11
6510,60435,80,13780,80,5518,527,4991,13,75,6,7
6511,40626,443,40626,443,7772,2569,5203,23,148,13,10
6512,56178,443,35008,443,12283477,390003,11893474,13073,164,4327,8746
6513,52024,80,44508,80,422,240,182,8,25,5,3
6514,58192,443,58192,443,4381,1474,2907,19,29,11,8
6515,40217,443,61607,443,5377,857,4520,21,88,8,13
6516,52026,80,21940,80,422,240,182,8,25,5,3
6517,60495,6882,55669,6882,70,70,0,2,8,2,0
6518,60816,443,60816,443,1320,685,635,14,182,7,7
6519,37965,58043,10741,58043,6029,3652,2377,79,3221,45,34
6520,57665,5228,43757,5228,2391,1434,957,16,3601,8,8
6521,49878,24855,0,0,66,66,0,1,91,1,0
6522,52607,443,23239,443,2860,258,2602,9,121,4,5
6523,60813,443,60813,443,1386,751,635,15,182,8,7
6524,16490,25174,0,0,66,66,0,1,0,1,0
6525,46116,57470,0,0,74,74,0,1,0,1,0
6526,49339,445,0,0,70,70,0,1,0,1,0
6527,15899,37807,0,0,62,62,0,1,0,1,0
6528,49308,22114,0,0,66,66,0,1,0,1,0
6529,10467,25174,0,0,62,62,0,1,0,1,0
6530,3381,44847,0,0,78,78,0,1,0,1,0
6531,49337,445,0,0,70,70,0,1,0,1,0
6532,61616,23,0,0,60,60,0,1,0,1,0
6533,47730,22,0,0,60,60,0,1,0,1,0
6534,49335,445,0,0,70,70,0,1,0,1,0
6535,28064,36237,0,0,62,62,0,1,0,1,0
6536,52749,443,45343,443,148418,107579,40839,315,6090,107,208
6537,55713,47783,26233,47783,70,70,0,1,5,1,0
6538,46014,53,46014,53,414,268,146,3,33,2,1
6539,52188,13182,48724,13182,70,70,0,2,9,2,0
6540,52191,32843,25090,32843,70,70,0,2,8,2,0
6541,46975,443,49913,443,70,70,0,1,5,1,0
6542,49505,443,25913,443,6318,2030,4288,25,270,12,13
6543,57808,53,57808,53,222,90,132,2,30,1,1
6544,60814,443,60814,443,1386,751,635,15,181,8,7
6545,52036,80,8626,80,366,240,126,7,24,5,2
6546,55039,443,11955,443,62,62,0,1,4,1,0
6547,65436,53,8668,53,234,94,140,2,29,1,1
6548,60758,53,57238,53,199,94,105,2,30,1,1
6549,52035,80,21577,80,426,240,186,8,24,5,3
6550,52028,80,63717,80,422,240,182,8,24,5,3
6551,53951,8999,2950,8999,70,70,0,2,7,2,0
6552,51555,443,44960,443,876,390,486,12,39,4,8
6553,53922,42285,1496,42285,70,70,0,1,4,1,0
6554,49572,443,43054,443,1820,1101,719,18,18,10,8
6555,54924,443,37000,443,62,62,0,1,4,1,0
6556,52040,80,54028,80,366,240,126,7,24,5,2
6557,35797,443,35797,443,4378,1471,2907,19,27,11,8
6558,55040,443,46427,443,62,62,0,1,4,1,0
6559,52022,80,47623,80,422,240,182,8,24,5,3
6560,52023,80,55578,80,366,240,126,7,24,5,2
6561,43215,443,60115,443,9781,3108,6673,28,15,15,13
6562,52161,19897,37234,19897,70,70,0,1,4,1,0
6563,42166,443,27279,443,4057,966,3091,14,31,8,6
6564,52197,19845,30024,19845,70,70,0,2,7,2,0
6565,59581,53,59581,53,823,98,725,2,29,1,1
6566,53925,61701,1063,61701,70,70,0,1,4,1,0
6567,52012,443,5821,443,126,60,66,3,10,2,1
6568,49440,53,37784,53,210,102,108,2,29,1,1
6569,51805,443,60178,443,6339,1901,4438,16,120,8,8
6570,59779,443,64471,443,70,70,0,1,5,1,0
6571,27988,40037,18791,40037,568,78,490,2,29,1,1
6572,34113,443,8238,443,70,70,0,1,5,1,0
6573,38117,443,59236,443,8598,3880,4718,23,200,13,10
6574,53170,20259,44123,20259,70,70,0,2,8,2,0
6575,65485,53,20874,53,718,94,624,2,30,1,1
6576,52190,29765,3143,29765,70,70,0,2,8,2,0
6577,55204,53,55204,53,239,98,141,2,30,1,1
6578,56753,80,58241,80,1462,703,759,8,16,5,3
6579,38568,53,38568,53,247,98,149,2,33,1,1
6580,54987,443,54987,443,3154,2012,1142,16,18,10,6
6581,65223,443,38564,443,5012,4134,878,17,98,10,7
6582,52159,16297,42997,16297,70,70,0,1,5,1,0
6583,52157,23002,50044,23002,70,70,0,1,5,1,0
6584,40633,53,51896,53,168,78,90,2,30,1,1
6585,34741,53,34741,53,414,268,146,3,33,2,1
6586,52155,63867,61917,63867,70,70,0,1,5,1,0
6587,65165,53,5142,53,177,94,83,2,30,1,1
6588,50519,443,63602,443,16215,1368,14847,36,77,12,24
6589,36838,443,43654,443,9381,1457,7924,21,31,11,10
6590,49507,443,28948,443,9536,2399,7137,32,270,17,15
6591,45309,443,7993,443,3094,2048,1046,18,16,9,9
6592,65383,443,27965,443,839325,38439,800886,1027,94,451,576
6593,54356,443,29580,443,18744,10266,8478,44,35,21,23
6594,51221,44710,11229,44710,481,150,331,2,1200,1,1
6595,49504,443,29645,443,26816,2982,23834,50,270,23,27
6596,52189,24190,3693,24190,70,70,0,2,9,2,0
6597,60675,443,27643,443,1871,1235,636,13,31,8,5
6598,52998,443,34422,443,57778,2562,55216,73,200,29,44
6599,42012,443,37519,443,14271,2106,12165,42,227,17,25
6600,50679,80,31176,80,2139,1167,972,10,20,6,4
6601,49152,514,0,0,142,142,0,2,30,2,0
6602,55152,53,56189,53,177,94,83,2,30,1,1
6603,56748,80,11482,80,946,531,415,11,296,6,5
6604,64898,53,12662,53,487,201,286,6,42,3,3
6605,65435,80,40330,80,11239,7307,3932,19,25,10,9
6606,46266,53,15636,53,308,118,190,2,30,1,1
6607,36834,443,42042,443,8975,1129,7846,19,31,10,9
6608,48656,80,8880,80,1114,534,580,12,15,7,5
6609,36835,443,45000,443,9115,1269,7846,21,31,12,9
6610,37087,80,29544,80,946,531,415,11,296,6,5
6611,50212,1688,47539,1688,70,70,0,1,5,1,0
6612,42167,443,27521,443,4117,1026,3091,15,31,9,6
6613,56431,443,60135,443,55149,7806,47343,134,108,61,73
6614,52093,80,7625,80,3019,716,2303,12,23,7,5
6615,60779,80,5237,80,1248,516,732,9,15,4,5
6616,52020,80,57766,80,426,240,186,8,24,5,3
6617,50265,80,26557,80,2100,1146,954,13,46,6,7
6618,60705,443,45671,443,24145,5933,18212,55,549,27,28
6619,48038,5222,35034,5222,49279,23110,26169,459,384,239,220
6620,49319,53,4413,53,199,94,105,2,30,1,1
6621,36837,443,3546,443,9311,1387,7924,20,31,10,10
6622,40680,5228,59129,5228,234,174,60,2,4,1,1
6623,46112,53,33823,53,168,78,90,2,30,1,1
6624,44228,443,22389,443,2754856,125760,2629096,3115,32,1340,1775
6625,52019,80,54297,80,426,240,186,8,24,5,3
6626,56658,443,35998,443,18959,1799,17160,35,110,15,20
6627,50419,443,44835,443,4590,575,4015,14,28,6,8
6628,50695,80,16857,80,1426,865,561,9,15,5,4
6629,47638,53,47638,53,212,98,114,2,30,1,1
6630,53950,32057,38888,32057,70,70,0,2,7,2,0
6631,55712,27816,8971,27816,316,190,126,5,16,3,2
6632,32645,53,32645,53,404,259,145,3,33,2,1
6633,65516,443,35348,443,451899,13130,438769,463,16,162,301
6634,64613,53,11249,53,212,102,110,2,30,1,1
6635,49570,443,47382,443,162268,121343,40925,316,6101,108,208
6636,64956,53,40414,53,402,118,284,2,29,1,1
6637,49949,53,8662,53,307,110,197,2,30,1,1
6638,54928,8245,11083,8245,280,214,66,2,30,1,1
6639,49506,443,13324,443,6002,1965,4037,23,270,11,12
6640,52831,53,52831,53,200,90,110,2,30,1,1
6641,57243,443,49244,443,27444,3840,23604,58,161,28,30
6642,65411,53,12985,53,194,94,100,2,30,1,1
6643,65114,53,42555,53,380,86,294,2,30,1,1
6644,49797,53,51758,53,718,94,624,2,30,1,1
6645,55152,53,31927,53,177,94,83,2,30,1,1
6646,60068,443,63784,443,10192,5090,5102,43,15,24,19
6647,52193,33027,31412,33027,70,70,0,2,8,2,0
6648,52195,50930,43224,50930,70,70,0,2,8,2,0
6649,52187,38153,15114,38153,70,70,0,2,9,2,0
6650,52158,3841,53385,3841,70,70,0,1,5,1,0
6651,40781,443,27911,443,362,302,60,2,5,1,1
6652,51130,80,19465,80,366,240,126,7,21,5,2
6653,59982,443,64265,443,7693,1284,6409,24,81,12,12
6654,56629,443,11922,443,23887293,546911,23340382,23137,108,7700,15437
6655,65165,53,64230,53,177,94,83,2,30,1,1
6656,51574,443,25990,443,3021,960,2061,14,135,7,7
6657,55027,443,27203,443,17167,5192,11975,32,121,17,15
6658,50560,443,20442,443,17710,10880,6830,44,271,25,19
6659,36836,443,26019,443,9381,1457,7924,21,31,11,10
6660,46899,443,24525,443,70,70,0,1,5,1,0
6661,52156,18238,30723,18238,70,70,0,1,5,1,0
6662,64590,443,12398,443,24686,1935,22751,36,17,17,19
6663,62956,443,13888,443,829275,26662,802613,884,129,295,589
6664,39375,443,57783,443,36154,9709,26445,60,161,27,33
6665,47444,443,24955,443,13920,5009,8911,34,30,18,16
6666,64070,53,27144,53,258,110,148,2,30,1,1
6667,53872,53,43483,53,70,70,0,1,30,1,0
6668,49153,53,53527,53,280,94,186,2,30,1,1
6669,46824,53,42441,53,326,78,248,2,30,1,1
6670,6881,6882,61481,6882,238,118,120,2,1199,1,1
6671,57470,1930,53151,1930,858,858,0,14,1199,14,0
6672,59830,443,56581,443,82533,15815,66718,124,131,50,74
6673,44959,443,64557,443,373033,19903,353130,469,143,180,289
6674,10151,38030,53424,38030,481,150,331,2,1200,1,1
6675,50210,443,12154,443,6444,1320,5124,31,727,10,21
6676,52001,80,13411,80,546,300,246,10,25,6,4
6677,63806,443,63806,443,4651,1744,2907,19,30,11,8
6678,52903,443,59181,443,3478,1580,1898,21,31,12,9
6679,50865,53,50865,53,242,98,144,2,30,1,1
6680,56120,53,62724,53,168,78,90,2,30,1,1
6681,35072,53,51638,53,168,78,90,2,30,1,1
6682,53920,34914,18938,34914,1781,1103,678,15,17,9,6
6683,51270,443,53083,443,190,70,120,4,15,2,2
6684,50673,80,12286,80,20265,5748,14517,34,23,16,18
6685,53226,80,34049,80,1054,602,452,10,20,5,5
6686,60368,443,19000,443,10387,2575,7812,26,108,13,13
6687,49948,53,31917,53,177,94,83,2,30,1,1
6688,49948,53,46968,53,177,94,83,2,30,1,1
6689,20388,53,20388,53,217,90,127,2,30,1,1
6690,55817,53,51311,53,177,94,83,2,30,1,1
6691,56141,53,48700,53,277,134,143,2,30,1,1
6692,65533,53,35566,53,277,134,143,2,30,1,1
6693,42608,1,0,0,62,62,0,1,0,1,0
6694,3986,17372,0,0,66,66,0,1,0,1,0
6695,54053,445,0,0,70,70,0,1,0,1,0
6696,54056,445,0,0,70,70,0,1,0,1,0
6697,54054,445,0,0,70,70,0,1,0,1,0
6698,3730,17372,0,0,62,62,0,1,0,1,0
6699,54048,445,0,0,70,70,0,1,0,1,0
6700,2919,37965,0,0,62,62,0,1,0,1,0
6701,49442,445,0,0,66,66,0,1,0,1,0
6702,49440,445,0,0,66,66,0,1,0,1,0
6703,49439,445,0,0,66,66,0,1,0,1,0
6704,53759,42873,0,0,74,74,0,1,0,1,0
6705,27841,35894,0,0,62,62,0,1,0,1,0
6706,55393,44512,0,0,66,66,0,1,0,1,0
6707,64808,27098,0,0,66,66,0,1,0,1,0
6708,49328,445,0,0,70,70,0,1,0,1,0
6709,54040,445,0,0,70,70,0,1,0,1,0
6710,54280,3385,0,0,60,60,0,1,0,1,0
6711,35100,11392,0,0,62,62,0,1,0,1,0
6712,46162,25174,0,0,62,62,0,1,0,1,0
6713,54034,445,0,0,70,70,0,1,0,1,0
6714,54033,445,0,0,70,70,0,1,0,1,0
6715,59068,49813,0,0,74,74,0,1,0,1,0
6716,54028,445,0,0,70,70,0,1,0,1,0
6717,49326,445,0,0,70,70,0,1,0,1,0
6718,31845,55777,0,0,62,62,0,1,0,1,0
6719,52026,26467,0,0,60,60,0,1,0,1,0
6720,3290,57470,0,0,145,145,0,1,0,1,0
6721,49325,445,0,0,70,70,0,1,0,1,0
6722,51865,61689,0,0,66,66,0,1,0,1,0
6723,11235,30188,0,0,62,62,0,1,0,1,0
6724,49324,445,0,0,70,70,0,1,0,1,0
6725,49323,445,0,0,70,70,0,1,0,1,0
6726,49318,445,0,0,70,70,0,1,0,1,0
6727,49321,445,0,0,70,70,0,1,0,1,0
6728,51922,44847,0,0,66,66,0,1,0,1,0
6729,33814,22114,0,0,146,146,0,1,0,1,0
6730,53928,15503,0,0,62,62,0,1,0,1,0
6731,51414,22,0,0,60,60,0,1,0,1,0
6732,51414,22,0,0,60,60,0,1,0,1,0
6733,52791,25174,0,0,66,66,0,1,0,1,0
6734,62339,25174,0,0,62,62,0,1,0,1,0
6735,49305,445,0,0,70,70,0,1,0,1,0
6736,49304,445,0,0,70,70,0,1,0,1,0
6737,54022,445,0,0,70,70,0,1,0,1,0
6738,54021,445,0,0,70,70,0,1,0,1,0
6739,54015,445,0,0,70,70,0,1,0,1,0
6740,49302,445,0,0,70,70,0,1,0,1,0
6741,53928,15503,0,0,145,145,0,1,0,1,0
6742,10306,44847,0,0,66,66,0,1,0,1,0
6743,48996,22114,0,0,146,146,0,1,0,1,0
6744,49294,445,0,0,70,70,0,1,0,1,0
6745,49295,445,0,0,70,70,0,1,0,1,0
6746,41003,5000,0,0,60,60,0,1,0,1,0
6747,49428,445,0,0,66,66,0,1,0,1,0
6748,41004,5000,0,0,60,60,0,1,0,1,0
6749,33948,1375,0,0,146,146,0,1,0,1,0
6750,63469,64147,0,0,62,62,0,1,0,1,0
6751,46275,64147,0,0,62,62,0,1,0,1,0
6752,51356,22114,0,0,66,66,0,1,0,1,0
6753,22916,25174,0,0,62,62,0,1,0,1,0
6754,53532,22114,0,0,62,62,0,1,0,1,0
6755,54014,445,0,0,70,70,0,1,0,1,0
6756,30542,25174,0,0,62,62,0,1,0,1,0
6757,59153,35440,0,0,62,62,0,1,0,1,0
6758,49283,445,0,0,70,70,0,1,0,1,0
6759,54013,445,0,0,70,70,0,1,0,1,0
6760,7891,25174,0,0,66,66,0,1,0,1,0
6761,50326,46824,0,0,66,66,0,1,0,1,0
6762,49414,445,0,0,66,66,0,1,0,1,0
6763,49411,445,0,0,66,66,0,1,0,1,0
6764,57726,37965,0,0,62,62,0,1,0,1,0
6765,50946,44847,0,0,62,62,0,1,0,1,0
6766,28830,37965,0,0,62,62,0,1,0,1,0
6767,20487,50584,0,0,66,66,0,1,0,1,0
6768,63690,64147,0,0,66,66,0,1,0,1,0
6769,14185,48637,0,0,60,60,0,1,0,1,0
6770,47682,20541,0,0,62,62,0,1,0,1,0
6771,32381,50584,0,0,66,66,0,1,0,1,0
6772,40903,5900,0,0,60,60,0,1,0,1,0
6773,58724,43890,0,0,66,66,0,1,0,1,0
6774,59965,36237,0,0,66,66,0,1,0,1,0
6775,49279,445,0,0,70,70,0,1,0,1,0
6776,3410,17372,0,0,62,62,0,1,0,1,0
6777,53929,443,27958,443,499,425,74,4,0,3,1
6778,53928,443,61918,443,499,425,74,4,0,3,1
6779,10532,26672,0,0,60,60,0,1,0,1,0
6780,3410,17372,0,0,145,145,0,1,0,1,0
6781,3406,17372,0,0,66,66,0,1,0,1,0
6782,54002,445,0,0,70,70,0,1,0,1,0
6783,54001,445,0,0,70,70,0,1,0,1,0
6784,53995,445,0,0,70,70,0,1,0,1,0
6785,53993,445,0,0,70,70,0,1,0,1,0
6786,3090,1,0,0,62,62,0,1,0,1,0
6787,1024,25174,0,0,146,146,0,1,0,1,0
6788,49408,445,0,0,66,66,0,1,0,1,0
6789,49267,445,0,0,70,70,0,1,0,1,0
6790,49269,445,0,0,70,70,0,1,0,1,0
6791,49268,445,0,0,70,70,0,1,0,1,0
6792,12604,80,0,0,60,60,0,1,0,1,0
6793,65216,35440,0,0,66,66,0,1,0,1,0
6794,49265,445,0,0,70,70,0,1,0,1,0
6795,40301,8696,0,0,60,60,0,1,0,1,0
6796,1955,35974,0,0,60,60,0,1,0,1,0
6797,49262,445,0,0,70,70,0,1,0,1,0
6798,49401,445,0,0,66,66,0,1,0,1,0
6799,49396,445,0,0,66,66,0,1,0,1,0
6800,49403,445,0,0,66,66,0,1,0,1,0
6801,49392,445,0,0,66,66,0,1,0,1,0
6802,49402,445,0,0,66,66,0,1,0,1,0
6803,49393,445,0,0,66,66,0,1,0,1,0
6804,49395,445,0,0,66,66,0,1,0,1,0
6805,64772,64147,0,0,62,62,0,1,0,1,0
6806,20706,23718,0,0,66,66,0,1,0,1,0
6807,60308,37965,0,0,66,66,0,1,0,1,0
6808,49001,22114,0,0,62,62,0,1,0,1,0
6809,53987,445,0,0,70,70,0,1,0,1,0
6810,55069,44847,0,0,62,62,0,1,0,1,0
6811,61730,25320,0,0,62,62,0,1,0,1,0
6812,51558,37965,0,0,72,72,0,1,0,1,0
6813,53984,445,0,0,70,70,0,1,0,1,0
6814,53981,445,0,0,70,70,0,1,0,1,0
6815,53980,445,0,0,70,70,0,1,0,1,0
6816,45837,25174,0,0,62,62,0,1,0,1,0
6817,346,23,0,0,60,60,0,1,0,1,0
6818,49257,445,0,0,70,70,0,1,0,1,0
6819,53103,8497,0,0,148,148,0,1,0,1,0
6820,443,4205,0,0,320,320,0,1,0,1,0
6821,4138,55777,0,0,66,66,0,1,0,1,0
6822,43155,35440,0,0,66,66,0,1,0,1,0
6823,54816,35440,0,0,62,62,0,1,0,1,0
6824,55893,45711,0,0,78,78,0,1,0,1,0
6825,45941,23388,0,0,60,60,0,1,0,1,0
6826,53979,445,0,0,70,70,0,1,0,1,0
6827,53972,445,0,0,70,70,0,1,0,1,0
6828,53973,445,0,0,70,70,0,1,0,1,0
6829,61911,50432,0,0,146,146,0,1,0,1,0
6830,59155,39004,0,0,74,74,0,1,0,1,0
6831,49384,445,0,0,66,66,0,1,0,1,0
6832,59223,17500,0,0,66,66,0,1,0,1,0
6833,49249,445,0,0,70,70,0,1,0,1,0
6834,53971,445,0,0,70,70,0,1,0,1,0
6835,49248,445,0,0,70,70,0,1,0,1,0
6836,59225,57587,0,0,66,66,0,1,0,1,0
6837,44408,57470,0,0,62,62,0,1,0,1,0
6838,54555,25174,0,0,66,66,0,1,0,1,0
6839,54976,2273,0,0,60,60,0,1,0,1,0
6840,61280,26467,0,0,66,66,0,1,0,1,0
6841,49383,445,0,0,66,66,0,1,0,1,0
6842,49379,445,0,0,66,66,0,1,0,1,0
6843,49381,445,0,0,66,66,0,1,0,1,0
6844,48258,37965,0,0,62,62,0,1,0,1,0
6845,49378,445,0,0,66,66,0,1,0,1,0
6846,63593,22114,0,0,66,66,0,1,0,1,0
6847,49242,445,0,0,70,70,0,1,0,1,0
6848,56909,50584,0,0,66,66,0,1,0,1,0
6849,49241,445,0,0,70,70,0,1,0,1,0
6850,61143,8080,0,0,60,60,0,1,0,1,0
6851,53964,445,0,0,70,70,0,1,0,1,0
6852,53962,445,0,0,70,70,0,1,0,1,0
6853,53956,445,0,0,70,70,0,1,0,1,0
6854,49237,445,0,0,70,70,0,1,0,1,0
6855,35507,15503,0,0,62,62,0,1,0,1,0
6856,46286,21247,0,0,146,146,0,1,0,1,0
6857,9327,57470,0,0,62,62,0,1,0,1,0
6858,46460,36237,0,0,146,146,0,1,0,1,0
6859,49236,445,0,0,70,70,0,1,0,1,0
6860,13528,51221,0,0,62,62,0,1,0,1,0
6861,49367,445,0,0,66,66,0,1,0,1,0
6862,64882,43890,0,0,66,66,0,1,0,1,0
6863,59214,57866,0,0,66,66,0,1,0,1,0
6864,52604,25174,0,0,66,66,0,1,0,1,0
6865,49531,26467,0,0,66,66,0,1,0,1,0
6866,50974,11392,0,0,66,66,0,1,0,1,0
6867,45964,3111,0,0,60,60,0,1,0,1,0
6868,45964,3111,0,0,60,60,0,1,0,1,0
6869,14208,51221,0,0,66,66,0,1,0,1,0
6870,59822,56205,0,0,66,66,0,1,0,1,0
6871,50396,62413,0,0,66,66,0,1,0,1,0
6872,49359,445,0,0,66,66,0,1,0,1,0
6873,49231,445,0,0,70,70,0,1,0,1,0
6874,53943,445,0,0,70,70,0,1,0,1,0
6875,57131,31061,0,0,145,145,0,1,0,1,0
6876,25565,41288,0,0,60,60,0,1,0,1,0
6877,52929,43890,0,0,66,66,0,1,0,1,0
6878,62575,12207,0,0,66,66,0,1,0,1,0
6879,53381,25174,0,0,62,62,0,1,0,1,0
6880,44414,23718,0,0,66,66,0,1,0,1,0
6881,18218,30349,0,0,148,148,0,1,0,1,0
6882,49356,445,0,0,66,66,0,1,0,1,0
6883,55312,64147,0,0,62,62,0,1,0,1,0
6884,18398,21247,0,0,66,66,0,1,0,1,0
6885,62020,64147,0,0,145,145,0,1,0,1,0
6886,38330,44847,0,0,66,66,0,1,0,1,0
6887,60416,37965,0,0,66,66,0,1,0,1,0
6888,23310,22114,0,0,66,66,0,1,0,1,0
6889,53759,42873,0,0,74,74,0,1,0,1,0
6890,61085,37965,0,0,62,62,0,1,0,1,0
6891,7561,43890,0,0,66,66,0,1,0,1,0
6892,49349,445,0,0,66,66,0,1,0,1,0
6893,49485,56972,0,0,62,62,0,1,0,1,0
6894,56924,26467,0,0,62,62,0,1,0,1,0
6895,37487,25174,0,0,66,66,0,1,0,1,0
6896,36729,443,18622,443,7480,1122,6358,27,257,13,14
6897,38644,1723,38644,1723,146,60,86,2,9,1,1
6898,48470,80,20195,80,959,544,415,11,315,6,5
6899,55681,53,52185,53,711,87,624,2,30,1,1
6900,56334,53,55727,53,170,87,83,2,30,1,1
6901,43686,443,17205,443,6804,914,5890,22,257,10,12
6902,49335,443,62056,443,125790,4516,121274,118,55,28,90
6903,57069,53,40804,53,1335,87,1248,4,32,2,2
6904,53947,867,53640,867,70,70,0,2,8,2,0
6905,60487,1134,57270,1134,70,70,0,1,5,1,0
6906,40218,443,5218,443,5254,927,4327,20,84,9,11
6907,55064,80,48645,80,1646,998,648,13,85,7,6
6908,55157,53,58441,53,711,87,624,2,30,1,1
6909,55710,53,65057,53,198,93,105,2,30,1,1
6910,38402,443,45229,443,3830718,112946,3717772,4353,224,1395,2958
6911,29126,7000,29126,7000,4124,2423,1701,20,16,11,9
6912,52154,4635,6285,4635,66,66,0,1,5,1,0
6913,57339,443,64003,443,1778020,204978,1573042,2589,987,1006,1583
6914,52710,443,22445,443,203346,21619,181727,301,376,140,161
6915,52829,443,52829,443,4613,1706,2907,19,30,11,8
6916,48551,443,38107,443,7104,888,6216,19,27,9,10
6917,48785,443,37520,443,6464,1223,5241,25,33,12,13
6918,59326,80,59326,80,109128,4773,104355,197,16,68,129
6919,60815,443,60815,443,1320,685,635,14,181,7,7
6920,54352,53,16730,53,578,286,292,9,16,5,4
6921,45314,80,7495,80,72376,2899,69477,79,16,29,50
6922,53075,53,27228,53,168,78,90,2,30,1,1
6923,35702,443,51381,443,13428,5815,7613,42,995,22,20
6924,36943,443,59404,443,15329,7087,8242,108,310,61,47
6925,36993,443,63240,443,7768,3071,4697,23,17,12,11
6926,31227,53,31227,53,407,261,146,3,32,2,1
6927,60486,8999,41044,8999,70,70,0,1,5,1,0
6928,43368,443,39927,443,190,70,120,4,15,2,2
6929,57760,80,57760,80,2934,1497,1437,10,16,6,4
6930,48786,443,62894,443,7130,1890,5240,25,33,12,13
6931,57240,53,57240,53,198,89,109,2,30,1,1
6932,56680,53,24501,53,711,87,624,2,30,1,1
6933,43024,53,45972,53,198,93,105,2,30,1,1
6934,57470,6881,1895,6881,528,528,0,9,1200,9,0
6935,55055,443,60639,443,14492,3190,11302,34,16,19,15
6936,1658,443,1658,443,12030,1282,10748,23,17,9,14
6937,40215,443,50672,443,5656,1009,4647,24,87,10,14
6938,25384,443,25384,443,3072,696,2376,13,16,8,5
6939,40220,443,35161,443,5448,989,4459,22,84,10,12
6940,53948,7370,61393,7370,70,70,0,2,8,2,0
6941,49300,443,11217,443,26747,8027,18720,58,92,25,33
6942,53614,443,10121,443,8347,1979,6368,32,19,17,15
6943,55936,53,2278,53,170,87,83,2,30,1,1
6944,51809,443,10522,443,82930,18836,64094,131,128,55,76
6945,19473,51413,8434,51413,459,149,310,2,1200,1,1
6946,36337,443,41043,443,3781,1917,1864,23,396,7,16
6947,58848,24855,0,0,66,66,0,1,90,1,0
6948,41156,443,9223,443,59486,3261,56225,74,360,29,45
6949,54517,443,8632,443,11460,2522,8938,19,122,9,10
6950,49343,445,0,0,66,66,0,1,0,1,0
6951,49218,445,0,0,70,70,0,1,0,1,0
6952,60645,35440,0,0,66,66,0,1,0,1,0
6953,62250,23117,0,0,66,66,0,1,0,1,0
6954,62208,37965,0,0,66,66,0,1,0,1,0
6955,31654,65473,0,0,148,148,0,1,0,1,0
6956,9226,57470,0,0,66,66,0,1,0,1,0
6957,49215,445,0,0,70,70,0,1,0,1,0
6958,37191,48817,0,0,159,159,0,1,0,1,0
6959,9745,26467,0,0,62,62,0,1,0,1,0
6960,13020,26467,0,0,66,66,0,1,0,1,0
6961,39171,22114,0,0,146,146,0,1,0,1,0
6962,54957,53,32234,53,102,102,0,1,30,1,0
6963,36697,443,4687,443,21563,17259,4304,70,78,37,33
6964,38711,443,23557,443,459089,10521,448568,449,16,141,308
6965,57979,443,3610,443,7970957,82522,7888435,6370,179,1027,5343
6966,41451,53,15515,53,359,86,273,2,30,1,1
6967,53934,445,0,0,70,70,0,1,0,1,0
6968,53932,445,0,0,70,70,0,1,0,1,0
6969,53931,445,0,0,70,70,0,1,0,1,0
6970,48016,57470,0,0,62,62,0,1,0,1,0
6971,59347,57470,0,0,66,66,0,1,0,1,0
6972,31130,30188,0,0,66,66,0,1,0,1,0
6973,49328,445,0,0,66,66,0,1,0,1,0
6974,49331,445,0,0,66,66,0,1,0,1,0
6975,49333,445,0,0,66,66,0,1,0,1,0
6976,49332,445,0,0,66,66,0,1,0,1,0
6977,49329,445,0,0,66,66,0,1,0,1,0
6978,49326,445,0,0,66,66,0,1,0,1,0
6979,53721,62413,0,0,146,146,0,1,0,1,0
6980,49211,445,0,0,70,70,0,1,0,1,0
6981,2780,23117,0,0,62,62,0,1,0,1,0
6982,49207,445,0,0,70,70,0,1,0,1,0
6983,51930,57470,0,0,62,62,0,1,0,1,0
6984,54011,44847,0,0,66,66,0,1,0,1,0
6985,19845,30024,0,0,62,62,0,1,0,1,0
6986,55842,64147,0,0,66,66,0,1,0,1,0
6987,49205,445,0,0,70,70,0,1,0,1,0
6988,58638,5900,0,0,62,62,0,1,0,1,0
6989,58638,5900,0,0,62,62,0,1,0,1,0
6990,58638,5900,0,0,62,62,0,1,0,1,0
6991,58638,5900,0,0,62,62,0,1,0,1,0
6992,58638,5900,0,0,62,62,0,1,0,1,0
6993,58638,5900,0,0,62,62,0,1,0,1,0
6994,58638,5900,0,0,62,62,0,1,0,1,0
6995,58638,5900,0,0,62,62,0,1,0,1,0
6996,58638,5900,0,0,62,62,0,1,0,1,0
6997,58638,5900,0,0,62,62,0,1,0,1,0
6998,58638,5900,0,0,62,62,0,1,0,1,0
6999,58638,5900,0,0,62,62,0,1,0,1,0
7000,58638,5900,0,0,62,62,0,1,0,1,0
7001,58638,5900,0,0,62,62,0,1,0,1,0
7002,58638,5900,0,0,62,62,0,1,0,1,0
7003,58638,5900,0,0,62,62,0,1,0,1,0
7004,58638,5900,0,0,62,62,0,1,0,1,0
7005,58638,5900,0,0,62,62,0,1,0,1,0
7006,58638,5900,0,0,62,62,0,1,0,1,0
7007,58638,5900,0,0,62,62,0,1,0,1,0
7008,58638,5900,0,0,62,62,0,1,0,1,0
7009,58638,5900,0,0,62,62,0,1,0,1,0
7010,58638,5900,0,0,62,62,0,1,0,1,0
7011,58638,5900,0,0,62,62,0,1,0,1,0
7012,58638,5900,0,0,62,62,0,1,0,1,0
7013,58638,5900,0,0,62,62,0,1,0,1,0
7014,58638,5900,0,0,62,62,0,1,0,1,0
7015,58638,5900,0,0,62,62,0,1,0,1,0
7016,58638,5900,0,0,62,62,0,1,0,1,0
7017,58638,5900,0,0,62,62,0,1,0,1,0
7018,58638,5900,0,0,62,62,0,1,0,1,0
7019,58638,5900,0,0,62,62,0,1,0,1,0
7020,58638,5900,0,0,62,62,0,1,0,1,0
7021,58638,5900,0,0,62,62,0,1,0,1,0
7022,58638,5900,0,0,62,62,0,1,0,1,0
7023,58638,5900,0,0,62,62,0,1,0,1,0
7024,58638,5900,0,0,62,62,0,1,0,1,0
7025,58638,5900,0,0,62,62,0,1,0,1,0
7026,58638,5900,0,0,62,62,0,1,0,1,0
7027,58638,5900,0,0,62,62,0,1,0,1,0
7028,58638,5900,0,0,62,62,0,1,0,1,0
7029,58638,5900,0,0,62,62,0,1,0,1,0
7030,58638,5900,0,0,62,62,0,1,0,1,0
7031,58638,5900,0,0,62,62,0,1,0,1,0
7032,58638,5900,0,0,62,62,0,1,0,1,0
7033,58638,5900,0,0,62,62,0,1,0,1,0
7034,58638,5900,0,0,62,62,0,1,0,1,0
7035,58638,5900,0,0,62,62,0,1,0,1,0
7036,58638,5900,0,0,62,62,0,1,0,1,0
7037,58638,5900,0,0,62,62,0,1,0,1,0
7038,58638,5900,0,0,62,62,0,1,0,1,0
7039,58638,5900,0,0,62,62,0,1,0,1,0
7040,58638,5900,0,0,62,62,0,1,0,1,0
7041,58638,5900,0,0,62,62,0,1,0,1,0
7042,58638,5900,0,0,62,62,0,1,0,1,0
7043,58638,5900,0,0,62,62,0,1,0,1,0
7044,58638,5900,0,0,62,62,0,1,0,1,0
7045,58638,5900,0,0,62,62,0,1,0,1,0
7046,58638,5900,0,0,62,62,0,1,0,1,0
7047,58638,5900,0,0,62,62,0,1,0,1,0
7048,58638,5900,0,0,62,62,0,1,0,1,0
7049,58638,5900,0,0,62,62,0,1,0,1,0
7050,58638,5900,0,0,62,62,0,1,0,1,0
7051,58638,5900,0,0,62,62,0,1,0,1,0
7052,58638,5900,0,0,62,62,0,1,0,1,0
7053,58638,5900,0,0,62,62,0,1,0,1,0
7054,58638,5900,0,0,62,62,0,1,0,1,0
7055,58638,5900,0,0,62,62,0,1,0,1,0
7056,58638,5900,0,0,62,62,0,1,0,1,0
7057,58638,5900,0,0,62,62,0,1,0,1,0
7058,58638,5900,0,0,62,62,0,1,0,1,0
7059,58638,5900,0,0,62,62,0,1,0,1,0
7060,58638,5900,0,0,62,62,0,1,0,1,0
7061,58638,5900,0,0,62,62,0,1,0,1,0
7062,58638,5900,0,0,62,62,0,1,0,1,0
7063,58638,5900,0,0,62,62,0,1,0,1,0
7064,58638,5900,0,0,62,62,0,1,0,1,0
7065,58638,5900,0,0,62,62,0,1,0,1,0
7066,58638,5900,0,0,62,62,0,1,0,1,0
7067,58638,5900,0,0,62,62,0,1,0,1,0
7068,58638,5900,0,0,62,62,0,1,0,1,0
7069,58638,5900,0,0,62,62,0,1,0,1,0
7070,58638,5900,0,0,62,62,0,1,0,1,0
7071,58638,5900,0,0,62,62,0,1,0,1,0
7072,58638,5900,0,0,62,62,0,1,0,1,0
7073,58638,5900,0,0,62,62,0,1,0,1,0
7074,58638,5900,0,0,62,62,0,1,0,1,0
7075,58638,5900,0,0,62,62,0,1,0,1,0
7076,58638,5900,0,0,62,62,0,1,0,1,0
7077,58638,5900,0,0,62,62,0,1,0,1,0
7078,58638,5900,0,0,62,62,0,1,0,1,0
7079,58638,5900,0,0,62,62,0,1,0,1,0
7080,58638,5900,0,0,62,62,0,1,0,1,0
7081,58638,5900,0,0,62,62,0,1,0,1,0
7082,58638,5900,0,0,62,62,0,1,0,1,0
7083,58638,5900,0,0,62,62,0,1,0,1,0
7084,52026,26467,0,0,60,60,0,1,0,1,0
7085,58638,5900,0,0,62,62,0,1,0,1,0
7086,58638,5900,0,0,62,62,0,1,0,1,0
7087,58638,5900,0,0,62,62,0,1,0,1,0
7088,58638,5900,0,0,62,62,0,1,0,1,0
7089,58638,5900,0,0,62,62,0,1,0,1,0
7090,58638,5900,0,0,62,62,0,1,0,1,0
7091,58638,5900,0,0,62,62,0,1,0,1,0
7092,58638,5900,0,0,62,62,0,1,0,1,0
7093,58638,5900,0,0,62,62,0,1,0,1,0
7094,58638,5900,0,0,62,62,0,1,0,1,0
7095,58638,5900,0,0,62,62,0,1,0,1,0
7096,58638,5900,0,0,62,62,0,1,0,1,0
7097,58638,5900,0,0,62,62,0,1,0,1,0
7098,58638,5900,0,0,62,62,0,1,0,1,0
7099,58638,5900,0,0,62,62,0,1,0,1,0
7100,58638,5900,0,0,62,62,0,1,0,1,0
7101,58638,5900,0,0,62,62,0,1,0,1,0
7102,58638,5900,0,0,62,62,0,1,0,1,0
7103,58638,5900,0,0,62,62,0,1,0,1,0
7104,58638,5900,0,0,62,62,0,1,0,1,0
7105,58638,5900,0,0,62,62,0,1,0,1,0
7106,58638,5900,0,0,62,62,0,1,0,1,0
7107,58638,5900,0,0,62,62,0,1,0,1,0
7108,58638,5900,0,0,62,62,0,1,0,1,0
7109,58638,5900,0,0,62,62,0,1,0,1,0
7110,58638,5900,0,0,62,62,0,1,0,1,0
7111,58638,5900,0,0,62,62,0,1,0,1,0
7112,58638,5900,0,0,62,62,0,1,0,1,0
7113,58638,5900,0,0,62,62,0,1,0,1,0
7114,58638,5900,0,0,62,62,0,1,0,1,0
7115,58638,5900,0,0,62,62,0,1,0,1,0
7116,58638,5900,0,0,62,62,0,1,0,1,0
7117,58638,5900,0,0,62,62,0,1,0,1,0
7118,58638,5900,0,0,62,62,0,1,0,1,0
7119,58638,5900,0,0,62,62,0,1,0,1,0
7120,58638,5900,0,0,62,62,0,1,0,1,0
7121,58638,5900,0,0,62,62,0,1,0,1,0
7122,58638,5900,0,0,62,62,0,1,0,1,0
7123,58638,5900,0,0,62,62,0,1,0,1,0
7124,58638,5900,0,0,62,62,0,1,0,1,0
7125,58638,5900,0,0,62,62,0,1,0,1,0
7126,58638,5900,0,0,62,62,0,1,0,1,0
7127,58638,5900,0,0,62,62,0,1,0,1,0
7128,58638,5900,0,0,62,62,0,1,0,1,0
7129,58638,5900,0,0,62,62,0,1,0,1,0
7130,58638,5900,0,0,62,62,0,1,0,1,0
7131,58638,5900,0,0,62,62,0,1,0,1,0
7132,58638,5900,0,0,62,62,0,1,0,1,0
7133,58638,5900,0,0,62,62,0,1,0,1,0
7134,58638,5900,0,0,62,62,0,1,0,1,0
7135,58638,5900,0,0,62,62,0,1,0,1,0
7136,58638,5900,0,0,62,62,0,1,0,1,0
7137,58638,5900,0,0,62,62,0,1,0,1,0
7138,58638,5900,0,0,62,62,0,1,0,1,0
7139,58638,5900,0,0,62,62,0,1,0,1,0
7140,58638,5900,0,0,62,62,0,1,0,1,0
7141,58638,5900,0,0,62,62,0,1,0,1,0
7142,58638,5900,0,0,62,62,0,1,0,1,0
7143,58638,5900,0,0,62,62,0,1,0,1,0
7144,58638,5900,0,0,62,62,0,1,0,1,0
7145,58638,5900,0,0,62,62,0,1,0,1,0
7146,58638,5900,0,0,62,62,0,1,0,1,0
7147,58638,5900,0,0,62,62,0,1,0,1,0
7148,58638,5900,0,0,62,62,0,1,0,1,0
7149,58638,5900,0,0,62,62,0,1,0,1,0
7150,58638,5900,0,0,62,62,0,1,0,1,0
7151,58638,5900,0,0,62,62,0,1,0,1,0
7152,58638,5900,0,0,62,62,0,1,0,1,0
7153,58638,5900,0,0,62,62,0,1,0,1,0
7154,58638,5900,0,0,62,62,0,1,0,1,0
7155,58638,5900,0,0,62,62,0,1,0,1,0
7156,58638,5900,0,0,62,62,0,1,0,1,0
7157,58638,5900,0,0,62,62,0,1,0,1,0
7158,58638,5900,0,0,62,62,0,1,0,1,0
7159,58638,5900,0,0,62,62,0,1,0,1,0
7160,58638,5900,0,0,62,62,0,1,0,1,0
7161,58638,5900,0,0,62,62,0,1,0,1,0
7162,58638,5900,0,0,62,62,0,1,0,1,0
7163,58638,5900,0,0,62,62,0,1,0,1,0
7164,58638,5900,0,0,62,62,0,1,0,1,0
7165,58638,5900,0,0,62,62,0,1,0,1,0
7166,58638,5900,0,0,62,62,0,1,0,1,0
7167,58638,5900,0,0,62,62,0,1,0,1,0
7168,58638,5900,0,0,62,62,0,1,0,1,0
7169,58638,5900,0,0,62,62,0,1,0,1,0
7170,58638,5900,0,0,62,62,0,1,0,1,0
7171,58638,5900,0,0,62,62,0,1,0,1,0
7172,58638,5900,0,0,62,62,0,1,0,1,0
7173,58638,5900,0,0,62,62,0,1,0,1,0
7174,58638,5900,0,0,62,62,0,1,0,1,0
7175,58638,5900,0,0,62,62,0,1,0,1,0
7176,58638,5900,0,0,62,62,0,1,0,1,0
7177,58638,5900,0,0,62,62,0,1,0,1,0
7178,58638,5900,0,0,62,62,0,1,0,1,0
7179,58638,5900,0,0,62,62,0,1,0,1,0
7180,58638,5900,0,0,62,62,0,1,0,1,0
7181,58638,5900,0,0,62,62,0,1,0,1,0
7182,58638,5900,0,0,62,62,0,1,0,1,0
7183,58638,5900,0,0,62,62,0,1,0,1,0
7184,58638,5900,0,0,62,62,0,1,0,1,0
7185,58638,5900,0,0,62,62,0,1,0,1,0
7186,58638,5900,0,0,62,62,0,1,0,1,0
7187,58638,5900,0,0,62,62,0,1,0,1,0
7188,58638,5900,0,0,62,62,0,1,0,1,0
7189,58638,5900,0,0,62,62,0,1,0,1,0
7190,58638,5900,0,0,62,62,0,1,0,1,0
7191,58638,5900,0,0,62,62,0,1,0,1,0
7192,58638,5900,0,0,62,62,0,1,0,1,0
7193,58638,5900,0,0,62,62,0,1,0,1,0
7194,58638,5900,0,0,62,62,0,1,0,1,0
7195,58638,5900,0,0,62,62,0,1,0,1,0
7196,58638,5900,0,0,62,62,0,1,0,1,0
7197,58638,5900,0,0,62,62,0,1,0,1,0
7198,58638,5900,0,0,62,62,0,1,0,1,0
7199,58638,5900,0,0,62,62,0,1,0,1,0
7200,58638,5900,0,0,62,62,0,1,0,1,0
7201,58638,5900,0,0,62,62,0,1,0,1,0
7202,58638,5900,0,0,62,62,0,1,0,1,0
7203,58638,5900,0,0,62,62,0,1,0,1,0
7204,58638,5900,0,0,62,62,0,1,0,1,0
7205,58638,5900,0,0,62,62,0,1,0,1,0
7206,58638,5900,0,0,62,62,0,1,0,1,0
7207,58638,5900,0,0,62,62,0,1,0,1,0
7208,58638,5900,0,0,62,62,0,1,0,1,0
7209,58638,5900,0,0,62,62,0,1,0,1,0
7210,58638,5900,0,0,62,62,0,1,0,1,0
7211,58638,5900,0,0,62,62,0,1,0,1,0
7212,58638,5900,0,0,62,62,0,1,0,1,0
7213,58638,5900,0,0,62,62,0,1,0,1,0
7214,58638,5900,0,0,62,62,0,1,0,1,0
7215,58638,5900,0,0,62,62,0,1,0,1,0
7216,58638,5900,0,0,62,62,0,1,0,1,0
7217,58638,5900,0,0,62,62,0,1,0,1,0
7218,58638,5900,0,0,62,62,0,1,0,1,0
7219,58638,5900,0,0,62,62,0,1,0,1,0
7220,58638,5900,0,0,62,62,0,1,0,1,0
7221,58638,5900,0,0,62,62,0,1,0,1,0
7222,58638,5900,0,0,62,62,0,1,0,1,0
7223,58638,5900,0,0,62,62,0,1,0,1,0
7224,58638,5900,0,0,62,62,0,1,0,1,0
7225,58638,5900,0,0,62,62,0,1,0,1,0
7226,58638,5900,0,0,62,62,0,1,0,1,0
7227,58638,5900,0,0,62,62,0,1,0,1,0
7228,58638,5900,0,0,62,62,0,1,0,1,0
7229,58638,5900,0,0,62,62,0,1,0,1,0
7230,58638,5900,0,0,62,62,0,1,0,1,0
7231,58638,5900,0,0,62,62,0,1,0,1,0
7232,58638,5900,0,0,62,62,0,1,0,1,0
7233,58638,5900,0,0,62,62,0,1,0,1,0
7234,58638,5900,0,0,62,62,0,1,0,1,0
7235,58638,5900,0,0,62,62,0,1,0,1,0
7236,58638,5900,0,0,62,62,0,1,0,1,0
7237,58638,5900,0,0,62,62,0,1,0,1,0
7238,58638,5900,0,0,62,62,0,1,0,1,0
7239,58638,5900,0,0,62,62,0,1,0,1,0
7240,58638,5900,0,0,62,62,0,1,0,1,0
7241,58638,5900,0,0,62,62,0,1,0,1,0
7242,58638,5900,0,0,62,62,0,1,0,1,0
7243,58638,5900,0,0,62,62,0,1,0,1,0
7244,53930,445,0,0,70,70,0,1,0,1,0
7245,58638,5900,0,0,62,62,0,1,0,1,0
7246,58638,5900,0,0,62,62,0,1,0,1,0
7247,53923,445,0,0,70,70,0,1,0,1,0
7248,58638,5900,0,0,62,62,0,1,0,1,0
7249,58638,5900,0,0,62,62,0,1,0,1,0
7250,53922,445,0,0,70,70,0,1,0,1,0
7251,58638,5900,0,0,62,62,0,1,0,1,0
7252,58638,5900,0,0,62,62,0,1,0,1,0
7253,53916,445,0,0,70,70,0,1,0,1,0
7254,58638,5900,0,0,62,62,0,1,0,1,0
7255,58638,5900,0,0,62,62,0,1,0,1,0
7256,58638,5900,0,0,62,62,0,1,0,1,0
7257,58638,5900,0,0,62,62,0,1,0,1,0
7258,58638,5900,0,0,62,62,0,1,0,1,0
7259,58638,5900,0,0,62,62,0,1,0,1,0
7260,58638,5900,0,0,62,62,0,1,0,1,0
7261,58638,5900,0,0,62,62,0,1,0,1,0
7262,58638,5900,0,0,62,62,0,1,0,1,0
7263,58638,5900,0,0,62,62,0,1,0,1,0
7264,58638,5900,0,0,62,62,0,1,0,1,0
7265,58638,5900,0,0,62,62,0,1,0,1,0
7266,58638,5900,0,0,62,62,0,1,0,1,0
7267,58638,5900,0,0,62,62,0,1,0,1,0
7268,58638,5900,0,0,62,62,0,1,0,1,0
7269,58638,5900,0,0,62,62,0,1,0,1,0
7270,58638,5900,0,0,62,62,0,1,0,1,0
7271,58638,5900,0,0,62,62,0,1,0,1,0
7272,58638,5900,0,0,62,62,0,1,0,1,0
7273,58638,5900,0,0,62,62,0,1,0,1,0
7274,58638,5900,0,0,62,62,0,1,0,1,0
7275,58638,5900,0,0,62,62,0,1,0,1,0
7276,58638,5900,0,0,62,62,0,1,0,1,0
7277,58638,5900,0,0,62,62,0,1,0,1,0
7278,58638,5900,0,0,62,62,0,1,0,1,0
7279,58638,5900,0,0,62,62,0,1,0,1,0
7280,58638,5900,0,0,62,62,0,1,0,1,0
7281,58638,5900,0,0,62,62,0,1,0,1,0
7282,58638,5900,0,0,62,62,0,1,0,1,0
7283,58638,5900,0,0,62,62,0,1,0,1,0
7284,58638,5900,0,0,62,62,0,1,0,1,0
7285,58638,5900,0,0,62,62,0,1,0,1,0
7286,58638,5900,0,0,62,62,0,1,0,1,0
7287,58638,5900,0,0,62,62,0,1,0,1,0
7288,58638,5900,0,0,62,62,0,1,0,1,0
7289,58638,5900,0,0,62,62,0,1,0,1,0
7290,58638,5900,0,0,62,62,0,1,0,1,0
7291,58638,5900,0,0,62,62,0,1,0,1,0
7292,58638,5900,0,0,62,62,0,1,0,1,0
7293,58638,5900,0,0,62,62,0,1,0,1,0
7294,58638,5900,0,0,62,62,0,1,0,1,0
7295,58638,5900,0,0,62,62,0,1,0,1,0
7296,58638,5900,0,0,62,62,0,1,0,1,0
7297,58638,5900,0,0,62,62,0,1,0,1,0
7298,58638,5900,0,0,62,62,0,1,0,1,0
7299,58638,5900,0,0,62,62,0,1,0,1,0
7300,58638,5900,0,0,62,62,0,1,0,1,0
7301,58638,5900,0,0,62,62,0,1,0,1,0
7302,58638,5900,0,0,62,62,0,1,0,1,0
7303,58638,5900,0,0,62,62,0,1,0,1,0
7304,58638,5900,0,0,62,62,0,1,0,1,0
7305,58638,5900,0,0,62,62,0,1,0,1,0
7306,58638,5900,0,0,62,62,0,1,0,1,0
7307,58638,5900,0,0,62,62,0,1,0,1,0
7308,58638,5900,0,0,62,62,0,1,0,1,0
7309,58638,5900,0,0,62,62,0,1,0,1,0
7310,58638,5900,0,0,62,62,0,1,0,1,0
7311,58638,5900,0,0,62,62,0,1,0,1,0
7312,58638,5900,0,0,62,62,0,1,0,1,0
7313,58638,5900,0,0,62,62,0,1,0,1,0
7314,58638,5900,0,0,62,62,0,1,0,1,0
7315,58638,5900,0,0,62,62,0,1,0,1,0
7316,58638,5900,0,0,62,62,0,1,0,1,0
7317,58638,5900,0,0,62,62,0,1,0,1,0
7318,58638,5900,0,0,62,62,0,1,0,1,0
7319,58638,5900,0,0,62,62,0,1,0,1,0
7320,58638,5900,0,0,62,62,0,1,0,1,0
7321,58638,5900,0,0,62,62,0,1,0,1,0
7322,58638,5900,0,0,62,62,0,1,0,1,0
7323,58638,5900,0,0,62,62,0,1,0,1,0
7324,58638,5900,0,0,62,62,0,1,0,1,0
7325,58638,5900,0,0,62,62,0,1,0,1,0
7326,58638,5900,0,0,62,62,0,1,0,1,0
7327,58638,5900,0,0,62,62,0,1,0,1,0
7328,58638,5900,0,0,62,62,0,1,0,1,0
7329,58638,5900,0,0,62,62,0,1,0,1,0
7330,58638,5900,0,0,62,62,0,1,0,1,0
7331,58638,5900,0,0,62,62,0,1,0,1,0
7332,58638,5900,0,0,62,62,0,1,0,1,0
7333,58638,5900,0,0,62,62,0,1,0,1,0
7334,58638,5900,0,0,62,62,0,1,0,1,0
7335,58638,5900,0,0,62,62,0,1,0,1,0
7336,58638,5900,0,0,62,62,0,1,0,1,0
7337,58638,5900,0,0,62,62,0,1,0,1,0
7338,58638,5900,0,0,62,62,0,1,0,1,0
7339,58638,5900,0,0,62,62,0,1,0,1,0
7340,58638,5900,0,0,62,62,0,1,0,1,0
7341,58638,5900,0,0,62,62,0,1,0,1,0
7342,58638,5900,0,0,62,62,0,1,0,1,0
7343,58638,5900,0,0,62,62,0,1,0,1,0
7344,58638,5900,0,0,62,62,0,1,0,1,0
7345,58638,5900,0,0,62,62,0,1,0,1,0
7346,58638,5900,0,0,62,62,0,1,0,1,0
7347,58638,5900,0,0,62,62,0,1,0,1,0
7348,58638,5900,0,0,62,62,0,1,0,1,0
7349,58638,5900,0,0,62,62,0,1,0,1,0
7350,58638,5900,0,0,62,62,0,1,0,1,0
7351,58638,5900,0,0,62,62,0,1,0,1,0
7352,58638,5900,0,0,62,62,0,1,0,1,0
7353,58638,5900,0,0,62,62,0,1,0,1,0
7354,58638,5900,0,0,62,62,0,1,0,1,0
7355,58638,5900,0,0,62,62,0,1,0,1,0
7356,58638,5900,0,0,62,62,0,1,0,1,0
7357,58638,5900,0,0,62,62,0,1,0,1,0
7358,58638,5900,0,0,62,62,0,1,0,1,0
7359,58638,5900,0,0,62,62,0,1,0,1,0
7360,58638,5900,0,0,62,62,0,1,0,1,0
7361,58638,5900,0,0,62,62,0,1,0,1,0
7362,58638,5900,0,0,62,62,0,1,0,1,0
7363,58638,5900,0,0,62,62,0,1,0,1,0
7364,58638,5900,0,0,62,62,0,1,0,1,0
7365,58638,5900,0,0,62,62,0,1,0,1,0
7366,58638,5900,0,0,62,62,0,1,0,1,0
7367,58638,5900,0,0,62,62,0,1,0,1,0
7368,58638,5900,0,0,62,62,0,1,0,1,0
7369,58638,5900,0,0,62,62,0,1,0,1,0
7370,58638,5900,0,0,62,62,0,1,0,1,0
7371,58638,5900,0,0,62,62,0,1,0,1,0
7372,58638,5900,0,0,62,62,0,1,0,1,0
7373,58638,5900,0,0,62,62,0,1,0,1,0
7374,58638,5900,0,0,62,62,0,1,0,1,0
7375,58638,5900,0,0,62,62,0,1,0,1,0
7376,58638,5900,0,0,62,62,0,1,0,1,0
7377,58638,5900,0,0,62,62,0,1,0,1,0
7378,58638,5900,0,0,62,62,0,1,0,1,0
7379,58638,5900,0,0,62,62,0,1,0,1,0
7380,58638,5900,0,0,62,62,0,1,0,1,0
7381,58638,5900,0,0,62,62,0,1,0,1,0
7382,58638,5900,0,0,62,62,0,1,0,1,0
7383,58638,5900,0,0,62,62,0,1,0,1,0
7384,58638,5900,0,0,62,62,0,1,0,1,0
7385,58638,5900,0,0,62,62,0,1,0,1,0
7386,58638,5900,0,0,62,62,0,1,0,1,0
7387,58638,5900,0,0,62,62,0,1,0,1,0
7388,58638,5900,0,0,62,62,0,1,0,1,0
7389,58638,5900,0,0,62,62,0,1,0,1,0
7390,58638,5900,0,0,62,62,0,1,0,1,0
7391,58638,5900,0,0,62,62,0,1,0,1,0
7392,58638,5900,0,0,62,62,0,1,0,1,0
7393,58638,5900,0,0,62,62,0,1,0,1,0
7394,58638,5900,0,0,62,62,0,1,0,1,0
7395,58638,5900,0,0,62,62,0,1,0,1,0
7396,58638,5900,0,0,62,62,0,1,0,1,0
7397,58638,5900,0,0,62,62,0,1,0,1,0
7398,58638,5900,0,0,62,62,0,1,0,1,0
7399,58638,5900,0,0,62,62,0,1,0,1,0
7400,58638,5900,0,0,62,62,0,1,0,1,0
7401,58638,5900,0,0,62,62,0,1,0,1,0
7402,58638,5900,0,0,62,62,0,1,0,1,0
7403,58638,5900,0,0,62,62,0,1,0,1,0
7404,58638,5900,0,0,62,62,0,1,0,1,0
7405,58638,5900,0,0,62,62,0,1,0,1,0
7406,58638,5900,0,0,62,62,0,1,0,1,0
7407,58638,5900,0,0,62,62,0,1,0,1,0
7408,58638,5900,0,0,62,62,0,1,0,1,0
7409,58638,5900,0,0,62,62,0,1,0,1,0
7410,58638,5900,0,0,62,62,0,1,0,1,0
7411,58638,5900,0,0,62,62,0,1,0,1,0
7412,58638,5900,0,0,62,62,0,1,0,1,0
7413,58638,5900,0,0,62,62,0,1,0,1,0
7414,58638,5900,0,0,62,62,0,1,0,1,0
7415,58638,5900,0,0,62,62,0,1,0,1,0
7416,58638,5900,0,0,62,62,0,1,0,1,0
7417,58638,5900,0,0,62,62,0,1,0,1,0
7418,58638,5900,0,0,62,62,0,1,0,1,0
7419,58638,5900,0,0,62,62,0,1,0,1,0
7420,58638,5900,0,0,62,62,0,1,0,1,0
7421,58638,5900,0,0,62,62,0,1,0,1,0
7422,58638,5900,0,0,62,62,0,1,0,1,0
7423,58638,5900,0,0,62,62,0,1,0,1,0
7424,58638,5900,0,0,62,62,0,1,0,1,0
7425,58638,5900,0,0,62,62,0,1,0,1,0
7426,58638,5900,0,0,62,62,0,1,0,1,0
7427,58638,5900,0,0,62,62,0,1,0,1,0
7428,58638,5900,0,0,62,62,0,1,0,1,0
7429,58638,5900,0,0,62,62,0,1,0,1,0
7430,58638,5900,0,0,62,62,0,1,0,1,0
7431,58638,5900,0,0,62,62,0,1,0,1,0
7432,58638,5900,0,0,62,62,0,1,0,1,0
7433,58638,5900,0,0,62,62,0,1,0,1,0
7434,58638,5900,0,0,62,62,0,1,0,1,0
7435,58638,5900,0,0,62,62,0,1,0,1,0
7436,58638,5900,0,0,62,62,0,1,0,1,0
7437,58638,5900,0,0,62,62,0,1,0,1,0
7438,58638,5900,0,0,62,62,0,1,0,1,0
7439,58638,5900,0,0,62,62,0,1,0,1,0
7440,58638,5900,0,0,62,62,0,1,0,1,0
7441,58638,5900,0,0,62,62,0,1,0,1,0
7442,58638,5900,0,0,62,62,0,1,0,1,0
7443,58638,5900,0,0,62,62,0,1,0,1,0
7444,58638,5900,0,0,62,62,0,1,0,1,0
7445,58638,5900,0,0,62,62,0,1,0,1,0
7446,58638,5900,0,0,62,62,0,1,0,1,0
7447,58638,5900,0,0,62,62,0,1,0,1,0
7448,58638,5900,0,0,62,62,0,1,0,1,0
7449,58638,5900,0,0,62,62,0,1,0,1,0
7450,58638,5900,0,0,62,62,0,1,0,1,0
7451,58638,5900,0,0,62,62,0,1,0,1,0
7452,58638,5900,0,0,62,62,0,1,0,1,0
7453,58638,5900,0,0,62,62,0,1,0,1,0
7454,58638,5900,0,0,62,62,0,1,0,1,0
7455,58638,5900,0,0,62,62,0,1,0,1,0
7456,58638,5900,0,0,62,62,0,1,0,1,0
7457,58638,5900,0,0,62,62,0,1,0,1,0
7458,58638,5900,0,0,62,62,0,1,0,1,0
7459,58638,5900,0,0,62,62,0,1,0,1,0
7460,58638,5900,0,0,62,62,0,1,0,1,0
7461,58638,5900,0,0,62,62,0,1,0,1,0
7462,58638,5900,0,0,62,62,0,1,0,1,0
7463,58638,5900,0,0,62,62,0,1,0,1,0
7464,58638,5900,0,0,62,62,0,1,0,1,0
7465,58638,5900,0,0,62,62,0,1,0,1,0
7466,58638,5900,0,0,62,62,0,1,0,1,0
7467,58638,5900,0,0,62,62,0,1,0,1,0
7468,58638,5900,0,0,62,62,0,1,0,1,0
7469,58638,5900,0,0,62,62,0,1,0,1,0
7470,58638,5900,0,0,62,62,0,1,0,1,0
7471,51993,25174,0,0,66,66,0,1,0,1,0
7472,58638,5900,0,0,62,62,0,1,0,1,0
7473,58638,5900,0,0,62,62,0,1,0,1,0
7474,58638,5900,0,0,62,62,0,1,0,1,0
7475,58638,5900,0,0,62,62,0,1,0,1,0
7476,58638,5900,0,0,62,62,0,1,0,1,0
7477,58638,5900,0,0,62,62,0,1,0,1,0
7478,58638,5900,0,0,62,62,0,1,0,1,0
7479,58638,5900,0,0,62,62,0,1,0,1,0
7480,58638,5900,0,0,62,62,0,1,0,1,0
7481,58638,5900,0,0,62,62,0,1,0,1,0
7482,58638,5900,0,0,62,62,0,1,0,1,0
7483,58638,5900,0,0,62,62,0,1,0,1,0
7484,58638,5900,0,0,62,62,0,1,0,1,0
7485,58638,5900,0,0,62,62,0,1,0,1,0
7486,58638,5900,0,0,62,62,0,1,0,1,0
7487,58638,5900,0,0,62,62,0,1,0,1,0
7488,58638,5900,0,0,62,62,0,1,0,1,0
7489,58638,5900,0,0,62,62,0,1,0,1,0
7490,58638,5900,0,0,62,62,0,1,0,1,0
7491,58638,5900,0,0,62,62,0,1,0,1,0
7492,58638,5900,0,0,62,62,0,1,0,1,0
7493,57928,30188,0,0,62,62,0,1,0,1,0
7494,443,54507,0,0,82,82,0,1,0,1,0
7495,6881,26171,65454,26171,219,118,101,2,1199,1,1
7496,60493,55172,57169,55172,320,140,180,6,7,3,3
7497,56345,443,39296,443,39990,1989,38001,50,147,17,33
7498,53332,80,59740,80,9094,5469,3625,22,166,12,10
7499,54796,443,9714,443,6668,1926,4742,20,15,11,9
7500,41056,443,45681,443,8185,1381,6804,22,831,11,11
7501,39293,443,5290,443,70,70,0,1,4,1,0
7502,55048,80,23955,80,3084,1646,1438,19,131,10,9
7503,57835,53,49650,53,308,118,190,2,29,1,1
7504,57700,53,7203,53,308,118,190,2,29,1,1
7505,58459,53,37044,53,307,86,221,2,29,1,1
7506,56038,53,40238,53,177,94,83,2,29,1,1
7507,55047,53,41022,53,308,94,214,2,29,1,1
7508,52599,53,38138,53,338,94,244,2,29,1,1
7509,65226,443,51904,443,35968,13816,22152,77,96,34,43
7510,64945,53,47640,53,292,126,166,2,29,1,1
7511,55936,53,21289,53,177,94,83,2,30,1,1
7512,49658,53,2388,53,195,102,93,2,30,1,1
7513,50241,53,25762,53,728,102,626,2,30,1,1
7514,56334,53,34646,53,177,94,83,2,30,1,1
7515,9480,443,14084,443,6100,777,5323,17,25,9,8
7516,45032,53,45032,53,216,82,134,2,33,1,1
7517,57665,53,28556,53,168,78,90,2,30,1,1
7518,41785,443,3150,443,13183,1682,11501,26,78,12,14
7519,50377,53,9572,53,167,78,89,2,30,1,1
7520,35817,443,2802,443,3120,1862,1258,18,15,11,7
7521,42574,53,42574,53,262,106,156,2,32,1,1
7522,31176,53,31176,53,414,268,146,3,32,2,1
7523,41664,53,40771,53,376,78,298,2,30,1,1
7524,56334,53,19616,53,177,94,83,2,30,1,1
7525,9479,443,13111,443,6100,777,5323,17,25,9,8
7526,56324,53,13523,53,177,94,83,2,30,1,1
7527,52182,53,34693,53,199,94,105,2,30,1,1
7528,56080,443,20631,443,3970,1726,2244,13,135,6,7
7529,59116,53,59116,53,203,82,121,2,30,1,1
7530,62077,443,1621,443,17761,7207,10554,44,46,25,19
7531,9474,443,14729,443,6100,777,5323,17,26,9,8
7532,9473,443,29099,443,6100,777,5323,17,26,9,8
7533,38555,443,24882,443,40928,36006,4922,59,16,34,25
7534,58369,53,2783,53,167,78,89,2,30,1,1
7535,50378,53,37644,53,167,78,89,2,30,1,1
7536,49454,53,42230,53,248,118,130,2,30,1,1
7537,56324,53,52043,53,177,94,83,2,30,1,1
7538,46461,53,27823,53,199,94,105,2,30,1,1
7539,57837,443,41125,443,17236,1691,15545,19,146,5,14
7540,38728,53,38728,53,414,268,146,3,33,2,1
7541,40865,8100,52976,8100,78,78,0,1,5,1,0
7542,9475,443,36657,443,4063,969,3094,16,26,9,7
7543,55710,63545,52051,63545,504,318,186,8,15,5,3
7544,33641,443,2360,443,15017,6951,8066,49,20,25,24
7545,65126,53,19594,53,216,94,122,2,30,1,1
7546,49634,53,7065,53,257,102,155,2,30,1,1
7547,58368,53,61007,53,167,78,89,2,30,1,1
7548,55074,443,36824,443,3143,2172,971,19,25,9,10
7549,55066,80,57629,80,2554,1742,812,15,77,8,7
7550,39995,443,36730,443,4160,2228,1932,25,159,13,12
7551,60416,443,11714,443,4953,1111,3842,22,104,12,10
7552,53831,443,42938,443,190,70,120,4,15,2,2
7553,60406,80,16333,80,1370,704,666,23,105,12,11
7554,43477,443,38784,443,20739,7254,13485,97,734,44,53
7555,58057,80,11789,80,2708,1386,1322,23,75,12,11
7556,52002,80,36032,80,546,300,246,10,24,6,4
7557,54957,53,30594,53,197,102,95,2,33,1,1
7558,54036,443,30085,443,43295,8391,34904,66,49,32,34
7559,53909,20545,63910,20545,612,366,246,10,19,6,4
7560,41786,443,30860,443,174542,9281,165261,227,78,104,123
7561,48372,8100,12918,8100,78,78,0,1,5,1,0
7562,56751,80,54705,80,1462,703,759,8,16,5,3
7563,9476,443,21369,443,3999,905,3094,15,26,8,7
7564,64282,53,55682,53,215,94,121,2,30,1,1
7565,65453,53,23093,53,311,94,217,2,30,1,1
7566,51103,5223,3221,5223,4968,1304,3664,26,1190,13,13
7567,60369,443,60379,443,7939,955,6984,22,107,11,11
7568,55936,53,1988,53,177,94,83,2,29,1,1
7569,40657,443,5933,443,9869,2395,7474,36,129,20,16
7570,49757,53,24825,53,212,94,118,2,29,1,1
7571,55817,53,47066,53,177,94,83,2,30,1,1
7572,50677,80,32544,80,3664,1440,2224,12,20,6,6
7573,56582,53,17999,53,196,102,94,2,32,1,1
7574,58366,53,25101,53,167,78,89,2,30,1,1
7575,60488,27615,38598,27615,70,70,0,1,5,1,0
7576,60485,13314,55482,13314,70,70,0,1,5,1,0
7577,58367,53,2848,53,167,78,89,2,30,1,1
7578,56038,53,12140,53,177,94,83,2,30,1,1
7579,44577,53,21603,53,199,94,105,2,30,1,1
7580,22114,4789,50813,4789,70,70,0,1,30,1,0
7581,58365,53,51432,53,260,86,174,2,30,1,1
7582,57464,53,0,0,86,86,0,1,30,1,0
7583,59183,53,39038,53,260,86,174,2,30,1,1
7584,57470,1,59410,1,132,132,0,3,1199,3,0
7585,64059,80,17237,80,374,192,182,7,15,4,3
7586,60415,443,32364,443,7727,2796,4931,36,104,18,18
7587,65517,443,57866,443,92117,4799,87318,107,15,43,64
7588,64432,53,45233,53,482,188,294,6,44,3,3
7589,46225,53,7961,53,199,94,105,2,30,1,1
7590,46912,53,4234,53,168,78,90,2,30,1,1
7591,51115,80,32483,80,1426,930,496,10,22,7,3
7592,59328,80,59328,80,24437,12718,11719,41,15,16,25
7593,64381,53,35709,53,168,86,82,2,32,1,1
7594,51804,53,51804,53,247,98,149,2,33,1,1
7595,49071,443,20590,443,130,70,60,3,5,2,1
7596,56752,80,35742,80,1462,703,759,8,16,5,3
7597,62076,443,11320,443,7370,2873,4497,23,47,13,10
7598,57075,53,34299,53,212,102,110,2,30,1,1
7599,60817,443,60817,443,1320,685,635,14,180,7,7
7600,50156,443,23478,443,6666,1682,4984,28,1157,15,13
7601,27114,53,27114,53,414,268,146,3,33,2,1
7602,64994,53,18089,53,216,102,114,2,30,1,1
7603,54533,443,7224,443,2638,330,2308,12,135,5,7
7604,49789,53,40494,53,177,94,83,2,30,1,1
7605,64690,53,18350,53,338,110,228,2,30,1,1
7606,56887,53,19033,53,177,94,83,2,31,1,1
7607,43732,443,60967,443,5719,1339,4380,19,361,9,10
7608,8941,443,25184,443,541643,15245,526398,507,416,103,404
7609,52196,25336,19782,25336,316,136,180,6,6,3,3
7610,52152,58114,56068,58114,70,70,0,1,5,1,0
7611,49573,443,10413,443,1326,876,450,11,55,6,5
7612,49674,443,19357,443,5917,1570,4347,20,53,10,10
7613,49578,443,49511,443,6947,833,6114,20,54,9,11
7614,49574,443,40939,443,16191,13348,2843,30,55,17,13
7615,3764,9694,0,0,66,66,0,1,0,1,0
7616,16862,21247,0,0,62,62,0,1,0,1,0
7617,58638,5900,0,0,62,62,0,1,0,1,0
7618,58638,5900,0,0,62,62,0,1,0,1,0
7619,58638,5900,0,0,62,62,0,1,0,1,0
7620,58638,5900,0,0,62,62,0,1,0,1,0
7621,49557,443,57017,443,38022,18448,19574,53,57,27,26
7622,63427,443,12602,443,15135,12791,2344,43,81,22,21
7623,62080,443,19549,443,2902,1562,1340,22,46,12,10
7624,55936,53,60791,53,177,94,83,2,30,1,1
7625,49227,53,48621,53,718,94,624,2,30,1,1
7626,49641,443,54383,443,5776,1079,4697,15,53,8,7
7627,50489,443,45489,443,1268,638,630,12,17,7,5
7628,49639,443,62054,443,5776,1079,4697,15,53,8,7
7629,52201,44054,14407,44054,70,70,0,1,5,1,0
7630,52150,37603,63249,37603,70,70,0,1,5,1,0
7631,49595,80,13926,80,1285,772,513,11,53,6,5
7632,64985,53,50795,53,412,97,315,4,58,2,2
7633,58638,5900,0,0,62,62,0,1,0,1,0
7634,58638,5900,0,0,62,62,0,1,0,1,0
7635,58638,5900,0,0,62,62,0,1,0,1,0
7636,58638,5900,0,0,62,62,0,1,0,1,0
7637,58638,5900,0,0,62,62,0,1,0,1,0
7638,58638,5900,0,0,62,62,0,1,0,1,0
7639,58638,5900,0,0,62,62,0,1,0,1,0
7640,58638,5900,0,0,62,62,0,1,0,1,0
7641,58638,5900,0,0,62,62,0,1,0,1,0
7642,58638,5900,0,0,62,62,0,1,0,1,0
7643,58638,5900,0,0,62,62,0,1,0,1,0
7644,58638,5900,0,0,62,62,0,1,0,1,0
7645,58638,5900,0,0,62,62,0,1,0,1,0
7646,58638,5900,0,0,62,62,0,1,0,1,0
7647,58638,5900,0,0,62,62,0,1,0,1,0
7648,58638,5900,0,0,62,62,0,1,0,1,0
7649,58638,5900,0,0,62,62,0,1,0,1,0
7650,58638,5900,0,0,62,62,0,1,0,1,0
7651,58638,5900,0,0,62,62,0,1,0,1,0
7652,58638,5900,0,0,62,62,0,1,0,1,0
7653,58638,5900,0,0,62,62,0,1,0,1,0
7654,58638,5900,0,0,62,62,0,1,0,1,0
7655,58638,5900,0,0,62,62,0,1,0,1,0
7656,58638,5900,0,0,62,62,0,1,0,1,0
7657,58638,5900,0,0,62,62,0,1,0,1,0
7658,58638,5900,0,0,62,62,0,1,0,1,0
7659,58638,5900,0,0,62,62,0,1,0,1,0
7660,58638,5900,0,0,62,62,0,1,0,1,0
7661,58638,5900,0,0,62,62,0,1,0,1,0
7662,58638,5900,0,0,62,62,0,1,0,1,0
7663,58638,5900,0,0,62,62,0,1,0,1,0
7664,58638,5900,0,0,62,62,0,1,0,1,0
7665,58638,5900,0,0,62,62,0,1,0,1,0
7666,58638,5900,0,0,62,62,0,1,0,1,0
7667,58638,5900,0,0,62,62,0,1,0,1,0
7668,58638,5900,0,0,62,62,0,1,0,1,0
7669,58638,5900,0,0,62,62,0,1,0,1,0
7670,58638,5900,0,0,62,62,0,1,0,1,0
7671,58638,5900,0,0,62,62,0,1,0,1,0
7672,58638,5900,0,0,62,62,0,1,0,1,0
7673,58638,5900,0,0,62,62,0,1,0,1,0
7674,58638,5900,0,0,62,62,0,1,0,1,0
7675,58638,5900,0,0,62,62,0,1,0,1,0
7676,58638,5900,0,0,62,62,0,1,0,1,0
7677,58638,5900,0,0,62,62,0,1,0,1,0
7678,58638,5900,0,0,62,62,0,1,0,1,0
7679,58638,5900,0,0,62,62,0,1,0,1,0
7680,58638,5900,0,0,62,62,0,1,0,1,0
7681,58638,5900,0,0,62,62,0,1,0,1,0
7682,58638,5900,0,0,62,62,0,1,0,1,0
7683,58638,5900,0,0,62,62,0,1,0,1,0
7684,58638,5900,0,0,62,62,0,1,0,1,0
7685,58638,5900,0,0,62,62,0,1,0,1,0
7686,58638,5900,0,0,62,62,0,1,0,1,0
7687,58638,5900,0,0,62,62,0,1,0,1,0
7688,58638,5900,0,0,62,62,0,1,0,1,0
7689,58638,5900,0,0,62,62,0,1,0,1,0
7690,58638,5900,0,0,62,62,0,1,0,1,0
7691,58638,5900,0,0,62,62,0,1,0,1,0
7692,58638,5900,0,0,62,62,0,1,0,1,0
7693,58638,5900,0,0,62,62,0,1,0,1,0
7694,58638,5900,0,0,62,62,0,1,0,1,0
7695,58638,5900,0,0,62,62,0,1,0,1,0
7696,58638,5900,0,0,62,62,0,1,0,1,0
7697,58638,5900,0,0,62,62,0,1,0,1,0
7698,58638,5900,0,0,62,62,0,1,0,1,0
7699,58638,5900,0,0,62,62,0,1,0,1,0
7700,58638,5900,0,0,62,62,0,1,0,1,0
7701,58638,5900,0,0,62,62,0,1,0,1,0
7702,58638,5900,0,0,62,62,0,1,0,1,0
7703,58638,5900,0,0,62,62,0,1,0,1,0
7704,58638,5900,0,0,62,62,0,1,0,1,0
7705,58638,5900,0,0,62,62,0,1,0,1,0
7706,58638,5900,0,0,62,62,0,1,0,1,0
7707,58638,5900,0,0,62,62,0,1,0,1,0
7708,58638,5900,0,0,62,62,0,1,0,1,0
7709,58638,5900,0,0,62,62,0,1,0,1,0
7710,58638,5900,0,0,62,62,0,1,0,1,0
7711,58638,5900,0,0,62,62,0,1,0,1,0
7712,58638,5900,0,0,62,62,0,1,0,1,0
7713,58638,5900,0,0,62,62,0,1,0,1,0
7714,58638,5900,0,0,62,62,0,1,0,1,0
7715,58638,5900,0,0,62,62,0,1,0,1,0
7716,58638,5900,0,0,62,62,0,1,0,1,0
7717,58638,5900,0,0,62,62,0,1,0,1,0
7718,58638,5900,0,0,62,62,0,1,0,1,0
7719,58638,5900,0,0,62,62,0,1,0,1,0
7720,58638,5900,0,0,62,62,0,1,0,1,0
7721,58638,5900,0,0,62,62,0,1,0,1,0
7722,58638,5900,0,0,62,62,0,1,0,1,0
7723,58638,5900,0,0,62,62,0,1,0,1,0
7724,58638,5900,0,0,62,62,0,1,0,1,0
7725,58638,5900,0,0,62,62,0,1,0,1,0
7726,49847,23,0,0,60,60,0,1,0,1,0
7727,58638,5900,0,0,62,62,0,1,0,1,0
7728,58638,5900,0,0,62,62,0,1,0,1,0
7729,58638,5900,0,0,62,62,0,1,0,1,0
7730,49314,445,0,0,66,66,0,1,0,1,0
7731,49312,445,0,0,66,66,0,1,0,1,0
7732,49311,445,0,0,66,66,0,1,0,1,0
7733,58638,5900,0,0,62,62,0,1,0,1,0
7734,58638,5900,0,0,62,62,0,1,0,1,0
7735,58638,5900,0,0,62,62,0,1,0,1,0
7736,58638,5900,0,0,62,62,0,1,0,1,0
7737,58638,5900,0,0,62,62,0,1,0,1,0
7738,58638,5900,0,0,62,62,0,1,0,1,0
7739,58638,5900,0,0,62,62,0,1,0,1,0
7740,58638,5900,0,0,62,62,0,1,0,1,0
7741,58638,5900,0,0,62,62,0,1,0,1,0
7742,58638,5900,0,0,62,62,0,1,0,1,0
7743,58638,5900,0,0,62,62,0,1,0,1,0
7744,58638,5900,0,0,62,62,0,1,0,1,0
7745,58638,5900,0,0,62,62,0,1,0,1,0
7746,58638,5900,0,0,62,62,0,1,0,1,0
7747,58638,5900,0,0,62,62,0,1,0,1,0
7748,58638,5900,0,0,62,62,0,1,0,1,0
7749,58638,5900,0,0,62,62,0,1,0,1,0
7750,58638,5900,0,0,62,62,0,1,0,1,0
7751,58638,5900,0,0,62,62,0,1,0,1,0
7752,58638,5900,0,0,62,62,0,1,0,1,0
7753,58638,5900,0,0,62,62,0,1,0,1,0
7754,58638,5900,0,0,62,62,0,1,0,1,0
7755,58638,5900,0,0,62,62,0,1,0,1,0
7756,58638,5900,0,0,62,62,0,1,0,1,0
7757,58638,5900,0,0,62,62,0,1,0,1,0
7758,58638,5900,0,0,62,62,0,1,0,1,0
7759,58638,5900,0,0,62,62,0,1,0,1,0
7760,58638,5900,0,0,62,62,0,1,0,1,0
7761,58638,5900,0,0,62,62,0,1,0,1,0
7762,58638,5900,0,0,62,62,0,1,0,1,0
7763,58638,5900,0,0,62,62,0,1,0,1,0
7764,58638,5900,0,0,62,62,0,1,0,1,0
7765,58638,5900,0,0,62,62,0,1,0,1,0
7766,58638,5900,0,0,62,62,0,1,0,1,0
7767,58638,5900,0,0,62,62,0,1,0,1,0
7768,58638,5900,0,0,62,62,0,1,0,1,0
7769,58638,5900,0,0,62,62,0,1,0,1,0
7770,58638,5900,0,0,62,62,0,1,0,1,0
7771,58638,5900,0,0,62,62,0,1,0,1,0
7772,58638,5900,0,0,62,62,0,1,0,1,0
7773,58638,5900,0,0,62,62,0,1,0,1,0
7774,58638,5900,0,0,62,62,0,1,0,1,0
7775,58638,5900,0,0,62,62,0,1,0,1,0
7776,58638,5900,0,0,62,62,0,1,0,1,0
7777,58638,5900,0,0,62,62,0,1,0,1,0
7778,58638,5900,0,0,62,62,0,1,0,1,0
7779,58638,5900,0,0,62,62,0,1,0,1,0
7780,58638,5900,0,0,62,62,0,1,0,1,0
7781,58638,5900,0,0,62,62,0,1,0,1,0
7782,58638,5900,0,0,62,62,0,1,0,1,0
7783,58638,5900,0,0,62,62,0,1,0,1,0
7784,58638,5900,0,0,62,62,0,1,0,1,0
7785,58638,5900,0,0,62,62,0,1,0,1,0
7786,58638,5900,0,0,62,62,0,1,0,1,0
7787,58638,5900,0,0,62,62,0,1,0,1,0
7788,58638,5900,0,0,62,62,0,1,0,1,0
7789,58638,5900,0,0,62,62,0,1,0,1,0
7790,58638,5900,0,0,62,62,0,1,0,1,0
7791,58638,5900,0,0,62,62,0,1,0,1,0
7792,58638,5900,0,0,62,62,0,1,0,1,0
7793,58638,5900,0,0,62,62,0,1,0,1,0
7794,58638,5900,0,0,62,62,0,1,0,1,0
7795,58638,5900,0,0,62,62,0,1,0,1,0
7796,58638,5900,0,0,62,62,0,1,0,1,0
7797,58638,5900,0,0,62,62,0,1,0,1,0
7798,58638,5900,0,0,62,62,0,1,0,1,0
7799,58638,5900,0,0,62,62,0,1,0,1,0
7800,58638,5900,0,0,62,62,0,1,0,1,0
7801,58638,5900,0,0,62,62,0,1,0,1,0
7802,58638,5900,0,0,62,62,0,1,0,1,0
7803,58638,5900,0,0,62,62,0,1,0,1,0
7804,58638,5900,0,0,62,62,0,1,0,1,0
7805,58638,5900,0,0,62,62,0,1,0,1,0
7806,58638,5900,0,0,62,62,0,1,0,1,0
7807,58638,5900,0,0,62,62,0,1,0,1,0
7808,58638,5900,0,0,62,62,0,1,0,1,0
7809,58638,5900,0,0,62,62,0,1,0,1,0
7810,58638,5900,0,0,62,62,0,1,0,1,0
7811,58638,5900,0,0,62,62,0,1,0,1,0
7812,58638,5900,0,0,62,62,0,1,0,1,0
7813,58638,5900,0,0,62,62,0,1,0,1,0
7814,58638,5900,0,0,62,62,0,1,0,1,0
7815,58638,5900,0,0,62,62,0,1,0,1,0
7816,58638,5900,0,0,62,62,0,1,0,1,0
7817,58638,5900,0,0,62,62,0,1,0,1,0
7818,58638,5900,0,0,62,62,0,1,0,1,0
7819,58638,5900,0,0,62,62,0,1,0,1,0
7820,58638,5900,0,0,62,62,0,1,0,1,0
7821,58638,5900,0,0,62,62,0,1,0,1,0
7822,58638,5900,0,0,62,62,0,1,0,1,0
7823,58638,5900,0,0,62,62,0,1,0,1,0
7824,58638,5900,0,0,62,62,0,1,0,1,0
7825,58638,5900,0,0,62,62,0,1,0,1,0
7826,58638,5900,0,0,62,62,0,1,0,1,0
7827,58638,5900,0,0,62,62,0,1,0,1,0
7828,58638,5900,0,0,62,62,0,1,0,1,0
7829,58638,5900,0,0,62,62,0,1,0,1,0
7830,58638,5900,0,0,62,62,0,1,0,1,0
7831,58638,5900,0,0,62,62,0,1,0,1,0
7832,58638,5900,0,0,62,62,0,1,0,1,0
7833,58638,5900,0,0,62,62,0,1,0,1,0
7834,58638,5900,0,0,62,62,0,1,0,1,0
7835,58638,5900,0,0,62,62,0,1,0,1,0
7836,58638,5900,0,0,62,62,0,1,0,1,0
7837,58638,5900,0,0,62,62,0,1,0,1,0
7838,58638,5900,0,0,62,62,0,1,0,1,0
7839,58638,5900,0,0,62,62,0,1,0,1,0
7840,58638,5900,0,0,62,62,0,1,0,1,0
7841,58638,5900,0,0,62,62,0,1,0,1,0
7842,58638,5900,0,0,62,62,0,1,0,1,0
7843,58638,5900,0,0,62,62,0,1,0,1,0
7844,58638,5900,0,0,62,62,0,1,0,1,0
7845,58638,5900,0,0,62,62,0,1,0,1,0
7846,58638,5900,0,0,62,62,0,1,0,1,0
7847,58638,5900,0,0,62,62,0,1,0,1,0
7848,58638,5900,0,0,62,62,0,1,0,1,0
7849,58638,5900,0,0,62,62,0,1,0,1,0
7850,58638,5900,0,0,62,62,0,1,0,1,0
7851,58638,5900,0,0,62,62,0,1,0,1,0
7852,58638,5900,0,0,62,62,0,1,0,1,0
7853,58638,5900,0,0,62,62,0,1,0,1,0
7854,58638,5900,0,0,62,62,0,1,0,1,0
7855,58638,5900,0,0,62,62,0,1,0,1,0
7856,58638,5900,0,0,62,62,0,1,0,1,0
7857,58638,5900,0,0,62,62,0,1,0,1,0
7858,58638,5900,0,0,62,62,0,1,0,1,0
7859,58638,5900,0,0,62,62,0,1,0,1,0
7860,58638,5900,0,0,62,62,0,1,0,1,0
7861,58638,5900,0,0,62,62,0,1,0,1,0
7862,58638,5900,0,0,62,62,0,1,0,1,0
7863,58638,5900,0,0,62,62,0,1,0,1,0
7864,58638,5900,0,0,62,62,0,1,0,1,0
7865,58638,5900,0,0,62,62,0,1,0,1,0
7866,58638,5900,0,0,62,62,0,1,0,1,0
7867,58638,5900,0,0,62,62,0,1,0,1,0
7868,58638,5900,0,0,62,62,0,1,0,1,0
7869,58638,5900,0,0,62,62,0,1,0,1,0
7870,58638,5900,0,0,62,62,0,1,0,1,0
7871,58638,5900,0,0,62,62,0,1,0,1,0
7872,58638,5900,0,0,62,62,0,1,0,1,0
7873,58638,5900,0,0,62,62,0,1,0,1,0
7874,58638,5900,0,0,62,62,0,1,0,1,0
7875,58638,5900,0,0,62,62,0,1,0,1,0
7876,58638,5900,0,0,62,62,0,1,0,1,0
7877,58638,5900,0,0,62,62,0,1,0,1,0
7878,58638,5900,0,0,62,62,0,1,0,1,0
7879,58638,5900,0,0,62,62,0,1,0,1,0
7880,58638,5900,0,0,62,62,0,1,0,1,0
7881,58638,5900,0,0,62,62,0,1,0,1,0
7882,58638,5900,0,0,62,62,0,1,0,1,0
7883,58638,5900,0,0,62,62,0,1,0,1,0
7884,58638,5900,0,0,62,62,0,1,0,1,0
7885,58638,5900,0,0,62,62,0,1,0,1,0
7886,58638,5900,0,0,62,62,0,1,0,1,0
7887,58638,5900,0,0,62,62,0,1,0,1,0
7888,58638,5900,0,0,62,62,0,1,0,1,0
7889,58638,5900,0,0,62,62,0,1,0,1,0
7890,58638,5900,0,0,62,62,0,1,0,1,0
7891,58638,5900,0,0,62,62,0,1,0,1,0
7892,58638,5900,0,0,62,62,0,1,0,1,0
7893,58638,5900,0,0,62,62,0,1,0,1,0
7894,58638,5900,0,0,62,62,0,1,0,1,0
7895,58638,5900,0,0,62,62,0,1,0,1,0
7896,58638,5900,0,0,62,62,0,1,0,1,0
7897,58638,5900,0,0,62,62,0,1,0,1,0
7898,58638,5900,0,0,62,62,0,1,0,1,0
7899,58638,5900,0,0,62,62,0,1,0,1,0
7900,58638,5900,0,0,62,62,0,1,0,1,0
7901,58638,5900,0,0,62,62,0,1,0,1,0
7902,58638,5900,0,0,62,62,0,1,0,1,0
7903,14656,36237,0,0,66,66,0,1,0,1,0
7904,64363,22114,0,0,62,62,0,1,0,1,0
7905,52236,25174,0,0,66,66,0,1,0,1,0
7906,60899,25174,0,0,62,62,0,1,0,1,0
7907,49197,445,0,0,70,70,0,1,0,1,0
7908,58638,5900,0,0,62,62,0,1,0,1,0
7909,58638,5900,0,0,62,62,0,1,0,1,0
7910,58638,5900,0,0,62,62,0,1,0,1,0
7911,58638,5900,0,0,62,62,0,1,0,1,0
7912,58638,5900,0,0,62,62,0,1,0,1,0
7913,58638,5900,0,0,62,62,0,1,0,1,0
7914,58638,5900,0,0,62,62,0,1,0,1,0
7915,58638,5900,0,0,62,62,0,1,0,1,0
7916,58638,5900,0,0,62,62,0,1,0,1,0
7917,58638,5900,0,0,62,62,0,1,0,1,0
7918,58638,5900,0,0,62,62,0,1,0,1,0
7919,58638,5900,0,0,62,62,0,1,0,1,0
7920,58638,5900,0,0,62,62,0,1,0,1,0
7921,58638,5900,0,0,62,62,0,1,0,1,0
7922,58638,5900,0,0,62,62,0,1,0,1,0
7923,58638,5900,0,0,62,62,0,1,0,1,0
7924,58638,5900,0,0,62,62,0,1,0,1,0
7925,58638,5900,0,0,62,62,0,1,0,1,0
7926,43888,64147,0,0,62,62,0,1,0,1,0
7927,58638,5900,0,0,62,62,0,1,0,1,0
7928,58638,5900,0,0,62,62,0,1,0,1,0
7929,56528,64147,0,0,62,62,0,1,0,1,0
7930,49195,445,0,0,70,70,0,1,0,1,0
7931,62642,25174,0,0,66,66,0,1,0,1,0
7932,14333,51050,0,0,62,62,0,1,0,1,0
7933,53911,445,0,0,70,70,0,1,0,1,0
7934,39063,44847,0,0,66,66,0,1,0,1,0
7935,28649,43890,0,0,62,62,0,1,0,1,0
7936,53910,445,0,0,70,70,0,1,0,1,0
7937,53902,445,0,0,70,70,0,1,0,1,0
7938,53901,445,0,0,70,70,0,1,0,1,0
7939,33948,50432,0,0,146,146,0,1,0,1,0
7940,31066,57470,0,0,74,74,0,1,0,1,0
7941,443,44138,0,0,60,60,0,1,0,1,0
7942,49194,445,0,0,70,70,0,1,0,1,0
7943,57236,53733,0,0,66,66,0,1,0,1,0
7944,49193,445,0,0,70,70,0,1,0,1,0
7945,52944,23,0,0,60,60,0,1,0,1,0
7946,55155,2767,0,0,62,62,0,1,0,1,0
7947,49192,445,0,0,70,70,0,1,0,1,0
7948,23512,57354,0,0,145,145,0,1,0,1,0
7949,11136,19910,0,0,62,62,0,1,0,1,0
7950,49189,445,0,0,70,70,0,1,0,1,0
7951,49190,445,0,0,70,70,0,1,0,1,0
7952,8194,21247,0,0,62,62,0,1,0,1,0
7953,1280,25174,0,0,62,62,0,1,0,1,0
7954,22263,30188,0,0,66,66,0,1,0,1,0
7955,59436,22114,0,0,62,62,0,1,0,1,0
7956,49172,445,0,0,70,70,0,1,0,1,0
7957,49171,445,0,0,70,70,0,1,0,1,0
7958,49169,445,0,0,70,70,0,1,0,1,0
7959,23079,9694,0,0,62,62,0,1,0,1,0
7960,49160,445,0,0,70,70,0,1,0,1,0
7961,49161,445,0,0,70,70,0,1,0,1,0
7962,53892,445,0,0,70,70,0,1,0,1,0
7963,53889,445,0,0,70,70,0,1,0,1,0
7964,53887,445,0,0,70,70,0,1,0,1,0
7965,58435,64631,0,0,74,74,0,1,0,1,0
7966,1660,8696,0,0,62,62,0,1,0,1,0
7967,47561,26467,0,0,62,62,0,1,0,1,0
7968,37008,42707,0,0,62,62,0,1,0,1,0
7969,49300,445,0,0,66,66,0,1,0,1,0
7970,18173,25174,0,0,66,66,0,1,0,1,0
7971,65529,445,0,0,70,70,0,1,0,1,0
7972,49607,25174,0,0,66,66,0,1,0,1,0
7973,7686,25174,0,0,62,62,0,1,0,1,0
7974,58148,43890,0,0,66,66,0,1,0,1,0
7975,53193,22,53193,22,295,126,169,4,0,2,2
7976,53886,445,0,0,70,70,0,1,0,1,0
7977,36419,50584,0,0,62,62,0,1,0,1,0
7978,36629,23117,0,0,62,62,0,1,0,1,0
7979,1117,37965,0,0,62,62,0,1,0,1,0
7980,53884,445,0,0,70,70,0,1,0,1,0
7981,53579,42707,0,0,66,66,0,1,0,1,0
7982,57585,51221,0,0,62,62,0,1,0,1,0
7983,17004,64147,0,0,66,66,0,1,0,1,0
7984,40301,8696,0,0,60,60,0,1,0,1,0
7985,1955,35974,0,0,60,60,0,1,0,1,0
7986,17842,22114,0,0,62,62,0,1,0,1,0
7987,5912,22114,0,0,62,62,0,1,0,1,0
7988,49283,445,0,0,66,66,0,1,0,1,0
7989,49286,445,0,0,66,66,0,1,0,1,0
7990,2049,32480,0,0,62,62,0,1,0,1,0
7991,59048,57470,0,0,66,66,0,1,0,1,0
7992,24351,57470,0,0,62,62,0,1,0,1,0
7993,65525,445,0,0,70,70,0,1,0,1,0
7994,25328,23,0,0,60,60,0,1,0,1,0
7995,50169,25174,0,0,62,62,0,1,0,1,0
7996,49182,21247,0,0,66,66,0,1,0,1,0
7997,8080,37965,0,0,62,62,0,1,0,1,0
7998,4748,64147,0,0,62,62,0,1,0,1,0
7999,53874,445,0,0,70,70,0,1,0,1,0
8000,53867,445,0,0,70,70,0,1,0,1,0
8001,53866,445,0,0,70,70,0,1,0,1,0
8002,53864,445,0,0,70,70,0,1,0,1,0
8003,52518,35440,0,0,66,66,0,1,0,1,0
8004,24931,25174,0,0,62,62,0,1,0,1,0
8005,54598,37965,0,0,66,66,0,1,0,1,0
8006,65516,445,0,0,70,70,0,1,0,1,0
8007,65513,445,0,0,70,70,0,1,0,1,0
8008,65514,445,0,0,70,70,0,1,0,1,0
8009,61948,48817,0,0,145,145,0,1,0,1,0
8010,64461,31652,0,0,62,62,0,1,0,1,0
8011,65511,445,0,0,70,70,0,1,0,1,0
8012,45908,3383,0,0,60,60,0,1,0,1,0
8013,65508,445,0,0,70,70,0,1,0,1,0
8014,49281,445,0,0,66,66,0,1,0,1,0
8015,52969,44847,0,0,66,66,0,1,0,1,0
8016,49272,445,0,0,66,66,0,1,0,1,0
8017,49274,445,0,0,66,66,0,1,0,1,0
8018,49264,445,0,0,66,66,0,1,0,1,0
8019,49269,445,0,0,66,66,0,1,0,1,0
8020,49271,445,0,0,66,66,0,1,0,1,0
8021,49267,445,0,0,66,66,0,1,0,1,0
8022,49263,445,0,0,66,66,0,1,0,1,0
8023,10380,5223,0,0,148,148,0,1,0,1,0
8024,55985,44847,0,0,146,146,0,1,0,1,0
8025,53860,445,0,0,70,70,0,1,0,1,0
8026,53856,445,0,0,70,70,0,1,0,1,0
8027,53854,445,0,0,70,70,0,1,0,1,0
8028,53852,445,0,0,70,70,0,1,0,1,0
8029,2864,25174,0,0,66,66,0,1,0,1,0
8030,65503,445,0,0,70,70,0,1,0,1,0
8031,21179,44847,0,0,62,62,0,1,0,1,0
8032,13285,29892,0,0,145,145,0,1,0,1,0
8033,7342,22114,0,0,66,66,0,1,0,1,0
8034,23843,26467,0,0,62,62,0,1,0,1,0
8035,50990,23884,0,0,66,66,0,1,0,1,0
8036,35589,25174,0,0,66,66,0,1,0,1,0
8037,65495,445,0,0,70,70,0,1,0,1,0
8038,65493,445,0,0,70,70,0,1,0,1,0
8039,53850,445,0,0,70,70,0,1,0,1,0
8040,53845,445,0,0,70,70,0,1,0,1,0
8041,53844,445,0,0,70,70,0,1,0,1,0
8042,49256,445,0,0,66,66,0,1,0,1,0
8043,53843,445,0,0,70,70,0,1,0,1,0
8044,63867,35993,0,0,66,66,0,1,0,1,0
8045,49254,445,0,0,66,66,0,1,0,1,0
8046,62902,32468,0,0,66,66,0,1,0,1,0
8047,38565,51505,0,0,62,62,0,1,0,1,0
8048,49252,445,0,0,66,66,0,1,0,1,0
8049,49250,445,0,0,66,66,0,1,0,1,0
8050,443,4205,0,0,320,320,0,1,0,1,0
8051,65489,445,0,0,70,70,0,1,0,1,0
8052,12290,22114,0,0,66,66,0,1,0,1,0
8053,49248,445,0,0,66,66,0,1,0,1,0
8054,65487,445,0,0,70,70,0,1,0,1,0
8055,28583,22114,0,0,146,146,0,1,0,1,0
8056,54277,22114,0,0,62,62,0,1,0,1,0
8057,65483,445,0,0,70,70,0,1,0,1,0
8058,53836,445,0,0,70,70,0,1,0,1,0
8059,53830,445,0,0,70,70,0,1,0,1,0
8060,53827,445,0,0,70,70,0,1,0,1,0
8061,65482,445,0,0,70,70,0,1,0,1,0
8062,55586,23,0,0,60,60,0,1,0,1,0
8063,60527,35440,0,0,66,66,0,1,0,1,0
8064,9731,64147,0,0,62,62,0,1,0,1,0
8065,30270,37965,0,0,66,66,0,1,0,1,0
8066,14023,37965,0,0,62,62,0,1,0,1,0
8067,18574,56205,0,0,66,66,0,1,0,1,0
8068,49336,25174,0,0,62,62,0,1,0,1,0
8069,56887,53,57938,53,170,87,83,2,30,1,1
8070,36215,443,40898,443,3554,2208,1346,18,256,10,8
8071,64231,443,45459,443,2227,1018,1209,17,16,8,9
8072,49452,443,8798,443,16012,6573,9439,43,175,20,23
8073,49353,443,32645,443,7030,1195,5835,20,76,10,10
8074,49349,80,16332,80,2391,532,1859,11,76,6,5
8075,50269,443,40163,443,7543,2533,5010,26,55,14,12
8076,14667,80,14667,80,3197,2167,1030,17,72,10,7
8077,55376,53,17927,53,711,87,624,2,30,1,1
8078,43576,80,43576,80,44566,6675,37891,58,23,27,31
8079,64385,443,64385,443,18895,2061,16834,34,18,18,16
8080,49385,443,8821,443,16316,7445,8871,49,237,23,26
8081,55660,443,55660,443,51312,5706,45606,77,48,38,39
8082,57093,53,32863,53,711,87,624,2,30,1,1
8083,57888,443,62185,443,9802,5628,4174,56,225,29,27
8084,49351,443,50580,443,11389,1184,10205,22,76,9,13
8085,61614,53,61614,53,257,101,156,2,33,1,1
8086,39223,80,40485,80,1052,612,440,10,15,5,5
8087,64376,443,64376,443,4592,1685,2907,19,29,11,8
8088,65462,53,18628,53,98,98,0,1,30,1,0
8089,54627,80,54627,80,12385,1831,10554,20,20,9,11
8090,50584,49001,53256,49001,480,150,330,2,1200,1,1
8091,57598,80,57598,80,40484,2008,38476,47,145,17,30
8092,57594,80,57594,80,110070,5374,104696,112,156,36,76
8093,55659,443,55659,443,25716,7632,18084,52,48,31,21
8094,52147,30265,61743,30265,66,66,0,1,5,1,0
8095,60143,443,49806,443,16448,5420,11028,47,319,23,24
8096,1230,3389,1230,3389,3910,1805,2105,20,19,12,8
8097,49196,53,19330,53,91,91,0,1,30,1,0
8098,55646,443,13625,443,11771,2624,9147,50,19,25,25
8099,64095,53,19951,53,170,87,83,2,30,1,1
8100,55602,53,61633,53,711,87,624,2,30,1,1
8101,57288,53,40155,53,170,87,83,2,30,1,1
8102,49661,443,62284,443,6950,2484,4466,20,53,11,9
8103,55054,443,36646,443,7993,677,7316,16,15,8,8
8104,36336,443,11755,443,8111,5060,3051,31,396,11,20
8105,38369,15000,42954,15000,130,70,60,2,6,1,1
8106,52184,57262,18616,57262,70,70,0,2,8,2,0
8107,55127,53,18845,53,253,87,166,4,44,2,2
8108,52151,30692,49782,30692,66,66,0,1,5,1,0
8109,2001,80,2001,80,1535,652,883,9,16,5,4
8110,49352,443,51520,443,10055,1184,8871,21,76,9,12
8111,37997,80,37997,80,3581,2902,679,13,23,8,5
8112,55456,53,57964,53,711,87,624,2,30,1,1
8113,56658,53,1646,53,170,87,83,2,30,1,1
8114,56945,53,29864,53,711,87,624,2,30,1,1
8115,55097,53,65390,53,170,87,83,2,31,1,1
8116,30960,45761,37537,45761,462,462,0,8,3632,8,0
8117,57170,3389,57170,3389,3413,1458,1955,16,19,8,8
8118,49481,53,49481,53,222,101,121,2,31,1,1
8119,55820,60038,0,0,66,66,0,1,91,1,0
8120,57052,53,52166,53,170,87,83,2,31,1,1
8121,30960,45760,12069,45760,462,462,0,8,3632,8,0
8122,53191,443,21271,443,7694,3364,4330,21,123,11,10
8123,55833,53,54382,53,170,87,83,2,31,1,1
8124,65477,445,0,0,70,70,0,1,0,1,0
8125,58399,56205,0,0,66,66,0,1,0,1,0
8126,41719,50584,0,0,146,146,0,1,0,1,0
8127,57578,51221,0,0,62,62,0,1,0,1,0
8128,443,54507,0,0,82,82,0,1,0,1,0
8129,49230,445,0,0,66,66,0,1,0,1,0
8130,23873,30188,0,0,66,66,0,1,0,1,0
8131,53815,445,0,0,70,70,0,1,0,1,0
8132,58608,62413,0,0,62,62,0,1,0,1,0
8133,34166,50584,0,0,146,146,0,1,0,1,0
8134,23844,26467,0,0,62,62,0,1,0,1,0
8135,57484,30317,0,0,66,66,0,1,0,1,0
8136,44265,80,44265,80,22407,7251,15156,35,23,16,19
8137,28040,443,50475,443,5578,1390,4188,19,15,9,10
8138,26054,80,26054,80,1798,540,1258,10,15,6,4
8139,34408,443,19414,443,9649,3714,5935,47,340,24,23
8140,56658,53,51855,53,177,94,83,2,30,1,1
8141,44812,443,17089,443,6152,420,5732,13,120,6,7
8142,57600,80,57600,80,3164,815,2349,12,144,6,6
8143,53918,24300,60964,24300,1735,975,760,11,16,7,4
8144,49559,443,14886,443,1332,876,456,11,56,6,5
8145,57444,443,3253,443,9581,3281,6300,36,16,16,20
8146,60033,443,2482,443,4223,2828,1395,23,28,13,10
8147,53214,443,52186,443,526,156,370,8,14,3,5
8148,64117,53,35902,53,350,94,256,2,29,1,1
8149,53227,53,11040,53,78,78,0,1,29,1,0
8150,56031,53,65070,53,177,94,83,2,30,1,1
8151,41688,443,15969,443,626036,38764,587272,713,191,245,468
8152,49302,443,38802,443,9232,3149,6083,55,40,31,24
8153,49214,80,50752,80,2734,1498,1236,21,262,11,10
8154,53164,443,44686,443,38442,16213,22229,67,46,30,37
8155,57599,80,57599,80,60244,2829,57415,65,144,22,43
8156,60513,443,14543,443,9456,1987,7469,28,30,15,13
8157,57597,80,57597,80,80556,2669,77887,84,144,28,56
8158,49638,443,58989,443,5776,1079,4697,15,52,8,7
8159,51123,443,33422,443,6625,1673,4952,20,20,10,10
8160,49587,443,57871,443,5879,870,5009,18,53,9,9
8161,49481,80,30554,80,11436,5021,6415,38,126,20,18
8162,49364,443,4324,443,5141,896,4245,17,69,8,9
8163,60804,40010,37467,40010,316,136,180,6,5,3,3
8164,56611,53,59791,53,181,94,87,2,31,1,1
8165,44984,80,44984,80,7061,2943,4118,16,23,9,7
8166,49989,53,19506,53,301,85,216,4,53,2,2
8167,49658,53,46008,53,195,102,93,2,29,1,1
8168,55695,53,3075,53,177,94,83,2,29,1,1
8169,50412,80,26565,80,1524,341,1183,11,36,4,7
8170,62082,443,37456,443,2826,1618,1208,21,45,12,9
8171,49572,443,30462,443,7538,4953,2585,21,54,12,9
8172,49577,443,34979,443,6947,833,6114,20,53,9,11
8173,49670,443,18797,443,16957,6203,10754,30,52,14,16
8174,49994,53,33575,53,86,86,0,1,29,1,0
8175,38710,443,50238,443,89931,3417,86514,94,15,30,64
8176,56658,53,42222,53,177,94,83,2,29,1,1
8177,1936,80,29393,80,214,140,74,4,15,3,1
8178,65254,53,46437,53,459,94,365,4,45,2,2
8179,56668,53,61814,53,177,94,83,2,29,1,1
8180,64095,53,40106,53,177,94,83,2,30,1,1
8181,55695,53,64745,53,177,94,83,2,29,1,1
8182,57288,53,46993,53,177,94,83,2,30,1,1
8183,55541,53,64093,53,177,94,83,2,30,1,1
8184,21133,33447,47731,33447,481,150,331,2,1199,1,1
8185,49100,80,49100,80,3568,2889,679,13,23,8,5
8186,43228,443,18463,443,1527,940,587,14,22,8,6
8187,52174,43106,42661,43106,258,70,188,4,9,2,2
8188,52149,52188,10170,52188,70,70,0,1,5,1,0
8189,55127,53,39994,53,253,87,166,4,43,2,2
8190,57288,53,13037,53,177,94,83,2,30,1,1
8191,49303,443,12405,443,10844,5117,5727,42,17,25,17
8192,51118,80,35500,80,366,240,126,7,21,5,2
8193,50272,53,50516,53,168,78,90,2,30,1,1
8194,53079,80,59311,80,2424,1110,1314,11,78,7,4
8195,53921,18183,42637,18183,826,386,440,12,15,6,6
8196,49304,443,13306,443,12436,7656,4780,41,17,23,18
8197,52148,29104,16660,29104,70,70,0,1,5,1,0
8198,57375,443,64184,443,130,70,60,2,15,1,1
8199,55658,443,55658,443,26504,10384,16120,58,48,37,21
8200,37662,443,57596,443,4428,2241,2187,19,46,11,8
8201,54260,443,6069,443,5904,1876,4028,18,18,10,8
8202,64973,53,14211,53,210,102,108,2,30,1,1
8203,49633,53,37557,53,210,102,108,2,30,1,1
8204,49346,443,65391,443,7292,950,6342,19,75,9,10
8205,56678,443,37527,443,4099,2450,1649,36,2615,19,17
8206,64784,53,13638,53,226,102,124,2,30,1,1
8207,57052,53,26525,53,177,94,83,2,30,1,1
8208,65225,443,9124,443,3350,2037,1313,25,95,14,11
8209,64095,53,56290,53,177,94,83,2,30,1,1
8210,57316,53,12512,53,177,94,83,2,30,1,1
8211,57316,53,3738,53,177,94,83,2,30,1,1
8212,50276,53,20646,53,94,94,0,1,30,1,0
8213,57288,53,40505,53,177,94,83,2,30,1,1
8214,55541,53,4475,53,177,94,83,2,30,1,1
8215,50418,443,31085,443,4507,744,3763,17,29,7,10
8216,44307,443,62796,443,92044,19483,72561,147,186,55,92
8217,55295,3389,55295,3389,4365,2581,1784,20,33,11,9
8218,50643,80,56301,80,5660,3544,2116,17,47,10,7
8219,38139,443,10441,443,49386,4604,44782,82,32,43,39
8220,62081,443,56055,443,3044,1694,1350,23,45,13,10
8221,38113,443,46610,443,2849678,105912,2743766,3255,124,1284,1971
8222,49479,80,63239,80,9192,4788,4404,30,126,17,13
8223,49579,443,1881,443,6629,827,5802,19,53,9,10
8224,43897,443,6897,443,6259,1816,4443,30,2615,16,14
8225,50486,443,7512,443,1043,556,487,10,16,6,4
8226,62073,443,32648,443,9559,3243,6316,28,46,16,12
8227,55600,443,16865,443,11891,2141,9750,40,231,19,21
8228,62075,443,48853,443,9318,3002,6316,28,46,16,12
8229,57596,80,57596,80,64768,3074,61694,72,145,26,46
8230,49586,443,54181,443,5879,870,5009,18,53,9,9
8231,49636,443,48846,443,6158,1149,5009,17,52,9,8
8232,49657,443,3247,443,6181,833,5348,19,52,9,10
8233,49588,443,55419,443,5879,870,5009,18,53,9,9
8234,49656,443,39036,443,6006,763,5243,17,52,8,9
8235,52910,53,52910,53,414,268,146,3,32,2,1
8236,55966,443,29704,443,214312,69934,144378,612,671,303,309
8237,52185,13269,32926,13269,70,70,0,2,7,2,0
8238,26253,53,26253,53,414,268,146,3,33,2,1
8239,52182,60769,63523,60769,70,70,0,2,8,2,0
8240,52200,42430,1127,42430,70,70,0,1,5,1,0
8241,52202,64241,11975,64241,164,70,94,2,4,1,1
8242,52199,35549,6211,35549,70,70,0,1,5,1,0
8243,49347,443,42711,443,8309,949,7360,19,75,9,10
8244,52198,12727,17212,12727,70,70,0,1,5,1,0
8245,51974,443,46910,443,17456,7877,9579,47,49,24,23
8246,51135,80,18450,80,254,128,126,5,15,3,2
8247,51120,80,28128,80,366,240,126,7,21,5,2
8248,43218,443,34506,443,2683108,71922,2611186,2467,150,623,1844
8249,65303,53,28109,53,94,94,0,1,29,1,0
8250,38066,443,48945,443,328599,275779,52820,868,342,483,385
8251,49931,53,22854,53,594,196,398,6,82,3,3
8252,65068,53,6356,53,336,111,225,4,29,2,2
8253,56668,53,54886,53,177,94,83,2,29,1,1
8254,64036,53,37626,53,692,224,468,6,49,3,3
8255,64095,53,63030,53,177,94,83,2,29,1,1
8256,56334,53,1244,53,177,94,83,2,29,1,1
8257,18657,53,18657,53,295,90,205,2,29,1,1
8258,49434,53,25380,53,183,86,97,2,29,1,1
8259,56658,53,20785,53,177,94,83,2,29,1,1
8260,56031,53,4995,53,177,94,83,2,29,1,1
8261,49789,53,65450,53,177,94,83,2,30,1,1
8262,59829,443,54560,443,948180,35714,912466,1121,119,378,743
8263,59683,443,7689,443,16524,4274,12250,35,133,15,20
8264,65221,53,28071,53,196,86,110,2,30,1,1
8265,65221,53,13826,53,168,86,82,2,30,1,1
8266,57052,53,38641,53,177,94,83,2,30,1,1
8267,61686,53,52741,53,196,86,110,2,30,1,1
8268,9068,443,2083,443,5045,2005,3040,14,119,7,7
8269,41906,80,41906,80,127215,3221,123994,137,3685,42,95
8270,50012,53,43824,53,94,94,0,1,30,1,0
8271,60340,443,5002,443,6844,2441,4403,19,181,9,10
8272,52090,80,61372,80,2774,703,2071,12,22,7,5
8273,43226,443,42884,443,1583877,43930,1539947,1405,93,297,1108
8274,49300,443,11326,443,10704,4094,6610,52,47,29,23
8275,56887,53,35999,53,177,94,83,2,30,1,1
8276,56172,53,39320,53,216,102,114,2,30,1,1
8277,55026,443,35367,443,17336,5332,12004,33,121,18,15
8278,44847,6892,1040,6892,279,161,118,3,1200,2,1
8279,30188,14038,49780,14038,502,150,352,2,1200,1,1
8280,47929,80,47929,80,11976,6928,5048,25,24,14,11
8281,53958,80,11138,80,130,70,60,2,15,1,1
8282,52183,13503,62699,13503,70,70,0,2,8,2,0
8283,51700,80,43241,80,30853,2456,28397,48,78,25,23
8284,39980,443,41321,443,130,70,60,2,15,1,1
8285,45418,443,36338,443,137754,15176,122578,229,99,106,123
8286,55127,53,60626,53,253,87,166,4,44,2,2
8287,52091,80,64640,80,2825,716,2109,12,22,7,5
8288,62072,443,3018,443,6095,1965,4130,26,46,15,11
8289,38065,443,63801,443,911697,74083,837614,1247,343,459,788
8290,40392,443,64453,443,8105,2278,5827,27,196,15,12
8291,49424,53,36639,53,210,102,108,2,30,1,1
8292,56887,53,63111,53,177,94,83,2,30,1,1
8293,49609,53,45961,53,177,94,83,2,31,1,1
8294,49469,53,17330,53,718,94,624,2,30,1,1
8295,65448,53,13119,53,209,110,99,2,30,1,1
8296,58320,53,15987,53,331,86,245,2,30,1,1
8297,55189,53,54191,53,211,102,109,2,30,1,1
8298,55677,53,59623,53,177,94,83,2,30,1,1
8299,57052,53,21671,53,177,94,83,2,30,1,1
8300,56291,53,26927,53,177,94,83,2,31,1,1
8301,57673,53,25100,53,273,94,179,2,30,1,1
8302,60812,443,60812,443,2871,1671,1200,17,179,9,8
8303,56375,53,31585,53,177,94,83,2,31,1,1
8304,53202,443,37949,443,6043,1568,4475,11,120,4,7
8305,56394,443,33249,443,12371,1344,11027,30,3944,10,20
8306,64106,53,22227,53,309,102,207,4,53,2,2
8307,49414,443,32360,443,11485,3381,8104,39,124,23,16
8308,49410,443,22106,443,87590,6597,80993,129,125,48,81
8309,55127,53,49558,53,253,87,166,4,44,2,2
8310,45440,25,45440,25,7679,1922,5757,34,17,15,19
8311,52179,14354,64270,14354,70,70,0,2,8,2,0
8312,53941,53739,11665,53739,70,70,0,2,8,2,0
8313,52146,18174,63624,18174,70,70,0,1,5,1,0
8314,52933,443,60920,443,5582,1388,4194,19,15,9,10
8315,52088,80,52684,80,3442,1728,1714,15,21,9,6
8316,44943,443,56912,443,16225,2078,14147,38,42,19,19
8317,55929,80,55929,80,450,246,204,8,29,5,3
8318,43886,5223,33165,5223,3721,1173,2548,18,257,11,7
8319,28039,443,43641,443,5576,1388,4188,19,15,9,10
8320,38647,443,52794,443,15266,12916,2350,42,81,24,18
8321,46683,443,34091,443,416,210,206,7,28,4,3
8322,55926,80,55926,80,450,246,204,8,29,5,3
8323,55927,80,55927,80,450,246,204,8,29,5,3
8324,52932,443,34898,443,20789,4927,15862,35,31,20,15
8325,64622,36829,0,0,66,66,0,1,0,1,0
8326,21704,16933,0,0,62,62,0,1,0,1,0
8327,40787,57470,0,0,62,62,0,1,0,1,0
8328,49227,445,0,0,66,66,0,1,0,1,0
8329,60389,16933,0,0,66,66,0,1,0,1,0
8330,49220,445,0,0,66,66,0,1,0,1,0
8331,1053,2310,0,0,148,148,0,1,0,1,0
8332,12348,50265,0,0,62,62,0,1,0,1,0
8333,65464,445,0,0,70,70,0,1,0,1,0
8334,49216,445,0,0,66,66,0,1,0,1,0
8335,64723,56205,0,0,62,62,0,1,0,1,0
8336,56388,22114,0,0,66,66,0,1,0,1,0
8337,64949,44847,0,0,66,66,0,1,0,1,0
8338,65461,445,0,0,70,70,0,1,0,1,0
8339,1377,44847,0,0,146,146,0,1,0,1,0
8340,62149,22114,0,0,66,66,0,1,0,1,0
8341,18725,35440,0,0,62,62,0,1,0,1,0
8342,18725,35440,0,0,146,146,0,1,0,1,0
8343,52026,26467,0,0,60,60,0,1,0,1,0
8344,54633,36237,0,0,66,66,0,1,0,1,0
8345,42094,35440,0,0,62,62,0,1,0,1,0
8346,60571,26467,0,0,62,62,0,1,0,1,0
8347,53806,445,0,0,70,70,0,1,0,1,0
8348,53804,445,0,0,70,70,0,1,0,1,0
8349,53803,445,0,0,70,70,0,1,0,1,0
8350,49204,445,0,0,66,66,0,1,0,1,0
8351,49198,445,0,0,66,66,0,1,0,1,0
8352,49199,445,0,0,66,66,0,1,0,1,0
8353,49201,445,0,0,66,66,0,1,0,1,0
8354,49203,445,0,0,66,66,0,1,0,1,0
8355,49202,445,0,0,66,66,0,1,0,1,0
8356,49200,445,0,0,66,66,0,1,0,1,0
8357,49196,445,0,0,66,66,0,1,0,1,0
8358,65456,445,0,0,70,70,0,1,0,1,0
8359,49938,57470,0,0,66,66,0,1,0,1,0
8360,65455,445,0,0,70,70,0,1,0,1,0
8361,62348,50584,0,0,66,66,0,1,0,1,0
8362,51754,18375,0,0,62,62,0,1,0,1,0
8363,2525,23,0,0,60,60,0,1,0,1,0
8364,65453,445,0,0,70,70,0,1,0,1,0
8365,11585,56205,0,0,66,66,0,1,0,1,0
8366,50488,22114,0,0,66,66,0,1,0,1,0
8367,57677,57470,0,0,62,62,0,1,0,1,0
8368,55406,25174,0,0,62,62,0,1,0,1,0
8369,49196,25174,0,0,66,66,0,1,0,1,0
8370,1369,48817,0,0,145,145,0,1,0,1,0
8371,53800,445,0,0,70,70,0,1,0,1,0
8372,53801,445,0,0,70,70,0,1,0,1,0
8373,53799,445,0,0,70,70,0,1,0,1,0
8374,53794,445,0,0,70,70,0,1,0,1,0
8375,55620,30188,0,0,66,66,0,1,0,1,0
8376,4752,30188,0,0,62,62,0,1,0,1,0
8377,47125,8055,0,0,159,159,0,1,0,1,0
8378,64989,50265,0,0,66,66,0,1,0,1,0
8379,32796,37965,0,0,66,66,0,1,0,1,0
8380,32679,37965,0,0,62,62,0,1,0,1,0
8381,49184,445,0,0,66,66,0,1,0,1,0
8382,49182,445,0,0,66,66,0,1,0,1,0
8383,49183,445,0,0,66,66,0,1,0,1,0
8384,65446,445,0,0,70,70,0,1,0,1,0
8385,39941,2767,0,0,62,62,0,1,0,1,0
8386,65444,445,0,0,70,70,0,1,0,1,0
8387,36881,56205,0,0,62,62,0,1,0,1,0
8388,49393,30188,0,0,62,62,0,1,0,1,0
8389,65443,445,0,0,70,70,0,1,0,1,0
8390,53783,445,0,0,70,70,0,1,0,1,0
8391,65442,445,0,0,70,70,0,1,0,1,0
8392,65441,445,0,0,70,70,0,1,0,1,0
8393,53781,445,0,0,70,70,0,1,0,1,0
8394,53777,445,0,0,70,70,0,1,0,1,0
8395,53776,445,0,0,70,70,0,1,0,1,0
8396,443,54507,0,0,82,82,0,1,0,1,0
8397,65439,445,0,0,70,70,0,1,0,1,0
8398,65438,445,0,0,70,70,0,1,0,1,0
8399,51046,25174,0,0,66,66,0,1,0,1,0
8400,48478,49903,0,0,62,62,0,1,0,1,0
8401,16979,56205,0,0,66,66,0,1,0,1,0
8402,29177,44847,0,0,66,66,0,1,0,1,0
8403,58751,51221,0,0,62,62,0,1,0,1,0
8404,443,14591,0,0,131,131,0,1,0,1,0
8405,61711,35440,0,0,66,66,0,1,0,1,0
8406,443,4205,0,0,320,320,0,1,0,1,0
8407,61784,49903,0,0,66,66,0,1,0,1,0
8408,59326,57470,0,0,74,74,0,1,0,1,0
8409,53927,443,24116,443,495,421,74,4,0,3,1
8410,53923,443,32187,443,499,425,74,4,0,3,1
8411,2238,22114,0,0,62,62,0,1,0,1,0
8412,65423,445,0,0,70,70,0,1,0,1,0
8413,65422,445,0,0,70,70,0,1,0,1,0
8414,65418,445,0,0,70,70,0,1,0,1,0
8415,22350,25174,0,0,66,66,0,1,0,1,0
8416,65413,445,0,0,70,70,0,1,0,1,0
8417,65412,445,0,0,70,70,0,1,0,1,0
8418,56719,37807,0,0,66,66,0,1,0,1,0
8419,61911,15503,0,0,146,146,0,1,0,1,0
8420,43747,22114,0,0,66,66,0,1,0,1,0
8421,53764,445,0,0,70,70,0,1,0,1,0
8422,53761,445,0,0,70,70,0,1,0,1,0
8423,53759,445,0,0,70,70,0,1,0,1,0
8424,40301,8696,0,0,60,60,0,1,0,1,0
8425,1955,35974,0,0,60,60,0,1,0,1,0
8426,52596,17372,0,0,66,66,0,1,0,1,0
8427,45941,23386,0,0,60,60,0,1,0,1,0
8428,49172,445,0,0,66,66,0,1,0,1,0
8429,24376,50584,0,0,66,66,0,1,0,1,0
8430,34360,25174,0,0,66,66,0,1,0,1,0
8431,58118,22114,0,0,66,66,0,1,0,1,0
8432,65401,445,0,0,70,70,0,1,0,1,0
8433,6832,51505,0,0,62,62,0,1,0,1,0
8434,31660,35440,0,0,66,66,0,1,0,1,0
8435,64811,51221,0,0,66,66,0,1,0,1,0
8436,42453,17,0,0,60,60,0,1,0,1,0
8437,443,54507,0,0,82,82,0,1,0,1,0
8438,53758,445,0,0,70,70,0,1,0,1,0
8439,53757,445,0,0,70,70,0,1,0,1,0
8440,15333,60043,0,0,62,62,0,1,0,1,0
8441,11692,25174,0,0,66,66,0,1,0,1,0
8442,62400,35993,0,0,62,62,0,1,0,1,0
8443,61911,3855,0,0,146,146,0,1,0,1,0
8444,65397,445,0,0,70,70,0,1,0,1,0
8445,55893,45711,0,0,78,78,0,1,0,1,0
8446,49156,445,0,0,66,66,0,1,0,1,0
8447,65533,445,0,0,66,66,0,1,0,1,0
8448,53071,25174,0,0,66,66,0,1,0,1,0
8449,3524,25174,0,0,62,62,0,1,0,1,0
8450,61898,50584,0,0,66,66,0,1,0,1,0
8451,38629,25174,0,0,66,66,0,1,0,1,0
8452,64334,25174,0,0,66,66,0,1,0,1,0
8453,65388,445,0,0,70,70,0,1,0,1,0
8454,65387,445,0,0,70,70,0,1,0,1,0
8455,65386,445,0,0,70,70,0,1,0,1,0
8456,18577,25174,0,0,62,62,0,1,0,1,0
8457,64923,25174,0,0,66,66,0,1,0,1,0
8458,65382,445,0,0,70,70,0,1,0,1,0
8459,53748,445,0,0,70,70,0,1,0,1,0
8460,53745,445,0,0,70,70,0,1,0,1,0
8461,53746,445,0,0,70,70,0,1,0,1,0
8462,53737,445,0,0,70,70,0,1,0,1,0
8463,60485,22114,0,0,66,66,0,1,0,1,0
8464,65381,445,0,0,70,70,0,1,0,1,0
8465,3765,64147,0,0,66,66,0,1,0,1,0
8466,53844,22114,0,0,66,66,0,1,0,1,0
8467,19068,37965,0,0,62,62,0,1,0,1,0
8468,443,54507,0,0,82,82,0,1,0,1,0
8469,51313,25174,0,0,66,66,0,1,0,1,0
8470,65530,445,0,0,66,66,0,1,0,1,0
8471,0,0,0,0,480,244,236,4,0,2,2
8472,56377,51505,0,0,66,66,0,1,0,1,0
8473,1594,44847,0,0,62,62,0,1,0,1,0
8474,61911,1,0,0,146,146,0,1,0,1,0
8475,65519,445,0,0,66,66,0,1,0,1,0
8476,65522,445,0,0,66,66,0,1,0,1,0
8477,65513,445,0,0,66,66,0,1,0,1,0
8478,65524,445,0,0,66,66,0,1,0,1,0
8479,65521,445,0,0,66,66,0,1,0,1,0
8480,65515,445,0,0,66,66,0,1,0,1,0
8481,65518,445,0,0,66,66,0,1,0,1,0
8482,54043,36237,0,0,66,66,0,1,0,1,0
8483,53730,445,0,0,70,70,0,1,0,1,0
8484,443,4205,0,0,320,320,0,1,0,1,0
8485,20741,64147,0,0,62,62,0,1,0,1,0
8486,51414,50584,0,0,62,62,0,1,0,1,0
8487,65374,445,0,0,70,70,0,1,0,1,0
8488,53728,445,0,0,70,70,0,1,0,1,0
8489,53724,445,0,0,70,70,0,1,0,1,0
8490,53726,445,0,0,70,70,0,1,0,1,0
8491,443,56513,0,0,78,78,0,1,0,1,0
8492,57761,15503,0,0,66,66,0,1,0,1,0
8493,3580,25174,0,0,62,62,0,1,0,1,0
8494,65367,445,0,0,70,70,0,1,0,1,0
8495,32701,23,0,0,60,60,0,1,0,1,0
8496,65365,445,0,0,70,70,0,1,0,1,0
8497,3381,44847,0,0,78,78,0,1,0,1,0
8498,20619,25174,0,0,62,62,0,1,0,1,0
8499,16424,55108,0,0,145,145,0,1,0,1,0
8500,10627,23117,0,0,66,66,0,1,0,1,0
8501,53722,445,0,0,70,70,0,1,0,1,0
8502,53718,445,0,0,70,70,0,1,0,1,0
8503,53717,445,0,0,70,70,0,1,0,1,0
8504,39839,22114,0,0,62,62,0,1,0,1,0
8505,65506,445,0,0,66,66,0,1,0,1,0
8506,53715,445,0,0,70,70,0,1,0,1,0
8507,65360,445,0,0,70,70,0,1,0,1,0
8508,19875,30170,0,0,145,145,0,1,0,1,0
8509,65503,445,0,0,66,66,0,1,0,1,0
8510,10467,25174,0,0,62,62,0,1,0,1,0
8511,443,54507,0,0,82,82,0,1,0,1,0
8512,65359,445,0,0,70,70,0,1,0,1,0
8513,65502,445,0,0,66,66,0,1,0,1,0
8514,65500,445,0,0,66,66,0,1,0,1,0
8515,19579,23,0,0,60,60,0,1,0,1,0
8516,65499,445,0,0,66,66,0,1,0,1,0
8517,12457,57866,0,0,66,66,0,1,0,1,0
8518,54440,26467,0,0,66,66,0,1,0,1,0
8519,8889,2917,0,0,60,60,0,1,0,1,0
8520,65355,445,0,0,70,70,0,1,0,1,0
8521,23519,25174,0,0,62,62,0,1,0,1,0
8522,47612,5228,36863,5228,2880,1648,1232,22,3602,10,12
8523,52961,5228,16793,5228,1410,933,477,11,3600,6,5
8524,56951,53,51481,53,250,86,164,4,31,2,2
8525,49800,53,17712,53,87,87,0,1,30,1,0
8526,52006,443,14012,443,2898,2047,851,19,22,11,8
8527,53932,27258,15001,27258,70,70,0,2,7,2,0
8528,19302,443,26733,443,2227,1018,1209,17,15,8,9
8529,57470,13613,11885,13613,1577,594,983,20,1601,10,10
8530,49609,53,22044,53,170,87,83,2,30,1,1
8531,47039,443,29901,443,2809,1884,925,19,25,11,8
8532,53936,5915,64456,5915,70,70,0,2,7,2,0
8533,62060,443,7381,443,12169,4985,7184,34,52,19,15
8534,34768,443,18480,443,11605,6867,4738,29,256,17,12
8535,55276,53,33496,53,170,87,83,2,31,1,1
8536,55661,443,55661,443,24362,8850,15512,52,47,32,20
8537,49408,443,34465,443,7967,2176,5791,27,125,14,13
8538,54669,80,16041,80,1148,599,549,14,318,7,7
8539,52181,1038,23058,1038,70,70,0,2,8,2,0
8540,48110,443,9219,443,537031,23421,513610,622,43,258,364
8541,2298,53,2298,53,221,83,138,2,32,1,1
8542,27727,53,27727,53,407,261,146,3,32,2,1
8543,57172,3389,57172,3389,3347,1458,1889,15,18,8,7
8544,55277,53,53790,53,701,88,613,2,30,1,1
8545,57880,53,57880,53,231,97,134,2,30,1,1
8546,55967,53,9494,53,701,88,613,2,30,1,1
8547,64381,53,43493,53,168,86,82,2,31,1,1
8548,55375,53,46240,53,711,87,624,2,31,1,1
8549,53912,8999,51602,8999,1869,1009,860,15,18,9,6
8550,60452,443,43264,443,5807,2168,3639,17,135,8,9
8551,46212,443,28562,443,190,70,120,4,15,2,2
8552,50460,443,50460,443,1159,668,491,11,31,6,5
8553,52709,443,18513,443,266282,13744,252538,313,374,128,185
8554,50817,443,46052,443,17161,1619,15542,18,153,4,14
8555,53872,443,4533,443,11541,4181,7360,62,283,27,35
8556,62828,443,62828,443,4604,1697,2907,19,29,11,8
8557,34477,5900,34477,5900,60,60,0,1,5,1,0
8558,35924,443,41677,443,4310,1640,2670,22,159,10,12
8559,56756,53,22443,53,711,87,624,2,30,1,1
8560,59111,443,56216,443,10912,6095,4817,28,17,15,13
8561,61508,443,13468,443,215490,8471,207019,194,45,45,149
8562,61507,443,11095,443,443128,10267,432861,362,45,60,302
8563,50198,443,55477,443,29124,1724,27400,41,160,16,25
8564,59363,443,28293,443,15860,1930,13930,37,195,14,23
8565,50478,80,50478,80,2086,1637,449,10,19,6,4
8566,52173,44632,63328,44632,258,70,188,4,9,2,2
8567,46211,443,37976,443,190,70,120,4,16,2,2
8568,56985,53,26642,53,916,86,830,2,30,1,1
8569,57220,53,51033,53,701,88,613,2,30,1,1
8570,57340,53,41414,53,711,87,624,2,30,1,1
8571,56375,53,7933,53,170,87,83,2,30,1,1
8572,37075,48817,0,0,62,62,0,1,0,1,0
8573,55973,25174,0,0,62,62,0,1,0,1,0
8574,16490,25174,0,0,66,66,0,1,0,1,0
8575,443,4205,0,0,187,187,0,1,0,1,0
8576,12226,37965,0,0,62,62,0,1,0,1,0
8577,53709,445,0,0,70,70,0,1,0,1,0
8578,34932,38608,0,0,62,62,0,1,0,1,0
8579,57557,64147,0,0,66,66,0,1,0,1,0
8580,65354,445,0,0,70,70,0,1,0,1,0
8581,49308,22114,0,0,66,66,0,1,0,1,0
8582,49418,22114,0,0,62,62,0,1,0,1,0
8583,53706,445,0,0,70,70,0,1,0,1,0
8584,53701,445,0,0,70,70,0,1,0,1,0
8585,33948,15503,0,0,146,146,0,1,0,1,0
8586,28064,36237,0,0,62,62,0,1,0,1,0
8587,53838,36829,0,0,66,66,0,1,0,1,0
8588,65487,445,0,0,66,66,0,1,0,1,0
8589,65349,445,0,0,70,70,0,1,0,1,0
8590,57470,13613,29471,13613,1577,594,983,20,1600,10,10
8591,49406,80,42946,80,2074,1309,765,10,124,6,4
8592,50454,80,50454,80,450,246,204,8,33,5,3
8593,53921,443,59413,443,499,425,74,4,0,3,1
8594,53912,443,42597,443,499,425,74,4,0,3,1
8595,53922,443,26654,443,499,425,74,4,0,3,1
8596,53920,443,44819,443,499,425,74,4,0,3,1
8597,53915,443,3997,443,499,425,74,4,0,3,1
8598,53911,443,51915,443,499,425,74,4,0,3,1
8599,53909,443,45501,443,499,425,74,4,0,3,1
8600,53919,443,62398,443,499,425,74,4,0,3,1
8601,53916,443,57375,443,499,425,74,4,0,3,1
8602,53907,443,41234,443,499,425,74,4,0,3,1
8603,53917,443,58017,443,499,425,74,4,0,3,1
8604,53918,443,16862,443,499,425,74,4,0,3,1
8605,53908,443,36300,443,499,425,74,4,0,3,1
8606,53914,443,31627,443,499,425,74,4,0,3,1
8607,53906,443,56748,443,499,425,74,4,0,3,1
8608,53913,443,40081,443,499,425,74,4,0,3,1
8609,53910,443,14287,443,499,425,74,4,0,3,1
8610,53905,443,17585,443,499,425,74,4,0,3,1
8611,443,4205,0,0,187,187,0,1,0,1,0
8612,443,60040,0,0,60,60,0,1,0,1,0
8613,26239,25174,0,0,66,66,0,1,0,1,0
8614,23218,62413,0,0,62,62,0,1,0,1,0
8615,20706,23718,0,0,66,66,0,1,0,1,0
8616,55246,31573,0,0,66,66,0,1,0,1,0
8617,65480,445,0,0,66,66,0,1,0,1,0
8618,35100,11392,0,0,62,62,0,1,0,1,0
8619,53687,445,0,0,70,70,0,1,0,1,0
8620,37308,43890,0,0,62,62,0,1,0,1,0
8621,45944,44847,0,0,62,62,0,1,0,1,0
8622,50198,5529,0,0,148,148,0,1,0,1,0
8623,59032,25174,0,0,66,66,0,1,0,1,0
8624,15018,37965,0,0,62,62,0,1,0,1,0
8625,52026,26467,0,0,60,60,0,1,0,1,0
8626,65478,445,0,0,66,66,0,1,0,1,0
8627,51865,61689,0,0,66,66,0,1,0,1,0
8628,30181,61689,0,0,62,62,0,1,0,1,0
8629,55833,53,8720,53,177,94,83,2,30,1,1
8630,57271,53,1300,53,228,102,126,2,30,1,1
8631,40362,443,26484,443,8229,2091,6138,24,361,12,12
8632,57102,443,24363,443,17207,7111,10096,44,51,23,21
8633,39353,9339,55496,9339,170706,9877,160829,260,46,110,150
8634,49409,443,26346,443,6574,2176,4398,28,124,14,14
8635,37664,443,11325,443,3338,2337,1001,18,45,11,7
8636,52180,20121,52199,20121,70,70,0,2,7,2,0
8637,52934,443,64385,443,5584,1390,4194,19,14,9,10
8638,53167,22083,32129,22083,70,70,0,1,4,1,0
8639,33042,443,44384,443,10328,5341,4987,26,35,13,13
8640,49412,443,12912,443,9266,2595,6671,35,123,18,17
8641,52178,30922,40190,30922,70,70,0,2,7,2,0
8642,55097,53,14648,53,177,94,83,2,29,1,1
8643,33261,443,59567,443,14176,1843,12333,30,201,16,14
8644,55097,53,54198,53,177,94,83,2,29,1,1
8645,50393,80,25546,80,366,180,186,7,26,4,3
8646,56669,443,3032,443,7458,4186,3272,24,102,14,10
8647,50391,80,6997,80,300,180,120,6,26,4,2
8648,57867,27019,27516,27019,468,390,78,5,30,4,1
8649,55276,53,62860,53,177,94,83,2,30,1,1
8650,57350,53,14841,53,177,94,83,2,30,1,1
8651,34147,53,34147,53,227,106,121,2,30,1,1
8652,56273,53,48350,53,197,102,95,2,33,1,1
8653,32228,53,32228,53,228,90,138,2,33,1,1
8654,50395,80,11837,80,487,180,307,6,26,4,2
8655,45717,80,45717,80,2081,1632,449,10,19,6,4
8656,50394,80,50061,80,306,180,126,6,26,4,2
8657,40358,53,40358,53,414,268,146,3,32,2,1
8658,5588,5588,0,0,3498,1872,1626,48,200,24,24
8659,35066,443,6201,443,33823,28233,5590,84,102,47,37
8660,64898,53,64087,53,487,201,286,6,39,3,3
8661,56273,53,58204,53,197,102,95,2,30,1,1
8662,56375,53,41703,53,177,94,83,2,30,1,1
8663,65426,80,28723,80,65980,5156,60824,86,23,39,47
8664,57470,64050,27080,64050,1660,677,983,20,1600,10,10
8665,57408,53,37720,53,195,102,93,2,30,1,1
8666,65469,53,36424,53,308,110,198,2,30,1,1
8667,57350,53,37868,53,177,94,83,2,30,1,1
8668,32914,5222,62781,5222,8702,4668,4034,92,626,50,42
8669,57408,53,13747,53,195,102,93,2,33,1,1
8670,50392,80,28117,80,306,180,126,6,26,4,2
8671,9417,443,16764,443,324745,7830,316915,327,31,112,215
8672,52002,80,8270,80,7480,4670,2810,47,324,30,17
8673,64758,53,44548,53,311,102,209,2,30,1,1
8674,56291,53,26835,53,177,94,83,2,30,1,1
8675,49609,53,44498,53,177,94,83,2,30,1,1
8676,17750,6881,35389,6881,150,150,0,1,1200,1,0
8677,50265,60276,27315,60276,481,150,331,2,1200,1,1
8678,55893,443,18162,443,6176,908,5268,17,15,8,9
8679,43674,80,1697,80,13872,1244,12628,29,19,14,15
8680,52176,17572,27555,17572,70,70,0,2,8,2,0
8681,56066,53,13837,53,184,102,82,2,30,1,1
8682,60851,443,17568,443,36974,3935,33039,56,61,27,29
8683,50396,80,52675,80,487,180,307,6,26,4,2
8684,53933,20801,58007,20801,70,70,0,2,7,2,0
8685,55924,80,55924,80,450,246,204,8,28,5,3
8686,52143,33283,33804,33283,70,70,0,1,5,1,0
8687,55925,80,55925,80,450,246,204,8,28,5,3
8688,47785,443,12110,443,9224,2055,7169,37,41,19,18
8689,42607,443,6741,443,10221,3259,6962,36,120,18,18
8690,49413,443,21606,443,7849,1104,6745,23,123,12,11
8691,55928,80,55928,80,17982,2112,15870,35,28,18,17
8692,51502,443,63032,443,6559,2158,4401,30,17,16,14
8693,49407,80,27843,80,2408,1466,942,10,124,6,4
8694,46684,443,11949,443,26724,2570,24154,52,42,26,26
8695,52175,1101,39473,1101,70,70,0,2,8,2,0
8696,37661,443,23960,443,3226,2225,1001,18,46,11,7
8697,52111,80,49500,80,1582,866,716,11,20,7,4
8698,54101,443,19141,443,4013,2840,1173,23,27,13,10
8699,49415,443,37841,443,9623,3235,6388,33,118,18,15
8700,49411,443,49244,443,17524,2569,14955,38,124,17,21
8701,50453,80,50453,80,450,246,204,8,30,5,3
8702,64798,53,18186,53,177,94,83,2,29,1,1
8703,34661,53,34661,53,414,268,146,3,33,2,1
8704,56795,53,50687,53,177,94,83,2,29,1,1
8705,38759,443,29453,443,8057,2726,5331,27,239,13,14
8706,64798,53,6106,53,177,94,83,2,29,1,1
8707,49960,53,57227,53,198,94,104,2,29,1,1
8708,55677,53,14201,53,177,94,83,2,29,1,1
8709,65329,53,20205,53,278,102,176,2,29,1,1
8710,49215,53,25508,53,214,102,112,2,30,1,1
8711,49954,53,47734,53,228,110,118,2,30,1,1
8712,56795,53,22826,53,177,94,83,2,30,1,1
8713,55833,53,34904,53,177,94,83,2,30,1,1
8714,32813,53,32813,53,414,268,146,3,33,2,1
8715,36079,53,36079,53,235,90,145,2,32,1,1
8716,52144,15208,55499,15208,70,70,0,1,5,1,0
8717,51169,443,52987,443,21686,7655,14031,77,379,40,37
8718,33044,443,11890,443,9695,5259,4436,24,35,12,12
8719,44448,443,36659,443,5960,1651,4309,21,85,12,9
8720,27997,53,0,0,223,86,137,2,30,1,1
8721,33583,443,54351,443,479444,14906,464538,489,62,173,316
8722,55276,53,58176,53,177,94,83,2,30,1,1
8723,48223,5222,8848,5222,14939,1037,13902,35,579,11,24
8724,61631,443,61631,443,4748,1841,2907,19,26,11,8
8725,50390,80,49086,80,360,180,180,7,26,4,3
8726,49301,443,5775,443,6550,1836,4714,25,46,15,10
8727,25849,53,25849,53,404,259,145,3,32,2,1
8728,50485,443,22667,443,6028,2012,4016,25,16,14,11
8729,56066,53,44669,53,196,86,110,2,30,1,1
8730,56375,53,48204,53,177,94,83,2,30,1,1
8731,56573,443,64654,443,16205,6113,10092,36,110,20,16
8732,54360,443,26291,443,12260,3870,8390,52,283,27,25
8733,50389,443,61820,443,306,180,126,6,26,4,2
8734,10371,53,10371,53,404,259,145,3,33,2,1
8735,42630,53,12099,53,168,78,90,2,30,1,1
8736,60222,443,32889,443,12428,5331,7097,47,32,21,26
8737,56476,53,12813,53,94,94,0,1,30,1,0
8738,57163,443,53866,443,4694,2454,2240,14,135,7,7
8739,62323,443,8004,443,6383,2838,3545,17,135,9,8
8740,57631,443,50238,443,16277,3466,12811,46,1801,22,24
8741,52171,63033,49679,63033,70,70,0,2,8,2,0
8742,49722,53,53892,53,873,280,593,8,80,4,4
8743,64053,47783,24062,47783,70,70,0,1,5,1,0
8744,54955,53,60657,53,177,94,83,2,31,1,1
8745,55939,53,41055,53,177,94,83,2,30,1,1
8746,64780,53,37698,53,627,224,403,6,56,3,3
8747,58900,5223,13059,5223,160,86,74,2,6,1,1
8748,61408,443,17703,443,9492,3543,5949,49,117,25,24
8749,60880,443,55222,443,25751,2629,23122,49,49,23,26
8750,55375,53,40220,53,222,102,120,2,30,1,1
8751,55833,53,32426,53,177,94,83,2,30,1,1
8752,34378,443,1903,443,11269403,319214,10950189,11392,382,3773,7619
8753,49246,53,17908,53,177,94,83,2,30,1,1
8754,56143,53,50780,53,177,94,83,2,30,1,1
8755,52231,50934,0,0,62,62,0,1,0,1,0
8756,41914,443,49039,443,466,392,74,4,0,3,1
8757,65336,445,0,0,70,70,0,1,0,1,0
8758,17213,22114,0,0,146,146,0,1,0,1,0
8759,42558,64147,0,0,62,62,0,1,0,1,0
8760,65469,445,0,0,66,66,0,1,0,1,0
8761,50765,22114,0,0,62,62,0,1,0,1,0
8762,65463,445,0,0,66,66,0,1,0,1,0
8763,65333,445,0,0,70,70,0,1,0,1,0
8764,54189,64147,0,0,66,66,0,1,0,1,0
8765,3875,25174,0,0,62,62,0,1,0,1,0
8766,1480,12447,0,0,62,62,0,1,0,1,0
8767,26921,26467,0,0,62,62,0,1,0,1,0
8768,45941,23386,0,0,60,60,0,1,0,1,0
8769,11030,17372,0,0,62,62,0,1,0,1,0
8770,61387,43890,0,0,62,62,0,1,0,1,0
8771,53532,22114,0,0,62,62,0,1,0,1,0
8772,17811,23,0,0,60,60,0,1,0,1,0
8773,59097,2767,0,0,66,66,0,1,0,1,0
8774,65328,445,0,0,70,70,0,1,0,1,0
8775,53678,445,0,0,70,70,0,1,0,1,0
8776,53676,445,0,0,70,70,0,1,0,1,0
8777,53674,445,0,0,70,70,0,1,0,1,0
8778,65327,445,0,0,70,70,0,1,0,1,0
8779,65451,445,0,0,66,66,0,1,0,1,0
8780,65453,445,0,0,66,66,0,1,0,1,0
8781,65448,445,0,0,66,66,0,1,0,1,0
8782,65450,445,0,0,66,66,0,1,0,1,0
8783,65449,445,0,0,66,66,0,1,0,1,0
8784,65452,445,0,0,66,66,0,1,0,1,0
8785,65447,445,0,0,66,66,0,1,0,1,0
8786,43056,11119,0,0,146,146,0,1,0,1,0
8787,65325,445,0,0,70,70,0,1,0,1,0
8788,64727,25174,0,0,66,66,0,1,0,1,0
8789,6889,9074,0,0,143,143,0,1,0,1,0
8790,39380,49903,0,0,146,146,0,1,0,1,0
8791,39380,46783,0,0,146,146,0,1,0,1,0
8792,50311,443,61436,443,466,392,74,4,0,3,1
8793,50326,46824,0,0,66,66,0,1,0,1,0
8794,25889,11446,0,0,62,62,0,1,0,1,0
8795,31003,10511,0,0,145,145,0,1,0,1,0
8796,19270,56448,0,0,78,78,0,1,0,1,0
8797,31619,51221,0,0,62,62,0,1,0,1,0
8798,63690,64147,0,0,66,66,0,1,0,1,0
8799,63469,64147,0,0,62,62,0,1,0,1,0
8800,20487,50584,0,0,66,66,0,1,0,1,0
8801,56604,17372,0,0,66,66,0,1,0,1,0
8802,53672,445,0,0,70,70,0,1,0,1,0
8803,53666,445,0,0,70,70,0,1,0,1,0
8804,53665,445,0,0,70,70,0,1,0,1,0
8805,53661,445,0,0,70,70,0,1,0,1,0
8806,65318,445,0,0,70,70,0,1,0,1,0
8807,32381,50584,0,0,66,66,0,1,0,1,0
8808,53692,44512,0,0,66,66,0,1,0,1,0
8809,65316,445,0,0,70,70,0,1,0,1,0
8810,65435,445,0,0,66,66,0,1,0,1,0
8811,65434,445,0,0,66,66,0,1,0,1,0
8812,65433,445,0,0,66,66,0,1,0,1,0
8813,56219,22114,0,0,66,66,0,1,0,1,0
8814,65315,445,0,0,70,70,0,1,0,1,0
8815,63873,44847,0,0,66,66,0,1,0,1,0
8816,65314,445,0,0,70,70,0,1,0,1,0
8817,65313,445,0,0,70,70,0,1,0,1,0
8818,65216,35440,0,0,66,66,0,1,0,1,0
8819,65308,445,0,0,70,70,0,1,0,1,0
8820,65307,445,0,0,70,70,0,1,0,1,0
8821,53654,445,0,0,70,70,0,1,0,1,0
8822,40301,8696,0,0,60,60,0,1,0,1,0
8823,1955,35974,0,0,60,60,0,1,0,1,0
8824,55439,37965,0,0,66,66,0,1,0,1,0
8825,53646,445,0,0,70,70,0,1,0,1,0
8826,53644,445,0,0,70,70,0,1,0,1,0
8827,53643,445,0,0,70,70,0,1,0,1,0
8828,49788,1433,0,0,60,60,0,1,0,1,0
8829,49788,1433,0,0,60,60,0,1,0,1,0
8830,65295,445,0,0,70,70,0,1,0,1,0
8831,65294,445,0,0,70,70,0,1,0,1,0
8832,65291,445,0,0,70,70,0,1,0,1,0
8833,4015,23117,0,0,62,62,0,1,0,1,0
8834,65285,445,0,0,70,70,0,1,0,1,0
8835,65284,445,0,0,70,70,0,1,0,1,0
8836,56826,22114,0,0,62,62,0,1,0,1,0
8837,39380,1,0,0,146,146,0,1,0,1,0
8838,59782,26467,0,0,62,62,0,1,0,1,0
8839,53637,445,0,0,70,70,0,1,0,1,0
8840,53635,445,0,0,70,70,0,1,0,1,0
8841,53633,445,0,0,70,70,0,1,0,1,0
8842,54007,50265,0,0,66,66,0,1,0,1,0
8843,49929,26467,0,0,62,62,0,1,0,1,0
8844,55893,45711,0,0,78,78,0,1,0,1,0
8845,14869,44847,0,0,62,62,0,1,0,1,0
8846,65421,445,0,0,66,66,0,1,0,1,0
8847,65273,445,0,0,70,70,0,1,0,1,0
8848,1029,44847,0,0,62,62,0,1,0,1,0
8849,59223,17500,0,0,66,66,0,1,0,1,0
8850,61280,26467,0,0,66,66,0,1,0,1,0
8851,59225,57587,0,0,66,66,0,1,0,1,0
8852,54555,25174,0,0,66,66,0,1,0,1,0
8853,60479,25174,0,0,62,62,0,1,0,1,0
8854,40845,64147,0,0,62,62,0,1,0,1,0
8855,39795,5900,0,0,60,60,0,1,0,1,0
8856,11337,15503,0,0,62,62,0,1,0,1,0
8857,58421,30188,0,0,66,66,0,1,0,1,0
8858,53629,445,0,0,70,70,0,1,0,1,0
8859,56909,50584,0,0,66,66,0,1,0,1,0
8860,64295,26467,0,0,62,62,0,1,0,1,0
8861,41885,25174,0,0,66,66,0,1,0,1,0
8862,8560,50584,0,0,66,66,0,1,0,1,0
8863,0,0,0,0,70,70,0,1,0,1,0
8864,53626,445,0,0,70,70,0,1,0,1,0
8865,55587,43890,0,0,62,62,0,1,0,1,0
8866,65268,445,0,0,70,70,0,1,0,1,0
8867,64016,25174,0,0,62,62,0,1,0,1,0
8868,65407,445,0,0,66,66,0,1,0,1,0
8869,65403,445,0,0,66,66,0,1,0,1,0
8870,56614,25174,0,0,66,66,0,1,0,1,0
8871,65260,445,0,0,70,70,0,1,0,1,0
8872,65258,445,0,0,70,70,0,1,0,1,0
8873,65257,445,0,0,70,70,0,1,0,1,0
8874,50052,65008,0,0,60,60,0,1,0,1,0
8875,65255,445,0,0,70,70,0,1,0,1,0
8876,39809,23,0,0,60,60,0,1,0,1,0
8877,65252,445,0,0,70,70,0,1,0,1,0
8878,64882,43890,0,0,66,66,0,1,0,1,0
8879,62197,22114,0,0,66,66,0,1,0,1,0
8880,49531,26467,0,0,66,66,0,1,0,1,0
8881,53614,445,0,0,70,70,0,1,0,1,0
8882,53608,445,0,0,70,70,0,1,0,1,0
8883,50974,11392,0,0,66,66,0,1,0,1,0
8884,53611,445,0,0,70,70,0,1,0,1,0
8885,53609,445,0,0,70,70,0,1,0,1,0
8886,52604,25174,0,0,66,66,0,1,0,1,0
8887,30542,25174,0,0,62,62,0,1,0,1,0
8888,51533,44847,0,0,66,66,0,1,0,1,0
8889,65401,445,0,0,66,66,0,1,0,1,0
8890,4232,50584,0,0,62,62,0,1,0,1,0
8891,52280,44847,0,0,66,66,0,1,0,1,0
8892,52929,43890,0,0,66,66,0,1,0,1,0
8893,65394,445,0,0,66,66,0,1,0,1,0
8894,65392,445,0,0,66,66,0,1,0,1,0
8895,65393,445,0,0,66,66,0,1,0,1,0
8896,65396,445,0,0,66,66,0,1,0,1,0
8897,65388,445,0,0,66,66,0,1,0,1,0
8898,65389,445,0,0,66,66,0,1,0,1,0
8899,65386,445,0,0,66,66,0,1,0,1,0
8900,65247,445,0,0,70,70,0,1,0,1,0
8901,44414,23718,0,0,66,66,0,1,0,1,0
8902,53602,445,0,0,70,70,0,1,0,1,0
8903,25276,50584,0,0,146,146,0,1,0,1,0
8904,64870,65473,0,0,148,148,0,1,0,1,0
8905,5826,26467,0,0,62,62,0,1,0,1,0
8906,53599,445,0,0,70,70,0,1,0,1,0
8907,53597,445,0,0,70,70,0,1,0,1,0
8908,53595,445,0,0,70,70,0,1,0,1,0
8909,1024,44847,0,0,146,146,0,1,0,1,0
8910,53161,51221,0,0,66,66,0,1,0,1,0
8911,48071,25174,0,0,146,146,0,1,0,1,0
8912,58049,50265,0,0,145,145,0,1,0,1,0
8913,65239,445,0,0,70,70,0,1,0,1,0
8914,58007,62413,0,0,62,62,0,1,0,1,0
8915,65236,445,0,0,70,70,0,1,0,1,0
8916,33973,50265,0,0,62,62,0,1,0,1,0
8917,56400,35440,0,0,66,66,0,1,0,1,0
8918,48839,37807,0,0,62,62,0,1,0,1,0
8919,43563,443,50861,443,466,392,74,4,0,3,1
8920,52169,59681,50827,59681,70,70,0,2,8,2,0
8921,55037,443,53217,443,13372,3722,9650,37,47,21,16
8922,52010,80,6411,80,1327,822,505,11,21,7,4
8923,55715,34309,29460,34309,260,140,120,5,8,3,2
8924,55133,53,7400,53,711,87,624,2,30,1,1
8925,55647,53,47322,53,711,87,624,2,30,1,1
8926,33498,25,33498,25,7825,2062,5763,36,17,17,19
8927,64051,19548,23106,19548,66,66,0,1,5,1,0
8928,18485,81,18485,81,146,60,86,2,10,1,1
8929,55708,22094,3066,22094,564,318,246,9,15,5,4
8930,6881,8229,31730,8229,150,150,0,1,1200,1,0
8931,56893,53,37100,53,170,87,83,2,31,1,1
8932,57150,53,24486,53,170,87,83,2,30,1,1
8933,59957,25,59957,25,1721,681,1040,22,17,10,12
8934,37593,443,32259,443,21234,9602,11632,48,70,28,20
8935,49275,7000,49275,7000,2163,676,1487,14,15,7,7
8936,52170,45144,16828,45144,70,70,0,2,8,2,0
8937,52142,54954,48530,54954,66,66,0,1,5,1,0
8938,47903,443,31427,443,9323,2192,7131,25,25,13,12
8939,40379,53,38675,53,168,78,90,2,30,1,1
8940,51859,7700,19893,7700,8425,6015,2410,73,34,37,36
8941,64056,51266,3673,51266,66,66,0,1,5,1,0
8942,50428,443,6305,443,4356,806,3550,14,15,7,7
8943,55496,80,55496,80,124,60,64,2,5,1,1
8944,56217,53,65360,53,711,87,624,2,30,1,1
8945,55259,443,24007,443,4523,3044,1479,17,64,10,7
8946,64279,53,15836,53,170,87,83,2,30,1,1
8947,56597,53,51184,53,711,87,624,2,30,1,1
8948,56998,53,18836,53,711,87,624,2,30,1,1
8949,55757,53,46754,53,170,87,83,2,30,1,1
8950,54955,53,57414,53,170,87,83,2,30,1,1
8951,26900,27017,56455,27017,926,410,516,12,31,6,6
8952,36812,53,60347,53,168,78,90,2,31,1,1
8953,57192,53,34742,53,170,87,83,2,31,1,1
8954,45189,443,22726,443,10789,5723,5066,36,136,17,19
8955,56924,53,50260,53,170,87,83,2,31,1,1
8956,49985,53,61904,53,312,90,222,2,31,1,1
8957,56075,443,56807,443,5640,3241,2399,22,120,11,11
8958,43747,22114,0,0,62,62,0,1,0,1,0
8959,60645,35440,0,0,66,66,0,1,0,1,0
8960,48978,25174,0,0,62,62,0,1,0,1,0
8961,53591,445,0,0,70,70,0,1,0,1,0
8962,53589,445,0,0,70,70,0,1,0,1,0
8963,53588,445,0,0,70,70,0,1,0,1,0
8964,65233,445,0,0,70,70,0,1,0,1,0
8965,9327,57470,0,0,62,62,0,1,0,1,0
8966,65377,445,0,0,66,66,0,1,0,1,0
8967,65231,445,0,0,70,70,0,1,0,1,0
8968,53586,445,0,0,70,70,0,1,0,1,0
8969,9226,57470,0,0,66,66,0,1,0,1,0
8970,45941,23386,0,0,60,60,0,1,0,1,0
8971,18517,31652,0,0,62,62,0,1,0,1,0
8972,65376,445,0,0,66,66,0,1,0,1,0
8973,65374,445,0,0,66,66,0,1,0,1,0
8974,65373,445,0,0,66,66,0,1,0,1,0
8975,61785,64147,0,0,66,66,0,1,0,1,0
8976,36369,443,28864,443,4039,2616,1423,24,45,14,10
8977,52172,7353,52329,7353,70,70,0,2,7,2,0
8978,60881,443,30566,443,8284,1577,6707,29,48,14,15
8979,49246,53,4565,53,177,94,83,2,30,1,1
8980,56143,53,46074,53,177,94,83,2,30,1,1
8981,54340,443,58977,443,79305,3202,76103,98,347,32,66
8982,38160,443,10215,443,8185,2274,5911,18,135,8,10
8983,57470,51413,33371,51413,460,150,310,2,1199,1,1
8984,37965,10909,61398,10909,844,152,692,4,1199,2,2
8985,55588,53,19559,53,168,86,82,2,30,1,1
8986,36379,443,4482,443,4041,2623,1418,22,94,12,10
8987,14247,53,14247,53,197,90,107,2,30,1,1
8988,56086,443,37563,443,7535,1003,6532,24,304,7,17
8989,57040,443,58515,443,59451,47894,11557,177,91,99,78
8990,9462,443,5144,443,4717,2929,1788,23,26,13,10
8991,9401,443,34975,443,7135,1346,5789,21,32,10,11
8992,53943,40534,14905,40534,320,140,180,6,5,3,3
8993,49392,80,13895,80,156587,46628,109959,307,314,203,104
8994,49227,2710,25043,2710,70,70,0,1,5,1,0
8995,50589,443,28626,443,10257,6305,3952,31,134,19,12
8996,49274,53,43421,53,212,102,110,2,29,1,1
8997,55276,53,25720,53,177,94,83,2,29,1,1
8998,55757,53,24073,53,177,94,83,2,30,1,1
8999,64279,53,29219,53,177,94,83,2,29,1,1
9000,55718,16805,42718,16805,70,70,0,2,8,2,0
9001,65023,53,34897,53,587,104,483,4,40,2,2
9002,49226,443,24983,443,532687,14365,518322,560,20,211,349
9003,32911,443,37831,443,970703,43045,927658,1244,141,563,681
9004,26900,27017,54890,27017,758,328,430,10,30,5,5
9005,33045,443,23219,443,4446,1298,3148,15,34,8,7
9006,50636,80,12150,80,16521,6496,10025,31,49,16,15
9007,65082,53,42896,53,305,94,211,4,35,2,2
9008,53914,44209,7956,44209,1729,985,744,16,16,9,7
9009,55605,53,59793,53,198,102,96,2,33,1,1
9010,55646,53,7208,53,216,94,122,2,30,1,1
9011,60227,443,25151,443,6553,871,5682,19,45,9,10
9012,64381,53,44937,53,952,291,661,8,68,4,4
9013,55605,53,59160,53,198,102,96,2,30,1,1
9014,49905,443,37995,443,798502,33164,765338,927,103,379,548
9015,65177,53,43720,53,258,110,148,2,30,1,1
9016,55601,53,58800,53,177,94,83,2,30,1,1
9017,21447,53,34557,53,80280,68084,12196,889,90,816,73
9018,59182,53,44334,53,260,86,174,2,30,1,1
9019,63970,53,19074,53,228,110,118,2,30,1,1
9020,57150,53,64897,53,177,94,83,2,30,1,1
9021,56566,53,0,0,86,86,0,1,30,1,0
9022,55584,53,28071,53,177,94,83,2,30,1,1
9023,11491,53,11491,53,247,98,149,2,32,1,1
9024,51976,443,42576,443,2466,1497,969,21,46,12,9
9025,56467,80,52250,80,22601,1621,20980,35,142,18,17
9026,65226,53,19267,53,79,79,0,2,34,2,0
9027,58760,443,41927,443,45482,2178,43304,56,15,22,34
9028,51975,443,30656,443,4692,2376,2316,30,47,16,14
9029,40457,443,34174,443,5630,3451,2179,39,67,20,19
9030,60878,443,39667,443,31315,6036,25279,65,49,32,33
9031,60879,443,57510,443,15774,5540,10234,48,48,26,22
9032,52003,80,10916,80,7464,4661,2803,47,323,30,17
9033,60702,443,49529,443,13618,5262,8356,54,101,26,28
9034,53934,48339,61953,48339,320,140,180,6,6,3,3
9035,40510,1488,40510,1488,156,156,0,3,7,3,0
9036,50591,443,54685,443,5611,3452,2159,22,133,13,9
9037,52168,62118,2887,62118,70,70,0,2,8,2,0
9038,58046,80,28676,80,2306,1112,1194,23,76,12,11
9039,51977,443,5724,443,2497,1528,969,22,46,13,9
9040,58014,443,11079,443,5528,3392,2136,31,80,16,15
9041,51635,80,51635,80,699944,13137,686807,676,20,195,481
9042,51113,80,51632,80,1948,1092,856,10,20,7,3
9043,32909,443,28727,443,160821,7879,152942,201,141,88,113
9044,53942,28921,35066,28921,320,140,180,6,6,3,3
9045,42226,53,42226,53,259,114,145,2,29,1,1
9046,40355,443,8929,443,15367456,244322,15123134,12866,268,1819,11047
9047,49609,53,20657,53,177,94,83,2,29,1,1
9048,55939,53,47586,53,177,94,83,2,29,1,1
9049,64055,45105,31145,45105,70,70,0,1,4,1,0
9050,54955,53,54702,53,177,94,83,2,29,1,1
9051,50214,53,15199,53,718,94,624,2,29,1,1
9052,56951,53,31366,53,168,86,82,2,29,1,1
9053,65456,53,31398,53,364,102,262,2,29,1,1
9054,56808,53,18042,53,180,94,86,2,35,1,1
9055,55013,53,63318,53,728,102,626,2,29,1,1
9056,56951,53,44679,53,168,86,82,2,29,1,1
9057,52087,80,10358,80,2757,648,2109,12,23,7,5
9058,63419,53,63419,53,216,90,126,2,30,1,1
9059,32910,443,36297,443,2299332,50663,2248669,2117,141,553,1564
9060,55959,53,27240,53,216,102,114,2,29,1,1
9061,50021,53,13540,53,821,102,719,2,30,1,1
9062,56951,53,25030,53,168,86,82,2,29,1,1
9063,56893,53,21610,53,177,94,83,2,30,1,1
9064,64279,53,42792,53,177,94,83,2,30,1,1
9065,57395,53,57395,53,208,82,126,2,30,1,1
9066,55757,53,45063,53,177,94,83,2,30,1,1
9067,54955,53,32337,53,177,94,83,2,30,1,1
9068,47548,53,51360,53,168,78,90,2,30,1,1
9069,64951,53,50176,53,402,118,284,2,30,1,1
9070,57150,53,36180,53,177,94,83,2,30,1,1
9071,64783,53,10599,53,214,94,120,2,30,1,1
9072,51112,80,46143,80,2433,1280,1153,11,20,7,4
9073,58920,80,59955,80,318,192,126,6,37,4,2
9074,52140,53155,46318,53155,70,70,0,1,5,1,0
9075,50684,80,50889,80,1658,1247,411,8,15,5,3
9076,50674,443,55479,443,8709,1708,7001,22,19,11,11
9077,32908,443,31863,443,1780845,46018,1734827,1751,141,546,1205
9078,58153,443,33248,443,12215,7275,4940,26,26,16,10
9079,49472,53,52589,53,209,102,107,2,30,1,1
9080,55778,53,1773,53,94,94,0,1,30,1,0
9081,50284,53,6888,53,168,78,90,2,30,1,1
9082,21954,53,21954,53,220,90,130,2,30,1,1
9083,41348,53,0,0,86,86,0,1,30,1,0
9084,55719,13302,11300,13302,70,70,0,2,8,2,0
9085,55720,51610,62012,51610,70,70,0,2,8,2,0
9086,60401,80,25195,80,190,64,126,4,103,2,2
9087,34388,443,29047,443,7002,1252,5750,28,258,15,13
9088,64279,53,4406,53,177,94,83,2,30,1,1
9089,56893,53,56270,53,177,94,83,2,30,1,1
9090,55757,53,50237,53,177,94,83,2,30,1,1
9091,36058,443,41067,443,11769,1894,9875,27,99,13,14
9092,49299,443,14634,443,6681,1950,4731,24,45,14,10
9093,52097,80,35130,80,1621,896,725,11,19,7,4
9094,37435,53,37435,53,414,268,146,3,32,2,1
9095,55717,13517,61965,13517,70,70,0,2,8,2,0
9096,60066,80,60066,80,355862,9048,346814,358,163,116,242
9097,48713,80,15220,80,3588672,75353,3513319,3500,154,1175,2325
9098,56716,80,53461,80,3742344,115431,3626913,3995,79,1382,2613
9099,32928,443,19319,443,1527,940,587,14,90,8,6
9100,55601,53,28384,53,177,94,83,2,30,1,1
9101,57385,53,16664,53,177,94,83,2,30,1,1
9102,55588,53,33228,53,168,86,82,2,30,1,1
9103,44351,53,3058,53,168,78,90,2,30,1,1
9104,55067,53,26485,53,178,94,84,2,31,1,1
9105,56924,53,38205,53,177,94,83,2,31,1,1
9106,55257,80,57672,80,3564,1625,1939,12,131,6,6
9107,65227,53,53714,53,180,86,94,2,30,1,1
9108,51551,53,57627,53,304,86,218,2,30,1,1
9109,57385,53,42061,53,177,94,83,2,30,1,1
9110,55921,53,32858,53,177,94,83,2,30,1,1
9111,26900,27017,37818,27017,422,164,258,6,30,3,3
9112,64573,443,4149,443,4158,2117,2041,11,120,6,5
9113,49160,61365,56372,61365,502,150,352,3,1200,2,1
9114,55859,443,4096,443,399086,26649,372437,488,462,156,332
9115,50265,27813,47510,27813,198,198,0,4,1200,4,0
9116,34960,443,12324,443,190,70,120,4,15,2,2
9117,50302,443,11942,443,11313,2617,8696,27,47,15,12
9118,38323,443,27893,443,130,70,60,2,15,1,1
9119,54957,53,54042,53,197,102,95,2,35,1,1
9120,59788,443,27023,443,248845,14935,233910,308,49,148,160
9121,57007,80,33678,80,214,140,74,4,31,3,1
9122,57008,80,59299,80,214,140,74,4,31,3,1
9123,57012,80,14292,80,214,140,74,4,31,3,1
9124,55067,53,40121,53,178,94,84,2,30,1,1
9125,39915,443,23556,443,27886,17603,10283,138,462,76,62
9126,57015,80,24329,80,214,140,74,4,31,3,1
9127,57909,80,13139,80,6510,1210,5300,15,18,8,7
9128,26900,27017,15895,27017,254,82,172,4,30,2,2
9129,56893,53,50861,53,177,94,83,2,30,1,1
9130,65152,53,13700,53,177,94,83,2,30,1,1
9131,55498,53,32880,53,177,94,83,2,31,1,1
9132,60802,40010,3447,40010,316,136,180,6,6,3,3
9133,52167,61948,12539,61948,70,70,0,2,8,2,0
9134,52001,80,32528,80,7578,4652,2926,49,323,30,19
9135,14752,53,14752,53,229,98,131,2,30,1,1
9136,13020,26467,0,0,66,66,0,1,0,1,0
9137,9745,26467,0,0,62,62,0,1,0,1,0
9138,31130,30188,0,0,66,66,0,1,0,1,0
9139,65371,445,0,0,66,66,0,1,0,1,0
9140,65227,445,0,0,70,70,0,1,0,1,0
9141,65226,445,0,0,70,70,0,1,0,1,0
9142,54816,35440,0,0,62,62,0,1,0,1,0
9143,49923,443,51816,443,466,392,74,4,1,3,1
9144,65332,56205,0,0,66,66,0,1,0,1,0
9145,53580,445,0,0,70,70,0,1,0,1,0
9146,1043,30170,0,0,159,159,0,1,0,1,0
9147,54816,35440,0,0,146,146,0,1,0,1,0
9148,53573,445,0,0,70,70,0,1,0,1,0
9149,53571,445,0,0,70,70,0,1,0,1,0
9150,10390,26467,0,0,66,66,0,1,0,1,0
9151,65221,445,0,0,70,70,0,1,0,1,0
9152,65360,445,0,0,66,66,0,1,0,1,0
9153,51430,25174,0,0,62,62,0,1,0,1,0
9154,57550,50584,0,0,62,62,0,1,0,1,0
9155,19594,23117,0,0,62,62,0,1,0,1,0
9156,52236,25174,0,0,66,66,0,1,0,1,0
9157,33814,22114,0,0,62,62,0,1,0,1,0
9158,59874,22114,0,0,66,66,0,1,0,1,0
9159,57985,26467,0,0,62,62,0,1,0,1,0
9160,65352,445,0,0,66,66,0,1,0,1,0
9161,53559,445,0,0,70,70,0,1,0,1,0
9162,65349,445,0,0,66,66,0,1,0,1,0
9163,20682,57470,0,0,62,62,0,1,0,1,0
9164,65208,445,0,0,70,70,0,1,0,1,0
9165,50052,65010,0,0,60,60,0,1,0,1,0
9166,62642,25174,0,0,66,66,0,1,0,1,0
9167,8194,21247,0,0,62,62,0,1,0,1,0
9168,4545,1900,0,0,136,136,0,1,0,1,0
9169,1865,25174,0,0,146,146,0,1,0,1,0
9170,65205,445,0,0,70,70,0,1,0,1,0
9171,65342,445,0,0,66,66,0,1,0,1,0
9172,27046,51505,0,0,66,66,0,1,0,1,0
9173,22263,30188,0,0,66,66,0,1,0,1,0
9174,65335,445,0,0,66,66,0,1,0,1,0
9175,23079,9694,0,0,62,62,0,1,0,1,0
9176,26698,25174,0,0,62,62,0,1,0,1,0
9177,18415,37965,0,0,62,62,0,1,0,1,0
9178,50637,36237,0,0,66,66,0,1,0,1,0
9179,1090,26296,0,0,159,159,0,1,0,1,0
9180,57131,7774,0,0,145,145,0,1,0,1,0
9181,65201,445,0,0,70,70,0,1,0,1,0
9182,65199,445,0,0,70,70,0,1,0,1,0
9183,18173,25174,0,0,66,66,0,1,0,1,0
9184,19270,56448,0,0,78,78,0,1,0,1,0
9185,53579,42707,0,0,66,66,0,1,0,1,0
9186,53550,445,0,0,70,70,0,1,0,1,0
9187,53548,445,0,0,70,70,0,1,0,1,0
9188,53546,445,0,0,70,70,0,1,0,1,0
9189,65197,445,0,0,70,70,0,1,0,1,0
9190,64014,3389,64014,3389,293,223,70,4,0,3,1
9191,65324,445,0,0,66,66,0,1,0,1,0
9192,65321,445,0,0,66,66,0,1,0,1,0
9193,65325,445,0,0,66,66,0,1,0,1,0
9194,65326,445,0,0,66,66,0,1,0,1,0
9195,65319,445,0,0,66,66,0,1,0,1,0
9196,65327,445,0,0,66,66,0,1,0,1,0
9197,65323,445,0,0,66,66,0,1,0,1,0
9198,65320,445,0,0,66,66,0,1,0,1,0
9199,37008,42707,0,0,62,62,0,1,0,1,0
9200,36419,50584,0,0,62,62,0,1,0,1,0
9201,29512,30188,0,0,66,66,0,1,0,1,0
9202,36629,23117,0,0,62,62,0,1,0,1,0
9203,26651,25174,0,0,62,62,0,1,0,1,0
9204,14447,25174,0,0,62,62,0,1,0,1,0
9205,10381,22114,0,0,62,62,0,1,0,1,0
9206,15319,51505,0,0,62,62,0,1,0,1,0
9207,2938,64147,0,0,62,62,0,1,0,1,0
9208,14692,25174,0,0,146,146,0,1,0,1,0
9209,65190,445,0,0,70,70,0,1,0,1,0
9210,61761,44847,0,0,66,66,0,1,0,1,0
9211,6666,27017,0,0,60,60,0,1,0,1,0
9212,53543,445,0,0,70,70,0,1,0,1,0
9213,53532,445,0,0,70,70,0,1,0,1,0
9214,53531,445,0,0,70,70,0,1,0,1,0
9215,53529,445,0,0,70,70,0,1,0,1,0
9216,65188,445,0,0,70,70,0,1,0,1,0
9217,56213,26467,0,0,66,66,0,1,0,1,0
9218,49182,21247,0,0,66,66,0,1,0,1,0
9219,38859,22114,0,0,62,62,0,1,0,1,0
9220,65306,445,0,0,66,66,0,1,0,1,0
9221,65305,445,0,0,66,66,0,1,0,1,0
9222,65304,445,0,0,66,66,0,1,0,1,0
9223,65187,445,0,0,70,70,0,1,0,1,0
9224,65186,445,0,0,70,70,0,1,0,1,0
9225,65185,445,0,0,70,70,0,1,0,1,0
9226,65183,445,0,0,70,70,0,1,0,1,0
9227,65181,445,0,0,70,70,0,1,0,1,0
9228,53527,445,0,0,70,70,0,1,0,1,0
9229,57928,30188,0,0,62,62,0,1,0,1,0
9230,53524,445,0,0,70,70,0,1,0,1,0
9231,53523,445,0,0,70,70,0,1,0,1,0
9232,53520,445,0,0,70,70,0,1,0,1,0
9233,17101,25174,0,0,62,62,0,1,0,1,0
9234,65167,445,0,0,70,70,0,1,0,1,0
9235,2932,44847,0,0,66,66,0,1,0,1,0
9236,65166,445,0,0,70,70,0,1,0,1,0
9237,55893,45711,0,0,78,78,0,1,0,1,0
9238,65161,445,0,0,70,70,0,1,0,1,0
9239,57928,30188,0,0,146,146,0,1,0,1,0
9240,65157,445,0,0,70,70,0,1,0,1,0
9241,65156,445,0,0,70,70,0,1,0,1,0
9242,11136,19910,0,0,62,62,0,1,0,1,0
9243,7342,22114,0,0,66,66,0,1,0,1,0
9244,21179,44847,0,0,62,62,0,1,0,1,0
9245,13285,29892,0,0,145,145,0,1,0,1,0
9246,35589,25174,0,0,66,66,0,1,0,1,0
9247,34281,52862,0,0,145,145,0,1,0,1,0
9248,53120,25174,0,0,62,62,0,1,0,1,0
9249,53508,445,0,0,70,70,0,1,0,1,0
9250,53507,445,0,0,70,70,0,1,0,1,0
9251,53503,445,0,0,70,70,0,1,0,1,0
9252,36405,443,39984,443,466,392,74,4,0,3,1
9253,65145,445,0,0,70,70,0,1,0,1,0
9254,65292,445,0,0,66,66,0,1,0,1,0
9255,51548,995,0,0,60,60,0,1,0,1,0
9256,33720,995,0,0,60,60,0,1,0,1,0
9257,52462,25174,0,0,66,66,0,1,0,1,0
9258,12694,22114,0,0,66,66,0,1,0,1,0
9259,68,67,0,0,594,594,0,1,0,1,0
9260,27110,22114,0,0,60,60,0,1,0,1,0
9261,12290,22114,0,0,66,66,0,1,0,1,0
9262,53501,445,0,0,70,70,0,1,0,1,0
9263,65141,445,0,0,70,70,0,1,0,1,0
9264,53499,445,0,0,70,70,0,1,0,1,0
9265,27502,50584,0,0,66,66,0,1,0,1,0
9266,10192,25174,0,0,66,66,0,1,0,1,0
9267,65132,445,0,0,70,70,0,1,0,1,0
9268,65130,445,0,0,70,70,0,1,0,1,0
9269,65131,445,0,0,70,70,0,1,0,1,0
9270,65126,445,0,0,70,70,0,1,0,1,0
9271,65280,445,0,0,66,66,0,1,0,1,0
9272,65276,445,0,0,66,66,0,1,0,1,0
9273,57172,17,0,0,60,60,0,1,0,1,0
9274,65125,445,0,0,70,70,0,1,0,1,0
9275,15585,64147,0,0,62,62,0,1,0,1,0
9276,53563,35440,0,0,62,62,0,1,0,1,0
9277,55735,50584,0,0,62,62,0,1,0,1,0
9278,57677,57470,0,0,62,62,0,1,0,1,0
9279,63398,25174,0,0,66,66,0,1,0,1,0
9280,53487,445,0,0,70,70,0,1,0,1,0
9281,53486,445,0,0,70,70,0,1,0,1,0
9282,53482,445,0,0,70,70,0,1,0,1,0
9283,53481,445,0,0,70,70,0,1,0,1,0
9284,35268,81,0,0,60,60,0,1,0,1,0
9285,49160,1171,0,0,146,146,0,1,0,1,0
9286,65271,445,0,0,66,66,0,1,0,1,0
9287,58399,56205,0,0,66,66,0,1,0,1,0
9288,11754,25174,0,0,62,62,0,1,0,1,0
9289,49754,35440,0,0,62,62,0,1,0,1,0
9290,37657,443,62208,443,8926,2746,6180,27,46,16,11
9291,26755,443,24399,443,7283,2586,4697,22,19,11,11
9292,55588,53,17857,53,168,86,82,2,34,1,1
9293,52166,57975,14625,57975,70,70,0,2,8,2,0
9294,53975,443,21855,443,2845,1694,1151,18,125,10,8
9295,39717,443,63809,443,10921,3102,7819,25,217,13,12
9296,59244,53,54257,53,168,78,90,2,30,1,1
9297,54512,80,54512,80,1923,1474,449,10,20,6,4
9298,39718,443,30883,443,10457,3150,7307,25,217,13,12
9299,53915,1026,61852,1026,70,70,0,1,5,1,0
9300,49531,80,9012,80,78,78,0,1,5,1,0
9301,57004,80,5611,80,214,140,74,4,30,3,1
9302,60571,443,5687,443,8728,4031,4697,23,17,12,11
9303,59955,25,59955,25,1656,677,979,21,16,10,11
9304,57010,80,42816,80,214,140,74,4,30,3,1
9305,26900,27017,57110,27017,422,164,258,6,30,3,3
9306,26900,27017,64702,27017,422,164,258,6,30,3,3
9307,55035,443,52274,443,13310,3162,10148,31,46,16,15
9308,55034,443,64856,443,45487,4986,40501,74,47,36,38
9309,56609,3389,56609,3389,3327,1438,1889,15,16,8,7
9310,39272,443,24238,443,7134,1963,5171,22,284,11,11
9311,39715,443,41417,443,65276,4554,60722,82,217,34,48
9312,39714,443,60107,443,922046,41258,880788,1106,218,498,608
9313,45628,80,45628,80,1243,530,713,10,20,5,5
9314,37659,443,25278,443,3354,2353,1001,18,45,11,7
9315,65482,443,27020,443,6762,3351,3411,31,160,14,17
9316,50116,22,50116,22,60,60,0,1,5,1,0
9317,64064,29856,35804,29856,66,66,0,2,8,2,0
9318,44885,443,34599,443,296,78,218,4,19,1,3
9319,53976,443,52741,443,1591,1004,587,15,125,8,7
9320,10026,443,31835,443,3409,1599,1810,24,80,12,12
9321,19520,7000,19520,7000,4579,2182,2397,16,17,9,7
9322,26900,27017,31530,27017,168,82,86,2,30,1,1
9323,53661,443,31154,443,8267,1779,6488,23,150,13,10
9324,60332,53,8836,53,419,111,308,2,31,1,1
9325,52326,443,20319,443,4939,2553,2386,51,72,28,23
9326,56606,3389,56606,3389,4130,2105,2025,18,16,9,9
9327,37660,443,48083,443,3354,2353,1001,18,45,11,7
9328,59956,25,59956,25,1867,743,1124,24,16,11,13
9329,39318,443,24928,443,6933,2226,4707,33,140,18,15
9330,39719,443,7093,443,450036,17745,432291,541,217,241,300
9331,44884,443,49689,443,296,78,218,4,19,1,3
9332,59900,3389,59900,3389,4286,2261,2025,20,18,11,9
9333,57456,443,62626,443,6350,1550,4800,23,41,12,11
9334,55033,443,57495,443,19846,10062,9784,42,47,22,20
9335,65445,80,60875,80,1279,714,565,11,19,6,5
9336,47971,443,27561,443,11482,2506,8976,48,1329,24,24
9337,26900,27017,50644,27017,422,164,258,6,30,3,3
9338,65152,53,43515,53,170,87,83,2,30,1,1
9339,55067,53,8321,53,172,88,84,2,30,1,1
9340,55498,53,58802,53,170,87,83,2,30,1,1
9341,55877,1135,9849,1135,489,149,340,2,1200,1,1
9342,26900,27017,11369,27017,422,164,258,6,30,3,3
9343,56519,53,32715,53,711,87,624,2,30,1,1
9344,49223,443,17029,443,14838,6995,7843,52,244,26,26
9345,46563,443,26794,443,127147,41867,85280,198,240,91,107
9346,56905,443,19184,443,7537,2310,5227,19,142,8,11
9347,65119,445,0,0,70,70,0,1,0,1,0
9348,44235,50265,0,0,145,145,0,1,0,1,0
9349,23873,30188,0,0,66,66,0,1,0,1,0
9350,47303,31170,0,0,145,145,0,1,0,1,0
9351,65263,445,0,0,66,66,0,1,0,1,0
9352,65262,445,0,0,66,66,0,1,0,1,0
9353,65268,445,0,0,66,66,0,1,0,1,0
9354,65267,445,0,0,66,66,0,1,0,1,0
9355,65259,445,0,0,66,66,0,1,0,1,0
9356,65264,445,0,0,66,66,0,1,0,1,0
9357,65257,445,0,0,66,66,0,1,0,1,0
9358,53473,445,0,0,70,70,0,1,0,1,0
9359,57484,30317,0,0,66,66,0,1,0,1,0
9360,53471,445,0,0,70,70,0,1,0,1,0
9361,21704,16933,0,0,62,62,0,1,0,1,0
9362,53469,445,0,0,70,70,0,1,0,1,0
9363,53467,445,0,0,70,70,0,1,0,1,0
9364,65111,445,0,0,70,70,0,1,0,1,0
9365,65109,445,0,0,70,70,0,1,0,1,0
9366,54221,57470,0,0,66,66,0,1,0,1,0
9367,59966,37965,0,0,66,66,0,1,0,1,0
9368,53015,64147,0,0,62,62,0,1,0,1,0
9369,65104,445,0,0,70,70,0,1,0,1,0
9370,443,14591,0,0,131,131,0,1,0,1,0
9371,65103,445,0,0,70,70,0,1,0,1,0
9372,64723,56205,0,0,62,62,0,1,0,1,0
9373,53462,445,0,0,70,70,0,1,0,1,0
9374,53460,445,0,0,70,70,0,1,0,1,0
9375,53459,445,0,0,70,70,0,1,0,1,0
9376,48448,48817,0,0,66,66,0,1,0,1,0
9377,61550,5529,0,0,145,145,0,1,0,1,0
9378,65250,445,0,0,66,66,0,1,0,1,0
9379,53458,445,0,0,70,70,0,1,0,1,0
9380,62914,11392,0,0,146,146,0,1,0,1,0
9381,10126,57470,0,0,62,62,0,1,0,1,0
9382,65248,445,0,0,66,66,0,1,0,1,0
9383,443,49689,0,0,60,60,0,1,0,1,0
9384,443,34599,0,0,60,60,0,1,0,1,0
9385,53704,23,0,0,60,60,0,1,0,1,0
9386,65099,445,0,0,70,70,0,1,0,1,0
9387,1024,25174,0,0,62,62,0,1,0,1,0
9388,65246,445,0,0,66,66,0,1,0,1,0
9389,65244,445,0,0,66,66,0,1,0,1,0
9390,13110,52126,0,0,145,145,0,1,0,1,0
9391,65242,445,0,0,66,66,0,1,0,1,0
9392,65098,445,0,0,70,70,0,1,0,1,0
9393,62348,50584,0,0,66,66,0,1,0,1,0
9394,49938,57470,0,0,66,66,0,1,0,1,0
9395,49370,443,33059,443,5782,1008,4774,17,1,8,9
9396,40787,57470,0,0,62,62,0,1,0,1,0
9397,65496,57470,0,0,146,146,0,1,0,1,0
9398,22547,48817,0,0,72,72,0,1,0,1,0
9399,53456,445,0,0,70,70,0,1,0,1,0
9400,50488,22114,0,0,66,66,0,1,0,1,0
9401,58715,64097,0,0,62,62,0,1,0,1,0
9402,8760,22114,0,0,66,66,0,1,0,1,0
9403,53448,445,0,0,70,70,0,1,0,1,0
9404,53442,445,0,0,70,70,0,1,0,1,0
9405,54883,51505,0,0,62,62,0,1,0,1,0
9406,62149,22114,0,0,66,66,0,1,0,1,0
9407,65093,445,0,0,70,70,0,1,0,1,0
9408,31066,57470,0,0,74,74,0,1,0,1,0
9409,37732,5007,0,0,60,60,0,1,0,1,0
9410,49196,25174,0,0,66,66,0,1,0,1,0
9411,65232,445,0,0,66,66,0,1,0,1,0
9412,52827,25174,0,0,62,62,0,1,0,1,0
9413,59096,57866,0,0,62,62,0,1,0,1,0
9414,64653,53,13693,53,241,94,147,2,30,1,1
9415,54022,443,12904,443,7653,1188,6465,21,16,12,9
9416,38135,443,62915,443,2568507,98538,2469969,2956,65,1228,1728
9417,55075,53,27475,53,168,78,90,2,30,1,1
9418,53121,443,47087,443,36181,3264,32917,51,62,24,27
9419,52007,80,41883,80,83736,4405,79331,114,19,48,66
9420,56742,443,19670,443,1327,918,409,10,34,6,4
9421,39011,80,17481,80,1114,534,580,12,15,7,5
9422,59789,443,29818,443,103556,8767,94789,144,48,75,69
9423,59790,443,41784,443,238429,14932,223497,314,48,159,155
9424,57150,53,60378,53,177,94,83,2,29,1,1
9425,55921,53,64539,53,177,94,83,2,29,1,1
9426,42520,53,41857,53,168,78,90,2,30,1,1
9427,57578,443,34885,443,13999,3478,10521,33,134,15,18
9428,55957,53,34097,53,178,94,84,2,30,1,1
9429,57006,80,58727,80,214,140,74,4,30,3,1
9430,57014,80,25497,80,214,140,74,4,30,3,1
9431,59122,80,13058,80,2865,2000,865,12,16,7,5
9432,57011,80,37769,80,214,140,74,4,30,3,1
9433,59407,443,59407,443,4736,1829,2907,19,29,11,8
9434,57009,80,12239,80,214,140,74,4,30,3,1
9435,49670,443,17269,443,98424,28850,69574,508,2054,274,234
9436,50637,80,36749,80,175050,8089,166961,167,48,48,119
9437,57013,80,33223,80,526,304,222,8,30,5,3
9438,52139,38259,26811,38259,70,70,0,1,4,1,0
9439,59787,443,50421,443,173218,14836,158382,227,48,114,113
9440,59786,443,7763,443,170002,17069,152933,229,48,118,111
9441,52164,42271,30250,42271,70,70,0,2,8,2,0
9442,53917,35885,37941,35885,70,70,0,1,4,1,0
9443,64063,37832,48121,37832,66,66,0,2,7,2,0
9444,58267,443,58267,443,4674,1767,2907,19,26,11,8
9445,58983,53,44611,53,168,78,90,2,29,1,1
9446,49985,53,62790,53,227,102,125,2,29,1,1
9447,57192,53,44126,53,177,94,83,2,30,1,1
9448,57192,53,42489,53,177,94,83,2,30,1,1
9449,39852,53,51714,53,223,78,145,2,30,1,1
9450,54023,443,2526,443,7653,1188,6465,21,16,12,9
9451,51965,443,54764,443,12738,5385,7353,37,67,21,16
9452,21447,53,55331,53,245648,213726,31922,2763,89,2579,184
9453,26900,27017,43770,27017,422,164,258,6,30,3,3
9454,46881,53,46881,53,197,90,107,2,30,1,1
9455,56414,53,14395,53,178,94,84,2,30,1,1
9456,64985,53,10267,53,86,86,0,1,60,1,0
9457,53922,42285,39226,42285,70,70,0,2,8,2,0
9458,64630,53,37942,53,350,94,256,2,30,1,1
9459,53171,443,32050,443,11080,4277,6803,23,42,10,13
9460,51605,443,15283,443,4343,2350,1993,17,36,9,8
9461,64586,443,13912,443,8573,2039,6534,25,32,14,11
9462,55709,30217,48170,30217,70,70,0,1,5,1,0
9463,50178,443,40731,443,6353,1075,5278,18,26,10,8
9464,49407,53,49407,53,247,98,149,2,32,1,1
9465,65431,53,65431,53,262,106,156,2,31,1,1
9466,5588,5588,0,0,3498,1872,1626,48,195,24,24
9467,50487,80,64502,80,13796,627,13169,20,30,8,12
9468,15732,53,15732,53,414,268,146,3,32,2,1
9469,55244,53,11760,53,168,78,90,2,30,1,1
9470,26900,27017,31467,27017,422,164,258,6,30,3,3
9471,26900,27017,33518,27017,422,164,258,6,30,3,3
9472,55498,53,29212,53,177,94,83,2,30,1,1
9473,26900,27017,60170,27017,422,164,258,6,30,3,3
9474,26900,27017,41644,27017,422,164,258,6,30,3,3
9475,26900,27017,15818,27017,422,164,258,6,30,3,3
9476,26900,27017,41011,27017,422,164,258,6,30,3,3
9477,26900,27017,26279,27017,422,164,258,6,30,3,3
9478,55407,53,58404,53,195,94,101,2,30,1,1
9479,56924,53,57471,53,177,94,83,2,30,1,1
9480,53162,443,22912,443,23929,10333,13596,51,43,25,26
9481,52138,25621,21857,25621,70,70,0,1,5,1,0
9482,49484,80,9940,80,3333,672,2661,12,15,7,5
9483,33893,443,60654,443,8623,1758,6865,36,28,17,19
9484,54025,443,49847,443,7653,1188,6465,21,16,12,9
9485,51602,443,19989,443,19664,8943,10721,42,37,22,20
9486,55498,53,62567,53,177,94,83,2,30,1,1
9487,40404,80,22213,80,1502,467,1035,9,180,5,4
9488,19787,53,19787,53,414,268,146,3,32,2,1
9489,40430,80,30893,80,1566,754,812,10,15,6,4
9490,26900,27017,6136,27017,422,164,258,6,30,3,3
9491,65152,53,60141,53,177,94,83,2,30,1,1
9492,48817,6886,48817,6886,491,150,341,2,1200,1,1
9493,6881,47488,39178,47488,150,150,0,2,1200,2,0
9494,56182,80,62619,80,2085,797,1288,10,15,6,4
9495,41763,443,59315,443,9797,1934,7863,21,15,12,9
9496,56744,443,47935,443,6205,986,5219,16,32,10,6
9497,57005,80,30107,80,214,140,74,4,30,3,1
9498,51996,80,49659,80,6518746,206365,6312381,6886,22,2687,4199
9499,57445,66,37294,66,70,70,0,2,8,2,0
9500,51690,80,20015,80,1273,471,802,11,290,6,5
9501,52163,14181,24095,14181,70,70,0,2,8,2,0
9502,10903,53,10903,53,247,98,149,2,32,1,1
9503,52165,49740,56721,49740,70,70,0,2,8,2,0
9504,6775,53,6775,53,228,90,138,2,32,1,1
9505,53930,19831,49369,19831,70,70,0,2,7,2,0
9506,443,35556,443,35556,70,70,0,1,4,1,0
9507,59785,443,14021,443,1077274,41232,1036042,1152,49,455,697
9508,60492,11339,16258,11339,70,70,0,2,8,2,0
9509,50684,80,15318,80,62,62,0,1,5,1,0
9510,55584,53,38540,53,177,94,83,2,29,1,1
9511,53122,443,60812,443,12409,2224,10185,36,26,19,17
9512,54658,6881,23302,6881,705,583,122,6,26,4,2
9513,58002,80,62017,80,2362,1608,754,22,80,12,10
9514,64398,53,23095,53,181,86,95,2,29,1,1
9515,26900,27017,9336,27017,422,164,258,6,30,3,3
9516,42813,443,40546,443,1241645,28525,1213120,1200,65,328,872
9517,65152,53,30200,53,177,94,83,2,30,1,1
9518,41940,443,2811,443,26974,22004,4970,80,216,42,38
9519,54979,53,4787,53,102,102,0,1,59,1,0
9520,65075,53,31161,53,293,94,199,2,29,1,1
9521,55199,53,60419,53,223,78,145,2,30,1,1
9522,26900,27017,55012,27017,422,164,258,6,30,3,3
9523,49861,53,46345,53,261,94,167,2,30,1,1
9524,26900,27017,46101,27017,422,164,258,6,30,3,3
9525,49996,53,34015,53,210,102,108,2,30,1,1
9526,51608,443,59688,443,4646,2347,2299,17,34,9,8
9527,56994,53,32105,53,177,94,83,2,30,1,1
9528,49201,53,24647,53,243,86,157,2,30,1,1
9529,33671,443,8770,443,12536,1564,10972,30,809,13,17
9530,52651,53,52651,53,414,268,146,3,31,2,1
9531,57396,443,49419,443,362,302,60,2,5,1,1
9532,52136,42939,1692,42939,70,70,0,1,5,1,0
9533,54024,443,29413,443,7653,1188,6465,21,16,12,9
9534,56924,53,46939,53,177,94,83,2,30,1,1
9535,51604,443,33369,443,19611,6865,12746,46,37,24,22
9536,26900,27017,12054,27017,422,164,258,6,30,3,3
9537,36946,123,44700,123,184,94,90,2,30,1,1
9538,59038,53,59038,53,832,106,726,2,30,1,1
9539,65403,53,49597,53,359,94,265,2,30,1,1
9540,6755,53,6755,53,247,98,149,2,32,1,1
9541,60489,53151,64380,53151,70,70,0,2,8,2,0
9542,53925,61701,5754,61701,70,70,0,2,8,2,0
9543,53916,23505,16942,23505,70,70,0,1,5,1,0
9544,50684,80,37949,80,66772,4924,61848,110,19,60,50
9545,26900,27017,32007,27017,422,164,258,6,30,3,3
9546,26900,27017,38519,27017,422,164,258,6,30,3,3
9547,51609,443,37311,443,4598,2312,2286,17,34,9,8
9548,65092,53,51583,53,263,94,169,2,30,1,1
9549,65319,53,54613,53,200,94,106,2,30,1,1
9550,57354,53,4539,53,177,94,83,2,30,1,1
9551,50356,443,55689,443,505625,19174,486451,584,143,204,380
9552,58170,443,59368,443,12391,6068,6323,52,133,24,28
9553,55891,443,55891,443,4581,1674,2907,19,30,11,8
9554,57021,443,20461,443,227559,47160,180399,379,143,187,192
9555,54539,80,58817,80,4162,3455,707,14,15,8,6
9556,17840,53,17840,53,414,268,146,3,32,2,1
9557,58732,443,10734,443,1038,502,536,16,33,8,8
9558,53924,45212,48371,45212,70,70,0,2,8,2,0
9559,44979,443,29869,443,130,70,60,3,5,2,1
9560,43513,443,9885,443,224,164,60,3,5,2,1
9561,50629,443,56409,443,70,70,0,1,5,1,0
9562,65515,443,2957,443,419763,12080,407683,429,16,147,282
9563,54021,443,39071,443,7653,1188,6465,21,16,12,9
9564,55067,53,59893,53,178,94,84,2,30,1,1
9565,51603,443,54804,443,19849,6817,13032,45,37,23,22
9566,40554,53,2086,53,223,78,145,2,30,1,1
9567,64470,53,40171,53,261,94,167,2,30,1,1
9568,65194,53,61837,53,402,142,260,2,31,1,1
9569,6881,48947,47849,48947,228,118,110,2,1199,1,1
9570,4544,41599,1547,41599,710,710,0,6,302,6,0
9571,54035,443,14205,443,4454,2001,2453,11,120,6,5
9572,64049,1029,15442,1029,70,70,0,1,5,1,0
9573,57192,53,38984,53,177,94,83,2,30,1,1
9574,6881,6881,10552,6881,238,118,120,2,1200,1,1
9575,52161,19897,63116,19897,70,70,0,2,8,2,0
9576,52135,46475,11599,46475,70,70,0,1,5,1,0
9577,49368,443,7264,443,9482,4710,4772,19,17,11,8
9578,39323,443,25500,443,1394,733,661,14,81,8,6
9579,52004,80,9207,80,84657,4275,80382,105,19,45,60
9580,46212,443,38830,443,67265,57889,9376,174,102,98,76
9581,51137,443,57006,443,9269,5449,3820,70,460,33,37
9582,59177,443,33565,443,280,140,140,5,130,3,2
9583,63046,443,63046,443,4419,1512,2907,19,30,11,8
9584,61988,443,61988,443,4338,1431,2907,19,30,11,8
9585,26900,27017,55723,27017,20322,11404,8918,118,133,67,51
9586,64647,53,58835,53,575,193,382,6,80,3,3
9587,64260,53,38791,53,211,78,133,2,30,1,1
9588,54277,22114,0,0,62,62,0,1,0,1,0
9589,58143,57866,0,0,66,66,0,1,0,1,0
9590,37007,22114,0,0,146,146,0,1,0,1,0
9591,36881,56205,0,0,62,62,0,1,0,1,0
9592,65224,445,0,0,66,66,0,1,0,1,0
9593,53431,445,0,0,70,70,0,1,0,1,0
9594,63213,57866,0,0,62,62,0,1,0,1,0
9595,42228,51050,0,0,66,66,0,1,0,1,0
9596,61591,22114,0,0,146,146,0,1,0,1,0
9597,65080,445,0,0,70,70,0,1,0,1,0
9598,51046,25174,0,0,66,66,0,1,0,1,0
9599,63334,37807,0,0,66,66,0,1,0,1,0
9600,48478,49903,0,0,62,62,0,1,0,1,0
9601,65221,445,0,0,66,66,0,1,0,1,0
9602,40967,1433,0,0,60,60,0,1,0,1,0
9603,61784,49903,0,0,66,66,0,1,0,1,0
9604,57782,57470,0,0,66,66,0,1,0,1,0
9605,65077,445,0,0,70,70,0,1,0,1,0
9606,2238,22114,0,0,62,62,0,1,0,1,0
9607,1024,64147,0,0,62,62,0,1,0,1,0
9608,22350,25174,0,0,66,66,0,1,0,1,0
9609,40967,1433,0,0,60,60,0,1,0,1,0
9610,65215,445,0,0,66,66,0,1,0,1,0
9611,9731,64147,0,0,62,62,0,1,0,1,0
9612,45964,2225,0,0,60,60,0,1,0,1,0
9613,19270,56448,0,0,78,78,0,1,0,1,0
9614,65207,445,0,0,66,66,0,1,0,1,0
9615,7067,22114,0,0,146,146,0,1,0,1,0
9616,56562,44847,0,0,66,66,0,1,0,1,0
9617,31281,30188,0,0,62,62,0,1,0,1,0
9618,65072,445,0,0,70,70,0,1,0,1,0
9619,65071,445,0,0,70,70,0,1,0,1,0
9620,64878,26467,0,0,145,145,0,1,0,1,0
9621,52640,64147,0,0,62,62,0,1,0,1,0
9622,60571,26467,0,0,62,62,0,1,0,1,0
9623,58725,10387,0,0,145,145,0,1,0,1,0
9624,65069,445,0,0,70,70,0,1,0,1,0
9625,61369,64147,0,0,62,62,0,1,0,1,0
9626,34360,25174,0,0,66,66,0,1,0,1,0
9627,58118,22114,0,0,66,66,0,1,0,1,0
9628,53423,445,0,0,70,70,0,1,0,1,0
9629,53419,445,0,0,70,70,0,1,0,1,0
9630,53418,445,0,0,70,70,0,1,0,1,0
9631,1594,44847,0,0,62,62,0,1,0,1,0
9632,65198,445,0,0,66,66,0,1,0,1,0
9633,65195,445,0,0,66,66,0,1,0,1,0
9634,65192,445,0,0,66,66,0,1,0,1,0
9635,65199,445,0,0,66,66,0,1,0,1,0
9636,65196,445,0,0,66,66,0,1,0,1,0
9637,65197,445,0,0,66,66,0,1,0,1,0
9638,65193,445,0,0,66,66,0,1,0,1,0
9639,65191,445,0,0,66,66,0,1,0,1,0
9640,57677,23,0,0,60,60,0,1,0,1,0
9641,64811,51221,0,0,66,66,0,1,0,1,0
9642,56952,22114,0,0,146,146,0,1,0,1,0
9643,58751,51221,0,0,62,62,0,1,0,1,0
9644,64847,22114,0,0,66,66,0,1,0,1,0
9645,42094,35440,0,0,62,62,0,1,0,1,0
9646,1968,23,0,0,60,60,0,1,0,1,0
9647,51076,25174,0,0,146,146,0,1,0,1,0
9648,56639,48817,0,0,66,66,0,1,0,1,0
9649,65062,445,0,0,70,70,0,1,0,1,0
9650,25457,25604,0,0,62,62,0,1,0,1,0
9651,65060,445,0,0,70,70,0,1,0,1,0
9652,46604,57866,0,0,62,62,0,1,0,1,0
9653,55893,45711,0,0,78,78,0,1,0,1,0
9654,53416,445,0,0,70,70,0,1,0,1,0
9655,53408,445,0,0,70,70,0,1,0,1,0
9656,53404,445,0,0,70,70,0,1,0,1,0
9657,53403,445,0,0,70,70,0,1,0,1,0
9658,65059,445,0,0,70,70,0,1,0,1,0
9659,56578,25174,0,0,62,62,0,1,0,1,0
9660,19204,57866,0,0,62,62,0,1,0,1,0
9661,38629,25174,0,0,66,66,0,1,0,1,0
9662,18577,25174,0,0,62,62,0,1,0,1,0
9663,65058,445,0,0,70,70,0,1,0,1,0
9664,65057,445,0,0,70,70,0,1,0,1,0
9665,65178,445,0,0,66,66,0,1,0,1,0
9666,65177,445,0,0,66,66,0,1,0,1,0
9667,65176,445,0,0,66,66,0,1,0,1,0
9668,57471,62413,0,0,62,62,0,1,0,1,0
9669,65055,445,0,0,70,70,0,1,0,1,0
9670,65051,445,0,0,70,70,0,1,0,1,0
9671,3765,64147,0,0,66,66,0,1,0,1,0
9672,7905,22114,0,0,62,62,0,1,0,1,0
9673,60337,30188,0,0,66,66,0,1,0,1,0
9674,31785,25174,0,0,146,146,0,1,0,1,0
9675,62043,25174,0,0,62,62,0,1,0,1,0
9676,64334,25174,0,0,66,66,0,1,0,1,0
9677,60485,22114,0,0,66,66,0,1,0,1,0
9678,0,0,0,0,156,156,0,2,0,2,0
9679,0,0,0,0,156,156,0,2,0,2,0
9680,0,0,0,0,156,156,0,2,0,2,0
9681,0,0,0,0,156,156,0,2,0,2,0
9682,0,0,0,0,102,102,0,1,0,1,0
9683,61609,25174,0,0,146,146,0,1,0,1,0
9684,51313,25174,0,0,66,66,0,1,0,1,0
9685,50593,64147,0,0,62,62,0,1,0,1,0
9686,56377,51505,0,0,66,66,0,1,0,1,0
9687,12794,35440,0,0,146,146,0,1,0,1,0
9688,53398,445,0,0,70,70,0,1,0,1,0
9689,60049,25174,0,0,66,66,0,1,0,1,0
9690,65039,445,0,0,70,70,0,1,0,1,0
9691,65038,445,0,0,70,70,0,1,0,1,0
9692,65034,445,0,0,70,70,0,1,0,1,0
9693,27055,25174,0,0,62,62,0,1,0,1,0
9694,53395,445,0,0,70,70,0,1,0,1,0
9695,53394,445,0,0,70,70,0,1,0,1,0
9696,53392,445,0,0,70,70,0,1,0,1,0
9697,65029,445,0,0,70,70,0,1,0,1,0
9698,65028,445,0,0,70,70,0,1,0,1,0
9699,11056,6881,0,0,146,146,0,1,0,1,0
9700,55250,25174,0,0,146,146,0,1,0,1,0
9701,54043,36237,0,0,66,66,0,1,0,1,0
9702,3580,25174,0,0,62,62,0,1,0,1,0
9703,57761,15503,0,0,66,66,0,1,0,1,0
9704,2919,37965,0,0,62,62,0,1,0,1,0
9705,52699,25174,0,0,62,62,0,1,0,1,0
9706,25009,35440,0,0,66,66,0,1,0,1,0
9707,22542,30188,0,0,62,62,0,1,0,1,0
9708,63786,25174,0,0,62,62,0,1,0,1,0
9709,65017,445,0,0,70,70,0,1,0,1,0
9710,53380,445,0,0,70,70,0,1,0,1,0
9711,53379,445,0,0,70,70,0,1,0,1,0
9712,53375,445,0,0,70,70,0,1,0,1,0
9713,6486,64147,0,0,66,66,0,1,0,1,0
9714,54189,22114,0,0,66,66,0,1,0,1,0
9715,65165,445,0,0,66,66,0,1,0,1,0
9716,10627,23117,0,0,66,66,0,1,0,1,0
9717,55082,25174,0,0,62,62,0,1,0,1,0
9718,58091,51505,0,0,62,62,0,1,0,1,0
9719,37834,30349,0,0,145,145,0,1,0,1,0
9720,63173,36237,0,0,62,62,0,1,0,1,0
9721,54542,25604,0,0,66,66,0,1,0,1,0
9722,12457,57866,0,0,66,66,0,1,0,1,0
9723,65013,445,0,0,70,70,0,1,0,1,0
9724,24616,48983,0,0,146,146,0,1,0,1,0
9725,58079,50584,0,0,66,66,0,1,0,1,0
9726,30583,25174,0,0,66,66,0,1,0,1,0
9727,23519,25174,0,0,62,62,0,1,0,1,0
9728,53373,445,0,0,70,70,0,1,0,1,0
9729,32474,48817,0,0,148,148,0,1,0,1,0
9730,18655,44847,0,0,66,66,0,1,0,1,0
9731,52130,1035,52488,1035,66,66,0,1,5,1,0
9732,41630,15000,14960,15000,130,70,60,2,5,1,1
9733,46409,80,19897,80,4674,767,3907,17,15,9,8
9734,56263,443,47325,443,101747,13436,88311,135,319,53,82
9735,55521,53,16753,53,711,87,624,2,30,1,1
9736,60491,38789,32066,38789,320,140,180,6,7,3,3
9737,58888,443,23971,443,7329,949,6380,17,35,7,10
9738,56112,80,39554,80,8113,1082,7031,19,16,10,9
9739,9439,443,40829,443,6092,775,5317,17,25,9,8
9740,55440,53,50711,53,711,87,624,2,30,1,1
9741,9430,443,49322,443,6094,771,5323,17,26,9,8
9742,59810,443,33915,443,630054,19786,610268,711,381,261,450
9743,54957,53,36470,53,99,99,0,1,30,1,0
9744,49394,443,62275,443,1392,731,661,14,80,8,6
9745,62120,443,62120,443,4378,1471,2907,19,27,11,8
9746,9432,443,6777,443,6094,771,5323,17,26,9,8
9747,56110,80,5106,80,31087,1654,29433,42,16,18,24
9748,58890,15000,13228,15000,138,78,60,2,5,1,1
9749,64898,53,23347,53,487,201,286,6,37,3,3
9750,49878,53,34561,53,216,94,122,2,30,1,1
9751,13794,3389,13794,3389,3910,1805,2105,20,19,12,8
9752,55772,53,55772,53,194,87,107,2,30,1,1
9753,37319,80,37445,80,1056,682,374,10,15,6,4
9754,9442,443,1324,443,6100,777,5323,17,25,9,8
9755,49396,443,4932,443,1394,733,661,14,80,8,6
9756,9437,443,16715,443,6285,839,5446,19,25,10,9
9757,52133,15015,35766,15015,66,66,0,1,5,1,0
9758,56998,53,8754,53,170,87,83,2,31,1,1
9759,55032,443,43927,443,12704,3182,9522,35,49,16,19
9760,52348,80,52348,80,2910,1489,1421,10,16,6,4
9761,52131,28980,37358,28980,66,66,0,1,5,1,0
9762,56808,53,41016,53,90,90,0,1,30,1,0
9763,55568,443,60113,443,8979,5057,3922,89,110,51,38
9764,56994,53,65507,53,170,87,83,2,30,1,1
9765,55957,53,38699,53,172,88,84,2,30,1,1
9766,56273,53,61553,53,194,99,95,2,30,1,1
9767,50584,53,13408,53,793,101,692,2,30,1,1
9768,37682,5228,19029,5228,5554,755,4799,14,3600,8,6
9769,54888,443,50282,443,1775,169,1606,7,122,3,4
9770,65498,53,22566,53,752,93,659,2,31,1,1
9771,15503,61471,17657,61471,490,149,341,2,1200,1,1
9772,22571,51505,0,0,62,62,0,1,0,1,0
9773,6121,51505,0,0,66,66,0,1,0,1,0
9774,53366,445,0,0,70,70,0,1,0,1,0
9775,65003,445,0,0,70,70,0,1,0,1,0
9776,65002,445,0,0,70,70,0,1,0,1,0
9777,65001,445,0,0,70,70,0,1,0,1,0
9778,37075,48817,0,0,62,62,0,1,0,1,0
9779,65000,445,0,0,70,70,0,1,0,1,0
9780,57557,64147,0,0,66,66,0,1,0,1,0
9781,64997,445,0,0,70,70,0,1,0,1,0
9782,65150,445,0,0,66,66,0,1,0,1,0
9783,65147,445,0,0,66,66,0,1,0,1,0
9784,47063,15503,0,0,146,146,0,1,0,1,0
9785,54440,26467,0,0,66,66,0,1,0,1,0
9786,53360,445,0,0,70,70,0,1,0,1,0
9787,53358,445,0,0,70,70,0,1,0,1,0
9788,53354,445,0,0,70,70,0,1,0,1,0
9789,53352,445,0,0,70,70,0,1,0,1,0
9790,27811,57866,0,0,146,146,0,1,0,1,0
9791,55246,31573,0,0,66,66,0,1,0,1,0
9792,64990,445,0,0,70,70,0,1,0,1,0
9793,53838,36829,0,0,66,66,0,1,0,1,0
9794,65143,445,0,0,66,66,0,1,0,1,0
9795,26239,25174,0,0,66,66,0,1,0,1,0
9796,64808,27098,0,0,66,66,0,1,0,1,0
9797,65135,445,0,0,66,66,0,1,0,1,0
9798,65136,445,0,0,66,66,0,1,0,1,0
9799,65138,445,0,0,66,66,0,1,0,1,0
9800,65130,445,0,0,66,66,0,1,0,1,0
9801,65131,445,0,0,66,66,0,1,0,1,0
9802,65132,445,0,0,66,66,0,1,0,1,0
9803,65128,445,0,0,66,66,0,1,0,1,0
9804,53346,445,0,0,70,70,0,1,0,1,0
9805,56793,56205,0,0,62,62,0,1,0,1,0
9806,45944,44847,0,0,62,62,0,1,0,1,0
9807,64981,445,0,0,70,70,0,1,0,1,0
9808,33401,51505,0,0,62,62,0,1,0,1,0
9809,64980,445,0,0,70,70,0,1,0,1,0
9810,53343,445,0,0,70,70,0,1,0,1,0
9811,53342,445,0,0,70,70,0,1,0,1,0
9812,53340,445,0,0,70,70,0,1,0,1,0
9813,60976,22114,0,0,62,62,0,1,0,1,0
9814,52091,11392,0,0,62,62,0,1,0,1,0
9815,11235,30188,0,0,66,66,0,1,0,1,0
9816,1030,35776,0,0,139,139,0,1,0,1,0
9817,29884,25174,0,0,62,62,0,1,0,1,0
9818,64974,445,0,0,70,70,0,1,0,1,0
9819,64973,445,0,0,70,70,0,1,0,1,0
9820,17280,22114,0,0,62,62,0,1,0,1,0
9821,49894,1433,0,0,60,60,0,1,0,1,0
9822,49894,1433,0,0,60,60,0,1,0,1,0
9823,27841,35894,0,0,62,62,0,1,0,1,0
9824,62339,25174,0,0,66,66,0,1,0,1,0
9825,52358,30188,0,0,66,66,0,1,0,1,0
9826,31845,55777,0,0,62,62,0,1,0,1,0
9827,58955,57470,0,0,74,74,0,1,0,1,0
9828,59493,44847,0,0,66,66,0,1,0,1,0
9829,53337,445,0,0,70,70,0,1,0,1,0
9830,53336,445,0,0,70,70,0,1,0,1,0
9831,53335,445,0,0,70,70,0,1,0,1,0
9832,34772,15503,0,0,146,146,0,1,0,1,0
9833,65121,445,0,0,66,66,0,1,0,1,0
9834,53330,445,0,0,70,70,0,1,0,1,0
9835,64969,445,0,0,70,70,0,1,0,1,0
9836,65120,445,0,0,66,66,0,1,0,1,0
9837,65117,445,0,0,66,66,0,1,0,1,0
9838,42065,53,0,0,86,86,0,1,30,1,0
9839,24486,53,24486,53,414,268,146,3,31,2,1
9840,123,123,26744,123,184,94,90,2,30,1,1
9841,25436,53,25436,53,220,90,130,2,30,1,1
9842,52086,80,55343,80,2703,632,2071,12,22,7,5
9843,9456,443,36831,443,6096,777,5319,17,25,9,8
9844,54811,443,21381,443,3392,2305,1087,22,80,11,11
9845,64045,7426,33466,7426,70,70,0,1,4,1,0
9846,64047,16221,14226,16221,70,70,0,1,4,1,0
9847,55716,36989,39721,36989,320,140,180,6,6,3,3
9848,52132,55014,27986,55014,70,70,0,1,4,1,0
9849,9455,443,43647,443,6096,777,5319,17,25,9,8
9850,56414,53,12496,53,178,94,84,2,29,1,1
9851,55957,53,35891,53,178,94,84,2,29,1,1
9852,52134,18470,56970,18470,70,70,0,1,4,1,0
9853,55957,53,33865,53,178,94,84,2,30,1,1
9854,52853,443,21647,443,9582,3906,5676,21,135,10,11
9855,37965,18122,9264,18122,3957,2324,1633,51,1794,29,22
9856,59377,443,61380,443,43483,26315,17168,86,62,54,32
9857,60136,443,31780,443,21278,12533,8745,57,183,36,21
9858,56922,53,40001,53,168,86,82,2,30,1,1
9859,47230,443,43067,443,9930,3002,6928,34,120,17,17
9860,60703,443,30992,443,66716,4091,62625,98,278,43,55
9861,56126,53,5534,53,177,94,83,2,30,1,1
9862,64852,53,45042,53,209,110,99,2,30,1,1
9863,58808,80,14493,80,2295,1574,721,10,375,6,4
9864,64966,53,61255,53,347,100,247,4,49,2,2
9865,52206,443,46301,443,6278,682,5596,17,20,8,9
9866,38709,443,40146,443,398925,9369,389556,391,16,123,268
9867,55705,54638,46726,54638,504,318,186,8,15,5,3
9868,56273,53,51229,53,197,102,95,2,33,1,1
9869,63873,61002,7411,61002,5431,3164,2267,32,76,18,14
9870,49768,53,39040,53,459,103,356,4,43,2,2
9871,55704,13343,3338,13343,564,318,246,9,15,5,4
9872,49369,443,29095,443,7165,1099,6066,16,15,9,7
9873,61391,443,41670,443,11151,3001,8150,51,365,25,26
9874,18157,53,35666,53,215,94,121,2,30,1,1
9875,37590,443,37590,443,4572,1665,2907,19,27,11,8
9876,57149,53,34608,53,382,94,288,2,30,1,1
9877,63141,55860,18547,55860,316,190,126,5,15,3,2
9878,49435,53,64990,53,608,199,409,6,69,3,3
9879,53166,39564,63800,39564,70,70,0,1,5,1,0
9880,56654,53,47578,53,102,102,0,1,30,1,0
9881,65035,53,56043,53,234,102,132,2,30,1,1
9882,56998,53,31320,53,177,94,83,2,30,1,1
9883,56998,53,64754,53,177,94,83,2,30,1,1
9884,62995,53,21772,53,102,102,0,1,30,1,0
9885,53166,53,17813,53,168,78,90,2,30,1,1
9886,33861,443,34883,443,8084,2638,5446,26,20,14,12
9887,47957,443,9309,443,7658,4247,3411,29,31,15,14
9888,65374,53,40635,53,376,102,274,4,47,2,2
9889,64932,53,8604,53,230,102,128,2,30,1,1
9890,57121,53,54174,53,257,110,147,2,30,1,1
9891,65352,53,23820,53,416,102,314,2,30,1,1
9892,34981,80,29727,80,1658,1344,314,10,15,5,5
9893,5924,53,5924,53,220,90,130,2,30,1,1
9894,56600,443,42581,443,13773,6668,7105,31,105,19,12
9895,65323,53,53376,53,247,118,129,2,30,1,1
9896,64406,53,3194,53,102,102,0,1,30,1,0
9897,57158,53,11939,53,969,86,883,2,30,1,1
9898,42578,443,22827,443,68806,2442,66364,71,215,19,52
9899,39325,443,37130,443,1396,735,661,14,80,8,6
9900,46525,53,46525,53,404,259,145,3,32,2,1
9901,55713,47783,7321,47783,70,70,0,2,8,2,0
9902,52162,15104,33803,15104,70,70,0,2,7,2,0
9903,65514,443,30386,443,92638,4519,88119,105,15,39,66
9904,64048,44918,54494,44918,70,70,0,1,4,1,0
9905,42569,443,10285,443,7284,1456,5828,21,360,10,11
9906,52177,21079,54277,21079,316,136,180,6,5,3,3
9907,9445,443,7220,443,6094,771,5323,17,25,9,8
9908,64041,80,63585,80,314,192,122,6,15,4,2
9909,40709,443,9964,443,5565,1382,4183,22,158,11,11
9910,49196,53,18490,53,230,91,139,3,47,2,1
9911,49293,5223,22335,5223,202,142,60,2,15,1,1
9912,49746,53,11363,53,236,94,142,2,29,1,1
9913,51174,80,58764,80,1658,1344,314,10,15,5,5
9914,10963,53,53121,53,177,86,91,2,30,1,1
9915,65313,53,20235,53,802,288,514,8,75,4,4
9916,57354,53,26026,53,177,94,83,2,29,1,1
9917,55048,53,48265,53,215,94,121,2,29,1,1
9918,49432,53,40864,53,338,118,220,2,29,1,1
9919,57273,53,29269,53,177,94,83,2,30,1,1
9920,53791,53,19031,53,102,102,0,1,30,1,0
9921,52758,53,52758,53,197,90,107,2,30,1,1
9922,51166,53,27662,53,168,78,90,2,30,1,1
9923,55218,53,56966,53,402,142,260,2,30,1,1
9924,56994,53,35888,53,177,94,83,2,30,1,1
9925,54553,53,37407,53,102,102,0,1,30,1,0
9926,55305,53,21908,53,94,94,0,1,30,1,0
9927,36502,53,33412,53,168,78,90,2,30,1,1
9928,45186,443,63714,443,5959,169,5790,10,121,3,7
9929,32971,443,64078,443,12597,6029,6568,36,267,15,21
9930,46351,53,46351,53,262,106,156,2,31,1,1
9931,53929,60741,10876,60741,320,140,180,6,6,3,3
9932,49455,53,42395,53,1750,184,1566,6,85,3,3
9933,49766,53,54774,53,234,102,132,2,30,1,1
9934,60438,53,64563,53,78,78,0,1,30,1,0
9935,58863,443,30901,443,4546411,95150,4451261,4312,109,1197,3115
9936,37513,443,37513,443,4347,1440,2907,19,30,11,8
9937,56558,443,56558,443,4656,1749,2907,19,27,11,8
9938,19253,53,19253,53,414,268,146,3,32,2,1
9939,55786,53,55786,53,247,98,149,2,32,1,1
9940,52052,80,13756,80,2308,1541,767,11,18,7,4
9941,57273,53,15438,53,177,94,83,2,30,1,1
9942,59182,53,59092,53,168,78,90,2,30,1,1
9943,32860,53,58856,53,168,78,90,2,30,1,1
9944,56922,53,64459,53,168,86,82,2,30,1,1
9945,20270,3478,6426,3478,443,294,149,2,300,1,1
9946,37437,443,24632,443,4809,818,3991,15,15,8,7
9947,52159,16297,7644,16297,70,70,0,2,8,2,0
9948,50212,1688,56560,1688,70,70,0,2,8,2,0
9949,51989,80,41304,80,4166,1708,2458,14,16,7,7
9950,45057,443,6642,443,7536,1915,5621,31,20,17,14
9951,50387,80,54775,80,8105,3187,4918,18,24,9,9
9952,64631,53,53048,53,226,102,124,2,30,1,1
9953,61637,53,21621,53,86,86,0,1,30,1,0
9954,55445,53,8991,53,102,102,0,1,30,1,0
9955,56994,53,19050,53,177,94,83,2,30,1,1
9956,50265,53606,10997,53606,528,528,0,9,1200,9,0
9957,51811,443,43399,443,4007,2063,1944,12,122,6,6
9958,50545,443,51366,443,9654,1771,7883,27,186,14,13
9959,55435,443,60769,443,684908,25994,658914,762,141,263,499
9960,57408,53,58963,53,195,102,93,2,33,1,1
9961,15450,53,15450,53,216,82,134,2,33,1,1
9962,52127,44198,61078,44198,70,70,0,1,5,1,0
9963,49367,443,60799,443,22639,7456,15183,32,16,17,15
9964,50634,53,32177,53,218,86,132,2,30,1,1
9965,44099,443,23895,443,8049289,98432,7950857,6501,125,717,5784
9966,55160,443,10978,443,333522,14341,319181,347,129,109,238
9967,49219,80,41190,80,2010,664,1346,11,84,7,4
9968,64764,53,35102,53,211,102,109,2,30,1,1
9969,50426,53,48591,53,889,404,485,10,30,5,5
9970,56126,53,21706,53,177,94,83,2,30,1,1
9971,49702,53,29408,53,771,102,669,2,31,1,1
9972,44886,443,1331,443,7775,2973,4802,36,57,19,17
9973,54986,53,53684,53,164,78,86,2,30,1,1
9974,36291,53,42350,53,199,94,105,2,31,1,1
9975,59605,443,24489,443,4507,1525,2982,24,148,13,11
9976,65116,445,0,0,66,66,0,1,0,1,0
9977,50493,15503,0,0,146,146,0,1,0,1,0
9978,64968,445,0,0,70,70,0,1,0,1,0
9979,54189,64147,0,0,66,66,0,1,0,1,0
9980,42558,64147,0,0,62,62,0,1,0,1,0
9981,65115,445,0,0,66,66,0,1,0,1,0
9982,58021,22114,0,0,62,62,0,1,0,1,0
9983,56326,56205,0,0,66,66,0,1,0,1,0
9984,59153,35440,0,0,66,66,0,1,0,1,0
9985,53327,445,0,0,70,70,0,1,0,1,0
9986,5617,64147,0,0,145,145,0,1,0,1,0
9987,64963,445,0,0,70,70,0,1,0,1,0
9988,24292,48817,0,0,148,148,0,1,0,1,0
9989,7891,25174,0,0,66,66,0,1,0,1,0
9990,53317,445,0,0,70,70,0,1,0,1,0
9991,53316,445,0,0,70,70,0,1,0,1,0
9992,50946,44847,0,0,66,66,0,1,0,1,0
9993,47342,20541,0,0,66,66,0,1,0,1,0
9994,65103,445,0,0,66,66,0,1,0,1,0
9995,60308,37965,0,0,66,66,0,1,0,1,0
9996,53692,44512,0,0,66,66,0,1,0,1,0
9997,61000,15503,0,0,146,146,0,1,0,1,0
9998,12318,41864,0,0,139,139,0,1,0,1,0
9999,56202,15503,0,0,146,146,0,1,0,1,0
10000,12616,23,0,0,60,60,0,1,0,1,0
10001,59326,57470,0,0,74,74,0,1,0,1,0
10002,56604,17372,0,0,66,66,0,1,0,1,0
10003,11030,17372,0,0,62,62,0,1,0,1,0
10004,42030,25,0,0,74,74,0,1,0,1,0
10005,3090,1,0,0,66,66,0,1,0,1,0
10006,63873,44847,0,0,66,66,0,1,0,1,0
10007,56219,22114,0,0,66,66,0,1,0,1,0
10008,46275,64147,0,0,62,62,0,1,0,1,0
10009,443,14591,0,0,131,131,0,1,0,1,0
10010,993,58185,0,0,129,129,0,1,0,1,0
10011,65096,445,0,0,66,66,0,1,0,1,0
10012,53302,445,0,0,70,70,0,1,0,1,0
10013,64950,445,0,0,70,70,0,1,0,1,0
10014,45964,2225,0,0,60,60,0,1,0,1,0
10015,61730,25320,0,0,66,66,0,1,0,1,0
10016,55429,25174,0,0,66,66,0,1,0,1,0
10017,58646,44847,0,0,62,62,0,1,0,1,0
10018,64947,445,0,0,70,70,0,1,0,1,0
10019,12616,23,0,0,60,60,0,1,0,1,0
10020,65093,445,0,0,66,66,0,1,0,1,0
10021,64772,64147,0,0,66,66,0,1,0,1,0
10022,55069,44847,0,0,66,66,0,1,0,1,0
10023,62392,15503,0,0,146,146,0,1,0,1,0
10024,56679,5900,0,0,60,60,0,1,0,1,0
10025,65085,445,0,0,66,66,0,1,0,1,0
10026,65078,445,0,0,66,66,0,1,0,1,0
10027,7360,14914,0,0,157,157,0,1,0,1,0
10028,64942,445,0,0,70,70,0,1,0,1,0
10029,54007,50265,0,0,66,66,0,1,0,1,0
10030,64941,445,0,0,70,70,0,1,0,1,0
10031,4138,55777,0,0,66,66,0,1,0,1,0
10032,64939,445,0,0,70,70,0,1,0,1,0
10033,54758,35993,0,0,62,62,0,1,0,1,0
10034,14869,44847,0,0,62,62,0,1,0,1,0
10035,56205,51505,0,0,66,66,0,1,0,1,0
10036,55893,45711,0,0,78,78,0,1,0,1,0
10037,31539,37965,0,0,62,62,0,1,0,1,0
10038,53294,445,0,0,70,70,0,1,0,1,0
10039,53292,445,0,0,70,70,0,1,0,1,0
10040,53291,445,0,0,70,70,0,1,0,1,0
10041,65063,445,0,0,66,66,0,1,0,1,0
10042,65065,445,0,0,66,66,0,1,0,1,0
10043,65069,445,0,0,66,66,0,1,0,1,0
10044,65066,445,0,0,66,66,0,1,0,1,0
10045,65070,445,0,0,66,66,0,1,0,1,0
10046,65068,445,0,0,66,66,0,1,0,1,0
10047,65071,445,0,0,66,66,0,1,0,1,0
10048,65067,445,0,0,66,66,0,1,0,1,0
10049,58421,30188,0,0,66,66,0,1,0,1,0
10050,8560,50584,0,0,66,66,0,1,0,1,0
10051,64932,445,0,0,70,70,0,1,0,1,0
10052,14208,51221,0,0,66,66,0,1,0,1,0
10053,13528,51221,0,0,62,62,0,1,0,1,0
10054,38053,50584,0,0,62,62,0,1,0,1,0
10055,64930,445,0,0,70,70,0,1,0,1,0
10056,6126,25174,0,0,62,62,0,1,0,1,0
10057,54280,3385,0,0,60,60,0,1,0,1,0
10058,32307,22114,0,0,146,146,0,1,0,1,0
10059,11337,15503,0,0,62,62,0,1,0,1,0
10060,52430,22114,0,0,62,62,0,1,0,1,0
10061,64929,445,0,0,70,70,0,1,0,1,0
10062,57420,22114,0,0,62,62,0,1,0,1,0
10063,64928,445,0,0,70,70,0,1,0,1,0
10064,53289,445,0,0,70,70,0,1,0,1,0
10065,53287,445,0,0,70,70,0,1,0,1,0
10066,53283,445,0,0,70,70,0,1,0,1,0
10067,53277,445,0,0,70,70,0,1,0,1,0
10068,64927,445,0,0,70,70,0,1,0,1,0
10069,51769,17,0,0,60,60,0,1,0,1,0
10070,64921,445,0,0,70,70,0,1,0,1,0
10071,64922,445,0,0,70,70,0,1,0,1,0
10072,17262,25174,0,0,62,62,0,1,0,1,0
10073,59214,57866,0,0,66,66,0,1,0,1,0
10074,65050,445,0,0,66,66,0,1,0,1,0
10075,65049,445,0,0,66,66,0,1,0,1,0
10076,65047,445,0,0,66,66,0,1,0,1,0
10077,993,49276,0,0,129,129,0,1,0,1,0
10078,53669,23,0,0,60,60,0,1,0,1,0
10079,51533,44847,0,0,66,66,0,1,0,1,0
10080,64909,445,0,0,70,70,0,1,0,1,0
10081,64908,445,0,0,70,70,0,1,0,1,0
10082,64904,445,0,0,70,70,0,1,0,1,0
10083,55899,57470,0,0,78,78,0,1,0,1,0
10084,64898,445,0,0,70,70,0,1,0,1,0
10085,62197,22114,0,0,66,66,0,1,0,1,0
10086,60000,1879,0,0,145,145,0,1,0,1,0
10087,64899,445,0,0,70,70,0,1,0,1,0
10088,53270,445,0,0,70,70,0,1,0,1,0
10089,52280,44847,0,0,66,66,0,1,0,1,0
10090,53265,445,0,0,70,70,0,1,0,1,0
10091,53263,445,0,0,70,70,0,1,0,1,0
10092,53259,445,0,0,70,70,0,1,0,1,0
10093,62575,12207,0,0,66,66,0,1,0,1,0
10094,53160,25174,0,0,62,62,0,1,0,1,0
10095,64324,37807,0,0,146,146,0,1,0,1,0
10096,60606,3389,0,0,60,60,0,1,0,1,0
10097,19875,30170,0,0,145,145,0,1,0,1,0
10098,55312,64147,0,0,66,66,0,1,0,1,0
10099,12878,25174,0,0,146,146,0,1,0,1,0
10100,29178,35440,0,0,62,62,0,1,0,1,0
10101,38330,44847,0,0,66,66,0,1,0,1,0
10102,64733,35440,0,0,62,62,0,1,0,1,0
10103,45964,55559,0,0,60,60,0,1,0,1,0
10104,53381,25174,0,0,66,66,0,1,0,1,0
10105,22220,25174,0,0,62,62,0,1,0,1,0
10106,64887,445,0,0,70,70,0,1,0,1,0
10107,56400,35440,0,0,66,66,0,1,0,1,0
10108,5060,37965,0,0,66,66,0,1,0,1,0
10109,49485,56972,0,0,66,66,0,1,0,1,0
10110,55605,53,56113,53,196,100,96,2,30,1,1
10111,39682,443,54017,443,4439,862,3577,16,160,9,7
10112,60996,443,58632,443,6043,1568,4475,11,120,4,7
10113,55703,13836,63794,13836,70,70,0,1,5,1,0
10114,52124,11296,48870,11296,66,66,0,1,5,1,0
10115,52154,4635,63801,4635,70,70,0,2,8,2,0
10116,30960,45751,20805,45751,66,66,0,1,3600,1,0
10117,51595,443,49515,443,10614,5312,5302,25,91,14,11
10118,37654,443,34226,443,12531,5566,6965,34,46,20,14
10119,46863,15000,49470,15000,130,70,60,2,5,1,1
10120,62055,443,14508,443,11694,4947,6747,34,48,19,15
10121,56099,53,33681,53,701,88,613,2,30,1,1
10122,56228,53,46587,53,711,87,624,2,30,1,1
10123,38658,443,22719,443,1294,864,430,12,81,7,5
10124,58149,443,24568,443,153,93,60,2,5,1,1
10125,50920,443,56379,443,3440,2371,1069,17,96,10,7
10126,62064,443,63626,443,11582,2503,9079,33,47,17,16
10127,57408,53,58813,53,190,97,93,2,30,1,1
10128,46792,443,1807,443,7298,2661,4637,21,18,11,10
10129,56374,53,54087,53,711,87,624,2,30,1,1
10130,50585,80,63970,80,1726,963,763,13,80,7,6
10131,37655,443,41125,443,9811,3415,6396,29,46,17,12
10132,37649,443,13055,443,32391,21443,10948,69,47,41,28
10133,47969,443,44705,443,10825,4667,6158,25,159,15,10
10134,58402,53,52417,53,578,286,292,9,15,5,4
10135,37453,443,30746,443,8891,1846,7045,27,147,14,13
10136,57368,53,6129,53,701,88,613,2,30,1,1
10137,37656,443,58778,443,9875,3479,6396,29,46,17,12
10138,52129,55550,34471,55550,66,66,0,1,5,1,0
10139,53976,443,65435,443,9921,2236,7685,35,32,17,18
10140,60487,1134,43276,1134,70,70,0,2,8,2,0
10141,59148,443,64998,443,26615,22329,4286,52,272,30,22
10142,49240,53,28241,53,198,101,97,2,30,1,1
10143,55830,53,42279,53,170,87,83,2,30,1,1
10144,61712,443,30612,443,7443,2692,4751,19,76,11,8
10145,43057,443,23412,443,7725,1980,5745,25,20,14,11
10146,41803,443,1948,443,11804,4009,7795,41,150,21,20
10147,30960,45758,64660,45758,462,462,0,8,3632,8,0
10148,60486,8999,61783,8999,70,70,0,2,8,2,0
10149,57248,443,46396,443,4113,1387,2726,15,36,8,7
10150,57246,8525,57246,8525,138,78,60,2,5,1,1
10151,58664,53,14984,53,192,90,102,2,30,1,1
10152,65316,53,63877,53,780,93,687,2,30,1,1
10153,56738,53,36120,53,264,87,177,4,37,2,2
10154,55601,53,41824,53,815,95,720,2,30,1,1
10155,55850,53,58369,53,816,97,719,2,30,1,1
10156,50408,53,36344,53,182,93,89,2,31,1,1
10157,62188,443,50318,443,6973,2413,4560,22,148,11,11
10158,6882,5406,43769,5406,654,150,504,3,1200,1,2
10159,50579,53,55360,53,174,89,85,2,31,1,1
10160,49708,53,5780,53,172,88,84,2,31,1,1
10161,64125,53,8672,53,198,101,97,2,31,1,1
10162,55308,443,11904,443,14364,4095,10269,33,404,13,20
10163,56249,443,29498,443,80340,72269,8071,106,122,65,41
10164,51662,443,4972,443,7532,3051,4481,13,121,6,7
10165,50584,34393,36839,34393,509,150,359,2,1200,1,1
10166,56848,53,54786,53,764,99,665,2,31,1,1
10167,61528,443,29665,443,138544,7073,131471,165,144,59,106
10168,39617,80,39617,80,419378,16035,403343,506,132,226,280
10169,37014,25174,0,0,66,66,0,1,0,1,0
10170,9504,25174,0,0,146,146,0,1,0,1,0
10171,53250,445,0,0,70,70,0,1,0,1,0
10172,53252,445,0,0,70,70,0,1,0,1,0
10173,53247,445,0,0,70,70,0,1,0,1,0
10174,43747,22114,0,0,62,62,0,1,0,1,0
10175,62250,23117,0,0,66,66,0,1,0,1,0
10176,65038,445,0,0,66,66,0,1,0,1,0
10177,61785,64147,0,0,66,66,0,1,0,1,0
10178,51783,50584,0,0,62,62,0,1,0,1,0
10179,40845,64147,0,0,62,62,0,1,0,1,0
10180,64883,445,0,0,70,70,0,1,0,1,0
10181,54502,443,10226,443,6750,1755,4995,16,103,9,7
10182,65529,53,12629,53,199,102,97,2,30,1,1
10183,45364,443,12194,443,9276,2422,6854,25,186,14,11
10184,54518,25174,0,0,62,62,0,1,0,1,0
10185,50708,22114,0,0,62,62,0,1,0,1,0
10186,48350,57470,0,0,74,74,0,1,0,1,0
10187,64872,445,0,0,70,70,0,1,0,1,0
10188,64874,445,0,0,70,70,0,1,0,1,0
10189,64871,445,0,0,70,70,0,1,0,1,0
10190,53245,445,0,0,70,70,0,1,0,1,0
10191,46879,37807,0,0,146,146,0,1,0,1,0
10192,45941,23386,0,0,60,60,0,1,0,1,0
10193,64869,445,0,0,70,70,0,1,0,1,0
10194,53244,445,0,0,70,70,0,1,0,1,0
10195,64867,445,0,0,70,70,0,1,0,1,0
10196,55477,22114,0,0,146,146,0,1,0,1,0
10197,65332,56205,0,0,66,66,0,1,0,1,0
10198,54011,44847,0,0,66,66,0,1,0,1,0
10199,51930,57470,0,0,66,66,0,1,0,1,0
10200,2780,23117,0,0,66,66,0,1,0,1,0
10201,40120,23,0,0,60,60,0,1,0,1,0
10202,5826,26467,0,0,62,62,0,1,0,1,0
10203,10390,26467,0,0,66,66,0,1,0,1,0
10204,65023,445,0,0,66,66,0,1,0,1,0
10205,65019,445,0,0,66,66,0,1,0,1,0
10206,37887,22114,0,0,66,66,0,1,0,1,0
10207,443,14591,0,0,60,60,0,1,0,1,0
10208,4111,25174,0,0,62,62,0,1,0,1,0
10209,23719,22114,0,0,62,62,0,1,0,1,0
10210,68,67,0,0,346,346,0,1,0,1,0
10211,64860,445,0,0,70,70,0,1,0,1,0
10212,53233,445,0,0,70,70,0,1,0,1,0
10213,53230,445,0,0,70,70,0,1,0,1,0
10214,56738,53,8511,53,264,87,177,4,37,2,2
10215,52155,63867,51864,63867,70,70,0,2,7,2,0
10216,64801,53,57986,53,211,102,109,2,29,1,1
10217,49240,53,11212,53,199,102,97,2,29,1,1
10218,49271,53,54358,53,186,102,84,2,30,1,1
10219,52125,80,43801,80,2178,1003,1175,10,15,6,4
10220,57235,15187,23276,15187,1269359015,948477220,320881795,1036116,9283,747520,288596
10221,50410,443,7615,443,14049,602,13447,19,35,6,13
10222,43495,5223,54062,5223,139,139,0,2,6,2,0
10223,64030,24096,24415,24096,442,320,122,7,17,5,2
10224,34331,53,34331,53,404,259,145,3,32,2,1
10225,35073,443,44227,443,6201,1790,4411,24,330,13,11
10226,38708,443,36955,443,90166,3481,86685,96,15,31,65
10227,62914,993,49276,993,9285,4057,5228,80,45,39,41
10228,62056,443,37684,443,13784,6865,6919,38,47,21,17
10229,37785,80,22917,80,2293,1576,717,12,15,6,6
10230,41592,443,47156,443,2913,1752,1161,15,15,9,6
10231,57691,53,57691,53,247,98,149,2,32,1,1
10232,64899,53,42372,53,767,102,665,2,29,1,1
10233,52156,18238,49104,18238,70,70,0,2,7,2,0
10234,52157,23002,39596,23002,70,70,0,2,7,2,0
10235,52158,3841,65016,3841,70,70,0,2,7,2,0
10236,40839,53,42784,53,78,78,0,1,29,1,0
10237,53910,1024,45263,1024,70,70,0,1,4,1,0
10238,49240,53,18179,53,199,102,97,2,30,1,1
10239,65282,53,39898,53,193,102,91,2,30,1,1
10240,51815,443,62038,443,9061,3443,5618,64,121,27,37
10241,55830,53,20748,53,177,94,83,2,30,1,1
10242,59604,443,43036,443,4507,1525,2982,24,147,13,11
10243,27366,5222,55342,5222,3833,1007,2826,27,68,11,16
10244,62911,993,63006,993,8753,4199,4554,76,54,41,35
10245,49240,53,19807,53,330,101,229,4,47,2,2
10246,49271,53,62549,53,178,94,84,2,30,1,1
10247,44401,53,44401,53,197,90,107,2,30,1,1
10248,20341,53,20341,53,225,90,135,2,30,1,1
10249,55683,53,63904,53,391,134,257,2,30,1,1
10250,51647,443,26913,443,6400,1830,4570,26,316,13,13
10251,41484,443,26840,443,433834,12764,421070,452,32,156,296
10252,49922,53,18616,53,583,105,478,4,42,2,2
10253,35202,443,16914,443,10848,4083,6765,37,16,21,16
10254,35012,80,6218,80,1295,572,723,12,15,7,5
10255,50472,443,48641,443,251744,9600,242144,302,23,129,173
10256,57208,53,43799,53,184,86,98,2,30,1,1
10257,62061,443,61994,443,53531,5139,48392,75,47,34,41
10258,55706,33677,37931,33677,210,140,70,4,14,3,1
10259,53853,443,28816,443,3692,2154,1538,25,81,12,13
10260,50577,80,14735,80,469212,19981,449231,601,134,276,325
10261,33108,22,33108,22,7930,3351,4579,56,38,27,29
10262,62916,993,58185,993,8832,3647,5185,77,41,35,42
10263,65529,53,2543,53,199,102,97,2,30,1,1
10264,61044,53,61044,53,180,82,98,2,30,1,1
10265,64610,53,2406,53,292,102,190,2,30,1,1
10266,56231,53,14277,53,268,94,174,2,30,1,1
10267,57161,53,62554,53,196,94,102,2,30,1,1
10268,50683,443,31278,443,12362,1650,10712,33,300,14,19
10269,65196,53,20787,53,164,86,78,2,30,1,1
10270,62909,993,50101,993,8033,4241,3792,67,54,42,25
10271,50080,5223,34413,5223,10876,5991,4885,39,93,22,17
10272,65282,53,16283,53,193,102,91,2,30,1,1
10273,49442,53,12597,53,326,110,216,2,30,1,1
10274,65057,53,20625,53,397,102,295,2,30,1,1
10275,48496,443,6861,443,2661,1558,1103,18,807,7,11
10276,56840,53,4523,53,242,110,132,2,30,1,1
10277,45979,80,24142,80,1638,1324,314,10,15,5,5
10278,37653,443,30565,443,9605,2939,6666,29,46,17,12
10279,60488,27615,36232,27615,70,70,0,2,8,2,0
10280,52126,56057,8315,56057,70,70,0,1,5,1,0
10281,55543,3389,55543,3389,3488,1774,1714,17,32,9,8
10282,60485,13314,64825,13314,70,70,0,2,8,2,0
10283,56799,443,37236,443,7511,2237,5274,17,16,9,8
10284,52128,21294,45027,21294,70,70,0,1,4,1,0
10285,62920,993,31712,993,7974,4175,3799,65,32,40,25
10286,49163,443,41945,443,2529,1230,1299,17,16,9,8
10287,65465,53,17852,53,755,102,653,2,29,1,1
10288,56738,53,23984,53,264,87,177,4,37,2,2
10289,56998,53,58740,53,177,94,83,2,29,1,1
10290,52308,53,36287,53,70,70,0,1,29,1,0
10291,65462,53,17722,53,102,102,0,1,30,1,0
10292,55988,53,26621,53,353,94,259,2,30,1,1
10293,60944,443,4014,443,5081,896,4185,16,70,8,8
10294,40932,443,9497,443,10803,4485,6318,36,345,19,17
10295,42854,443,46516,443,4268,2836,1432,25,19,13,12
10296,22659,53,22659,53,247,98,149,2,32,1,1
10297,52077,53,26834,53,199,94,105,2,30,1,1
10298,53913,28402,8057,28402,70,70,0,1,4,1,0
10299,55039,53,9278,53,177,94,83,2,30,1,1
10300,55039,53,21186,53,177,94,83,2,30,1,1
10301,13859,53,13859,53,215,98,117,2,30,1,1
10302,64823,53,48646,53,210,102,108,2,30,1,1
10303,55830,53,13004,53,177,94,83,2,30,1,1
10304,49709,80,19787,80,1702,1388,314,10,15,5,5
10305,65130,53,36063,53,266,110,156,2,30,1,1
10306,55830,53,38726,53,177,94,83,2,29,1,1
10307,56185,53,59066,53,216,94,122,2,30,1,1
10308,64220,53,21263,53,265,110,155,2,30,1,1
10309,59399,53,32458,53,232,94,138,2,30,1,1
10310,31126,53,31126,53,240,98,142,2,30,1,1
10311,56326,53,62646,53,177,94,83,2,30,1,1
10312,64125,53,22287,53,199,102,97,2,31,1,1
10313,58345,123,37586,123,184,94,90,2,30,1,1
10314,65343,53,9995,53,197,102,95,2,30,1,1
10315,65082,53,20499,53,183,94,89,2,31,1,1
10316,51813,443,19561,443,3182,1568,1614,8,121,4,4
10317,55293,53,52510,53,230,110,120,2,30,1,1
10318,65100,53,63534,53,199,102,97,2,30,1,1
10319,41139,443,57233,443,9152383,160511,8991872,8428,252,2261,6167
10320,61800,3389,61800,3389,3429,1474,1955,16,16,8,8
10321,35247,80,59441,80,1614,1300,314,10,15,5,5
10322,41444,80,42580,80,1000,577,423,10,200,6,4
10323,56439,80,9837,80,17128,1499,15629,24,25,9,15
10324,49701,443,3982,443,28497,1646,26851,31,138,9,22
10325,64912,53,63953,53,356,118,238,2,30,1,1
10326,43853,443,27275,443,6156,4764,1392,17,231,11,6
10327,32869,53,32869,53,197,90,107,2,30,1,1
10328,40453,443,22159,443,114,114,0,2,120,2,0
10329,65218,53,61017,53,193,102,91,2,31,1,1
10330,27777,80,27777,80,12281469,369857,11911612,13837,31,5536,8301
10331,34310,80,6005,80,1614,1300,314,10,15,5,5
10332,44894,443,39327,443,1849,1130,719,17,36,9,8
10333,50640,80,59027,80,2374,936,1438,13,45,7,6
10334,62908,993,3979,993,8772,3614,5158,77,54,35,42
10335,64426,53,20042,53,289,101,188,4,51,2,2
10336,49582,53,29592,53,168,78,90,2,30,1,1
10337,54613,53,0,0,86,86,0,1,30,1,0
10338,58771,53,58771,53,226,106,120,2,30,1,1
10339,12567,53,12567,53,231,90,141,2,30,1,1
10340,52125,49224,3384,49224,70,70,0,1,5,1,0
10341,62066,443,55561,443,11816,3175,8641,32,46,16,16
10342,62915,993,36226,993,8257,4187,4070,70,43,42,28
10343,65343,53,45711,53,197,102,95,2,30,1,1
10344,57442,53,59819,53,411,110,301,2,30,1,1
10345,51221,45722,40795,45722,481,150,331,2,1200,1,1
10346,36588,5223,46105,5223,4336,1518,2818,23,3005,14,9
10347,55423,53,31871,53,177,94,83,2,31,1,1
10348,64259,53,65307,53,211,78,133,2,31,1,1
10349,49515,53,61596,53,195,102,93,2,31,1,1
10350,49516,53,19547,53,183,94,89,2,31,1,1
10351,61163,443,25794,443,8637,5348,3289,37,738,15,22
10352,44847,20009,63949,20009,502,150,352,2,1200,1,1
10353,37965,52608,29898,52608,1577,594,983,20,2766,10,10
10354,38945,443,48637,443,20511,4206,16305,24,134,7,17
10355,65355,53,61445,53,741,94,647,2,30,1,1
10356,65100,53,16934,53,199,102,97,2,30,1,1
10357,38731,443,59272,443,13181,5856,7325,23,135,11,12
10358,10151,10016,24460,10016,460,150,310,2,1200,1,1
10359,30188,13384,3738,13384,501,150,351,2,1200,1,1
10360,49659,443,27992,443,11455,2804,8651,59,121,28,31
10361,52152,58114,40189,58114,70,70,0,2,8,2,0
10362,51987,443,55315,443,134,60,74,3,5,2,1
10363,50128,443,52903,443,15069,5689,9380,51,35,27,24
10364,59284,443,33120,443,10243,3289,6954,41,26,21,20
10365,45564,443,62998,443,4851,848,4003,16,16,9,7
10366,51157,443,53397,443,2791,1800,991,26,186,15,11
10367,50408,53,10616,53,183,94,89,2,30,1,1
10368,20253,53,20253,53,404,259,145,3,33,2,1
10369,5048,53,5048,53,247,98,149,2,34,1,1
10370,19850,53,19850,53,404,259,145,3,32,2,1
10371,54978,80,11814,80,1448,539,909,17,32,9,8
10372,49860,53,46004,53,212,102,110,2,30,1,1
10373,60484,52001,52870,52001,320,140,180,6,8,3,3
10374,46202,443,10482,443,19149,2846,16303,41,25,20,21
10375,58058,53,0,0,86,86,0,1,30,1,0
10376,53226,445,0,0,70,70,0,1,0,1,0
10377,53223,445,0,0,70,70,0,1,0,1,0
10378,64363,22114,0,0,66,66,0,1,0,1,0
10379,60899,25174,0,0,66,66,0,1,0,1,0
10380,33814,22114,0,0,62,62,0,1,0,1,0
10381,65014,445,0,0,66,66,0,1,0,1,0
10382,59874,22114,0,0,66,66,0,1,0,1,0
10383,27922,25174,0,0,62,62,0,1,0,1,0
10384,57348,25174,0,0,62,62,0,1,0,1,0
10385,3764,9694,0,0,66,66,0,1,0,1,0
10386,60605,3389,0,0,60,60,0,1,0,1,0
10387,9212,51505,0,0,62,62,0,1,0,1,0
10388,62194,50584,0,0,62,62,0,1,0,1,0
10389,39583,37965,0,0,66,66,0,1,0,1,0
10390,12909,47807,0,0,148,148,0,1,0,1,0
10391,50052,65008,0,0,60,60,0,1,0,1,0
10392,65006,445,0,0,66,66,0,1,0,1,0
10393,65009,445,0,0,66,66,0,1,0,1,0
10394,65008,445,0,0,66,66,0,1,0,1,0
10395,65005,445,0,0,66,66,0,1,0,1,0
10396,64999,445,0,0,66,66,0,1,0,1,0
10397,65002,445,0,0,66,66,0,1,0,1,0
10398,65000,445,0,0,66,66,0,1,0,1,0
10399,56528,64147,0,0,62,62,0,1,0,1,0
10400,64853,445,0,0,70,70,0,1,0,1,0
10401,28649,43890,0,0,66,66,0,1,0,1,0
10402,64850,445,0,0,70,70,0,1,0,1,0
10403,39063,44847,0,0,66,66,0,1,0,1,0
10404,53220,445,0,0,70,70,0,1,0,1,0
10405,31066,57470,0,0,74,74,0,1,0,1,0
10406,53215,445,0,0,70,70,0,1,0,1,0
10407,53214,445,0,0,70,70,0,1,0,1,0
10408,53211,445,0,0,70,70,0,1,0,1,0
10409,55155,2767,0,0,66,66,0,1,0,1,0
10410,42722,56448,0,0,70,70,0,1,0,1,0
10411,64846,445,0,0,70,70,0,1,0,1,0
10412,52459,3399,0,0,60,60,0,1,0,1,0
10413,50394,25174,0,0,62,62,0,1,0,1,0
10414,43888,64147,0,0,62,62,0,1,0,1,0
10415,64845,445,0,0,70,70,0,1,0,1,0
10416,1280,25174,0,0,66,66,0,1,0,1,0
10417,443,56513,0,0,78,78,0,1,0,1,0
10418,59436,22114,0,0,66,66,0,1,0,1,0
10419,19298,30188,0,0,62,62,0,1,0,1,0
10420,64841,445,0,0,70,70,0,1,0,1,0
10421,50637,36237,0,0,66,66,0,1,0,1,0
10422,53206,445,0,0,70,70,0,1,0,1,0
10423,53204,445,0,0,70,70,0,1,0,1,0
10424,53203,445,0,0,70,70,0,1,0,1,0
10425,47771,25174,0,0,146,146,0,1,0,1,0
10426,64993,445,0,0,66,66,0,1,0,1,0
10427,53202,445,0,0,70,70,0,1,0,1,0
10428,64840,445,0,0,70,70,0,1,0,1,0
10429,64991,445,0,0,66,66,0,1,0,1,0
10430,64988,445,0,0,66,66,0,1,0,1,0
10431,64987,445,0,0,66,66,0,1,0,1,0
10432,64985,445,0,0,66,66,0,1,0,1,0
10433,5912,22114,0,0,62,62,0,1,0,1,0
10434,1660,8696,0,0,62,62,0,1,0,1,0
10435,51455,53733,0,0,62,62,0,1,0,1,0
10436,60579,25174,0,0,62,62,0,1,0,1,0
10437,10312,23117,0,0,62,62,0,1,0,1,0
10438,64835,445,0,0,70,70,0,1,0,1,0
10439,48839,37807,0,0,62,62,0,1,0,1,0
10440,17004,64147,0,0,66,66,0,1,0,1,0
10441,53197,445,0,0,70,70,0,1,0,1,0
10442,33589,23,0,0,60,60,0,1,0,1,0
10443,20953,23,0,0,60,60,0,1,0,1,0
10444,6247,51221,0,0,62,62,0,1,0,1,0
10445,10381,22114,0,0,62,62,0,1,0,1,0
10446,53193,445,0,0,70,70,0,1,0,1,0
10447,53191,445,0,0,70,70,0,1,0,1,0
10448,52625,25174,0,0,62,62,0,1,0,1,0
10449,29512,30188,0,0,66,66,0,1,0,1,0
10450,2049,32480,0,0,66,66,0,1,0,1,0
10451,61761,44847,0,0,66,66,0,1,0,1,0
10452,56213,26467,0,0,66,66,0,1,0,1,0
10453,4748,64147,0,0,66,66,0,1,0,1,0
10454,45964,2225,0,0,60,60,0,1,0,1,0
10455,64975,445,0,0,66,66,0,1,0,1,0
10456,13588,15503,0,0,62,62,0,1,0,1,0
10457,47561,26467,0,0,62,62,0,1,0,1,0
10458,64822,445,0,0,70,70,0,1,0,1,0
10459,21993,25174,0,0,62,62,0,1,0,1,0
10460,63136,25174,0,0,62,62,0,1,0,1,0
10461,1143,25174,0,0,62,62,0,1,0,1,0
10462,64967,445,0,0,66,66,0,1,0,1,0
10463,53176,445,0,0,70,70,0,1,0,1,0
10464,60180,31573,0,0,62,62,0,1,0,1,0
10465,64819,445,0,0,70,70,0,1,0,1,0
10466,2864,25174,0,0,66,66,0,1,0,1,0
10467,443,14591,0,0,60,60,0,1,0,1,0
10468,443,14591,0,0,85,85,0,1,0,1,0
10469,443,14591,0,0,100,100,0,1,0,1,0
10470,993,3979,0,0,129,129,0,1,0,1,0
10471,2932,44847,0,0,66,66,0,1,0,1,0
10472,64965,445,0,0,66,66,0,1,0,1,0
10473,55893,45711,0,0,78,78,0,1,0,1,0
10474,51430,25174,0,0,62,62,0,1,0,1,0
10475,20682,57470,0,0,62,62,0,1,0,1,0
10476,57585,51221,0,0,62,62,0,1,0,1,0
10477,64815,445,0,0,70,70,0,1,0,1,0
10478,15347,55108,0,0,148,148,0,1,0,1,0
10479,64958,445,0,0,66,66,0,1,0,1,0
10480,50052,65010,0,0,60,60,0,1,0,1,0
10481,64813,445,0,0,70,70,0,1,0,1,0
10482,64954,445,0,0,66,66,0,1,0,1,0
10483,24351,57470,0,0,62,62,0,1,0,1,0
10484,0,0,0,0,244,244,0,2,0,2,0
10485,64811,445,0,0,70,70,0,1,0,1,0
10486,53120,25174,0,0,62,62,0,1,0,1,0
10487,18415,37965,0,0,62,62,0,1,0,1,0
10488,59937,18375,0,0,62,62,0,1,0,1,0
10489,52462,25174,0,0,66,66,0,1,0,1,0
10490,62339,25174,0,0,66,66,0,1,0,1,0
10491,54914,51505,0,0,62,62,0,1,0,1,0
10492,63867,35993,0,0,66,66,0,1,0,1,0
10493,59048,57470,0,0,66,66,0,1,0,1,0
10494,68,67,0,0,594,594,0,1,0,1,0
10495,53166,445,0,0,70,70,0,1,0,1,0
10496,53165,445,0,0,70,70,0,1,0,1,0
10497,53162,445,0,0,70,70,0,1,0,1,0
10498,64940,445,0,0,66,66,0,1,0,1,0
10499,64939,445,0,0,66,66,0,1,0,1,0
10500,64937,445,0,0,66,66,0,1,0,1,0
10501,64941,445,0,0,66,66,0,1,0,1,0
10502,64936,445,0,0,66,66,0,1,0,1,0
10503,64938,445,0,0,66,66,0,1,0,1,0
10504,64934,445,0,0,66,66,0,1,0,1,0
10505,64933,445,0,0,66,66,0,1,0,1,0
10506,33886,52255,0,0,162,162,0,1,0,1,0
10507,30729,22114,0,0,62,62,0,1,0,1,0
10508,64804,445,0,0,70,70,0,1,0,1,0
10509,59060,50584,0,0,62,62,0,1,0,1,0
10510,64802,445,0,0,70,70,0,1,0,1,0
10511,51615,25174,0,0,62,62,0,1,0,1,0
10512,64801,445,0,0,70,70,0,1,0,1,0
10513,10192,25174,0,0,66,66,0,1,0,1,0
10514,64800,445,0,0,70,70,0,1,0,1,0
10515,64799,445,0,0,70,70,0,1,0,1,0
10516,50236,25174,0,0,62,62,0,1,0,1,0
10517,64793,445,0,0,70,70,0,1,0,1,0
10518,64795,445,0,0,70,70,0,1,0,1,0
10519,2346,25174,0,0,62,62,0,1,0,1,0
10520,36456,25174,0,0,146,146,0,1,0,1,0
10521,53160,445,0,0,70,70,0,1,0,1,0
10522,53157,445,0,0,70,70,0,1,0,1,0
10523,53155,445,0,0,70,70,0,1,0,1,0
10524,53144,445,0,0,70,70,0,1,0,1,0
10525,55735,50584,0,0,62,62,0,1,0,1,0
10526,26425,22114,0,0,146,146,0,1,0,1,0
10527,23843,26467,0,0,62,62,0,1,0,1,0
10528,63398,25174,0,0,66,66,0,1,0,1,0
10529,54976,15503,0,0,62,62,0,1,0,1,0
10530,64921,445,0,0,66,66,0,1,0,1,0
10531,64920,445,0,0,66,66,0,1,0,1,0
10532,64918,445,0,0,66,66,0,1,0,1,0
10533,60527,35440,0,0,66,66,0,1,0,1,0
10534,64781,445,0,0,70,70,0,1,0,1,0
10535,64780,445,0,0,70,70,0,1,0,1,0
10536,80,18811,0,0,60,60,0,1,0,1,0
10537,64775,445,0,0,70,70,0,1,0,1,0
10538,64770,445,0,0,70,70,0,1,0,1,0
10539,64771,445,0,0,70,70,0,1,0,1,0
10540,49336,25174,0,0,66,66,0,1,0,1,0
10541,57578,51221,0,0,66,66,0,1,0,1,0
10542,37522,22114,0,0,62,62,0,1,0,1,0
10543,9505,443,9745,443,3613,433,3180,11,16,6,5
10544,49068,443,37354,443,98965,16634,82331,187,30,82,105
10545,50411,8080,50411,8080,1626,798,828,11,61,6,5
10546,56088,53,17141,53,774,101,673,2,30,1,1
10547,56582,53,45513,53,98,98,0,1,30,1,0
10548,64426,53,47787,53,289,101,188,4,50,2,2
10549,50592,443,1677,443,9646,3396,6250,23,79,12,11
10550,9513,443,25594,443,3615,435,3180,11,16,6,5
10551,52160,49212,45447,49212,316,136,180,6,6,3,3
10552,56611,53,8939,53,91,91,0,1,30,1,0
10553,62052,443,44827,443,11674,2699,8975,27,48,14,13
10554,52147,30265,24438,30265,70,70,0,2,8,2,0
10555,65343,53,12324,53,194,99,95,2,30,1,1
10556,41892,443,2330,443,2594,1280,1314,17,17,9,8
10557,41890,443,5361,443,7014,1958,5056,31,18,19,12
10558,65082,53,15912,53,182,93,89,2,31,1,1
10559,50109,53,61948,53,768,99,669,2,30,1,1
10560,54998,53,17431,53,711,87,624,2,30,1,1
10561,55797,53,14709,53,735,88,647,2,30,1,1
10562,59959,80,18461,80,1052,612,440,10,16,5,5
10563,64886,53,27053,53,295,101,194,4,31,2,2
10564,19054,3389,19054,3389,3564,1850,1714,18,35,10,8
10565,34779,443,25876,443,34914,5279,29635,47,543,18,29
10566,53975,443,8391,443,9782,1996,7786,30,31,14,16
10567,45390,80,63396,80,16713,1698,15015,31,32,17,14
10568,54819,3389,54819,3389,3327,1438,1889,15,17,8,7
10569,38635,443,21019,443,4089,1965,2124,25,83,13,12
10570,55714,18904,51148,18904,320,140,180,6,6,3,3
10571,34354,443,64555,443,3603,562,3041,10,15,6,4
10572,9518,443,46388,443,3613,433,3180,11,16,6,5
10573,52776,443,19615,443,10091,2314,7777,33,17,18,15
10574,52121,58933,11142,58933,66,66,0,1,5,1,0
10575,49932,53,49932,53,404,259,145,3,32,2,1
10576,27316,443,39777,443,9439,1890,7549,29,67,14,15
10577,51930,80,17993,80,1669,865,804,13,76,8,5
10578,56712,53,57306,53,170,87,83,2,31,1,1
10579,50520,80,14281,80,1615,793,822,13,91,7,6
10580,49516,53,27772,53,182,93,89,2,31,1,1
10581,34338,443,58177,443,4542,2358,2184,20,20,11,9
10582,49339,443,48962,443,3191,2313,878,17,42,10,7
10583,55434,53,17321,53,1335,87,1248,4,38,2,2
10584,52151,30692,2893,30692,70,70,0,2,8,2,0
10585,55423,53,7848,53,170,87,83,2,30,1,1
10586,53905,50130,9021,50130,552,306,246,9,16,5,4
10587,50623,443,54546,443,13392,11220,2172,31,53,19,12
10588,55569,443,6204,443,8049,1560,6489,19,151,9,10
10589,51814,443,41543,443,6133,1655,4478,12,120,5,7
10590,50408,53,52200,53,182,93,89,2,30,1,1
10591,51807,443,44757,443,3561,1098,2463,10,121,5,5
10592,65228,53,60799,53,267,93,174,4,47,2,2
10593,61527,443,62594,443,17161,1619,15542,18,143,4,14
10594,56640,53,60510,53,733,93,640,2,31,1,1
10595,51806,443,40388,443,3182,1568,1614,8,121,4,4
10596,37567,443,40594,443,149229,139639,9590,226,256,124,102
10597,55195,443,24998,443,3543,1855,1688,20,122,10,10
10598,44131,443,6596,443,6582,1943,4639,14,122,7,7
10599,64842,53,17214,53,802,104,698,2,31,1,1
10600,55790,53,7477,53,170,87,83,2,31,1,1
10601,55163,443,13789,443,2329,505,1824,14,124,7,7
10602,58102,443,20475,443,14197,9283,4914,28,122,15,13
10603,19473,6881,31231,6881,490,149,341,2,1200,1,1
10604,49256,53,34162,53,174,89,85,2,31,1,1
10605,56273,53,26440,53,182,93,89,2,31,1,1
10606,58383,53,25867,53,357,87,270,2,31,1,1
10607,54979,53,3280,53,97,97,0,1,61,1,0
10608,56830,53,57872,53,190,97,93,2,31,1,1
10609,56524,443,60258,443,759397,22470,736927,766,108,270,496
10610,54444,443,16103,443,6275,3787,2488,17,147,8,9
10611,54403,443,27679,443,3486,924,2562,13,122,6,7
10612,57470,16414,19962,16414,726,726,0,12,1200,12,0
10613,30960,45750,9630,45750,66,66,0,1,3600,1,0
10614,14447,25174,0,0,62,62,0,1,0,1,0
10615,26651,25174,0,0,62,62,0,1,0,1,0
10616,53142,445,0,0,70,70,0,1,0,1,0
10617,14447,25174,0,0,146,146,0,1,0,1,0
10618,58608,62413,0,0,66,66,0,1,0,1,0
10619,49754,35440,0,0,62,62,0,1,0,1,0
10620,53138,445,0,0,70,70,0,1,0,1,0
10621,53133,445,0,0,70,70,0,1,0,1,0
10622,53132,445,0,0,70,70,0,1,0,1,0
10623,39393,22114,0,0,146,146,0,1,0,1,0
10624,61002,26314,0,0,143,143,0,1,0,1,0
10625,64759,445,0,0,70,70,0,1,0,1,0
10626,63538,80,37199,80,578,518,60,2,5,1,1
10627,54145,7000,54145,7000,3370,1595,1775,16,15,9,7
10628,65266,53,11513,53,754,94,660,2,30,1,1
10629,23844,26467,0,0,62,62,0,1,0,1,0
10630,52112,22114,0,0,66,66,0,1,0,1,0
10631,53123,445,0,0,70,70,0,1,0,1,0
10632,53120,445,0,0,70,70,0,1,0,1,0
10633,53119,445,0,0,70,70,0,1,0,1,0
10634,56388,22114,0,0,66,66,0,1,0,1,0
10635,59966,37965,0,0,66,66,0,1,0,1,0
10636,58897,23,0,0,60,60,0,1,0,1,0
10637,18116,37807,0,0,62,62,0,1,0,1,0
10638,64755,445,0,0,70,70,0,1,0,1,0
10639,64908,445,0,0,66,66,0,1,0,1,0
10640,11754,25174,0,0,62,62,0,1,0,1,0
10641,19209,62413,0,0,146,146,0,1,0,1,0
10642,1024,25174,0,0,62,62,0,1,0,1,0
10643,49370,11392,0,0,62,62,0,1,0,1,0
10644,12348,50265,0,0,62,62,0,1,0,1,0
10645,64744,445,0,0,70,70,0,1,0,1,0
10646,64746,445,0,0,70,70,0,1,0,1,0
10647,64743,445,0,0,70,70,0,1,0,1,0
10648,46116,57470,0,0,74,74,0,1,0,1,0
10649,64740,445,0,0,70,70,0,1,0,1,0
10650,64739,445,0,0,70,70,0,1,0,1,0
10651,1794,22114,0,0,146,146,0,1,0,1,0
10652,53117,445,0,0,70,70,0,1,0,1,0
10653,38549,22114,0,0,62,62,0,1,0,1,0
10654,51754,18375,0,0,66,66,0,1,0,1,0
10655,53116,445,0,0,70,70,0,1,0,1,0
10656,7619,50584,0,0,62,62,0,1,0,1,0
10657,55079,25174,0,0,62,62,0,1,0,1,0
10658,18570,2323,0,0,60,60,0,1,0,1,0
10659,7435,62609,0,0,148,148,0,1,0,1,0
10660,64892,445,0,0,66,66,0,1,0,1,0
10661,64890,445,0,0,66,66,0,1,0,1,0
10662,55406,25174,0,0,66,66,0,1,0,1,0
10663,37826,23,0,0,60,60,0,1,0,1,0
10664,31066,57470,0,0,74,74,0,1,0,1,0
10665,8760,22114,0,0,66,66,0,1,0,1,0
10666,55620,30188,0,0,66,66,0,1,0,1,0
10667,64733,445,0,0,70,70,0,1,0,1,0
10668,64989,50265,0,0,66,66,0,1,0,1,0
10669,52827,25174,0,0,62,62,0,1,0,1,0
10670,25579,23,0,0,60,60,0,1,0,1,0
10671,12596,53,12596,53,197,90,107,2,30,1,1
10672,45412,53,45412,53,220,90,130,2,30,1,1
10673,58748,443,1980,443,522925,36953,485972,799,229,304,495
10674,60801,40010,50650,40010,316,136,180,6,6,3,3
10675,52150,37603,39264,37603,70,70,0,2,7,2,0
10676,52123,46261,33776,46261,70,70,0,1,4,1,0
10677,52120,42751,45034,42751,70,70,0,1,5,1,0
10678,54573,80,38100,80,2091,823,1268,12,45,7,5
10679,49991,53,62734,53,257,102,155,2,29,1,1
10680,50433,53,63561,53,193,102,91,2,29,1,1
10681,55760,443,34599,443,4344,2974,1370,22,94,12,10
10682,46542,443,1363,443,5916,1144,4772,20,17,11,9
10683,61808,443,61318,443,8189,3146,5043,26,30,14,12
10684,50081,443,6983,443,18754,5240,13514,31,16,15,16
10685,53907,45622,15618,45622,70,70,0,1,4,1,0
10686,59250,443,54786,443,12632,3678,8954,42,27,23,19
10687,50129,443,27980,443,29436,9695,19741,54,34,30,24
10688,58894,443,56665,443,354,294,60,2,4,1,1
10689,64040,12226,50739,12226,70,70,0,1,4,1,0
10690,52098,80,42506,80,1955,913,1042,10,15,6,4
10691,53901,44425,38536,44425,1686,890,796,10,15,6,4
10692,65228,53,63836,53,267,93,174,4,46,2,2
10693,64674,53,13295,53,183,94,89,2,29,1,1
10694,53119,53,39459,53,326,102,224,2,29,1,1
10695,54818,3389,54818,3389,3409,1454,1955,16,16,8,8
10696,64986,53,51778,53,734,94,640,2,29,1,1
10697,57106,53,23546,53,214,94,120,2,29,1,1
10698,41008,53,32302,53,168,78,90,2,29,1,1
10699,64488,53,18852,53,291,102,189,2,29,1,1
10700,65196,53,56319,53,172,94,78,2,29,1,1
10701,64674,53,50248,53,183,94,89,2,29,1,1
10702,50148,53,50148,53,198,90,108,2,29,1,1
10703,50433,53,29987,53,193,102,91,2,30,1,1
10704,50559,53,33553,53,178,94,84,2,29,1,1
10705,55340,53,25572,53,324,110,214,2,29,1,1
10706,65365,53,21509,53,178,94,84,2,29,1,1
10707,49708,53,32399,53,178,94,84,2,30,1,1
10708,55417,53,4838,53,199,102,97,2,30,1,1
10709,49364,53,30235,53,183,94,89,2,30,1,1
10710,46484,22,46484,22,7922,3413,4509,55,38,26,29
10711,64270,53,47275,53,455,102,353,4,33,2,2
10712,56712,53,17239,53,177,94,83,2,30,1,1
10713,65104,53,20417,53,198,94,104,2,30,1,1
10714,49364,53,20144,53,183,94,89,2,30,1,1
10715,64705,53,6395,53,213,102,111,2,30,1,1
10716,56611,53,54736,53,181,94,87,2,32,1,1
10717,41482,443,54813,443,1062197,37438,1024759,1129,31,416,713
10718,50376,443,64568,443,7738,879,6859,19,27,10,9
10719,65343,53,45519,53,328,99,229,4,45,2,2
10720,55843,53,63569,53,177,94,83,2,30,1,1
10721,9510,443,20445,443,3615,435,3180,11,15,6,5
10722,49518,53,62825,53,266,110,156,2,30,1,1
10723,55423,53,51640,53,177,94,83,2,30,1,1
10724,49413,53,49413,53,225,90,135,2,30,1,1
10725,64258,53,3209,53,260,86,174,2,30,1,1
10726,55487,53,39202,53,195,102,93,2,30,1,1
10727,56997,53,32024,53,273,102,171,2,30,1,1
10728,64125,53,26967,53,199,102,97,2,30,1,1
10729,64718,53,58761,53,266,110,156,2,30,1,1
10730,26940,53,26940,53,197,90,107,2,30,1,1
10731,50579,53,23674,53,179,94,85,2,30,1,1
10732,40216,443,24772,443,10196,2175,8021,25,186,14,11
10733,49932,53,55615,53,195,102,93,2,30,1,1
10734,56712,53,47464,53,177,94,83,2,30,1,1
10735,55417,53,14562,53,199,102,97,2,30,1,1
10736,50404,8080,50404,8080,11938,4533,7405,33,98,20,13
10737,55944,53,13576,53,194,94,100,2,30,1,1
10738,65324,53,23853,53,748,94,654,2,30,1,1
10739,40781,443,52827,443,448,78,370,7,20,2,5
10740,57260,53,31217,53,211,102,109,2,30,1,1
10741,58000,17,58000,17,66,66,0,1,30,1,0
10742,36712,53,0,0,139,70,69,2,30,1,1
10743,49312,53,27461,53,772,102,670,2,30,1,1
10744,49708,53,64935,53,178,94,84,2,30,1,1
10745,52122,43073,59163,43073,70,70,0,1,5,1,0
10746,56532,53,29846,53,291,88,203,4,50,2,2
10747,51852,443,17719,443,1382291,55962,1326329,1491,24,582,909
10748,59522,443,54778,443,8743,2676,6067,30,25,16,14
10749,55217,443,55217,443,3239,740,2499,15,40,8,7
10750,58418,443,64364,443,15305,3334,11971,45,198,21,24
10751,45376,80,8854,80,2259,1068,1191,12,31,8,4
10752,65228,53,34659,53,267,93,174,4,46,2,2
10753,35311,80,30298,80,947,376,571,8,14,5,3
10754,53246,5222,38090,5222,10577,3496,7081,68,616,36,32
10755,32100,53,32100,53,200,90,110,2,29,1,1
10756,60482,2924,18303,2924,320,140,180,6,7,3,3
10757,64674,53,62663,53,183,94,89,2,29,1,1
10758,60877,443,6098,443,8536,2392,6144,29,45,17,12
10759,3851,53,3851,53,235,90,145,2,33,1,1
10760,49515,53,58908,53,195,102,93,2,29,1,1
10761,46324,443,40837,443,24465,3945,20520,39,18,18,21
10762,44718,80,25526,80,4336,2408,1928,18,21,10,8
10763,56738,53,54145,53,264,87,177,4,36,2,2
10764,50424,53,64071,53,195,102,93,2,29,1,1
10765,63877,53,63877,53,247,98,149,2,32,1,1
10766,52149,52188,59594,52188,70,70,0,2,8,2,0
10767,64897,53,12641,53,266,110,156,2,30,1,1
10768,51716,5223,22569,5223,4524,1489,3035,26,1327,15,11
10769,51385,443,10522,443,8388,760,7628,20,145,6,14
10770,60873,443,24507,443,10707,2969,7738,32,47,18,14
10771,65269,53,18855,53,226,102,124,2,30,1,1
10772,56830,53,55667,53,195,102,93,2,30,1,1
10773,58473,443,15678,443,3120,1862,1258,18,15,11,7
10774,55423,53,64857,53,177,94,83,2,30,1,1
10775,60367,53,22365,53,233,110,123,2,30,1,1
10776,58396,80,29243,80,1088,599,489,13,315,7,6
10777,56326,53,18129,53,177,94,83,2,29,1,1
10778,52221,53,60196,53,164,78,86,2,29,1,1
10779,10034,53,10034,53,215,98,117,2,29,1,1
10780,50424,53,47336,53,195,102,93,2,30,1,1
10781,11906,53,11906,53,220,90,130,2,30,1,1
10782,51197,443,47968,443,3211,781,2430,17,135,8,9
10783,64125,53,18557,53,199,102,97,2,30,1,1
10784,55843,53,38678,53,177,94,83,2,30,1,1
10785,65331,53,20706,53,767,102,665,2,29,1,1
10786,49575,53,46030,53,775,102,673,2,29,1,1
10787,45395,53,0,0,86,86,0,1,30,1,0
10788,55291,53,55867,53,243,94,149,2,31,1,1
10789,49516,53,32390,53,183,94,89,2,31,1,1
10790,64886,53,36555,53,199,102,97,2,30,1,1
10791,65092,53,7341,53,197,102,95,2,30,1,1
10792,55908,53,13210,53,389,110,279,2,30,1,1
10793,49752,53,13383,53,199,86,113,2,31,1,1
10794,49852,53,14933,53,230,102,128,2,31,1,1
10795,50378,443,14135,443,7738,879,6859,19,27,10,9
10796,64987,53,8755,53,357,107,250,4,36,2,2
10797,9500,443,23639,443,3614,434,3180,11,15,6,5
10798,62499,443,53888,443,1332,876,456,11,26,6,5
10799,49482,53,61985,53,460,84,376,4,46,2,2
10800,63672,53,63672,53,198,90,108,2,30,1,1
10801,4773,53,4773,53,197,90,107,2,30,1,1
10802,49516,53,40491,53,183,94,89,2,30,1,1
10803,49926,53,10749,53,266,110,156,2,30,1,1
10804,57505,443,24632,443,3640,606,3034,13,120,6,7
10805,65287,53,18878,53,180,94,86,2,31,1,1
10806,50675,80,44462,80,1658,1247,411,8,15,5,3
10807,50377,443,39949,443,7738,879,6859,19,27,10,9
10808,49297,80,62329,80,16249,1328,14921,28,45,14,14
10809,56582,53,45398,53,196,102,94,2,33,1,1
10810,55702,80,29070,80,70,70,0,1,5,1,0
10811,49183,53,29082,53,451,91,360,4,36,2,2
10812,52089,443,10472,443,15525,1642,13883,32,16,16,16
10813,9506,443,29564,443,3614,434,3180,11,15,6,5
10814,64426,53,6048,53,289,101,188,4,50,2,2
10815,22078,53,22078,53,229,98,131,2,30,1,1
10816,65413,53,65505,53,266,110,156,2,30,1,1
10817,65082,53,43263,53,183,94,89,2,30,1,1
10818,65098,53,11310,53,260,94,166,2,30,1,1
10819,56427,53,1277,53,178,94,84,2,30,1,1
10820,9520,443,43478,443,3614,434,3180,11,15,6,5
10821,52148,29104,12286,29104,70,70,0,2,8,2,0
10822,52119,49239,52121,49239,160,70,90,2,5,1,1
10823,50624,80,47844,80,12701,9788,2913,29,52,16,13
10824,49708,53,16944,53,178,94,84,2,30,1,1
10825,30353,53,30353,53,200,90,110,2,30,1,1
10826,48070,53,48070,53,197,90,107,2,30,1,1
10827,55487,53,11679,53,195,102,93,2,30,1,1
10828,34517,53,34517,53,200,82,118,2,30,1,1
10829,59002,53,19057,53,238,94,144,2,30,1,1
10830,59045,53,10960,53,231,110,121,2,30,1,1
10831,33281,53,7345,53,86,86,0,1,30,1,0
10832,64576,443,9952,443,7069,1210,5859,13,120,6,7
10833,55163,53,20116,53,197,102,95,2,31,1,1
10834,64958,53,42023,53,197,102,95,2,31,1,1
10835,57470,29633,40389,29633,1660,677,983,20,1595,10,10
10836,54550,443,8260,443,3296,1329,1967,14,135,7,7
10837,52118,33515,33825,33515,70,70,0,1,5,1,0
10838,50593,80,24582,80,2365,1068,1297,13,79,7,6
10839,65228,53,51061,53,267,93,174,4,46,2,2
10840,65218,53,49451,53,193,102,91,2,30,1,1
10841,55866,53,10182,53,257,94,163,2,30,1,1
10842,49932,53,14546,53,195,102,93,2,30,1,1
10843,49727,53,64244,53,280,110,170,2,31,1,1
10844,49942,53,37670,53,196,94,102,2,31,1,1
10845,49709,53,49112,53,466,93,373,4,50,2,2
10846,62498,443,43471,443,14786,3978,10808,32,26,15,17
10847,50583,80,63777,80,2226,1077,1149,13,79,7,6
10848,53900,45682,23799,45682,492,306,186,8,15,5,3
10849,64037,18592,48496,18592,70,70,0,1,5,1,0
10850,50578,80,29631,80,1791,900,891,14,79,7,7
10851,51466,443,58507,443,7638,1758,5880,24,17,13,11
10852,49256,53,11555,53,179,94,85,2,30,1,1
10853,15986,8000,55850,8000,212,150,62,2,30,1,1
10854,55812,53,26314,53,215,94,121,2,30,1,1
10855,65493,53,48274,53,266,110,156,2,30,1,1
10856,65257,53,51798,53,266,110,156,2,30,1,1
10857,53107,445,0,0,70,70,0,1,0,1,0
10858,53106,445,0,0,70,70,0,1,0,1,0
10859,53104,445,0,0,70,70,0,1,0,1,0
10860,53102,445,0,0,70,70,0,1,0,1,0
10861,64887,445,0,0,66,66,0,1,0,1,0
10862,56534,60043,0,0,145,145,0,1,0,1,0
10863,64725,445,0,0,70,70,0,1,0,1,0
10864,6712,5060,0,0,410,410,0,1,0,1,0
10865,49393,30188,0,0,66,66,0,1,0,1,0
10866,64723,445,0,0,70,70,0,1,0,1,0
10867,12226,37965,0,0,62,62,0,1,0,1,0
10868,39941,2767,0,0,62,62,0,1,0,1,0
10869,58504,57470,0,0,62,62,0,1,0,1,0
10870,64873,445,0,0,66,66,0,1,0,1,0
10871,64879,445,0,0,66,66,0,1,0,1,0
10872,64876,445,0,0,66,66,0,1,0,1,0
10873,64882,445,0,0,66,66,0,1,0,1,0
10874,64878,445,0,0,66,66,0,1,0,1,0
10875,64874,445,0,0,66,66,0,1,0,1,0
10876,64881,445,0,0,66,66,0,1,0,1,0
10877,42228,51050,0,0,66,66,0,1,0,1,0
10878,5831,22114,0,0,62,62,0,1,0,1,0
10879,53090,445,0,0,70,70,0,1,0,1,0
10880,54666,36237,0,0,62,62,0,1,0,1,0
10881,63334,37807,0,0,66,66,0,1,0,1,0
10882,53086,445,0,0,70,70,0,1,0,1,0
10883,53085,445,0,0,70,70,0,1,0,1,0
10884,53083,445,0,0,70,70,0,1,0,1,0
10885,64719,445,0,0,70,70,0,1,0,1,0
10886,64717,445,0,0,70,70,0,1,0,1,0
10887,10126,57470,0,0,62,62,0,1,0,1,0
10888,57782,57470,0,0,66,66,0,1,0,1,0
10889,39570,62413,0,0,146,146,0,1,0,1,0
10890,443,46223,0,0,66,66,0,1,0,1,0
10891,59326,57470,0,0,74,74,0,1,0,1,0
10892,49160,44512,0,0,146,146,0,1,0,1,0
10893,64713,445,0,0,70,70,0,1,0,1,0
10894,56562,44847,0,0,66,66,0,1,0,1,0
10895,64712,445,0,0,70,70,0,1,0,1,0
10896,53077,445,0,0,70,70,0,1,0,1,0
10897,53078,445,0,0,70,70,0,1,0,1,0
10898,53076,445,0,0,70,70,0,1,0,1,0
10899,64863,445,0,0,66,66,0,1,0,1,0
10900,3559,51050,0,0,146,146,0,1,0,1,0
10901,53074,445,0,0,70,70,0,1,0,1,0
10902,64862,445,0,0,66,66,0,1,0,1,0
10903,16119,57470,0,0,145,145,0,1,0,1,0
10904,62550,51505,0,0,62,62,0,1,0,1,0
10905,64858,445,0,0,66,66,0,1,0,1,0
10906,64860,445,0,0,66,66,0,1,0,1,0
10907,64856,445,0,0,66,66,0,1,0,1,0
10908,31281,30188,0,0,62,62,0,1,0,1,0
10909,17289,25174,0,0,146,146,0,1,0,1,0
10910,64707,445,0,0,70,70,0,1,0,1,0
10911,6832,51505,0,0,66,66,0,1,0,1,0
10912,51413,54751,0,0,136,136,0,1,0,1,0
10913,28305,25773,0,0,148,148,0,1,0,1,0
10914,64847,22114,0,0,66,66,0,1,0,1,0
10915,40155,25174,0,0,66,66,0,1,0,1,0
10916,61382,25174,0,0,62,62,0,1,0,1,0
10917,6881,6881,0,0,62,62,0,1,0,1,0
10918,53068,445,0,0,70,70,0,1,0,1,0
10919,38755,22114,0,0,66,66,0,1,0,1,0
10920,53061,445,0,0,70,70,0,1,0,1,0
10921,53060,445,0,0,70,70,0,1,0,1,0
10922,22547,48817,0,0,72,72,0,1,0,1,0
10923,50077,443,55619,443,1786,172,1614,7,0,3,4
10924,62400,35993,0,0,66,66,0,1,0,1,0
10925,15333,60043,0,0,62,62,0,1,0,1,0
10926,56639,48817,0,0,66,66,0,1,0,1,0
10927,45964,2228,0,0,60,60,0,1,0,1,0
10928,53071,25174,0,0,66,66,0,1,0,1,0
10929,3524,25174,0,0,66,66,0,1,0,1,0
10930,64846,445,0,0,66,66,0,1,0,1,0
10931,61898,50584,0,0,66,66,0,1,0,1,0
10932,19330,25174,0,0,146,146,0,1,0,1,0
10933,15499,22114,0,0,146,146,0,1,0,1,0
10934,64694,445,0,0,70,70,0,1,0,1,0
10935,49160,46824,0,0,146,146,0,1,0,1,0
10936,13285,29892,0,0,145,145,0,1,0,1,0
10937,25565,42779,0,0,60,60,0,1,0,1,0
10938,36154,47807,0,0,146,146,0,1,0,1,0
10939,60337,30188,0,0,66,66,0,1,0,1,0
10940,59803,22114,0,0,62,62,0,1,0,1,0
10941,62043,25174,0,0,62,62,0,1,0,1,0
10942,64691,445,0,0,70,70,0,1,0,1,0
10943,64838,445,0,0,66,66,0,1,0,1,0
10944,53048,445,0,0,70,70,0,1,0,1,0
10945,44334,26467,0,0,62,62,0,1,0,1,0
10946,60049,25174,0,0,66,66,0,1,0,1,0
10947,64835,445,0,0,66,66,0,1,0,1,0
10948,54280,3385,0,0,60,60,0,1,0,1,0
10949,51414,50584,0,0,66,66,0,1,0,1,0
10950,3478,45401,0,0,109,109,0,1,0,1,0
10951,64686,445,0,0,70,70,0,1,0,1,0
10952,64685,445,0,0,70,70,0,1,0,1,0
10953,64828,445,0,0,66,66,0,1,0,1,0
10954,27055,25174,0,0,62,62,0,1,0,1,0
10955,57293,25174,0,0,146,146,0,1,0,1,0
10956,64683,445,0,0,70,70,0,1,0,1,0
10957,25009,35440,0,0,66,66,0,1,0,1,0
10958,64819,445,0,0,66,66,0,1,0,1,0
10959,49514,52255,0,0,162,162,0,1,0,1,0
10960,32132,25174,0,0,62,62,0,1,0,1,0
10961,61406,1,0,0,78,78,0,1,0,1,0
10962,20619,25174,0,0,66,66,0,1,0,1,0
10963,52640,64147,0,0,62,62,0,1,0,1,0
10964,6486,64147,0,0,66,66,0,1,0,1,0
10965,54189,22114,0,0,66,66,0,1,0,1,0
10966,53036,445,0,0,70,70,0,1,0,1,0
10967,58079,50584,0,0,66,66,0,1,0,1,0
10968,64676,445,0,0,70,70,0,1,0,1,0
10969,10144,62609,0,0,148,148,0,1,0,1,0
10970,53038,445,0,0,70,70,0,1,0,1,0
10971,53034,445,0,0,70,70,0,1,0,1,0
10972,64812,445,0,0,66,66,0,1,0,1,0
10973,64809,445,0,0,66,66,0,1,0,1,0
10974,64808,445,0,0,66,66,0,1,0,1,0
10975,64811,445,0,0,66,66,0,1,0,1,0
10976,64804,445,0,0,66,66,0,1,0,1,0
10977,64807,445,0,0,66,66,0,1,0,1,0
10978,64805,445,0,0,66,66,0,1,0,1,0
10979,64806,445,0,0,66,66,0,1,0,1,0
10980,54542,25604,0,0,66,66,0,1,0,1,0
10981,64674,445,0,0,70,70,0,1,0,1,0
10982,25457,25604,0,0,62,62,0,1,0,1,0
10983,16052,25174,0,0,146,146,0,1,0,1,0
10984,6122,23,0,0,60,60,0,1,0,1,0
10985,34932,38608,0,0,62,62,0,1,0,1,0
10986,64673,445,0,0,70,70,0,1,0,1,0
10987,30583,25174,0,0,66,66,0,1,0,1,0
10988,64672,445,0,0,70,70,0,1,0,1,0
10989,64671,445,0,0,70,70,0,1,0,1,0
10990,57013,53,60365,53,172,88,84,2,30,1,1
10991,65176,53,35365,53,182,93,89,2,30,1,1
10992,56070,53,35943,53,770,101,669,2,30,1,1
10993,53437,443,53437,443,4198,2498,1700,25,102,12,13
10994,53250,443,53250,443,1464,757,707,18,121,9,9
10995,48173,443,63016,443,4342,2152,2190,19,255,10,9
10996,64788,53,47380,53,168,86,82,2,30,1,1
10997,56414,53,17231,53,88,88,0,1,30,1,0
10998,64622,53,5676,53,738,86,652,2,30,1,1
10999,53251,443,53251,443,1404,697,707,17,121,8,9
11000,61797,23,61797,23,60,60,0,1,5,1,0
11001,50320,80,20341,80,50565,32661,17904,77,167,39,38
11002,50595,80,62524,80,2049,1065,984,15,78,8,7
11003,55985,53,19393,53,738,86,652,2,30,1,1
11004,56273,53,59580,53,182,93,89,2,30,1,1
11005,39932,80,45032,80,3472,2124,1348,14,21,8,6
11006,49332,443,62500,443,27727,1971,25756,51,80,21,30
11007,53249,443,53249,443,1404,697,707,17,121,8,9
11008,57395,53,14755,53,262,88,174,4,59,2,2
11009,56878,53,24786,53,168,86,82,2,31,1,1
11010,56018,53,52062,53,762,97,665,2,30,1,1
11011,56540,443,45404,443,103117,6206,96911,127,106,54,73
11012,53248,443,53248,443,1588,817,771,20,121,10,10
11013,48174,443,2102,443,3889,1992,1897,19,255,10,9
11014,54144,7000,54144,7000,3018,1627,1391,16,15,9,7
11015,26941,443,39877,443,8466,3146,5320,30,20,15,15
11016,49932,53,48698,53,190,97,93,2,30,1,1
11017,57887,53,44516,53,174,81,93,2,30,1,1
11018,50622,80,45334,80,11907,10409,1498,28,52,16,12
11019,49333,443,11751,443,30571,1990,28581,53,80,21,32
11020,50285,443,10190,443,18009,7378,10631,58,62,33,25
11021,36883,80,30047,80,114410,3755,110655,128,38,47,81
11022,65422,443,52517,443,2494,1643,851,17,23,9,8
11023,57356,53,43032,53,780,93,687,2,30,1,1
11024,56415,53,6839,53,198,101,97,2,30,1,1
11025,57287,53,44650,53,752,93,659,2,30,1,1
11026,54652,53,54652,53,216,98,118,2,30,1,1
11027,44355,80,33572,80,26085,2508,23577,52,38,29,23
11028,42020,80,16578,80,42657,2962,39695,68,38,36,32
11029,53213,443,51742,443,8451,2320,6131,25,104,13,12
11030,50588,80,47890,80,9116,7610,1506,22,78,12,10
11031,9416,443,41034,443,6090,773,5317,17,25,9,8
11032,59007,443,65066,443,2608,1523,1085,19,15,10,9
11033,53233,443,53233,443,4114,2535,1579,25,139,13,12
11034,50621,80,31852,80,11975,10368,1607,27,52,16,11
11035,53246,443,53246,443,1419,788,631,15,121,8,7
11036,50665,443,26812,443,374,192,182,7,28,4,3
11037,26989,80,26989,80,256062,8754,247308,297,18,124,173
11038,52115,10012,62951,10012,66,66,0,1,5,1,0
11039,34043,443,15753,443,7280,4154,3126,30,735,16,14
11040,53247,443,53247,443,1528,757,771,19,121,9,10
11041,65218,53,51807,53,186,95,91,2,30,1,1
11042,52164,443,52164,443,20480,2066,18414,37,17,19,18
11043,11295,40040,53425,40040,213,89,124,4,54,2,2
11044,45908,33330,45908,33330,124,60,64,3,5,2,1
11045,58369,53,5499,53,174,81,93,2,30,1,1
11046,41889,443,23289,443,6516,1722,4794,26,17,15,11
11047,56289,53,51620,53,749,89,660,2,30,1,1
11048,7275,13487,0,0,66,66,0,1,91,1,0
11049,6881,51413,17965,51413,150,150,0,1,1200,1,0
11050,55370,53,18357,53,747,93,654,2,31,1,1
11051,55970,53,19238,53,760,97,663,2,31,1,1
11052,55284,443,12539,443,2895,726,2169,10,121,5,5
11053,50479,443,34516,443,5491,2608,2883,17,122,8,9
11054,56964,53,51072,53,174,89,85,2,31,1,1
11055,55492,53,58378,53,760,96,664,2,31,1,1
11056,56217,53,54817,53,182,93,89,2,31,1,1
11057,51566,443,53596,443,3051,990,2061,14,135,7,7
11058,55566,443,9542,443,8426,4752,3674,37,122,18,19
11059,44513,443,46778,443,3698,1302,2396,13,136,6,7
11060,34170,80,19669,80,1298,473,825,16,392,5,11
11061,55163,53,35742,53,194,99,95,2,31,1,1
11062,49695,53,13184,53,772,103,669,2,31,1,1
11063,64958,53,26216,53,194,99,95,2,31,1,1
11064,65287,53,9876,53,176,90,86,2,31,1,1
11065,56562,53,48636,53,182,93,89,2,31,1,1
11066,57129,53,40985,53,793,101,692,2,31,1,1
11067,6355,25174,0,0,146,146,0,1,0,1,0
11068,64665,445,0,0,70,70,0,1,0,1,0
11069,64666,445,0,0,70,70,0,1,0,1,0
11070,55439,37965,0,0,66,66,0,1,0,1,0
11071,49418,22114,0,0,66,66,0,1,0,1,0
11072,54473,37807,0,0,66,66,0,1,0,1,0
11073,53032,445,0,0,70,70,0,1,0,1,0
11074,53028,445,0,0,70,70,0,1,0,1,0
11075,53026,445,0,0,70,70,0,1,0,1,0
11076,53021,445,0,0,70,70,0,1,0,1,0
11077,64653,445,0,0,70,70,0,1,0,1,0
11078,64652,445,0,0,70,70,0,1,0,1,0
11079,64650,445,0,0,70,70,0,1,0,1,0
11080,64792,445,0,0,66,66,0,1,0,1,0
11081,64790,445,0,0,66,66,0,1,0,1,0
11082,64789,445,0,0,66,66,0,1,0,1,0
11083,64642,445,0,0,70,70,0,1,0,1,0
11084,64643,445,0,0,70,70,0,1,0,1,0
11085,23218,62413,0,0,66,66,0,1,0,1,0
11086,43260,41615,0,0,145,145,0,1,0,1,0
11087,58101,46314,0,0,72,72,0,1,0,1,0
11088,53015,445,0,0,70,70,0,1,0,1,0
11089,37308,43890,0,0,62,62,0,1,0,1,0
11090,64808,27098,0,0,66,66,0,1,0,1,0
11091,62580,23,0,0,60,60,0,1,0,1,0
11092,53010,445,0,0,70,70,0,1,0,1,0
11093,53007,445,0,0,70,70,0,1,0,1,0
11094,53004,445,0,0,70,70,0,1,0,1,0
11095,55985,44847,0,0,62,62,0,1,0,1,0
11096,11228,25174,0,0,66,66,0,1,0,1,0
11097,36339,50584,0,0,146,146,0,1,0,1,0
11098,13021,25174,0,0,146,146,0,1,0,1,0
11099,59032,25174,0,0,66,66,0,1,0,1,0
11100,64631,445,0,0,70,70,0,1,0,1,0
11101,13418,22,0,0,60,60,0,1,0,1,0
11102,61550,5529,0,0,145,145,0,1,0,1,0
11103,11235,30188,0,0,66,66,0,1,0,1,0
11104,52231,50934,0,0,62,62,0,1,0,1,0
11105,29884,25174,0,0,62,62,0,1,0,1,0
11106,34112,44847,0,0,62,62,0,1,0,1,0
11107,50765,22114,0,0,66,66,0,1,0,1,0
11108,52996,445,0,0,70,70,0,1,0,1,0
11109,52994,445,0,0,70,70,0,1,0,1,0
11110,52990,445,0,0,70,70,0,1,0,1,0
11111,6121,51505,0,0,66,66,0,1,0,1,0
11112,64627,445,0,0,70,70,0,1,0,1,0
11113,44919,26467,0,0,62,62,0,1,0,1,0
11114,1480,12447,0,0,66,66,0,1,0,1,0
11115,5213,44847,0,0,62,62,0,1,0,1,0
11116,64778,445,0,0,66,66,0,1,0,1,0
11117,61057,25174,0,0,62,62,0,1,0,1,0
11118,64617,445,0,0,70,70,0,1,0,1,0
11119,64618,445,0,0,70,70,0,1,0,1,0
11120,64615,445,0,0,70,70,0,1,0,1,0
11121,55451,56205,0,0,66,66,0,1,0,1,0
11122,65231,50584,0,0,62,62,0,1,0,1,0
11123,47403,57470,0,0,109,109,0,1,0,1,0
11124,64613,445,0,0,70,70,0,1,0,1,0
11125,64611,445,0,0,70,70,0,1,0,1,0
11126,59097,2767,0,0,66,66,0,1,0,1,0
11127,59807,53,15491,53,263,94,169,2,30,1,1
11128,52098,443,38562,443,3015,2037,978,15,15,9,6
11129,53433,443,53433,443,15095,2556,12539,37,102,15,22
11130,49874,53,62950,53,196,94,102,2,30,1,1
11131,46751,53,46751,53,220,90,130,2,30,1,1
11132,64788,53,23511,53,168,86,82,2,30,1,1
11133,38626,443,25389,443,97751,9140,88611,115,82,39,76
11134,22075,53,22075,53,404,259,145,3,33,2,1
11135,53167,22083,1777,22083,70,70,0,2,8,2,0
11136,64038,28187,42501,28187,70,70,0,1,4,1,0
11137,57999,80,9823,80,5434,3724,1710,26,76,14,12
11138,54530,443,34587,443,6202,3033,3169,28,167,13,15
11139,49256,53,36401,53,179,94,85,2,29,1,1
11140,49729,53,55522,53,210,102,108,2,30,1,1
11141,55790,53,39330,53,177,94,83,2,30,1,1
11142,38562,443,38562,443,4611,1704,2907,19,28,11,8
11143,50385,80,53379,80,28942,2526,26416,39,25,16,23
11144,55179,443,6638,443,5839,1984,3855,19,18,11,8
11145,64426,53,39298,53,669,200,469,6,49,3,3
11146,60985,443,55270,443,11535,4866,6669,34,50,20,14
11147,35017,443,23449,443,826,362,464,13,30,6,7
11148,53245,443,53245,443,1220,659,561,13,120,7,6
11149,37646,443,54992,443,11821,3643,8178,30,45,17,13
11150,53282,443,7574,443,604924,37384,567540,846,154,315,531
11151,40335,443,28601,443,4397,2104,2293,29,85,11,18
11152,49934,53,18444,53,478,107,371,4,39,2,2
11153,64032,12343,46737,12343,630,508,122,9,15,7,2
11154,60483,57723,53854,57723,320,140,180,6,6,3,3
11155,52146,18174,42084,18174,70,70,0,2,7,2,0
11156,53435,443,53435,443,2503,1457,1046,21,102,10,11
11157,56427,53,25251,53,178,94,84,2,29,1,1
11158,49532,53,58267,53,334,92,242,4,49,2,2
11159,56534,53,14913,53,177,94,83,2,29,1,1
11160,64886,53,49173,53,199,102,97,2,29,1,1
11161,56830,53,25316,53,195,102,93,2,29,1,1
11162,64886,53,44785,53,199,102,97,2,29,1,1
11163,56081,53,46764,53,186,102,84,2,29,1,1
11164,56712,53,4358,53,177,94,83,2,30,1,1
11165,65176,53,65083,53,183,94,89,2,30,1,1
11166,55991,53,30604,53,183,94,89,2,30,1,1
11167,51994,80,37899,80,366,240,126,7,26,5,2
11168,52148,80,52148,80,62796,1961,60835,72,141,26,46
11169,58832,443,61522,443,274798,9459,265339,343,201,136,207
11170,65488,53,3940,53,266,110,156,2,30,1,1
11171,57013,53,17393,53,178,94,84,2,30,1,1
11172,55700,53,12317,53,337,110,227,2,30,1,1
11173,55588,53,33689,53,168,86,82,2,31,1,1
11174,52153,12673,40206,12673,316,136,180,6,6,3,3
11175,33525,53,64644,53,179,86,93,2,30,1,1
11176,59019,53,48512,53,179,86,93,2,30,1,1
11177,64324,53,5232,53,344,105,239,4,33,2,2
11178,65460,53,23650,53,184,94,90,2,30,1,1
11179,54710,443,54710,443,32709,8467,24242,54,20,29,25
11180,52143,33283,63927,33283,70,70,0,2,8,2,0
11181,56661,53,2934,53,288,93,195,4,32,2,2
11182,52005,80,9480,80,46046,2705,43341,60,15,29,31
11183,37629,443,33990,443,172,172,0,2,5,2,0
11184,45694,80,47472,80,154671,9533,145138,227,38,121,106
11185,60797,28080,55300,28080,70,70,0,1,5,1,0
11186,65249,53,14438,53,1579,94,1485,4,36,2,2
11187,52114,64853,36038,64853,70,70,0,1,5,1,0
11188,60872,443,60963,443,10306,3254,7052,32,47,18,14
11189,53122,80,53122,80,19237,829,18408,29,15,13,16
11190,38627,443,6493,443,32864,2590,30274,41,82,14,27
11191,24566,53,24566,53,216,90,126,2,30,1,1
11192,49980,53,10608,53,503,103,400,4,47,2,2
11193,13003,3389,13003,3389,3424,1710,1714,16,33,8,8
11194,56937,8200,55532,8200,78,78,0,1,30,1,0
11195,64110,53,20636,53,215,102,113,2,30,1,1
11196,49358,443,12762,443,137147,82203,54944,174,105,103,71
11197,49776,53,49776,53,256,114,142,2,30,1,1
11198,56565,53,34463,53,164,86,78,2,30,1,1
11199,1876,53,51383,53,404,261,143,3,30,2,1
11200,56830,53,56847,53,195,102,93,2,30,1,1
11201,50378,53,48801,53,184,94,90,2,30,1,1
11202,53466,443,35377,443,7866,2625,5241,25,120,11,14
11203,49225,443,22877,443,11707,2326,9381,28,19,14,14
11204,49422,53,49422,53,247,98,149,2,32,1,1
11205,56661,53,16607,53,288,93,195,4,32,2,2
11206,47042,80,50684,80,1122,682,440,11,15,6,5
11207,60984,443,58411,443,12163,4876,7287,35,50,20,15
11208,38619,443,65221,443,469799,14616,455183,474,129,155,319
11209,57254,443,6263,443,3948,1290,2658,13,120,6,7
11210,51973,80,57539,80,426,240,186,8,26,5,3
11211,56556,443,40496,443,8908,1849,7059,31,105,17,14
11212,41474,443,57047,443,2767442,82304,2685138,2961,85,1088,1873
11213,31089,53,31089,53,197,90,107,2,30,1,1
11214,56406,53,15140,53,213,102,111,2,30,1,1
11215,57183,53,32090,53,178,94,84,2,30,1,1
11216,52176,443,22865,443,8048,1360,6688,24,23,12,12
11217,50620,80,32710,80,16709,10372,6337,31,52,16,15
11218,50586,80,48187,80,6718,3126,3592,16,78,8,8
11219,50596,80,46998,80,1598,937,661,13,78,7,6
11220,50579,80,47300,80,1827,989,838,13,78,7,6
11221,50590,80,16341,80,1507,951,556,13,78,7,6
11222,56661,53,21967,53,288,93,195,4,32,2,2
11223,52144,15208,25879,15208,70,70,0,2,8,2,0
11224,52003,80,9765,80,88807,5957,82850,113,15,54,59
11225,53434,443,53434,443,2511,1464,1047,21,102,10,11
11226,50668,80,30546,80,24370,5713,18657,37,26,17,20
11227,64865,53,49871,53,305,97,208,4,53,2,2
11228,57395,53,40276,53,262,88,174,4,58,2,2
11229,55524,53,55524,53,197,90,107,2,29,1,1
11230,58414,53,7367,53,245,118,127,2,29,1,1
11231,54961,53,50012,53,211,102,109,2,29,1,1
11232,53911,1025,4663,1025,70,70,0,1,4,1,0
11233,55690,443,36462,443,914,444,470,14,29,7,7
11234,56534,53,47047,53,177,94,83,2,29,1,1
11235,65092,53,28213,53,197,102,95,2,29,1,1
11236,65087,53,28763,53,229,94,135,2,30,1,1
11237,44176,443,60900,443,3327,1940,1387,19,22,10,9
11238,41473,443,44182,443,4987881,144889,4842992,5257,85,1888,3369
11239,53897,46913,50139,46913,552,306,246,9,15,5,4
11240,62497,443,15059,443,10393,7059,3334,27,26,15,12
11241,41283,53,41283,53,247,98,149,2,31,1,1
11242,55790,53,54535,53,177,94,83,2,30,1,1
11243,49656,443,43316,443,19544,4428,15116,79,119,39,40
11244,65482,53,62841,53,374,91,283,4,33,2,2
11245,57395,53,64683,53,262,88,174,4,58,2,2
11246,52116,64692,3805,64692,70,70,0,1,5,1,0
11247,59748,53,55446,53,230,110,120,2,29,1,1
11248,56415,53,33684,53,199,102,97,2,29,1,1
11249,59582,53,61781,53,256,102,154,2,29,1,1
11250,55626,53,3780,53,319,126,193,2,29,1,1
11251,51971,80,56168,80,426,240,186,8,26,5,3
11252,53715,53,53715,53,216,98,118,2,29,1,1
11253,52149,80,52149,80,2928,694,2234,13,141,6,7
11254,65266,53,53450,53,233,102,131,2,29,1,1
11255,56081,53,27644,53,186,102,84,2,29,1,1
11256,64058,53,58322,53,280,110,170,2,30,1,1
11257,56415,53,13196,53,199,102,97,2,29,1,1
11258,57177,443,54507,443,1610,771,839,22,120,11,11
11259,65176,53,64926,53,183,94,89,2,29,1,1
11260,64424,53,20113,53,194,94,100,2,30,1,1
11261,49165,53,42494,53,257,126,131,2,30,1,1
11262,58555,443,6848,443,15546,2361,13185,39,123,18,21
11263,50051,53,51528,53,766,102,664,2,30,1,1
11264,55991,53,7983,53,183,94,89,2,30,1,1
11265,53438,443,53438,443,2511,1465,1046,21,102,10,11
11266,33876,53,33876,53,404,259,145,3,32,2,1
11267,64749,53,28339,53,199,94,105,2,33,1,1
11268,55230,53,65301,53,467,96,371,4,44,2,2
11269,57984,80,44496,80,5474,3658,1816,27,76,14,13
11270,64237,53,55167,53,199,86,113,2,30,1,1
11271,65161,53,65161,53,256,114,142,2,30,1,1
11272,56415,53,9528,53,199,102,97,2,30,1,1
11273,33651,53,33651,53,197,90,107,2,30,1,1
11274,49218,53,31585,53,179,86,93,2,30,1,1
11275,55914,53,21562,53,212,102,110,2,30,1,1
11276,55163,53,9459,53,197,102,95,2,30,1,1
11277,46658,53,46658,53,216,98,118,2,30,1,1
11278,55792,53,55035,53,199,102,97,2,30,1,1
11279,49790,53,8407,53,229,110,119,2,30,1,1
11280,55790,53,27986,53,177,94,83,2,30,1,1
11281,64958,53,60361,53,197,102,95,2,30,1,1
11282,41810,443,22241,443,7474,2385,5089,15,121,7,8
11283,53548,443,18610,443,6812,1127,5685,24,255,11,13
11284,52117,20600,3356,20600,70,70,0,1,5,1,0
11285,62045,443,52563,443,10467,4259,6208,65,56,38,27
11286,64407,53,28727,53,291,94,197,2,30,1,1
11287,49759,53,39321,53,201,86,115,2,30,1,1
11288,65184,53,30460,53,225,102,123,2,30,1,1
11289,56273,53,28560,53,183,94,89,2,30,1,1
11290,65287,53,16028,53,180,94,86,2,30,1,1
11291,56068,53,21388,53,214,102,112,2,30,1,1
11292,53436,443,53436,443,2505,1460,1045,21,102,10,11
11293,37924,80,11096,80,214,140,74,4,15,3,1
11294,51972,80,30646,80,426,240,186,8,26,5,3
11295,54143,7000,54143,7000,770727,19843,750884,802,16,295,507
11296,49430,443,49430,443,4377,1470,2907,19,30,11,8
11297,57395,53,28814,53,262,88,174,4,59,2,2
11298,64922,53,12906,53,255,102,153,2,30,1,1
11299,64530,53,5563,53,264,110,154,2,30,1,1
11300,56565,53,24401,53,164,86,78,2,30,1,1
11301,56911,53,22477,53,211,78,133,2,30,1,1
11302,57013,53,1233,53,178,94,84,2,30,1,1
11303,49256,53,62875,53,179,94,85,2,30,1,1
11304,49932,53,43257,53,195,102,93,2,30,1,1
11305,51463,53,6551,53,417,86,331,2,31,1,1
11306,56217,53,61344,53,183,94,89,2,31,1,1
11307,50109,53,52643,53,198,110,88,2,31,1,1
11308,49334,53,44213,53,194,102,92,2,31,1,1
11309,64467,53,16595,53,184,94,90,2,31,1,1
11310,57183,53,6659,53,178,94,84,2,31,1,1
11311,55163,53,4604,53,197,102,95,2,31,1,1
11312,56195,53,13348,53,194,94,100,2,30,1,1
11313,56648,53,16460,53,199,102,97,2,31,1,1
11314,64995,53,32873,53,210,110,100,2,31,1,1
11315,56622,53,41480,53,179,94,85,2,31,1,1
11316,46440,443,14076,443,8465,3202,5263,23,120,10,13
11317,53246,443,25270,443,6574,1935,4639,14,121,7,7
11318,36972,443,35947,443,7557,3602,3955,20,150,12,8
11319,56964,53,57920,53,179,94,85,2,30,1,1
11320,64467,53,4748,53,184,94,90,2,30,1,1
11321,55633,53,30545,53,195,102,93,2,30,1,1
11322,49993,53,3383,53,211,102,109,2,30,1,1
11323,39890,123,28941,123,184,94,90,2,30,1,1
11324,65059,53,30320,53,168,86,82,2,31,1,1
11325,56878,53,49284,53,168,86,82,2,31,1,1
11326,56225,53,55911,53,183,94,89,2,31,1,1
11327,56414,53,33736,53,178,94,84,2,31,1,1
11328,21133,51413,27138,51413,460,150,310,2,1199,1,1
11329,43261,53,43261,53,247,98,149,2,34,1,1
11330,57432,53,57432,53,247,98,149,2,34,1,1
11331,65218,53,25461,53,833,290,543,8,88,4,4
11332,60886,443,45692,443,12652,6172,6480,44,16,26,18
11333,37628,443,18772,443,70,70,0,2,5,2,0
11334,9486,443,47731,443,3642,421,3221,12,16,6,6
11335,41475,443,20491,443,1251209,30056,1221153,1238,85,386,852
11336,59488,80,65175,80,1114,534,580,12,16,7,5
11337,61387,43890,0,0,66,66,0,1,0,1,0
11338,28436,22114,0,0,146,146,0,1,0,1,0
11339,52989,445,0,0,70,70,0,1,0,1,0
11340,22542,30188,0,0,62,62,0,1,0,1,0
11341,52988,445,0,0,70,70,0,1,0,1,0
11342,64727,25174,0,0,66,66,0,1,0,1,0
11343,59153,35440,0,0,66,66,0,1,0,1,0
11344,47632,25174,0,0,62,62,0,1,0,1,0
11345,7891,25174,0,0,66,66,0,1,0,1,0
11346,9329,2323,0,0,60,60,0,1,0,1,0
11347,64763,445,0,0,66,66,0,1,0,1,0
11348,64765,445,0,0,66,66,0,1,0,1,0
11349,64605,445,0,0,70,70,0,1,0,1,0
11350,25889,11446,0,0,66,66,0,1,0,1,0
11351,51042,22114,0,0,66,66,0,1,0,1,0
11352,50946,44847,0,0,66,66,0,1,0,1,0
11353,14489,25174,0,0,146,146,0,1,0,1,0
11354,64343,6004,0,0,66,66,0,1,0,1,0
11355,47342,20541,0,0,66,66,0,1,0,1,0
11356,59326,57470,0,0,74,74,0,1,0,1,0
11357,52977,445,0,0,70,70,0,1,0,1,0
11358,52978,445,0,0,70,70,0,1,0,1,0
11359,52974,445,0,0,70,70,0,1,0,1,0
11360,52976,445,0,0,70,70,0,1,0,1,0
11361,63743,25174,0,0,62,62,0,1,0,1,0
11362,3090,1,0,0,66,66,0,1,0,1,0
11363,64597,445,0,0,70,70,0,1,0,1,0
11364,31619,51221,0,0,62,62,0,1,0,1,0
11365,34166,22114,0,0,146,146,0,1,0,1,0
11366,64596,445,0,0,70,70,0,1,0,1,0
11367,64758,445,0,0,66,66,0,1,0,1,0
11368,54142,20541,0,0,62,62,0,1,0,1,0
11369,64751,445,0,0,66,66,0,1,0,1,0
11370,64746,445,0,0,66,66,0,1,0,1,0
11371,64749,445,0,0,66,66,0,1,0,1,0
11372,64748,445,0,0,66,66,0,1,0,1,0
11373,64744,445,0,0,66,66,0,1,0,1,0
11374,64745,445,0,0,66,66,0,1,0,1,0
11375,64742,445,0,0,66,66,0,1,0,1,0
11376,64591,445,0,0,70,70,0,1,0,1,0
11377,52962,445,0,0,70,70,0,1,0,1,0
11378,64589,445,0,0,70,70,0,1,0,1,0
11379,2919,37965,0,0,62,62,0,1,0,1,0
11380,60308,37965,0,0,66,66,0,1,0,1,0
11381,26921,26467,0,0,62,62,0,1,0,1,0
11382,52959,445,0,0,70,70,0,1,0,1,0
11383,52958,445,0,0,70,70,0,1,0,1,0
11384,52955,445,0,0,70,70,0,1,0,1,0
11385,46275,64147,0,0,62,62,0,1,0,1,0
11386,64772,64147,0,0,66,66,0,1,0,1,0
11387,61730,25320,0,0,66,66,0,1,0,1,0
11388,55069,44847,0,0,66,66,0,1,0,1,0
11389,25619,25174,0,0,146,146,0,1,0,1,0
11390,64585,445,0,0,70,70,0,1,0,1,0
11391,59782,26467,0,0,62,62,0,1,0,1,0
11392,56826,22114,0,0,66,66,0,1,0,1,0
11393,36858,50265,0,0,146,146,0,1,0,1,0
11394,14208,51221,0,0,66,66,0,1,0,1,0
11395,64583,445,0,0,70,70,0,1,0,1,0
11396,27841,35894,0,0,62,62,0,1,0,1,0
11397,13528,51221,0,0,62,62,0,1,0,1,0
11398,4138,55777,0,0,66,66,0,1,0,1,0
11399,65025,57866,0,0,62,62,0,1,0,1,0
11400,31845,55777,0,0,62,62,0,1,0,1,0
11401,52951,445,0,0,70,70,0,1,0,1,0
11402,52949,445,0,0,70,70,0,1,0,1,0
11403,52950,445,0,0,70,70,0,1,0,1,0
11404,64737,445,0,0,66,66,0,1,0,1,0
11405,52946,445,0,0,70,70,0,1,0,1,0
11406,49929,26467,0,0,66,66,0,1,0,1,0
11407,64733,445,0,0,66,66,0,1,0,1,0
11408,3981,23117,0,0,66,66,0,1,0,1,0
11409,36548,25174,0,0,146,146,0,1,0,1,0
11410,60479,25174,0,0,66,66,0,1,0,1,0
11411,64730,445,0,0,66,66,0,1,0,1,0
11412,64729,445,0,0,66,66,0,1,0,1,0
11413,64579,445,0,0,70,70,0,1,0,1,0
11414,64727,445,0,0,66,66,0,1,0,1,0
11415,5955,55160,0,0,74,74,0,1,0,1,0
11416,443,56513,0,0,78,78,0,1,0,1,0
11417,17280,22114,0,0,62,62,0,1,0,1,0
11418,26879,37965,0,0,62,62,0,1,0,1,0
11419,443,54154,0,0,60,60,0,1,0,1,0
11420,64295,26467,0,0,66,66,0,1,0,1,0
11421,52941,445,0,0,70,70,0,1,0,1,0
11422,443,28553,0,0,74,74,0,1,0,1,0
11423,52932,445,0,0,70,70,0,1,0,1,0
11424,52931,445,0,0,70,70,0,1,0,1,0
11425,64016,25174,0,0,62,62,0,1,0,1,0
11426,52430,22114,0,0,62,62,0,1,0,1,0
11427,57420,22114,0,0,62,62,0,1,0,1,0
11428,56614,25174,0,0,66,66,0,1,0,1,0
11429,55587,43890,0,0,66,66,0,1,0,1,0
11430,64566,445,0,0,70,70,0,1,0,1,0
11431,64716,445,0,0,66,66,0,1,0,1,0
11432,35356,25174,0,0,146,146,0,1,0,1,0
11433,59214,57866,0,0,66,66,0,1,0,1,0
11434,26802,50584,0,0,62,62,0,1,0,1,0
11435,64563,445,0,0,70,70,0,1,0,1,0
11436,57131,35776,0,0,145,145,0,1,0,1,0
11437,18113,22114,0,0,146,146,0,1,0,1,0
11438,53097,25174,0,0,62,62,0,1,0,1,0
11439,56406,22114,0,0,62,62,0,1,0,1,0
11440,64708,445,0,0,66,66,0,1,0,1,0
11441,28570,25174,0,0,146,146,0,1,0,1,0
11442,52918,445,0,0,70,70,0,1,0,1,0
11443,15701,37965,0,0,146,146,0,1,0,1,0
11444,56387,25174,0,0,62,62,0,1,0,1,0
11445,62575,12207,0,0,66,66,0,1,0,1,0
11446,63587,22114,0,0,146,146,0,1,0,1,0
11447,55312,64147,0,0,66,66,0,1,0,1,0
11448,64705,445,0,0,66,66,0,1,0,1,0
11449,64559,445,0,0,70,70,0,1,0,1,0
11450,64557,445,0,0,70,70,0,1,0,1,0
11451,8999,8055,0,0,146,146,0,1,0,1,0
11452,53161,51221,0,0,66,66,0,1,0,1,0
11453,38330,44847,0,0,66,66,0,1,0,1,0
11454,64555,445,0,0,70,70,0,1,0,1,0
11455,53381,25174,0,0,66,66,0,1,0,1,0
11456,61660,64097,0,0,62,62,0,1,0,1,0
11457,64698,445,0,0,66,66,0,1,0,1,0
11458,4232,50584,0,0,66,66,0,1,0,1,0
11459,58007,62413,0,0,66,66,0,1,0,1,0
11460,64689,445,0,0,66,66,0,1,0,1,0
11461,15806,11392,0,0,66,66,0,1,0,1,0
11462,49684,80,60336,80,13889,4084,9805,27,16,13,14
11463,52108,20175,4699,20175,66,66,0,1,5,1,0
11464,37642,443,20516,443,69348,4180,65168,86,45,37,49
11465,60389,80,65223,80,2499,531,1968,11,125,6,5
11466,56480,80,24972,80,289731,8487,281244,294,136,104,190
11467,56482,80,53743,80,180583,6825,173758,188,136,68,120
11468,44977,443,32272,443,4848,1030,3818,16,26,9,7
11469,56922,53,43765,53,86,86,0,1,30,1,0
11470,60388,80,7152,80,2424,529,1895,11,125,6,5
11471,50375,443,2479,443,5419,705,4714,16,25,8,8
11472,50367,443,43632,443,1630,916,714,12,25,7,5
11473,50366,443,19959,443,1755,986,769,13,25,8,5
11474,55390,443,55390,443,164571,13257,151314,206,19,95,111
11475,65073,80,65073,80,169702,10513,159189,187,23,72,115
11476,56481,80,14814,80,71347,4788,66559,83,136,34,49
11477,58874,443,22621,443,4738,1023,3715,18,66,10,8
11478,64473,7000,64473,7000,3434,1595,1839,17,15,9,8
11479,45079,443,33534,443,7298,2661,4637,21,18,11,10
11480,49627,53,55437,53,760,97,663,2,30,1,1
11481,64051,19548,46632,19548,66,66,0,2,8,2,0
11482,52142,54954,50454,54954,70,70,0,2,8,2,0
11483,64056,51266,62758,51266,66,66,0,2,8,2,0
11484,37640,443,4915,443,11442,3116,8326,32,46,19,13
11485,60498,443,60498,443,8233,948,7285,18,30,10,8
11486,36951,443,31916,443,70,70,0,1,5,1,0
11487,37632,443,56701,443,11338,2980,8358,31,46,18,13
11488,56478,80,51578,80,73400,4542,68858,87,136,37,50
11489,41895,443,48920,443,282,60,222,5,14,2,3
11490,51979,80,40174,80,366,240,126,7,25,5,2
11491,60478,30889,28285,30889,1303,903,400,12,16,7,5
11492,55991,53,53761,53,182,93,89,2,30,1,1
11493,64945,53,11913,53,760,97,663,2,30,1,1
11494,56483,80,37968,80,82266,4947,77319,94,136,37,57
11495,50604,443,49840,443,7470,2479,4991,20,135,9,11
11496,51980,80,2288,80,366,240,126,7,25,5,2
11497,49951,80,49951,80,24361943,451235,23910708,22804,63,6533,16271
11498,34346,443,57407,443,3497,1845,1652,18,15,9,9
11499,54142,7000,54142,7000,4067,1750,2317,16,16,9,7
11500,43357,443,31552,443,6392,1099,5293,18,33,10,8
11501,53906,12051,58772,12051,164,70,94,2,5,1,1
11502,57183,53,27398,53,172,88,84,2,30,1,1
11503,52109,60841,45067,60841,156,66,90,2,5,1,1
11504,52110,35411,30183,35411,66,66,0,1,5,1,0
11505,49328,443,21805,443,74569,3173,71396,97,80,36,61
11506,64432,53,46411,53,168,86,82,2,30,1,1
11507,56622,53,20942,53,174,89,85,2,31,1,1
11508,55594,53,44459,53,752,93,659,2,31,1,1
11509,50022,53,60834,53,174,89,85,2,31,1,1
11510,56258,53,50751,53,772,103,669,2,30,1,1
11511,64467,53,11977,53,184,94,90,2,30,1,1
11512,64702,53,11324,53,760,97,663,2,31,1,1
11513,64580,53,16498,53,176,90,86,2,31,1,1
11514,56125,53,8463,53,168,86,82,2,31,1,1
11515,56239,53,24103,53,176,90,86,2,31,1,1
11516,56648,53,6533,53,198,101,97,2,31,1,1
11517,57040,53,44476,53,174,89,85,2,31,1,1
11518,56153,53,6546,53,742,88,654,2,31,1,1
11519,54340,443,13340,443,3176,752,2424,10,121,5,5
11520,63601,443,6476,443,26835,2611,24224,36,121,14,22
11521,54329,443,7872,443,7827,2416,5411,18,136,8,10
11522,46525,5228,57899,5228,1410,933,477,11,3601,6,5
11523,64995,53,18804,53,204,104,100,2,31,1,1
11524,56198,53,15932,53,789,110,679,2,31,1,1
11525,64839,53,19060,53,208,106,102,2,31,1,1
11526,56143,53,31546,53,748,106,642,2,31,1,1
11527,60896,53,29321,53,168,78,90,2,31,1,1
11528,56820,53,32969,53,186,95,91,2,31,1,1
11529,55662,53,51499,53,753,93,660,2,31,1,1
11530,57836,443,52669,443,15844,1691,14153,18,138,5,13
11531,65412,53,28937,53,782,105,677,2,31,1,1
11532,56827,53,43714,53,190,97,93,2,31,1,1
11533,65409,53,26325,53,753,93,660,2,31,1,1
11534,65531,53,43079,53,186,95,91,2,31,1,1
11535,56792,53,2003,53,782,105,677,2,31,1,1
11536,56928,53,48986,53,172,88,84,2,31,1,1
11537,50550,443,16736,443,4551,2140,2411,14,135,6,8
11538,51683,5228,43500,5228,9476,2759,6717,27,3601,15,12
11539,56468,53,40699,53,1421,97,1324,4,55,2,2
11540,57440,53,36326,53,198,101,97,2,31,1,1
11541,40458,53,17783,53,168,78,90,2,31,1,1
11542,49900,443,9178,443,6300,2644,3656,16,121,8,8
11543,57470,39541,8082,39541,792,792,0,13,1200,13,0
11544,49485,56972,0,0,66,66,0,1,0,1,0
11545,37014,25174,0,0,66,66,0,1,0,1,0
11546,57251,37965,0,0,62,62,0,1,0,1,0
11547,48978,25174,0,0,66,66,0,1,0,1,0
11548,42981,44847,0,0,62,62,0,1,0,1,0
11549,62250,23117,0,0,66,66,0,1,0,1,0
11550,64548,445,0,0,70,70,0,1,0,1,0
11551,59282,51050,0,0,62,62,0,1,0,1,0
11552,64546,445,0,0,70,70,0,1,0,1,0
11553,52907,445,0,0,70,70,0,1,0,1,0
11554,52906,445,0,0,70,70,0,1,0,1,0
11555,64675,445,0,0,66,66,0,1,0,1,0
11556,64678,445,0,0,66,66,0,1,0,1,0
11557,64679,445,0,0,66,66,0,1,0,1,0
11558,64681,445,0,0,66,66,0,1,0,1,0
11559,64683,445,0,0,66,66,0,1,0,1,0
11560,64682,445,0,0,66,66,0,1,0,1,0
11561,64680,445,0,0,66,66,0,1,0,1,0
11562,64677,445,0,0,66,66,0,1,0,1,0
11563,48676,53395,0,0,60,60,0,1,0,1,0
11564,44285,25174,0,0,146,146,0,1,0,1,0
11565,60113,22114,0,0,66,66,0,1,0,1,0
11566,59303,21247,0,0,62,62,0,1,0,1,0
11567,64545,445,0,0,70,70,0,1,0,1,0
11568,26884,37965,0,0,66,66,0,1,0,1,0
11569,64544,445,0,0,70,70,0,1,0,1,0
11570,64543,445,0,0,70,70,0,1,0,1,0
11571,49689,22114,0,0,62,62,0,1,0,1,0
11572,64539,445,0,0,70,70,0,1,0,1,0
11573,64538,445,0,0,70,70,0,1,0,1,0
11574,12830,25174,0,0,62,62,0,1,0,1,0
11575,51930,57470,0,0,66,66,0,1,0,1,0
11576,7588,1962,0,0,60,60,0,1,0,1,0
11577,2780,23117,0,0,66,66,0,1,0,1,0
11578,54011,44847,0,0,66,66,0,1,0,1,0
11579,64525,445,0,0,70,70,0,1,0,1,0
11580,64524,445,0,0,70,70,0,1,0,1,0
11581,64520,445,0,0,70,70,0,1,0,1,0
11582,52904,445,0,0,70,70,0,1,0,1,0
11583,52903,445,0,0,70,70,0,1,0,1,0
11584,52891,445,0,0,70,70,0,1,0,1,0
11585,52889,445,0,0,70,70,0,1,0,1,0
11586,3764,9694,0,0,66,66,0,1,0,1,0
11587,64515,445,0,0,70,70,0,1,0,1,0
11588,64514,445,0,0,70,70,0,1,0,1,0
11589,16620,25174,0,0,62,62,0,1,0,1,0
11590,64662,445,0,0,66,66,0,1,0,1,0
11591,64661,445,0,0,66,66,0,1,0,1,0
11592,64660,445,0,0,66,66,0,1,0,1,0
11593,4111,25174,0,0,62,62,0,1,0,1,0
11594,38053,50584,0,0,62,62,0,1,0,1,0
11595,57550,50584,0,0,66,66,0,1,0,1,0
11596,64363,22114,0,0,66,66,0,1,0,1,0
11597,19594,23117,0,0,66,66,0,1,0,1,0
11598,58266,443,20650,443,5619,1387,4232,18,205,10,8
11599,50527,53,64659,53,969,86,883,2,30,1,1
11600,29268,53,40863,53,220,78,142,2,30,1,1
11601,50202,53,17431,53,166,86,80,2,30,1,1
11602,48372,8100,19668,8100,234,234,0,4,11,4,0
11603,53902,55298,56516,55298,70,70,0,1,4,1,0
11604,55792,53,52460,53,199,102,97,2,29,1,1
11605,57183,53,22943,53,178,94,84,2,29,1,1
11606,56562,53,61427,53,183,94,89,2,30,1,1
11607,38624,443,30332,443,6385,1090,5295,18,33,10,8
11608,56562,53,42626,53,183,94,89,2,30,1,1
11609,33906,80,51887,80,1248,660,588,8,15,4,4
11610,64031,25933,32039,25933,436,254,182,7,14,4,3
11611,40865,8100,38607,8100,234,234,0,4,11,4,0
11612,41313,53,41313,53,404,259,145,3,32,2,1
11613,40651,443,45721,443,41517,28432,13085,89,601,47,42
11614,53904,1024,55644,1024,70,70,0,1,4,1,0
11615,41472,443,61400,443,680618,28384,652234,828,84,356,472
11616,53903,51339,10537,51339,70,70,0,1,4,1,0
11617,14442,443,28353,443,2601,1455,1146,18,15,8,10
11618,57605,443,60913,443,2614,1689,925,18,20,10,8
11619,59254,443,5881,443,8332,1024,7308,21,25,11,10
11620,52113,19619,19801,19619,70,70,0,1,4,1,0
11621,55404,53,35517,53,326,102,224,2,29,1,1
11622,57419,53,24851,53,326,110,216,2,29,1,1
11623,55633,53,59677,53,195,102,93,2,30,1,1
11624,49826,53,41958,53,279,95,184,4,59,2,2
11625,57013,53,50114,53,178,94,84,2,29,1,1
11626,49808,53,25125,53,268,102,166,2,29,1,1
11627,56535,443,1772,443,185925,12445,173480,210,105,82,128
11628,62917,993,58803,993,9056,4223,4833,82,35,42,40
11629,49227,2710,36226,2710,70,70,0,2,8,2,0
11630,37999,49152,14143,49152,156,156,0,3,8,3,0
11631,60869,443,60836,443,10630,3315,7315,27,46,15,12
11632,56013,443,56013,443,4599,1692,2907,19,26,11,8
11633,51967,80,56439,80,426,240,186,8,25,5,3
11634,51975,80,44833,80,426,240,186,8,25,5,3
11635,41471,443,22977,443,1973617,48070,1925547,1945,84,606,1339
11636,57440,53,5992,53,199,102,97,2,30,1,1
11637,55900,53,13889,53,194,102,92,2,30,1,1
11638,56835,53,43767,53,213,102,111,2,30,1,1
11639,40597,443,45954,443,11101,4498,6603,35,430,20,15
11640,54787,443,54787,443,18160,6539,11621,37,19,22,15
11641,58392,53,58392,53,404,259,145,3,33,2,1
11642,53128,443,20598,443,14603,4208,10395,39,48,20,19
11643,51480,3027,51480,3027,156,156,0,3,8,3,0
11644,58879,443,43164,443,10439,1785,8654,25,85,10,15
11645,51579,443,8189,443,1522,1210,312,9,28,4,5
11646,52140,53155,1111,53155,70,70,0,2,8,2,0
11647,50369,443,20659,443,8048,1189,6859,19,25,10,9
11648,60868,443,49136,443,9660,2402,7258,27,46,15,12
11649,51962,80,39391,80,422,240,182,8,25,5,3
11650,58004,80,58289,80,14922,10566,4356,39,75,20,19
11651,35811,443,26946,443,13562,3104,10458,38,201,22,16
11652,46512,443,4517,443,22641,10532,12109,62,200,35,27
11653,56494,80,51723,80,44136,2908,41228,56,135,25,31
11654,56488,80,17378,80,64702,3709,60993,76,135,30,46
11655,49750,5223,50752,5223,46785,27735,19050,232,5491,123,109
11656,56225,53,43887,53,183,94,89,2,30,1,1
11657,43862,443,61828,443,6600,1174,5426,23,62,13,10
11658,49773,53,20298,53,994,86,908,2,30,1,1
11659,51968,80,1754,80,366,240,126,7,25,5,2
11660,56827,53,56181,53,195,102,93,2,30,1,1
11661,51976,80,64058,80,366,240,126,7,25,5,2
11662,33462,53,33462,53,256,114,142,2,30,1,1
11663,55991,53,41227,53,183,94,89,2,30,1,1
11664,64904,53,1451,53,211,102,109,2,30,1,1
11665,50202,53,23143,53,166,86,80,2,30,1,1
11666,65059,53,35510,53,168,86,82,2,30,1,1
11667,48856,53,0,0,86,86,0,1,30,1,0
11668,40403,53,40667,53,199,94,105,2,30,1,1
11669,57002,53,39237,53,211,94,117,2,30,1,1
11670,50109,53,42164,53,198,110,88,2,30,1,1
11671,56532,443,14584,443,198167,11702,186465,220,105,84,136
11672,56125,53,57582,53,168,86,82,2,30,1,1
11673,41176,443,1178,443,31541,25324,6217,49,91,29,20
11674,64432,53,45713,53,168,86,82,2,30,1,1
11675,35809,443,51066,443,13084,2704,10380,36,201,21,15
11676,56356,53,61835,53,184,102,82,2,30,1,1
11677,65070,80,65070,80,145038,9857,135181,162,23,62,100
11678,50337,53,50337,53,260,106,154,2,30,1,1
11679,56683,443,65170,443,268,120,148,5,11,3,2
11680,51969,80,59733,80,366,240,126,7,25,5,2
11681,53892,25933,31211,25933,552,306,246,9,15,5,4
11682,51974,80,51357,80,426,240,186,8,25,5,3
11683,51977,80,40997,80,366,240,126,7,25,5,2
11684,57994,80,57049,80,2494,1540,954,21,75,11,10
11685,65071,80,65071,80,296372,11959,284413,311,23,113,198
11686,65067,80,65067,80,342198,13793,328405,355,23,126,229
11687,64030,53,64891,53,222,78,144,2,30,1,1
11688,56622,53,24570,53,179,94,85,2,30,1,1
11689,35117,443,10765,443,8866,4928,3938,26,121,13,13
11690,57996,80,13904,80,5411,3618,1793,27,75,14,13
11691,49296,53,40688,53,322,98,224,4,32,2,2
11692,42342,443,63705,443,494,198,296,8,17,4,4
11693,58001,80,18559,80,20532,14664,5868,47,75,24,23
11694,58003,80,63884,80,14987,10571,4416,40,75,20,20
11695,62041,443,33913,443,29329,6712,22617,54,60,23,31
11696,58681,443,24073,443,22576,10533,12043,61,200,35,26
11697,35742,443,2430,443,5612,1251,4361,22,65,12,10
11698,51970,80,32175,80,366,240,126,7,25,5,2
11699,51964,80,61928,80,306,120,186,6,25,3,3
11700,56487,80,45530,80,42070,2703,39367,53,135,22,31
11701,56491,80,30431,80,37154,2381,34773,50,135,23,27
11702,65109,53,18311,53,753,94,659,2,30,1,1
11703,48209,53,48209,53,628,82,546,2,30,1,1
11704,5431,53,64205,53,220,78,142,2,30,1,1
11705,49681,443,34762,443,7383,2461,4922,18,135,8,10
11706,51985,80,32955,80,1479,822,657,11,25,7,4
11707,1294,53,1294,53,216,82,134,2,32,1,1
11708,37627,443,10583,443,70,70,0,2,5,2,0
11709,9461,443,60064,443,2581,1602,979,17,20,9,8
11710,58000,80,21507,80,48253,13664,34589,66,75,25,41
11711,57995,80,53962,80,4065,2650,1415,25,75,13,12
11712,34331,443,59493,443,9415,3998,5417,23,301,11,12
11713,50380,443,13367,443,306,180,126,6,25,4,2
11714,51961,80,32070,80,26804,11349,15455,45,26,25,20
11715,58008,80,56721,80,2549,1595,954,21,75,11,10
11716,35338,443,31577,443,571121,38361,532760,718,69,342,376
11717,56531,443,49300,443,215863,14423,201440,245,105,95,150
11718,50336,80,50336,80,2143,676,1467,12,25,7,5
11719,56534,443,29507,443,265430,17951,247479,305,105,122,183
11720,60497,443,60497,443,12727,948,11779,21,30,10,11
11721,51993,80,56681,80,482,300,182,9,25,6,3
11722,51991,80,57002,80,482,300,182,9,25,6,3
11723,47834,443,47834,443,4716,1809,2907,19,26,11,8
11724,33150,53,63816,53,816,228,588,8,29,4,4
11725,49330,443,57448,443,137414,6004,131410,170,80,59,111
11726,64615,53,56632,53,395,89,306,4,32,2,2
11727,60601,443,55669,443,6180,926,5254,18,36,10,8
11728,56562,53,4746,53,183,94,89,2,29,1,1
11729,38000,49152,22175,49152,156,156,0,3,8,3,0
11730,64055,45105,11907,45105,66,66,0,2,7,2,0
11731,56217,53,16338,53,183,94,89,2,29,1,1
11732,64053,47783,54848,47783,66,66,0,2,7,2,0
11733,56004,443,46384,443,130,70,60,3,4,2,1
11734,55404,443,49426,443,70,70,0,1,5,1,0
11735,50374,443,56948,443,5359,705,4654,15,25,8,7
11736,64432,53,49029,53,168,86,82,2,30,1,1
11737,50373,443,34130,443,5422,707,4715,16,25,8,8
11738,56484,80,16261,80,97842,4441,93401,109,135,41,68
11739,56489,80,59923,80,118508,4979,113529,128,135,48,80
11740,56486,80,1722,80,46682,3447,43235,61,135,27,34
11741,56492,80,31421,80,74105,3416,70689,84,135,32,52
11742,62921,993,3682,993,8856,4253,4603,79,27,42,37
11743,56477,80,20829,80,95037,3407,91630,103,135,38,65
11744,65287,53,49493,53,180,94,86,2,30,1,1
11745,56217,53,53375,53,183,94,89,2,30,1,1
11746,50022,53,3051,53,179,94,85,2,30,1,1
11747,44846,53,44846,53,86,86,0,1,30,1,0
11748,49631,53,24676,53,184,102,82,2,30,1,1
11749,56333,53,59595,53,209,110,99,2,31,1,1
11750,57130,443,51431,443,10724,3758,6966,38,403,13,25
11751,38011,443,62208,443,14337,3375,10962,47,121,23,24
11752,37427,443,40807,443,26069,12062,14007,46,123,21,25
11753,14697,8000,41154,8000,274,150,124,4,60,2,2
11754,49334,53,34104,53,194,102,92,2,30,1,1
11755,64958,53,14759,53,197,102,95,2,30,1,1
11756,56733,53,5625,53,183,94,89,2,30,1,1
11757,64995,53,14595,53,210,110,100,2,30,1,1
11758,65240,53,39958,53,199,94,105,2,30,1,1
11759,64580,53,3526,53,180,94,86,2,30,1,1
11760,57440,53,58703,53,199,102,97,2,30,1,1
11761,59833,53,25424,53,195,94,101,2,30,1,1
11762,56922,53,63628,53,168,86,82,2,31,1,1
11763,51963,80,35774,80,422,240,182,8,25,5,3
11764,56485,80,57235,80,46400,3639,42761,59,135,25,34
11765,51978,80,26908,80,4612,3409,1203,14,25,9,5
11766,37222,443,57670,443,4713,895,3818,18,16,10,8
11767,56495,80,7502,80,32396,2695,29701,46,135,22,24
11768,56493,80,12499,80,65864,3286,62578,76,135,30,46
11769,55337,443,55337,443,7710,3932,3778,23,18,14,9
11770,54636,443,3394,443,311000,8576,302424,319,175,103,216
11771,49826,53,26730,53,650,286,364,8,84,4,4
11772,56837,53,1718,53,227,110,117,2,30,1,1
11773,64340,53,7157,53,266,110,156,2,30,1,1
11774,65136,53,36348,53,438,180,258,6,30,3,3
11775,56648,53,49574,53,199,102,97,2,30,1,1
11776,56622,53,6660,53,340,107,233,4,30,2,2
11777,56572,53,50763,53,438,180,258,6,30,3,3
11778,61948,53,63047,53,205,86,119,2,30,1,1
11779,28679,3389,28679,3389,3910,1805,2105,20,19,12,8
11780,59248,443,51315,443,8332,1024,7308,21,25,11,10
11781,37630,443,19874,443,10000,2634,7366,28,46,16,12
11782,35810,443,44672,443,13706,3115,10591,40,201,22,18
11783,45397,443,38399,443,970804,44459,926345,1113,200,446,667
11784,51965,80,11220,80,306,120,186,6,25,3,3
11785,60871,443,24250,443,8338,3198,5140,28,46,16,12
11786,64587,443,60822,443,24686,1935,22751,36,18,17,19
11787,65072,80,65072,80,250600,11390,239210,268,23,98,170
11788,33640,53,0,0,139,70,69,2,30,1,1
11789,34062,443,2265,443,3208,2015,1193,19,34,11,8
11790,55290,53,19726,53,198,94,104,2,30,1,1
11791,49818,53,62354,53,751,94,657,2,30,1,1
11792,55570,53,7060,53,889,404,485,10,30,5,5
11793,55995,53,56863,53,182,94,88,2,30,1,1
11794,49815,53,3379,53,789,110,679,2,31,1,1
11795,56536,443,5996,443,210110,14803,195307,246,105,103,143
11796,56533,443,15782,443,306579,19447,287132,335,105,129,206
11797,42672,443,42672,443,4378,1471,2907,19,30,11,8
11798,58005,80,36908,80,14927,10571,4356,39,75,20,19
11799,50368,443,46131,443,8048,1189,6859,19,25,10,9
11800,62924,993,52929,993,9376,4359,5017,86,19,44,42
11801,51966,80,49895,80,366,240,126,7,25,5,2
11802,56490,80,11731,80,43084,3056,40028,60,135,27,33
11803,64946,53,5511,53,452,118,334,2,30,1,1
11804,64580,53,18330,53,180,94,86,2,30,1,1
11805,49561,53,14887,53,211,94,117,2,30,1,1
11806,49381,53,1330,53,209,110,99,2,30,1,1
11807,49295,53,60068,53,172,94,78,2,30,1,1
11808,56356,53,24415,53,184,102,82,2,30,1,1
11809,57440,53,28373,53,199,102,97,2,30,1,1
11810,49257,53,41185,53,166,86,80,2,30,1,1
11811,49492,53,44432,53,199,102,97,2,30,1,1
11812,44846,53,44846,53,653,349,304,5,30,3,2
11813,65107,53,32581,53,266,110,156,2,30,1,1
11814,50250,53,63565,53,178,94,84,2,31,1,1
11815,57040,53,36140,53,179,94,85,2,31,1,1
11816,49532,53,28306,53,730,102,628,2,31,1,1
11817,63463,443,46376,443,3182,1568,1614,8,120,4,4
11818,52520,443,9446,443,4463,1215,3248,16,121,8,8
11819,41098,443,2984,443,3384,762,2622,15,135,7,8
11820,50265,58840,23141,58840,132,132,0,3,1200,3,0
11821,49538,53,45151,53,748,94,654,2,30,1,1
11822,55900,53,53468,53,194,102,92,2,30,1,1
11823,49889,53,48150,53,197,102,95,2,31,1,1
11824,56239,53,30874,53,180,94,86,2,31,1,1
11825,50523,53,7142,53,168,86,82,2,31,1,1
11826,64422,53,12114,53,180,94,86,2,31,1,1
11827,60191,53,31189,53,196,94,102,2,31,1,1
11828,49492,53,34957,53,199,102,97,2,31,1,1
11829,57204,53,62909,53,195,102,93,2,31,1,1
11830,44974,443,22658,443,17760,13913,3847,54,167,25,29
11831,63464,443,53137,443,5614,2964,2650,19,120,9,10
11832,62066,443,9765,443,3150,831,2319,13,135,6,7
11833,38721,443,64394,443,10216,3380,6836,26,120,12,14
11834,6881,35179,42052,35179,228,118,110,2,1199,1,1
11835,49660,443,16842,443,3721,1477,2244,15,121,8,7
11836,53212,443,49183,443,4681,2403,2278,19,135,10,9
11837,50265,25490,26928,25490,1766,1332,434,22,1200,15,7
11838,50265,5554,7404,5554,472,150,322,2,1200,1,1
11839,6881,50239,58874,50239,3514,1874,1640,15,1200,8,7
11840,64116,53,6578,53,267,94,173,4,59,2,2
11841,49631,53,37899,53,184,102,82,2,30,1,1
11842,64229,53,36573,53,266,110,156,2,31,1,1
11843,57281,443,25432,443,212477,8324,204153,232,122,79,153
11844,55106,443,7279,443,3411,887,2524,12,120,6,6
11845,50265,49754,28018,49754,402,132,270,6,1209,3,3
11846,55555,53,4576,53,194,102,92,2,31,1,1
11847,55996,443,19878,443,5323,2482,2841,31,19,15,16
11848,36628,80,65040,80,78,78,0,1,5,1,0
11849,64580,53,58707,53,425,90,335,4,43,2,2
11850,53917,35885,30826,35885,70,70,0,2,8,2,0
11851,56473,80,3557,80,48910,2361,46549,63,135,29,34
11852,34416,443,60300,443,10255,2803,7452,35,26,18,17
11853,65280,53,19530,53,166,86,80,2,31,1,1
11854,64033,29834,16078,29834,70,70,0,1,5,1,0
11855,5588,5588,0,0,3562,1936,1626,48,195,24,24
11856,60899,25174,0,0,66,66,0,1,0,1,0
11857,57348,25174,0,0,62,62,0,1,0,1,0
11858,49993,37965,0,0,66,66,0,1,0,1,0
11859,27922,25174,0,0,62,62,0,1,0,1,0
11860,52886,445,0,0,70,70,0,1,0,1,0
11861,9212,51505,0,0,62,62,0,1,0,1,0
11862,52885,445,0,0,70,70,0,1,0,1,0
11863,52881,445,0,0,70,70,0,1,0,1,0
11864,52876,445,0,0,70,70,0,1,0,1,0
11865,45218,25174,0,0,62,62,0,1,0,1,0
11866,64503,445,0,0,70,70,0,1,0,1,0
11867,26311,23,0,0,60,60,0,1,0,1,0
11868,28649,43890,0,0,66,66,0,1,0,1,0
11869,10003,64147,0,0,62,62,0,1,0,1,0
11870,11136,19910,0,0,62,62,0,1,0,1,0
11871,55155,2767,0,0,66,66,0,1,0,1,0
11872,17262,25174,0,0,62,62,0,1,0,1,0
11873,6666,3389,0,0,60,60,0,1,0,1,0
11874,1280,25174,0,0,66,66,0,1,0,1,0
11875,59810,6004,0,0,66,66,0,1,0,1,0
11876,35058,23,0,0,60,60,0,1,0,1,0
11877,27046,51505,0,0,66,66,0,1,0,1,0
11878,64499,445,0,0,70,70,0,1,0,1,0
11879,59436,22114,0,0,66,66,0,1,0,1,0
11880,52869,445,0,0,70,70,0,1,0,1,0
11881,52867,445,0,0,70,70,0,1,0,1,0
11882,52866,445,0,0,70,70,0,1,0,1,0
11883,65389,26467,0,0,62,62,0,1,0,1,0
11884,2332,35440,0,0,62,62,0,1,0,1,0
11885,62579,57866,0,0,62,62,0,1,0,1,0
11886,26698,25174,0,0,66,66,0,1,0,1,0
11887,64490,445,0,0,70,70,0,1,0,1,0
11888,64489,445,0,0,70,70,0,1,0,1,0
11889,64487,445,0,0,70,70,0,1,0,1,0
11890,64551,2310,0,0,143,143,0,1,0,1,0
11891,33973,50265,0,0,62,62,0,1,0,1,0
11892,64651,445,0,0,66,66,0,1,0,1,0
11893,2049,32480,0,0,66,66,0,1,0,1,0
11894,64486,445,0,0,70,70,0,1,0,1,0
11895,53160,25174,0,0,62,62,0,1,0,1,0
11896,64483,445,0,0,70,70,0,1,0,1,0
11897,50394,25174,0,0,62,62,0,1,0,1,0
11898,39063,44847,0,0,66,66,0,1,0,1,0
11899,5912,22114,0,0,62,62,0,1,0,1,0
11900,61465,22114,0,0,62,62,0,1,0,1,0
11901,14331,23,0,0,60,60,0,1,0,1,0
11902,22220,25174,0,0,62,62,0,1,0,1,0
11903,52861,445,0,0,70,70,0,1,0,1,0
11904,25237,25174,0,0,146,146,0,1,0,1,0
11905,52859,445,0,0,70,70,0,1,0,1,0
11906,31609,25174,0,0,62,62,0,1,0,1,0
11907,6889,11119,0,0,143,143,0,1,0,1,0
11908,56528,64147,0,0,62,62,0,1,0,1,0
11909,64476,445,0,0,70,70,0,1,0,1,0
11910,9512,443,14359,443,3614,434,3180,11,1,6,5
11911,17004,64147,0,0,66,66,0,1,0,1,0
11912,7686,25174,0,0,146,146,0,1,0,1,0
11913,64632,445,0,0,66,66,0,1,0,1,0
11914,64633,445,0,0,66,66,0,1,0,1,0
11915,60159,22114,0,0,62,62,0,1,0,1,0
11916,54518,25174,0,0,62,62,0,1,0,1,0
11917,36302,25174,0,0,146,146,0,1,0,1,0
11918,15319,51505,0,0,66,66,0,1,0,1,0
11919,64469,445,0,0,70,70,0,1,0,1,0
11920,38859,22114,0,0,66,66,0,1,0,1,0
11921,50708,22114,0,0,62,62,0,1,0,1,0
11922,52851,445,0,0,70,70,0,1,0,1,0
11923,52849,445,0,0,70,70,0,1,0,1,0
11924,52850,445,0,0,70,70,0,1,0,1,0
11925,52841,445,0,0,70,70,0,1,0,1,0
11926,64468,445,0,0,70,70,0,1,0,1,0
11927,2278,25174,0,0,146,146,0,1,0,1,0
11928,27995,22114,0,0,146,146,0,1,0,1,0
11929,1143,25174,0,0,62,62,0,1,0,1,0
11930,64024,22114,0,0,62,62,0,1,0,1,0
11931,51635,50265,0,0,66,66,0,1,0,1,0
11932,64629,445,0,0,66,66,0,1,0,1,0
11933,1117,37965,0,0,62,62,0,1,0,1,0
11934,2864,25174,0,0,66,66,0,1,0,1,0
11935,64462,445,0,0,70,70,0,1,0,1,0
11936,64624,445,0,0,66,66,0,1,0,1,0
11937,64622,445,0,0,66,66,0,1,0,1,0
11938,64623,445,0,0,66,66,0,1,0,1,0
11939,64618,445,0,0,66,66,0,1,0,1,0
11940,64617,445,0,0,66,66,0,1,0,1,0
11941,64614,445,0,0,66,66,0,1,0,1,0
11942,64612,445,0,0,66,66,0,1,0,1,0
11943,64461,445,0,0,70,70,0,1,0,1,0
11944,45964,2225,0,0,60,60,0,1,0,1,0
11945,52834,445,0,0,70,70,0,1,0,1,0
11946,17101,25174,0,0,66,66,0,1,0,1,0
11947,50615,80,48256,80,190675,79205,111470,237,41,104,133
11948,52831,445,0,0,70,70,0,1,0,1,0
11949,52830,445,0,0,70,70,0,1,0,1,0
11950,52827,445,0,0,70,70,0,1,0,1,0
11951,64457,445,0,0,70,70,0,1,0,1,0
11952,50052,65008,0,0,60,60,0,1,0,1,0
11953,2938,64147,0,0,62,62,0,1,0,1,0
11954,2064,22114,0,0,146,146,0,1,0,1,0
11955,64455,445,0,0,70,70,0,1,0,1,0
11956,7288,25174,0,0,62,62,0,1,0,1,0
11957,23719,22114,0,0,62,62,0,1,0,1,0
11958,443,46569,0,0,66,66,0,1,0,1,0
11959,443,46080,0,0,66,66,0,1,0,1,0
11960,0,0,0,0,600,306,294,6,0,3,3
11961,11228,23,0,0,60,60,0,1,0,1,0
11962,56999,25174,0,0,62,62,0,1,0,1,0
11963,16168,23,0,0,60,60,0,1,0,1,0
11964,52823,445,0,0,70,70,0,1,0,1,0
11965,52822,445,0,0,70,70,0,1,0,1,0
11966,52821,445,0,0,70,70,0,1,0,1,0
11967,55146,1433,0,0,60,60,0,1,0,1,0
11968,64605,445,0,0,66,66,0,1,0,1,0
11969,52818,445,0,0,70,70,0,1,0,1,0
11970,64451,445,0,0,70,70,0,1,0,1,0
11971,64603,445,0,0,66,66,0,1,0,1,0
11972,59048,57470,0,0,66,66,0,1,0,1,0
11973,24351,57470,0,0,62,62,0,1,0,1,0
11974,22783,64147,0,0,62,62,0,1,0,1,0
11975,63867,35993,0,0,66,66,0,1,0,1,0
11976,12694,22114,0,0,66,66,0,1,0,1,0
11977,64601,445,0,0,66,66,0,1,0,1,0
11978,64602,445,0,0,66,66,0,1,0,1,0
11979,6587,22114,0,0,146,146,0,1,0,1,0
11980,64599,445,0,0,66,66,0,1,0,1,0
11981,2707,37,0,0,60,60,0,1,0,1,0
11982,59523,37965,0,0,62,62,0,1,0,1,0
11983,40108,23,0,0,60,60,0,1,0,1,0
11984,52813,445,0,0,70,70,0,1,0,1,0
11985,52806,445,0,0,70,70,0,1,0,1,0
11986,52804,445,0,0,70,70,0,1,0,1,0
11987,22528,25174,0,0,62,62,0,1,0,1,0
11988,49834,23,0,0,60,60,0,1,0,1,0
11989,64438,445,0,0,70,70,0,1,0,1,0
11990,15585,64147,0,0,66,66,0,1,0,1,0
11991,53563,35440,0,0,66,66,0,1,0,1,0
11992,22036,44847,0,0,62,62,0,1,0,1,0
11993,64680,22114,0,0,146,146,0,1,0,1,0
11994,19875,30170,0,0,145,145,0,1,0,1,0
11995,64586,445,0,0,66,66,0,1,0,1,0
11996,1660,8696,0,0,62,62,0,1,0,1,0
11997,51544,50584,0,0,62,62,0,1,0,1,0
11998,64435,445,0,0,70,70,0,1,0,1,0
11999,10312,23117,0,0,62,62,0,1,0,1,0
12000,60527,35440,0,0,66,66,0,1,0,1,0
12001,1130,37965,0,0,145,145,0,1,0,1,0
12002,49336,25174,0,0,66,66,0,1,0,1,0
12003,57578,51221,0,0,66,66,0,1,0,1,0
12004,57585,51221,0,0,62,62,0,1,0,1,0
12005,37522,22114,0,0,62,62,0,1,0,1,0
12006,64579,445,0,0,66,66,0,1,0,1,0
12007,56770,53,63283,53,208,106,102,2,30,1,1
12008,51099,80,52841,80,3422,1962,1460,33,131,18,15
12009,38468,53,0,0,82,82,0,2,40,2,0
12010,52102,19604,31294,19604,66,66,0,1,5,1,0
12011,59644,443,54066,443,8362065,55143,8306922,6375,152,332,6043
12012,50293,80,34278,80,134242,13446,120796,154,161,58,96
12013,50328,80,59408,80,55878,5841,50037,70,94,29,41
12014,49889,53,17299,53,194,99,95,2,30,1,1
12015,55216,53,63091,53,174,89,85,2,30,1,1
12016,60857,443,19971,443,18385,7771,10614,47,48,27,20
12017,52104,51756,50928,51756,66,66,0,1,5,1,0
12018,52106,41632,33294,41632,66,66,0,1,5,1,0
12019,9483,80,46807,80,1579,421,1158,9,15,4,5
12020,49826,53,60102,53,466,192,274,6,83,3,3
12021,60006,443,38577,443,185169,75281,109888,426,111,209,217
12022,50298,80,48126,80,166956,16834,150122,187,161,72,115
12023,56479,80,1802,80,460182,11717,448465,462,135,162,300
12024,53894,2944,38557,2944,70,70,0,1,5,1,0
12025,61583,80,61583,80,12301,1642,10659,20,20,9,11
12026,64664,80,64664,80,1921,1472,449,10,20,6,4
12027,65280,53,4153,53,164,84,80,2,31,1,1
12028,49492,53,11177,53,198,101,97,2,31,1,1
12029,55955,53,2221,53,814,110,704,2,30,1,1
12030,58931,443,42670,443,1413,876,537,12,28,6,6
12031,51135,443,24290,443,6678,1212,5466,22,256,12,10
12032,58932,443,14070,443,1413,876,537,12,28,6,6
12033,51658,80,20246,80,44842,2446,42396,73,255,34,39
12034,41734,443,42617,443,153,93,60,2,5,1,1
12035,51997,443,19517,443,2648,1797,851,19,22,11,8
12036,64034,17935,37819,17935,66,66,0,1,5,1,0
12037,9482,443,2770,443,5657,487,5170,14,15,7,7
12038,2267,53,13184,53,826,826,0,8,44,8,0
12039,51996,443,3596,443,2648,1797,851,19,22,11,8
12040,61123,80,61123,80,21678,2120,19558,33,20,16,17
12041,52141,1033,19443,1033,316,136,180,6,7,3,3
12042,51098,80,4123,80,3378,1918,1460,33,131,18,15
12043,36953,443,22801,443,70,70,0,1,5,1,0
12044,57422,53,50721,53,747,90,657,2,30,1,1
12045,51899,80,55362,80,1758,989,769,13,76,8,5
12046,56678,53,61385,53,760,97,663,2,30,1,1
12047,49815,53,0,0,166,73,93,2,30,1,1
12048,56064,53,20414,53,710,89,621,2,30,1,1
12049,56333,53,63639,53,202,103,99,2,31,1,1
12050,53896,48027,30657,48027,70,70,0,1,5,1,0
12051,51652,80,52729,80,32942,2548,30394,58,255,28,30
12052,50116,22,50116,22,184,120,64,4,10,3,1
12053,50297,80,4817,80,145266,14613,130653,165,161,63,102
12054,51097,80,51452,80,3374,1914,1460,33,131,18,15
12055,53124,80,20707,80,4198,3534,664,13,19,8,5
12056,49683,80,8217,80,1548,847,701,10,15,5,5
12057,61908,7000,61908,7000,4131,1750,2381,17,15,9,8
12058,53886,49618,46889,49618,492,306,186,8,16,5,3
12059,49791,53,6212,53,777,87,690,2,30,1,1
12060,44925,443,50958,443,153,93,60,2,5,1,1
12061,49257,53,65016,53,164,84,80,2,30,1,1
12062,50250,53,19188,53,172,88,84,2,30,1,1
12063,56770,443,57005,443,124,64,60,2,16,1,1
12064,64422,53,42337,53,176,90,86,2,30,1,1
12065,55687,53,59046,53,186,95,91,2,31,1,1
12066,64937,53,42639,53,204,104,100,2,31,1,1
12067,55418,53,39604,53,168,86,82,2,31,1,1
12068,54339,443,11466,443,3149,769,2380,10,120,5,5
12069,57204,53,25182,53,190,97,93,2,30,1,1
12070,64116,53,5820,53,184,94,90,2,31,1,1
12071,25808,53,25808,53,218,99,119,2,31,1,1
12072,65466,53,3496,53,733,86,647,2,31,1,1
12073,50403,53,23748,53,168,86,82,2,31,1,1
12074,56955,53,57810,53,182,93,89,2,31,1,1
12075,65186,53,43195,53,733,85,648,2,31,1,1
12076,37694,5228,64819,5228,6930,1665,5265,18,3601,9,9
12077,55352,53,6913,53,216,110,106,2,31,1,1
12078,55332,53,16316,53,206,105,101,2,31,1,1
12079,56314,53,18925,53,733,86,647,2,31,1,1
12080,49972,53,57217,53,216,110,106,2,31,1,1
12081,55555,53,39560,53,188,96,92,2,31,1,1
12082,49296,53,29013,53,186,95,91,2,31,1,1
12083,55022,53,10600,53,190,97,93,2,31,1,1
12084,58905,443,41213,443,13055,5677,7378,29,122,15,14
12085,58717,443,32923,443,280,140,140,5,130,3,2
12086,57407,53,20489,53,755,94,661,2,31,1,1
12087,55707,53,37897,53,170,87,83,2,31,1,1
12088,56422,53,35743,53,190,97,93,2,31,1,1
12089,49546,53,57576,53,208,106,102,2,31,1,1
12090,64299,53,27762,53,164,84,80,2,31,1,1
12091,49210,53,34070,53,182,93,89,2,31,1,1
12092,64856,53,10911,53,755,93,662,2,31,1,1
12093,38102,5228,57941,5228,4235,1797,2438,38,4443,13,25
12094,35556,443,35556,443,7201,1167,6034,16,131,8,8
12095,47276,443,16535,443,7613,2230,5383,22,360,11,11
12096,55007,53,10621,53,164,84,80,2,31,1,1
12097,56036,53,20624,53,762,98,664,2,31,1,1
12098,49982,53,52781,53,206,105,101,2,31,1,1
12099,64615,53,39093,53,190,97,93,2,31,1,1
12100,65065,53,49362,53,754,94,660,2,31,1,1
12101,37299,443,19605,443,10790,5444,5346,21,122,10,11
12102,56312,53,11008,53,190,97,93,2,31,1,1
12103,54054,5228,24551,5228,8767,2486,6281,45,6062,24,21
12104,39735,443,13542,443,280,140,140,5,130,3,2
12105,6881,6881,62439,6881,502,150,352,2,1200,1,1
12106,6882,3800,7427,3800,150,150,0,2,1201,2,0
12107,47561,26467,0,0,62,62,0,1,0,1,0
12108,52790,445,0,0,70,70,0,1,0,1,0
12109,58608,62413,0,0,66,66,0,1,0,1,0
12110,8508,23,0,0,60,60,0,1,0,1,0
12111,45941,23386,0,0,60,60,0,1,0,1,0
12112,45941,23386,0,0,60,60,0,1,0,1,0
12113,42231,57470,0,0,78,78,0,1,0,1,0
12114,64430,445,0,0,70,70,0,1,0,1,0
12115,64429,445,0,0,70,70,0,1,0,1,0
12116,55425,37965,0,0,66,66,0,1,0,1,0
12117,1847,64147,0,0,62,62,0,1,0,1,0
12118,64576,445,0,0,66,66,0,1,0,1,0
12119,51046,53,51046,53,244,106,138,2,30,1,1
12120,53885,50379,49864,50379,492,306,186,8,15,5,3
12121,53887,6881,31498,6881,552,306,246,9,15,5,4
12122,59052,53,59052,53,235,90,145,2,32,1,1
12123,51015,80,51015,80,1905,1456,449,10,20,6,4
12124,64878,53,35842,53,511,92,419,4,45,2,2
12125,49237,53,49518,53,216,110,106,2,30,1,1
12126,55808,53,53764,53,730,102,628,2,30,1,1
12127,60666,123,38509,123,184,94,90,2,30,1,1
12128,56638,443,50177,443,44984,28294,16690,77,40,40,37
12129,50356,80,58294,80,1578,756,822,13,34,7,6
12130,52139,38259,57318,38259,70,70,0,2,7,2,0
12131,53895,36849,47178,36849,70,70,0,1,4,1,0
12132,45295,443,2561,443,6864,1633,5231,20,315,10,10
12133,57498,443,57498,443,4546,1639,2907,19,27,11,8
12134,56474,80,38347,80,8790,1387,7403,17,134,9,8
12135,56476,80,31067,80,5342,1304,4038,14,134,8,6
12136,56472,80,20215,80,45108,2309,42799,60,134,28,32
12137,55995,53,15590,53,182,94,88,2,29,1,1
12138,64029,38651,25596,38651,70,70,0,1,4,1,0
12139,64422,53,60156,53,180,94,86,2,29,1,1
12140,52107,11191,10065,11191,70,70,0,1,4,1,0
12141,47073,7275,39561,7275,416,210,206,7,15,4,3
12142,55187,53,45900,53,172,94,78,2,29,1,1
12143,58273,53,40385,53,202,86,116,2,30,1,1
12144,64741,53,9431,53,715,94,621,2,29,1,1
12145,49295,53,61148,53,164,86,78,2,29,1,1
12146,49257,53,51275,53,166,86,80,2,29,1,1
12147,57204,53,62842,53,195,102,93,2,29,1,1
12148,55187,53,40713,53,172,94,78,2,30,1,1
12149,50523,53,12561,53,168,86,82,2,29,1,1
12150,60021,443,37470,443,346221,14712,331509,474,107,211,263
12151,60027,443,20291,443,8216,2269,5947,42,106,25,17
12152,62937,80,62937,80,1918,1469,449,10,20,6,4
12153,52218,80,52218,80,1921,1472,449,10,20,6,4
12154,61422,80,46677,80,214,140,74,4,41,3,1
12155,49167,80,49167,80,1915,1466,449,10,20,6,4
12156,54634,443,32455,443,225732,7330,218402,246,174,86,160
12157,64633,53,20577,53,255,102,153,2,30,1,1
12158,49417,53,32052,53,211,110,101,2,30,1,1
12159,57033,53,53118,53,216,110,106,2,30,1,1
12160,57129,53,59540,53,265,94,171,2,30,1,1
12161,56928,53,10586,53,178,94,84,2,30,1,1
12162,55332,53,34862,53,211,110,101,2,30,1,1
12163,50025,53,41046,53,369,150,219,2,30,1,1
12164,38706,443,10577,443,90545,3481,87064,96,16,31,65
12165,60007,443,8441,443,7040,1933,5107,32,110,19,13
12166,40042,80,40042,80,1919,1470,449,10,20,6,4
12167,55709,30217,33191,30217,70,70,0,2,8,2,0
12168,57312,53,15531,53,212,110,102,2,30,1,1
12169,61430,80,6930,80,214,140,74,4,41,3,1
12170,61423,80,2681,80,214,140,74,4,41,3,1
12171,48646,80,48646,80,1916,1467,449,10,20,6,4
12172,52248,443,56929,443,190,70,120,4,15,2,2
12173,58720,443,50201,443,32598,22046,10552,83,60,49,34
12174,35921,443,62122,443,9667,4709,4958,27,88,14,13
12175,52138,25621,30366,25621,70,70,0,2,8,2,0
12176,64052,38119,11965,38119,312,132,180,6,6,3,3
12177,56950,53,63422,53,211,102,109,2,30,1,1
12178,61864,80,52616,80,9747,537,9210,14,16,6,8
12179,51650,80,8862,80,2681,1044,1637,22,255,12,10
12180,57425,53,41826,53,168,86,82,2,30,1,1
12181,49237,53,48024,53,216,110,106,2,30,1,1
12182,49257,53,43950,53,579,181,398,6,84,3,3
12183,44871,53,32671,53,168,78,90,2,30,1,1
12184,64228,53,55912,53,266,110,156,2,30,1,1
12185,49305,53,20734,53,571,181,390,6,73,3,3
12186,55216,53,56986,53,179,94,85,2,30,1,1
12187,49592,53,33191,53,177,94,83,2,30,1,1
12188,65171,53,41753,53,752,110,642,2,30,1,1
12189,49624,53,59918,53,293,126,167,2,30,1,1
12190,49261,53,20112,53,453,186,267,6,30,3,3
12191,56239,53,14198,53,180,94,86,2,30,1,1
12192,56955,53,15071,53,183,94,89,2,30,1,1
12193,57425,53,32563,53,168,86,82,2,30,1,1
12194,56929,53,55156,53,784,94,690,2,30,1,1
12195,55352,53,47404,53,216,110,106,2,30,1,1
12196,56333,53,40833,53,209,110,99,2,30,1,1
12197,65204,443,43176,443,1786,172,1614,7,120,3,4
12198,57022,53,55045,53,369,150,219,2,30,1,1
12199,49615,53,23958,53,199,102,97,2,30,1,1
12200,39827,53,39827,53,247,98,149,2,33,1,1
12201,61427,80,27068,80,214,140,74,4,41,3,1
12202,61425,80,54723,80,214,140,74,4,41,3,1
12203,61424,80,26157,80,214,140,74,4,41,3,1
12204,38707,443,59526,443,774099,15769,758330,743,16,223,520
12205,50629,80,50629,80,6210,2976,3234,16,20,9,7
12206,50319,53,7677,53,814,110,704,2,30,1,1
12207,49408,53,3483,53,252,102,150,2,30,1,1
12208,49417,53,14090,53,211,110,101,2,30,1,1
12209,56770,53,41386,53,212,110,102,2,30,1,1
12210,56827,53,18397,53,195,102,93,2,30,1,1
12211,64023,12954,37073,12954,504,382,122,8,15,6,2
12212,49991,80,45821,80,2668,543,2125,12,28,6,6
12213,35060,80,35060,80,1918,1469,449,10,20,6,4
12214,58394,53,41554,53,274,94,180,2,30,1,1
12215,64839,53,42360,53,212,110,102,2,30,1,1
12216,55216,53,52646,53,179,94,85,2,30,1,1
12217,55923,53,7980,53,177,94,83,2,30,1,1
12218,55923,53,53051,53,177,94,83,2,30,1,1
12219,64243,53,38194,53,257,102,155,2,30,1,1
12220,56125,53,3352,53,168,86,82,2,30,1,1
12221,64737,53,22713,53,285,94,191,2,31,1,1
12222,43639,443,43639,443,4683,1776,2907,19,29,11,8
12223,57905,80,48820,80,12974,3246,9728,29,29,16,13
12224,57983,443,38369,443,7966,3102,4864,18,75,10,8
12225,52105,1024,64532,1024,70,70,0,1,4,1,0
12226,56632,53,56632,53,235,90,145,2,33,1,1
12227,64054,54778,50482,54778,312,132,180,6,6,3,3
12228,64467,53,41082,53,548,194,354,6,63,3,3
12229,52136,42939,50885,42939,70,70,0,2,8,2,0
12230,2267,53,49774,53,826,826,0,8,44,8,0
12231,64422,53,39408,53,180,94,86,2,31,1,1
12232,61426,80,34225,80,214,140,74,4,41,3,1
12233,60867,443,23930,443,14125,3827,10298,33,45,18,15
12234,45882,443,31867,443,6617,1852,4765,23,132,13,10
12235,53695,443,14454,443,4045,439,3606,11,15,5,6
12236,61429,80,5078,80,214,140,74,4,41,3,1
12237,36351,80,36351,80,1920,1471,449,10,20,6,4
12238,49969,53,54536,53,356,105,251,4,49,2,2
12239,56475,80,2240,80,36057,2080,33977,45,134,19,26
12240,56125,53,44434,53,168,86,82,2,29,1,1
12241,49889,53,36232,53,197,102,95,2,29,1,1
12242,44299,80,44299,80,1915,1466,449,10,20,6,4
12243,52137,1026,43020,1026,196,136,60,4,8,3,1
12244,40105,80,32685,80,9656,3195,6461,19,23,12,7
12245,33196,443,16510,443,6989,5073,1916,24,111,14,10
12246,60011,443,4713,443,11061,2230,8831,40,109,23,17
12247,53899,45682,35205,45682,70,70,0,1,4,1,0
12248,56827,53,30639,53,195,102,93,2,29,1,1
12249,53898,12172,38766,12172,70,70,0,1,4,1,0
12250,58177,443,64098,443,810,340,470,13,34,6,7
12251,58982,5222,15289,5222,16545,8556,7989,69,69,30,39
12252,55057,53,53863,53,211,110,101,2,30,1,1
12253,59402,53,5852,53,203,86,117,2,30,1,1
12254,55372,53,41205,53,271,93,178,4,43,2,2
12255,64995,53,32224,53,210,110,100,2,30,1,1
12256,61428,80,48945,80,214,140,74,4,41,3,1
12257,64937,53,47101,53,210,110,100,2,30,1,1
12258,47928,443,47928,443,4564,1657,2907,19,27,11,8
12259,56360,53,26019,53,184,102,82,2,30,1,1
12260,34692,80,34692,80,3530,2851,679,13,20,8,5
12261,60037,443,34987,443,376301,13445,362856,452,102,198,254
12262,50027,53,20964,53,264,110,154,2,30,1,1
12263,57033,53,22099,53,216,110,106,2,30,1,1
12264,37492,53,45298,53,199,94,105,2,30,1,1
12265,55739,53,43741,53,215,102,113,2,30,1,1
12266,55057,53,26203,53,211,110,101,2,30,1,1
12267,56648,53,44024,53,199,102,97,2,30,1,1
12268,49615,53,57263,53,199,102,97,2,30,1,1
12269,64324,53,8144,53,179,94,85,2,30,1,1
12270,56955,53,64522,53,183,94,89,2,30,1,1
12271,55352,53,35227,53,216,110,106,2,30,1,1
12272,55991,53,9133,53,199,102,97,2,30,1,1
12273,49176,53,17276,53,264,110,154,2,30,1,1
12274,55887,443,44668,443,3954,778,3176,17,121,8,9
12275,55352,53,46162,53,216,110,106,2,30,1,1
12276,55216,53,32573,53,179,94,85,2,30,1,1
12277,55022,53,7516,53,195,102,93,2,30,1,1
12278,55837,53,32132,53,195,102,93,2,30,1,1
12279,55991,53,22499,53,199,102,97,2,30,1,1
12280,55068,443,46144,443,5611,3720,1891,28,54,16,12
12281,61421,80,3203,80,214,140,74,4,41,3,1
12282,35917,443,52534,443,13480,8545,4935,35,94,19,16
12283,55892,80,55892,80,1917,1468,449,10,20,6,4
12284,4296,53,43153,53,217,86,131,2,30,1,1
12285,49592,53,47137,53,177,94,83,2,30,1,1
12286,49333,53,61415,53,392,102,290,2,30,1,1
12287,64191,53,17402,53,264,110,154,2,30,1,1
12288,55687,53,38089,53,193,102,91,2,30,1,1
12289,49615,53,49539,53,199,102,97,2,30,1,1
12290,55555,53,24469,53,194,102,92,2,30,1,1
12291,64026,80,47805,80,314,192,122,6,15,4,2
12292,52213,80,42925,80,5022,1422,3600,16,135,8,8
12293,52103,7172,60174,7172,70,70,0,1,5,1,0
12294,64942,53,56338,53,803,390,413,9,71,5,4
12295,61431,80,8546,80,214,140,74,4,41,3,1
12296,58738,443,24230,443,12382,9652,2730,43,58,26,17
12297,56529,80,56529,80,1915,1466,449,10,20,6,4
12298,60030,443,28456,443,711172,27430,683742,812,104,342,470
12299,53889,19002,16357,19002,552,306,246,9,15,5,4
12300,64116,53,45149,53,267,94,173,4,59,2,2
12301,65531,53,44923,53,193,102,91,2,30,1,1
12302,56820,53,40391,53,193,102,91,2,30,1,1
12303,56360,53,60818,53,184,102,82,2,30,1,1
12304,40290,53,7159,53,168,78,90,2,30,1,1
12305,64731,53,48863,53,779,86,693,2,30,1,1
12306,49739,53,37326,53,757,102,655,2,30,1,1
12307,56113,53,45666,53,211,102,109,2,30,1,1
12308,50007,53,39028,53,216,110,106,2,30,1,1
12309,56239,53,49542,53,180,94,86,2,30,1,1
12310,50007,53,43367,53,216,110,106,2,30,1,1
12311,64251,53,54906,53,451,118,333,2,30,1,1
12312,52661,53,0,0,86,86,0,1,30,1,0
12313,53120,80,53120,80,26927,1133,25794,36,15,16,20
12314,36402,80,36402,80,1917,1468,449,10,20,6,4
12315,40471,80,40471,80,1917,1468,449,10,20,6,4
12316,60864,80,22050,80,10629,1104,9525,23,46,12,11
12317,36306,80,36306,80,1917,1468,449,10,20,6,4
12318,44673,80,44673,80,1916,1467,449,10,20,6,4
12319,60008,443,9561,443,7060,1850,5210,35,110,21,14
12320,65416,53,16237,53,213,102,111,2,30,1,1
12321,50007,53,59429,53,216,110,106,2,30,1,1
12322,63638,53,10182,53,286,78,208,2,30,1,1
12323,56362,53,52775,53,453,186,267,6,30,3,3
12324,55332,53,52188,53,211,110,101,2,30,1,1
12325,56312,53,62526,53,195,102,93,2,30,1,1
12326,55610,53,39164,53,199,102,97,2,30,1,1
12327,16776,53,16776,53,197,90,107,2,30,1,1
12328,56596,53,50700,53,199,102,97,2,30,1,1
12329,57204,53,65520,53,195,102,93,2,30,1,1
12330,55332,53,45716,53,211,110,101,2,30,1,1
12331,55638,53,1033,53,78,78,0,1,30,1,0
12332,49402,53,15984,53,185,102,83,2,31,1,1
12333,56312,53,52964,53,195,102,93,2,31,1,1
12334,49492,53,41002,53,199,102,97,2,31,1,1
12335,49262,443,12479,443,4353,1227,3126,12,135,6,6
12336,39277,443,14513,443,6891,1421,5470,20,127,12,8
12337,55707,53,31512,53,177,94,83,2,30,1,1
12338,65143,53,8081,53,199,102,97,2,30,1,1
12339,62524,53,62524,53,212,90,122,2,30,1,1
12340,49972,53,10685,53,216,110,106,2,31,1,1
12341,64116,53,50037,53,184,94,90,2,31,1,1
12342,55620,53,6956,53,178,94,84,2,31,1,1
12343,63993,53,47498,53,338,110,228,2,31,1,1
12344,49841,53,34208,53,264,110,154,2,31,1,1
12345,57312,53,30289,53,212,110,102,2,31,1,1
12346,34658,80,20483,80,6094,954,5140,15,3601,8,7
12347,56422,53,25062,53,195,102,93,2,31,1,1
12348,57132,53,52410,53,216,110,106,2,31,1,1
12349,64929,53,16910,53,168,86,82,2,31,1,1
12350,49296,53,53194,53,193,102,91,2,31,1,1
12351,47376,443,12829,443,2944,778,2166,10,120,5,5
12352,60569,443,44105,443,10385,4932,5453,21,135,9,12
12353,33156,3478,41500,3478,338,110,228,2,300,1,1
12354,57470,8621,39581,8621,469,150,319,2,1199,1,1
12355,64615,53,57777,53,195,102,93,2,31,1,1
12356,37222,443,49931,443,2394,1365,1029,18,275,9,9
12357,46046,443,33761,443,11019,4673,6346,32,423,17,15
12358,32900,443,53581,443,14739,1296,13443,30,306,9,21
12359,28592,53,28592,53,216,90,126,2,31,1,1
12360,55195,443,41833,443,907774,32911,874863,898,460,195,703
12361,37965,17336,18530,17336,481,150,331,2,1199,1,1
12362,39566,443,50145,443,9748,5209,4539,22,121,11,11
12363,52145,36670,58227,36670,316,136,180,6,6,3,3
12364,64047,16221,34665,16221,66,66,0,2,8,2,0
12365,64048,44918,64560,44918,66,66,0,2,8,2,0
12366,52135,46475,48450,46475,70,70,0,2,8,2,0
12367,50684,80,2387,80,132,132,0,2,8,2,0
12368,52099,28401,35047,28401,70,70,0,1,5,1,0
12369,49889,53,3966,53,310,99,211,4,40,2,2
12370,51103,443,36898,443,20280,13177,7103,82,1176,46,36
12371,55372,53,7749,53,271,93,178,4,43,2,2
12372,49826,53,43562,53,466,192,274,6,83,3,3
12373,56910,53,59135,53,211,78,133,2,30,1,1
12374,64427,445,0,0,70,70,0,1,0,1,0
12375,64568,445,0,0,66,66,0,1,0,1,0
12376,42490,1433,0,0,60,60,0,1,0,1,0
12377,53207,50584,0,0,66,66,0,1,0,1,0
12378,64567,445,0,0,66,66,0,1,0,1,0
12379,54221,57470,0,0,66,66,0,1,0,1,0
12380,35194,57470,0,0,74,74,0,1,0,1,0
12381,60180,31573,0,0,62,62,0,1,0,1,0
12382,56388,22114,0,0,66,66,0,1,0,1,0
12383,64418,445,0,0,70,70,0,1,0,1,0
12384,23844,26467,0,0,62,62,0,1,0,1,0
12385,64416,445,0,0,70,70,0,1,0,1,0
12386,23843,26467,0,0,62,62,0,1,0,1,0
12387,52782,445,0,0,70,70,0,1,0,1,0
12388,52778,445,0,0,70,70,0,1,0,1,0
12389,52779,445,0,0,70,70,0,1,0,1,0
12390,64415,445,0,0,70,70,0,1,0,1,0
12391,64553,445,0,0,66,66,0,1,0,1,0
12392,64552,445,0,0,66,66,0,1,0,1,0
12393,64548,445,0,0,66,66,0,1,0,1,0
12394,64554,445,0,0,66,66,0,1,0,1,0
12395,64551,445,0,0,66,66,0,1,0,1,0
12396,64549,445,0,0,66,66,0,1,0,1,0
12397,64547,445,0,0,66,66,0,1,0,1,0
12398,64550,445,0,0,66,66,0,1,0,1,0
12399,64414,445,0,0,70,70,0,1,0,1,0
12400,64413,445,0,0,70,70,0,1,0,1,0
12401,53373,64147,0,0,62,62,0,1,0,1,0
12402,64407,445,0,0,70,70,0,1,0,1,0
12403,64410,445,0,0,70,70,0,1,0,1,0
12404,53413,35440,0,0,146,146,0,1,0,1,0
12405,28476,25174,0,0,146,146,0,1,0,1,0
12406,59528,50584,0,0,146,146,0,1,0,1,0
12407,51754,18375,0,0,66,66,0,1,0,1,0
12408,64077,25174,0,0,62,62,0,1,0,1,0
12409,44886,23,0,0,60,60,0,1,0,1,0
12410,55620,30188,0,0,66,66,0,1,0,1,0
12411,64395,445,0,0,70,70,0,1,0,1,0
12412,64394,445,0,0,70,70,0,1,0,1,0
12413,64389,445,0,0,70,70,0,1,0,1,0
12414,58715,64097,0,0,62,62,0,1,0,1,0
12415,48706,23393,0,0,60,60,0,1,0,1,0
12416,54883,51505,0,0,66,66,0,1,0,1,0
12417,64385,445,0,0,70,70,0,1,0,1,0
12418,64384,445,0,0,70,70,0,1,0,1,0
12419,5228,3434,0,0,345,345,0,1,0,1,0
12420,7048,25174,0,0,62,62,0,1,0,1,0
12421,52772,445,0,0,70,70,0,1,0,1,0
12422,52770,445,0,0,70,70,0,1,0,1,0
12423,52768,445,0,0,70,70,0,1,0,1,0
12424,52762,445,0,0,70,70,0,1,0,1,0
12425,55406,25174,0,0,66,66,0,1,0,1,0
12426,53015,64147,0,0,62,62,0,1,0,1,0
12427,55713,25174,0,0,146,146,0,1,0,1,0
12428,64531,445,0,0,66,66,0,1,0,1,0
12429,64532,445,0,0,66,66,0,1,0,1,0
12430,64534,445,0,0,66,66,0,1,0,1,0
12431,30650,25174,0,0,62,62,0,1,0,1,0
12432,12348,50265,0,0,62,62,0,1,0,1,0
12433,64989,50265,0,0,66,66,0,1,0,1,0
12434,13062,52274,0,0,66,66,0,1,0,1,0
12435,30697,57866,0,0,62,62,0,1,0,1,0
12436,1024,25174,0,0,146,146,0,1,0,1,0
12437,59096,57866,0,0,66,66,0,1,0,1,0
12438,38549,22114,0,0,62,62,0,1,0,1,0
12439,58143,57866,0,0,66,66,0,1,0,1,0
12440,49393,30188,0,0,66,66,0,1,0,1,0
12441,52759,445,0,0,70,70,0,1,0,1,0
12442,64373,445,0,0,70,70,0,1,0,1,0
12443,39941,2767,0,0,62,62,0,1,0,1,0
12444,63213,57866,0,0,66,66,0,1,0,1,0
12445,52750,445,0,0,70,70,0,1,0,1,0
12446,52749,445,0,0,70,70,0,1,0,1,0
12447,52748,445,0,0,70,70,0,1,0,1,0
12448,60311,30627,0,0,66,66,0,1,0,1,0
12449,1024,44847,0,0,62,62,0,1,0,1,0
12450,65233,23117,0,0,62,62,0,1,0,1,0
12451,10082,64147,0,0,62,62,0,1,0,1,0
12452,49630,22,49630,22,295,126,169,4,1,2,2
12453,64369,445,0,0,70,70,0,1,0,1,0
12454,443,22238,0,0,112,112,0,1,0,1,0
12455,46808,25174,0,0,62,62,0,1,0,1,0
12456,1024,64147,0,0,62,62,0,1,0,1,0
12457,25237,25174,0,0,62,62,0,1,0,1,0
12458,64358,445,0,0,70,70,0,1,0,1,0
12459,64359,445,0,0,70,70,0,1,0,1,0
12460,52739,445,0,0,70,70,0,1,0,1,0
12461,64360,445,0,0,70,70,0,1,0,1,0
12462,52740,445,0,0,70,70,0,1,0,1,0
12463,52734,445,0,0,70,70,0,1,0,1,0
12464,37011,25174,0,0,62,62,0,1,0,1,0
12465,58627,64097,0,0,62,62,0,1,0,1,0
12466,64356,445,0,0,70,70,0,1,0,1,0
12467,50084,26672,0,0,62,62,0,1,0,1,0
12468,35657,48637,0,0,62,62,0,1,0,1,0
12469,64353,445,0,0,70,70,0,1,0,1,0
12470,64519,445,0,0,66,66,0,1,0,1,0
12471,45013,50584,0,0,146,146,0,1,0,1,0
12472,61369,64147,0,0,66,66,0,1,0,1,0
12473,58338,3353,0,0,60,60,0,1,0,1,0
12474,6832,51505,0,0,66,66,0,1,0,1,0
12475,52733,445,0,0,70,70,0,1,0,1,0
12476,52731,445,0,0,70,70,0,1,0,1,0
12477,64346,445,0,0,70,70,0,1,0,1,0
12478,40254,25174,0,0,146,146,0,1,0,1,0
12479,62400,35993,0,0,66,66,0,1,0,1,0
12480,64505,445,0,0,66,66,0,1,0,1,0
12481,64507,445,0,0,66,66,0,1,0,1,0
12482,43679,44847,0,0,62,62,0,1,0,1,0
12483,2437,23117,0,0,62,62,0,1,0,1,0
12484,64339,445,0,0,70,70,0,1,0,1,0
12485,46604,57866,0,0,66,66,0,1,0,1,0
12486,53071,25174,0,0,66,66,0,1,0,1,0
12487,64336,445,0,0,70,70,0,1,0,1,0
12488,45964,2225,0,0,60,60,0,1,0,1,0
12489,58716,9694,0,0,62,62,0,1,0,1,0
12490,3524,25174,0,0,66,66,0,1,0,1,0
12491,61898,50584,0,0,66,66,0,1,0,1,0
12492,56578,25174,0,0,66,66,0,1,0,1,0
12493,19204,57866,0,0,66,66,0,1,0,1,0
12494,52720,445,0,0,70,70,0,1,0,1,0
12495,52719,445,0,0,70,70,0,1,0,1,0
12496,52718,445,0,0,70,70,0,1,0,1,0
12497,52711,445,0,0,70,70,0,1,0,1,0
12498,57471,62413,0,0,66,66,0,1,0,1,0
12499,3800,48817,0,0,146,146,0,1,0,1,0
12500,51414,22,0,0,60,60,0,1,0,1,0
12501,59803,22114,0,0,62,62,0,1,0,1,0
12502,64498,445,0,0,66,66,0,1,0,1,0
12503,64333,445,0,0,70,70,0,1,0,1,0
12504,7905,22114,0,0,66,66,0,1,0,1,0
12505,64331,445,0,0,70,70,0,1,0,1,0
12506,7619,50584,0,0,62,62,0,1,0,1,0
12507,0,0,0,0,600,306,294,6,0,3,3
12508,12545,25174,0,0,62,62,0,1,0,1,0
12509,50593,64147,0,0,66,66,0,1,0,1,0
12510,64494,445,0,0,66,66,0,1,0,1,0
12511,64493,445,0,0,66,66,0,1,0,1,0
12512,64492,445,0,0,66,66,0,1,0,1,0
12513,64491,445,0,0,66,66,0,1,0,1,0
12514,64488,445,0,0,66,66,0,1,0,1,0
12515,64486,445,0,0,66,66,0,1,0,1,0
12516,64483,445,0,0,66,66,0,1,0,1,0
12517,55116,7574,0,0,62,62,0,1,0,1,0
12518,52706,445,0,0,70,70,0,1,0,1,0
12519,64327,445,0,0,70,70,0,1,0,1,0
12520,52703,445,0,0,70,70,0,1,0,1,0
12521,52701,445,0,0,70,70,0,1,0,1,0
12522,52699,445,0,0,70,70,0,1,0,1,0
12523,51414,50584,0,0,66,66,0,1,0,1,0
12524,15333,60043,0,0,62,62,0,1,0,1,0
12525,52492,37965,0,0,66,66,0,1,0,1,0
12526,36561,2767,0,0,62,62,0,1,0,1,0
12527,64326,445,0,0,70,70,0,1,0,1,0
12528,52699,25174,0,0,66,66,0,1,0,1,0
12529,1865,25174,0,0,62,62,0,1,0,1,0
12530,42796,22114,0,0,62,62,0,1,0,1,0
12531,63786,25174,0,0,66,66,0,1,0,1,0
12532,64321,445,0,0,70,70,0,1,0,1,0
12533,52696,445,0,0,70,70,0,1,0,1,0
12534,52695,445,0,0,70,70,0,1,0,1,0
12535,52691,445,0,0,70,70,0,1,0,1,0
12536,443,59493,0,0,60,60,0,1,0,1,0
12537,20619,25174,0,0,66,66,0,1,0,1,0
12538,64476,445,0,0,66,66,0,1,0,1,0
12539,52690,445,0,0,70,70,0,1,0,1,0
12540,26531,37965,0,0,62,62,0,1,0,1,0
12541,64474,445,0,0,66,66,0,1,0,1,0
12542,23940,41615,0,0,146,146,0,1,0,1,0
12543,55082,25174,0,0,66,66,0,1,0,1,0
12544,58091,51505,0,0,66,66,0,1,0,1,0
12545,64472,445,0,0,66,66,0,1,0,1,0
12546,64470,445,0,0,66,66,0,1,0,1,0
12547,43076,23,0,0,60,60,0,1,0,1,0
12548,49036,44847,0,0,62,62,0,1,0,1,0
12549,63173,36237,0,0,66,66,0,1,0,1,0
12550,64469,445,0,0,66,66,0,1,0,1,0
12551,54140,17372,0,0,66,66,0,1,0,1,0
12552,24311,22617,0,0,60,60,0,1,0,1,0
12553,58021,22114,0,0,66,66,0,1,0,1,0
12554,36551,23,0,0,60,60,0,1,0,1,0
12555,22571,51505,0,0,66,66,0,1,0,1,0
12556,56496,53,60823,53,186,95,91,2,30,1,1
12557,56596,53,26887,53,198,101,97,2,30,1,1
12558,9280,443,36215,443,4612,830,3782,16,27,9,7
12559,60481,40075,20355,40075,70,70,0,1,5,1,0
12560,61441,443,10709,443,7832,1143,6689,19,31,9,10
12561,47038,443,65328,443,2809,1884,925,19,24,11,8
12562,57312,53,16678,53,1385,85,1300,4,42,2,2
12563,53893,11344,38662,11344,70,70,0,1,5,1,0
12564,5588,5588,0,0,3562,1936,1626,48,193,24,24
12565,47438,80,47438,80,2886,1481,1405,10,15,6,4
12566,35088,443,54099,443,800,452,348,12,94,7,5
12567,34340,443,16904,443,3497,1845,1652,18,16,9,9
12568,56062,53,16578,53,744,89,655,2,31,1,1
12569,55963,53,27489,53,755,93,662,2,30,1,1
12570,47747,443,43132,443,4187,1350,2837,18,321,8,10
12571,9294,443,62511,443,6356,979,5377,19,27,10,9
12572,59392,443,2075,443,105190,30835,74355,372,589,169,203
12573,52131,28980,48915,28980,70,70,0,2,8,2,0
12574,52133,15015,56839,15015,70,70,0,2,8,2,0
12575,53915,1026,52746,1026,70,70,0,2,8,2,0
12576,37027,443,52306,443,90706,5324,85382,128,262,66,62
12577,65140,53,64543,53,198,101,97,2,30,1,1
12578,41151,443,41151,443,4713,1806,2907,19,30,11,8
12579,57794,53,57794,53,825,99,726,2,30,1,1
12580,46216,443,9972,443,161,101,60,2,5,1,1
12581,60479,53928,56520,53928,70,70,0,1,5,1,0
12582,59404,443,36010,443,11018,5022,5996,84,588,43,41
12583,42783,443,65446,443,13510,5888,7622,65,86,33,32
12584,39038,443,14810,443,3970,2230,1740,17,114,10,7
12585,56752,443,27500,443,11771,2624,9147,50,20,25,25
12586,51073,443,23186,443,7343,2672,4671,20,76,12,8
12587,60982,443,39893,443,18274,7660,10614,46,48,26,20
12588,32346,53,32346,53,194,87,107,2,30,1,1
12589,50421,53,19651,53,762,98,664,2,30,1,1
12590,64324,53,12173,53,174,89,85,2,30,1,1
12591,55563,53,57917,53,763,101,662,2,30,1,1
12592,34914,53,34914,53,825,99,726,2,30,1,1
12593,33812,443,2950,443,16120,8754,7366,36,327,21,15
12594,51449,443,58167,443,21779,7983,13796,44,97,25,19
12595,57132,53,28118,53,216,110,106,2,31,1,1
12596,55841,53,55031,53,265,86,179,4,59,2,2
12597,41000,443,31779,443,10675,5079,5596,88,588,47,41
12598,40906,443,50326,443,8138,2333,5805,26,106,14,12
12599,37031,443,21372,443,43818,31519,12299,85,259,49,36
12600,54805,443,42817,443,19635,9923,9712,165,588,72,93
12601,59405,443,49077,443,10726,4848,5878,79,588,40,39
12602,59570,443,28825,443,24203,14278,9925,168,320,74,94
12603,35542,23,35542,23,124,60,64,2,5,1,1
12604,54872,53,11458,53,578,286,292,9,15,5,4
12605,57211,443,58131,443,25881,12394,13487,221,579,105,116
12606,52130,1035,4806,1035,70,70,0,2,8,2,0
12607,58857,443,61452,443,674,130,544,11,129,3,8
12608,55372,53,64639,53,271,93,178,4,43,2,2
12609,49394,443,40363,443,7129,1853,5276,27,316,13,14
12610,57312,53,43620,53,208,106,102,2,30,1,1
12611,52775,123,25733,123,184,94,90,2,30,1,1
12612,65045,53,47072,53,755,94,661,2,30,1,1
12613,65481,53,28484,53,168,86,82,2,31,1,1
12614,37965,46405,21208,46405,1217,594,623,16,1764,10,6
12615,443,60746,0,0,60,60,0,1,90,1,0
12616,55941,53,18127,53,184,94,90,2,30,1,1
12617,50293,53,25447,53,740,93,647,2,31,1,1
12618,56028,53,49252,53,770,102,668,2,31,1,1
12619,64929,53,46254,53,168,86,82,2,31,1,1
12620,56586,53,7577,53,754,94,660,2,31,1,1
12621,49953,53,38496,53,757,98,659,2,31,1,1
12622,56293,53,53120,53,164,84,80,2,31,1,1
12623,56697,53,7977,53,711,87,624,2,31,1,1
12624,62763,443,43714,443,7755,4481,3274,17,135,9,8
12625,48817,48489,48817,48489,480,149,331,2,1200,1,1
12626,56437,53,21787,53,731,91,640,2,31,1,1
12627,56199,53,15227,53,256,93,163,2,31,1,1
12628,56965,53,30276,53,182,93,89,2,31,1,1
12629,55376,53,64673,53,198,101,97,2,31,1,1
12630,64403,53,35591,53,186,95,91,2,31,1,1
12631,49611,53,60181,53,170,87,83,2,31,1,1
12632,57969,53,57969,53,194,87,107,2,31,1,1
12633,49699,53,23875,53,202,103,99,2,31,1,1
12634,43394,53,50886,53,168,78,90,2,31,1,1
12635,48589,443,15567,443,15400,9133,6267,40,272,22,18
12636,56696,53,25639,53,757,98,659,2,31,1,1
12637,57450,53,43406,53,916,86,830,2,31,1,1
12638,56207,53,7940,53,761,100,661,2,31,1,1
12639,64543,53,58923,53,761,100,661,2,31,1,1
12640,49764,53,33834,53,198,101,97,2,31,1,1
12641,55218,80,61870,80,2568,1705,863,12,186,7,5
12642,43480,443,57887,443,58423,25600,32823,86,138,40,46
12643,43268,443,16959,443,8954,2755,6199,23,143,10,13
12644,55620,53,33396,53,172,88,84,2,31,1,1
12645,56054,53,43314,53,740,93,647,2,31,1,1
12646,50444,53,27303,53,256,93,163,2,31,1,1
12647,65447,53,45832,53,756,95,661,2,31,1,1
12648,56447,53,59083,53,758,96,662,2,31,1,1
12649,57007,53,30076,53,182,93,89,2,31,1,1
12650,64950,53,22680,53,182,93,89,2,31,1,1
12651,57352,53,8029,53,192,98,94,2,31,1,1
12652,64677,53,37767,53,182,93,89,2,31,1,1
12653,59559,443,47582,443,3255,1089,2166,10,122,5,5
12654,36229,62413,0,0,146,146,0,1,0,1,0
12655,18655,44847,0,0,66,66,0,1,0,1,0
12656,52685,445,0,0,70,70,0,1,0,1,0
12657,6881,6881,0,0,62,62,0,1,0,1,0
12658,64308,445,0,0,70,70,0,1,0,1,0
12659,52680,445,0,0,70,70,0,1,0,1,0
12660,52679,445,0,0,70,70,0,1,0,1,0
12661,12226,37965,0,0,62,62,0,1,0,1,0
12662,55439,37965,0,0,66,66,0,1,0,1,0
12663,8889,64500,0,0,60,60,0,1,0,1,0
12664,64305,445,0,0,70,70,0,1,0,1,0
12665,10547,57470,0,0,62,62,0,1,0,1,0
12666,44040,443,39447,443,11774,5465,6309,75,585,38,37
12667,60477,30889,23604,30889,70,70,0,1,5,1,0
12668,49418,22114,0,0,66,66,0,1,0,1,0
12669,64457,445,0,0,66,66,0,1,0,1,0
12670,26962,26467,0,0,66,66,0,1,0,1,0
12671,19175,50584,0,0,146,146,0,1,0,1,0
12672,35937,25174,0,0,66,66,0,1,0,1,0
12673,37308,43890,0,0,62,62,0,1,0,1,0
12674,43207,26467,0,0,62,62,0,1,0,1,0
12675,64450,445,0,0,66,66,0,1,0,1,0
12676,64300,445,0,0,70,70,0,1,0,1,0
12677,52662,445,0,0,70,70,0,1,0,1,0
12678,64299,445,0,0,70,70,0,1,0,1,0
12679,45461,25174,0,0,62,62,0,1,0,1,0
12680,23218,62413,0,0,66,66,0,1,0,1,0
12681,64297,445,0,0,70,70,0,1,0,1,0
12682,64448,445,0,0,66,66,0,1,0,1,0
12683,56793,56205,0,0,66,66,0,1,0,1,0
12684,59032,25174,0,0,66,66,0,1,0,1,0
12685,443,21255,0,0,66,66,0,1,0,1,0
12686,49546,53,5497,53,212,110,102,2,30,1,1
12687,56293,53,25636,53,166,86,80,2,30,1,1
12688,52182,443,4685,443,237151,13019,224132,251,42,90,161
12689,34053,443,6934,443,5987,1678,4309,21,199,12,9
12690,49738,53,39292,53,228,86,142,2,29,1,1
12691,50069,53,45809,53,764,102,662,2,29,1,1
12692,44543,443,30865,443,13478,2683,10795,36,104,19,17
12693,49611,53,44019,53,177,94,83,2,30,1,1
12694,50658,80,54358,80,5018,4314,704,11,30,6,5
12695,34059,80,37168,80,1151,711,440,10,15,5,5
12696,65471,53,5865,53,441,90,351,4,48,2,2
12697,53890,23310,38031,23310,70,70,0,1,4,1,0
12698,64045,7426,45943,7426,66,66,0,2,7,2,0
12699,52100,54130,1109,54130,70,70,0,1,4,1,0
12700,56730,443,7897,443,347884,9284,338600,360,31,125,235
12701,60800,40010,5284,40010,316,136,180,6,5,3,3
12702,55372,53,13857,53,271,93,178,4,42,2,2
12703,53275,443,20326,443,364,142,222,6,10,3,3
12704,18963,80,18963,80,1501,652,849,9,15,5,4
12705,57396,443,32290,443,152,78,74,2,4,1,1
12706,9312,443,24938,443,4618,840,3778,16,26,9,7
12707,63974,53,39548,53,212,102,110,2,29,1,1
12708,57312,53,15136,53,212,110,102,2,29,1,1
12709,65143,53,22648,53,822,102,720,2,29,1,1
12710,1848,53,1848,53,832,106,726,2,29,1,1
12711,49972,53,25100,53,328,110,218,4,57,2,2
12712,55514,53,45295,53,779,86,693,2,29,1,1
12713,57235,53,60743,53,757,102,655,2,29,1,1
12714,12230,53,12230,53,216,90,126,2,29,1,1
12715,65140,53,46396,53,199,102,97,2,29,1,1
12716,55007,53,23960,53,166,86,80,2,29,1,1
12717,55991,53,2664,53,199,102,97,2,30,1,1
12718,49982,53,16411,53,211,110,101,2,30,1,1
12719,55610,53,5256,53,822,102,720,2,29,1,1
12720,56909,53,4449,53,260,86,174,2,30,1,1
12721,56333,53,31573,53,209,110,99,2,30,1,1
12722,49210,53,10205,53,183,94,89,2,30,1,1
12723,55707,53,50329,53,177,94,83,2,29,1,1
12724,39416,443,62311,443,11188,5277,5911,95,587,44,51
12725,48287,443,53104,443,416,210,206,7,96,4,3
12726,60402,80,24295,80,1135,736,399,7,95,4,3
12727,55469,53,31769,53,193,102,91,2,30,1,1
12728,64314,53,48605,53,264,110,154,2,30,1,1
12729,55941,53,54126,53,184,94,90,2,30,1,1
12730,65511,443,62661,443,430254,12640,417614,442,16,155,287
12731,58431,443,11477,443,5771,3201,2570,22,161,10,12
12732,9299,443,15796,443,4216,771,3445,16,26,9,7
12733,60476,55100,33461,55100,70,70,0,1,5,1,0
12734,38772,443,61255,443,410,210,200,7,86,4,3
12735,9279,443,53983,443,4275,760,3515,15,27,8,7
12736,9307,443,6375,443,4458,1022,3436,16,26,9,7
12737,49385,53,7961,53,214,102,112,2,30,1,1
12738,55599,53,58938,53,258,118,140,2,30,1,1
12739,50096,53,56974,53,733,94,639,2,30,1,1
12740,52096,55854,62191,55854,70,70,0,1,5,1,0
12741,9300,443,62109,443,4216,771,3445,16,26,9,7
12742,55555,53,26797,53,194,102,92,2,30,1,1
12743,9322,443,10424,443,4106,703,3403,15,26,8,7
12744,56689,443,17106,443,4857,3938,919,18,81,11,7
12745,55707,53,50594,53,177,94,83,2,30,1,1
12746,56550,123,27975,123,184,94,90,2,30,1,1
12747,64793,53,53457,53,184,94,90,2,30,1,1
12748,65009,53,23695,53,152,78,74,2,30,1,1
12749,55469,53,3156,53,193,102,91,2,30,1,1
12750,49982,53,19488,53,211,110,101,2,30,1,1
12751,64908,53,55022,53,232,94,138,2,30,1,1
12752,56551,53,16307,53,458,188,270,6,30,3,3
12753,49210,53,44765,53,183,94,89,2,30,1,1
12754,56757,53,22580,53,322,118,204,2,30,1,1
12755,49874,53,37266,53,173,94,79,2,30,1,1
12756,49699,53,53158,53,209,110,99,2,30,1,1
12757,55376,53,17349,53,199,102,97,2,30,1,1
12758,43750,443,22954,443,248384,70243,178141,544,588,246,298
12759,41011,443,63172,443,175097,9838,165259,244,106,120,124
12760,49767,53,45579,53,341,102,239,4,37,2,2
12761,9311,443,26204,443,4082,958,3124,14,26,8,6
12762,9313,443,38695,443,4618,840,3778,16,26,9,7
12763,64813,7000,64813,7000,1300,676,624,14,15,7,7
12764,65510,443,47071,443,92101,4799,87302,107,16,43,64
12765,50403,53,33399,53,168,86,82,2,30,1,1
12766,56422,53,30231,53,195,102,93,2,30,1,1
12767,59962,53,13839,53,316,94,222,2,30,1,1
12768,65498,53,49564,53,749,94,655,2,30,1,1
12769,55941,53,34210,53,184,94,90,2,30,1,1
12770,39345,80,26537,80,918,461,457,9,16,6,3
12771,48286,443,64439,443,9590,3002,6588,25,96,14,11
12772,61314,443,62611,443,3320,2053,1267,27,318,14,13
12773,41583,443,3597,443,4168,2503,1665,20,255,11,9
12774,49568,443,58538,443,7180,4959,2221,34,81,18,16
12775,49402,53,17640,53,177,94,83,2,30,1,1
12776,55620,53,62411,53,178,94,84,2,30,1,1
12777,56496,53,41605,53,193,102,91,2,30,1,1
12778,56955,53,35942,53,183,94,89,2,30,1,1
12779,56652,53,11062,53,177,94,83,2,30,1,1
12780,65277,53,40483,53,167,86,81,2,30,1,1
12781,65102,53,35796,53,183,94,89,2,30,1,1
12782,50066,443,28197,443,7144,2505,4639,14,120,7,7
12783,50075,443,63297,443,4701,2758,1943,41,93,22,19
12784,55841,53,44587,53,265,86,179,4,58,2,2
12785,57385,443,20044,443,8747,3323,5424,45,110,25,20
12786,57443,443,31881,443,8287,2469,5818,31,18,14,17
12787,49546,53,2512,53,357,106,251,4,36,2,2
12788,51242,80,19033,80,3506,2280,1226,24,50,13,11
12789,56313,443,7717,443,37465,18615,18850,299,588,135,164
12790,55838,443,50460,443,11446,4102,7344,32,20,16,16
12791,58461,443,33796,443,6100,1233,4867,21,17,11,10
12792,53166,39564,27898,39564,70,70,0,2,8,2,0
12793,60020,443,30222,443,495428,22440,472988,692,106,316,376
12794,9302,443,20327,443,4216,771,3445,16,26,9,7
12795,52134,18470,2197,18470,70,70,0,2,7,2,0
12796,64049,1029,38472,1029,66,66,0,2,7,2,0
12797,52097,23279,1789,23279,70,70,0,1,5,1,0
12798,53716,443,22368,443,7055,1261,5794,21,82,10,11
12799,52132,55014,54625,55014,70,70,0,2,7,2,0
12800,53916,23505,33630,23505,70,70,0,2,7,2,0
12801,50079,443,3173,443,32829,8718,24111,41,17,18,23
12802,64299,53,26079,53,268,84,184,4,42,2,2
12803,57511,123,47594,123,184,94,90,2,29,1,1
12804,55687,53,45230,53,193,102,91,2,29,1,1
12805,9298,443,38844,443,4216,771,3445,16,26,9,7
12806,33401,51505,0,0,66,66,0,1,0,1,0
12807,60976,22114,0,0,66,66,0,1,0,1,0
12808,52091,11392,0,0,66,66,0,1,0,1,0
12809,52231,50934,0,0,62,62,0,1,0,1,0
12810,30304,26467,0,0,62,62,0,1,0,1,0
12811,64441,445,0,0,66,66,0,1,0,1,0
12812,55553,53,13806,53,199,94,105,2,29,1,1
12813,5588,5588,0,0,3498,1872,1626,48,193,24,24
12814,65264,53,51558,53,198,94,104,2,29,1,1
12815,64937,53,29678,53,210,110,100,2,29,1,1
12816,58763,53,58763,53,228,90,138,2,29,1,1
12817,64299,53,64888,53,166,86,80,2,29,1,1
12818,64324,53,40799,53,179,94,85,2,29,1,1
12819,55837,53,36982,53,195,102,93,2,29,1,1
12820,55687,53,12551,53,193,102,91,2,29,1,1
12821,53754,53,53754,53,257,114,143,2,30,1,1
12822,55022,53,15240,53,195,102,93,2,30,1,1
12823,49296,53,40772,53,193,102,91,2,30,1,1
12824,65140,53,14372,53,199,102,97,2,30,1,1
12825,64299,53,64359,53,166,86,80,2,30,1,1
12826,16071,53,16071,53,832,106,726,2,30,1,1
12827,64615,53,10268,53,195,102,93,2,30,1,1
12828,56422,53,39106,53,195,102,93,2,30,1,1
12829,55376,53,1208,53,199,102,97,2,30,1,1
12830,65481,53,17512,53,168,86,82,2,30,1,1
12831,64403,53,23409,53,193,102,91,2,30,1,1
12832,56574,53,9941,53,275,94,181,2,30,1,1
12833,56037,53,29985,53,168,94,74,2,31,1,1
12834,50122,53,55627,53,811,94,717,2,31,1,1
12835,64716,53,43003,53,195,102,93,2,31,1,1
12836,56664,443,64784,443,9160636,285656,8874980,9685,189,3160,6525
12837,50584,51413,3341,51413,475,150,325,2,1200,1,1
12838,4544,3478,63036,3478,338,110,228,2,299,1,1
12839,8916,443,25420,443,7685,1016,6669,29,413,11,18
12840,47674,443,2134,443,7576,2983,4593,33,42,18,15
12841,55085,80,12175,80,306,180,126,6,85,4,2
12842,55841,53,22596,53,265,86,179,4,59,2,2
12843,59762,53,43399,53,401,86,315,2,30,1,1
12844,65277,53,55975,53,167,86,81,2,30,1,1
12845,56596,53,51860,53,199,102,97,2,30,1,1
12846,53900,53,54773,53,270,168,102,3,30,2,1
12847,56496,53,56369,53,193,102,91,2,30,1,1
12848,65102,53,65408,53,183,94,89,2,30,1,1
12849,57335,443,56068,443,56199,3856,52343,81,216,39,42
12850,49210,53,33969,53,410,93,317,4,30,2,2
12851,64198,53,39637,53,321,102,219,2,30,1,1
12852,55254,53,52828,53,287,102,185,2,30,1,1
12853,49410,53,14771,53,167,86,81,2,30,1,1
12854,57352,53,35179,53,196,102,94,2,30,1,1
12855,49410,53,35309,53,167,86,81,2,31,1,1
12856,65481,53,51485,53,168,86,82,2,31,1,1
12857,54117,443,30153,443,661695,28430,633265,779,118,335,444
12858,50073,443,27421,443,22729,6539,16190,54,93,27,27
12859,35128,443,23671,443,9120,5103,4017,38,587,22,16
12860,37655,443,5274,443,17842,11204,6638,43,174,24,19
12861,51824,443,65512,443,10841,6594,4247,75,585,37,38
12862,53165,18504,45814,18504,70,70,0,2,8,2,0
12863,9297,443,46735,443,4216,771,3445,16,26,9,7
12864,51667,25826,2987,25826,9440,9440,0,11,30,11,0
12865,49972,53,55153,53,216,110,106,2,30,1,1
12866,65124,53,53068,53,243,102,141,2,30,1,1
12867,55418,53,32806,53,168,86,82,2,30,1,1
12868,50191,53,9113,53,734,94,640,2,30,1,1
12869,55941,53,27410,53,184,94,90,2,30,1,1
12870,49699,53,49094,53,209,110,99,2,30,1,1
12871,62578,53,27363,53,343,168,175,3,30,2,1
12872,65440,53,2075,53,189,102,87,2,30,1,1
12873,51104,443,47911,443,5220,3063,2157,14,135,7,7
12874,42611,443,22505,443,5559,1639,3920,21,186,12,9
12875,37569,443,62296,443,97539,6936,90603,160,597,74,86
12876,49281,443,26289,443,7655,2377,5278,20,135,11,9
12877,9291,443,14472,443,3944,902,3042,14,26,8,6
12878,61811,443,37922,443,214,140,74,4,15,3,1
12879,9277,443,3010,443,4230,760,3470,14,27,8,6
12880,50470,53,11331,53,770,102,668,2,30,1,1
12881,56149,53,56149,53,832,106,726,2,30,1,1
12882,65085,53,45076,53,258,102,156,2,30,1,1
12883,53182,443,14179,443,16255,8279,7976,42,422,21,21
12884,54757,443,1080,443,6954,1758,5196,29,361,15,14
12885,49764,53,36622,53,199,102,97,2,31,1,1
12886,65140,53,62512,53,199,102,97,2,31,1,1
12887,45355,443,7242,443,410,210,200,7,92,4,3
12888,52098,29067,64917,29067,70,70,0,1,5,1,0
12889,36414,80,15964,80,5046,4132,914,31,15,16,15
12890,9310,443,7475,443,4458,1022,3436,16,26,9,7
12891,27153,80,27153,80,6397,947,5450,15,18,8,7
12892,55841,53,32658,53,265,86,179,4,58,2,2
12893,49546,53,28213,53,212,110,102,2,30,1,1
12894,64937,53,12503,53,210,110,100,2,30,1,1
12895,57132,53,39108,53,216,110,106,2,30,1,1
12896,55467,53,65023,53,198,94,104,2,30,1,1
12897,64929,53,59059,53,168,86,82,2,30,1,1
12898,56652,53,9807,53,177,94,83,2,30,1,1
12899,65009,53,11589,53,152,78,74,2,30,1,1
12900,64959,53,50159,53,173,94,79,2,30,1,1
12901,44847,42103,11973,42103,502,150,352,2,1200,1,1
12902,56995,53,4474,53,167,86,81,2,30,1,1
12903,56293,53,1963,53,166,86,80,2,30,1,1
12904,57431,53,4214,53,733,94,639,2,30,1,1
12905,65440,53,49659,53,181,94,87,2,30,1,1
12906,64959,53,35711,53,173,94,79,2,30,1,1
12907,56731,53,12750,53,165,86,79,2,30,1,1
12908,45473,53,13745,53,168,78,90,2,31,1,1
12909,42993,443,7986,443,10692,4532,6160,31,134,16,15
12910,56496,53,28777,53,193,102,91,2,30,1,1
12911,43570,53,0,0,86,86,0,1,30,1,0
12912,11964,53,13321,53,268,94,174,2,30,1,1
12913,56965,53,26904,53,183,94,89,2,30,1,1
12914,56364,53,33489,53,308,94,214,2,30,1,1
12915,64677,53,58771,53,183,94,89,2,30,1,1
12916,56995,53,60804,53,167,86,81,2,30,1,1
12917,56396,53,48729,53,338,110,228,2,30,1,1
12918,56026,53,14279,53,189,102,87,2,30,1,1
12919,56472,53,36068,53,167,86,81,2,31,1,1
12920,49978,53,17082,53,195,102,93,2,31,1,1
12921,49978,53,55753,53,195,102,93,2,30,1,1
12922,56026,53,37730,53,181,94,87,2,31,1,1
12923,58070,443,16488,443,5041,2002,3039,14,120,7,7
12924,45822,443,11470,443,4201,2089,2112,11,120,6,5
12925,46857,443,55410,443,280,140,140,5,129,3,2
12926,55877,64536,41597,64536,469,150,319,2,1200,1,1
12927,57377,443,22825,443,11247,3991,7256,30,149,14,16
12928,58602,443,31018,443,3182,1568,1614,8,121,4,4
12929,64636,53,17069,53,166,86,80,2,31,1,1
12930,49487,53,26714,53,183,94,89,2,31,1,1
12931,55227,53,15557,53,183,102,81,2,31,1,1
12932,59068,443,48115,443,11182,6150,5032,65,1775,41,24
12933,53553,53,53553,53,229,98,131,2,30,1,1
12934,49646,53,51164,53,353,118,235,2,30,1,1
12935,35691,123,42659,123,184,94,90,2,30,1,1
12936,41073,53,41073,53,197,90,107,2,30,1,1
12937,39267,123,6756,123,184,94,90,2,30,1,1
12938,55620,53,36114,53,178,94,84,2,31,1,1
12939,64677,53,61310,53,183,94,89,2,31,1,1
12940,56491,53,20777,53,165,86,79,2,31,1,1
12941,65168,53,7392,53,185,102,83,2,31,1,1
12942,56731,53,43957,53,173,94,79,2,31,1,1
12943,55376,53,7206,53,199,102,97,2,31,1,1
12944,49348,53,24608,53,194,102,92,2,31,1,1
12945,64929,53,8681,53,168,86,82,2,31,1,1
12946,57352,53,29825,53,196,102,94,2,31,1,1
12947,57132,53,11896,53,216,110,106,2,31,1,1
12948,49699,53,28371,53,209,110,99,2,31,1,1
12949,49487,53,10311,53,183,94,89,2,31,1,1
12950,49359,80,26843,80,60,60,0,2,154,2,0
12951,54124,443,47726,443,13210,3034,10176,47,153,19,28
12952,53031,443,28915,443,2399,1799,600,15,120,10,5
12953,65375,53,14200,53,196,94,102,2,31,1,1
12954,37850,443,54127,443,3595,1468,2127,13,135,6,7
12955,41325,443,52651,443,9669,2488,7181,26,149,11,15
12956,53910,1024,52372,1024,70,70,0,2,8,2,0
12957,42263,443,45775,443,224,164,60,3,5,2,1
12958,51628,443,50977,443,5678,3121,2557,39,256,18,21
12959,55022,53,45433,53,195,102,93,2,30,1,1
12960,52127,44198,39130,44198,70,70,0,2,8,2,0
12961,52128,21294,46936,21294,70,70,0,2,8,2,0
12962,53883,24830,60159,24830,164,70,94,2,5,1,1
12963,41587,5222,51042,5222,208,60,148,4,14,2,2
12964,40439,443,42690,443,8126,1627,6499,29,165,16,13
12965,50077,443,29789,443,8172,1833,6339,25,93,14,11
12966,50078,443,13152,443,12035,9784,2251,41,92,22,19
12967,56472,53,13780,53,167,86,81,2,31,1,1
12968,57075,53,41557,53,443,182,261,6,31,3,3
12969,53888,39204,51033,39204,70,70,0,1,5,1,0
12970,36400,443,31590,443,53365,28404,24961,565,753,302,263
12971,54125,443,18046,443,170665,9296,161369,227,116,102,125
12972,53347,443,16972,443,21456,6153,15303,120,491,46,74
12973,55556,53,8408,53,183,94,89,2,30,1,1
12974,50288,53,30921,53,764,102,662,2,30,1,1
12975,65286,53,2453,53,369,102,267,2,30,1,1
12976,49611,53,24146,53,177,94,83,2,30,1,1
12977,64693,53,60951,53,766,102,664,2,30,1,1
12978,43390,53,0,0,184,86,98,2,30,1,1
12979,56965,53,44831,53,183,94,89,2,30,1,1
12980,6666,138,0,0,60,60,0,1,0,1,0
12981,9552,57470,0,0,62,62,0,1,0,1,0
12982,4111,25174,0,0,146,146,0,1,0,1,0
12983,64437,445,0,0,66,66,0,1,0,1,0
12984,50765,22114,0,0,66,66,0,1,0,1,0
12985,64290,445,0,0,70,70,0,1,0,1,0
12986,51578,44847,0,0,66,66,0,1,0,1,0
12987,52358,30188,0,0,66,66,0,1,0,1,0
12988,64288,445,0,0,70,70,0,1,0,1,0
12989,1480,12447,0,0,66,66,0,1,0,1,0
12990,6881,6881,0,0,146,146,0,1,0,1,0
12991,61057,25174,0,0,62,62,0,1,0,1,0
12992,1035,57470,0,0,72,72,0,1,0,1,0
12993,64287,445,0,0,70,70,0,1,0,1,0
12994,59493,44847,0,0,66,66,0,1,0,1,0
12995,46116,57470,0,0,74,74,0,1,0,1,0
12996,64286,445,0,0,70,70,0,1,0,1,0
12997,64285,445,0,0,70,70,0,1,0,1,0
12998,11136,15503,0,0,62,62,0,1,0,1,0
12999,64280,445,0,0,70,70,0,1,0,1,0
13000,64279,445,0,0,70,70,0,1,0,1,0
13001,52655,445,0,0,70,70,0,1,0,1,0
13002,52650,445,0,0,70,70,0,1,0,1,0
13003,52651,445,0,0,70,70,0,1,0,1,0
13004,6881,6881,0,0,62,62,0,1,0,1,0
13005,64422,445,0,0,66,66,0,1,0,1,0
13006,64420,445,0,0,66,66,0,1,0,1,0
13007,64423,445,0,0,66,66,0,1,0,1,0
13008,64424,445,0,0,66,66,0,1,0,1,0
13009,64421,445,0,0,66,66,0,1,0,1,0
13010,64419,445,0,0,66,66,0,1,0,1,0
13011,64418,445,0,0,66,66,0,1,0,1,0
13012,64417,445,0,0,66,66,0,1,0,1,0
13013,59097,2767,0,0,66,66,0,1,0,1,0
13014,61387,43890,0,0,66,66,0,1,0,1,0
13015,56326,56205,0,0,66,66,0,1,0,1,0
13016,59736,51505,0,0,146,146,0,1,0,1,0
13017,64727,25174,0,0,66,66,0,1,0,1,0
13018,64267,445,0,0,70,70,0,1,0,1,0
13019,64266,445,0,0,70,70,0,1,0,1,0
13020,64264,445,0,0,70,70,0,1,0,1,0
13021,22490,25174,0,0,62,62,0,1,0,1,0
13022,64256,445,0,0,70,70,0,1,0,1,0
13023,64257,445,0,0,70,70,0,1,0,1,0
13024,26265,37965,0,0,66,66,0,1,0,1,0
13025,23091,11119,0,0,148,148,0,1,0,1,0
13026,47632,25174,0,0,62,62,0,1,0,1,0
13027,52647,445,0,0,70,70,0,1,0,1,0
13028,52641,445,0,0,70,70,0,1,0,1,0
13029,52637,445,0,0,70,70,0,1,0,1,0
13030,52636,445,0,0,70,70,0,1,0,1,0
13031,34932,38608,0,0,62,62,0,1,0,1,0
13032,64343,6004,0,0,66,66,0,1,0,1,0
13033,6843,42873,0,0,62,62,0,1,0,1,0
13034,49160,57470,0,0,146,146,0,1,0,1,0
13035,2707,37,0,0,60,60,0,1,0,1,0
13036,64404,445,0,0,66,66,0,1,0,1,0
13037,64403,445,0,0,66,66,0,1,0,1,0
13038,64402,445,0,0,66,66,0,1,0,1,0
13039,63743,25174,0,0,62,62,0,1,0,1,0
13040,64245,445,0,0,70,70,0,1,0,1,0
13041,1024,25174,0,0,62,62,0,1,0,1,0
13042,25889,11446,0,0,66,66,0,1,0,1,0
13043,22948,26467,0,0,62,62,0,1,0,1,0
13044,52630,445,0,0,70,70,0,1,0,1,0
13045,51062,1433,0,0,60,60,0,1,0,1,0
13046,52625,445,0,0,70,70,0,1,0,1,0
13047,52626,445,0,0,70,70,0,1,0,1,0
13048,52622,445,0,0,70,70,0,1,0,1,0
13049,64587,43890,0,0,62,62,0,1,0,1,0
13050,55985,44847,0,0,62,62,0,1,0,1,0
13051,50328,22114,0,0,62,62,0,1,0,1,0
13052,64241,445,0,0,70,70,0,1,0,1,0
13053,1620,53567,0,0,62,62,0,1,0,1,0
13054,54236,36829,0,0,62,62,0,1,0,1,0
13055,64230,445,0,0,70,70,0,1,0,1,0
13056,64231,445,0,0,70,70,0,1,0,1,0
13057,64229,445,0,0,70,70,0,1,0,1,0
13058,55600,22,0,0,60,60,0,1,0,1,0
13059,56826,22114,0,0,66,66,0,1,0,1,0
13060,64228,445,0,0,70,70,0,1,0,1,0
13061,25067,22114,0,0,146,146,0,1,0,1,0
13062,64225,445,0,0,70,70,0,1,0,1,0
13063,58646,44847,0,0,66,66,0,1,0,1,0
13064,52613,445,0,0,70,70,0,1,0,1,0
13065,52612,445,0,0,70,70,0,1,0,1,0
13066,52607,445,0,0,70,70,0,1,0,1,0
13067,55429,25174,0,0,66,66,0,1,0,1,0
13068,44154,22114,0,0,62,62,0,1,0,1,0
13069,64393,445,0,0,66,66,0,1,0,1,0
13070,45452,443,54388,443,16362,3716,12646,79,601,38,41
13071,16158,50584,0,0,66,66,0,1,0,1,0
13072,54758,35993,0,0,66,66,0,1,0,1,0
13073,55341,39004,0,0,74,74,0,1,0,1,0
13074,56205,51505,0,0,66,66,0,1,0,1,0
13075,60479,25174,0,0,66,66,0,1,0,1,0
13076,49841,1433,0,0,60,60,0,1,0,1,0
13077,2427,25174,0,0,146,146,0,1,0,1,0
13078,49929,26467,0,0,66,66,0,1,0,1,0
13079,64219,445,0,0,70,70,0,1,0,1,0
13080,45964,2225,0,0,60,60,0,1,0,1,0
13081,52605,445,0,0,70,70,0,1,0,1,0
13082,52166,26467,0,0,66,66,0,1,0,1,0
13083,64295,26467,0,0,66,66,0,1,0,1,0
13084,52603,445,0,0,70,70,0,1,0,1,0
13085,28192,50584,0,0,66,66,0,1,0,1,0
13086,13285,29892,0,0,145,145,0,1,0,1,0
13087,59782,26467,0,0,62,62,0,1,0,1,0
13088,52459,33890,0,0,60,60,0,1,0,1,0
13089,0,0,0,0,480,244,236,4,0,2,2
13090,48271,25174,0,0,146,146,0,1,0,1,0
13091,58022,8010,0,0,60,60,0,1,0,1,0
13092,6882,55839,0,0,146,146,0,1,0,1,0
13093,6126,25174,0,0,66,66,0,1,0,1,0
13094,64211,445,0,0,70,70,0,1,0,1,0
13095,64376,445,0,0,66,66,0,1,0,1,0
13096,64375,445,0,0,66,66,0,1,0,1,0
13097,64016,25174,0,0,62,62,0,1,0,1,0
13098,31539,37965,0,0,62,62,0,1,0,1,0
13099,64210,445,0,0,70,70,0,1,0,1,0
13100,56872,21247,0,0,70,70,0,1,0,1,0
13101,45964,2228,0,0,60,60,0,1,0,1,0
13102,56614,25174,0,0,66,66,0,1,0,1,0
13103,55587,43890,0,0,66,66,0,1,0,1,0
13104,52593,445,0,0,70,70,0,1,0,1,0
13105,52594,445,0,0,70,70,0,1,0,1,0
13106,52590,445,0,0,70,70,0,1,0,1,0
13107,52584,445,0,0,70,70,0,1,0,1,0
13108,64205,445,0,0,70,70,0,1,0,1,0
13109,64203,445,0,0,70,70,0,1,0,1,0
13110,62189,64147,0,0,62,62,0,1,0,1,0
13111,64369,445,0,0,66,66,0,1,0,1,0
13112,26921,26467,0,0,62,62,0,1,0,1,0
13113,63855,25174,0,0,62,62,0,1,0,1,0
13114,64366,445,0,0,66,66,0,1,0,1,0
13115,64364,445,0,0,66,66,0,1,0,1,0
13116,64357,445,0,0,66,66,0,1,0,1,0
13117,64361,445,0,0,66,66,0,1,0,1,0
13118,64355,445,0,0,66,66,0,1,0,1,0
13119,64356,445,0,0,66,66,0,1,0,1,0
13120,64353,445,0,0,66,66,0,1,0,1,0
13121,64199,445,0,0,70,70,0,1,0,1,0
13122,54883,60043,0,0,62,62,0,1,0,1,0
13123,8889,52294,0,0,60,60,0,1,0,1,0
13124,57131,35776,0,0,145,145,0,1,0,1,0
13125,6842,42873,0,0,62,62,0,1,0,1,0
13126,52578,445,0,0,70,70,0,1,0,1,0
13127,51414,22,0,0,60,60,0,1,0,1,0
13128,57991,22114,0,0,66,66,0,1,0,1,0
13129,52575,445,0,0,70,70,0,1,0,1,0
13130,52572,445,0,0,70,70,0,1,0,1,0
13131,52573,445,0,0,70,70,0,1,0,1,0
13132,64198,445,0,0,70,70,0,1,0,1,0
13133,29178,35440,0,0,66,66,0,1,0,1,0
13134,31619,51221,0,0,62,62,0,1,0,1,0
13135,53161,51221,0,0,66,66,0,1,0,1,0
13136,61550,5529,0,0,145,145,0,1,0,1,0
13137,64733,35440,0,0,66,66,0,1,0,1,0
13138,58007,62413,0,0,66,66,0,1,0,1,0
13139,51232,23,0,0,60,60,0,1,0,1,0
13140,49653,80,62428,80,372,192,180,7,42,4,3
13141,49659,80,54132,80,1937,885,1052,13,42,7,6
13142,49635,80,43715,80,318,192,126,6,42,4,2
13143,49618,80,5688,80,314,192,122,6,42,4,2
13144,49655,80,40166,80,499,192,307,6,42,4,2
13145,62912,443,19185,443,10829,2227,8602,35,47,20,15
13146,52094,55986,33027,55986,66,66,0,1,5,1,0
13147,49646,80,33279,80,318,192,126,6,42,4,2
13148,50827,443,49837,443,7298,2661,4637,21,17,11,10
13149,50999,443,57620,443,6765,1108,5657,17,18,10,7
13150,43326,443,43455,443,8065,2689,5376,27,315,14,13
13151,56472,53,9100,53,166,85,81,2,31,1,1
13152,49978,53,13448,53,190,97,93,2,30,1,1
13153,49619,80,12609,80,318,192,126,6,42,4,2
13154,49487,53,6709,53,182,93,89,2,30,1,1
13155,55538,53,15605,53,168,86,82,2,30,1,1
13156,49407,80,43999,80,4878,1570,3308,19,165,10,9
13157,64716,53,37975,53,190,97,93,2,31,1,1
13158,49616,80,21429,80,314,192,122,6,42,4,2
13159,49622,80,33304,80,454,262,192,8,42,5,3
13160,49634,80,5183,80,318,192,126,6,42,4,2
13161,49617,80,31416,80,314,192,122,6,42,4,2
13162,52124,11296,17277,11296,70,70,0,2,8,2,0
13163,50998,443,9197,443,6765,1108,5657,17,18,10,7
13164,52129,55550,12680,55550,70,70,0,2,8,2,0
13165,52095,48896,29371,48896,66,66,0,1,5,1,0
13166,55700,443,30597,443,10286,1326,8960,25,1017,8,17
13167,34320,443,18156,443,5823,1597,4226,21,19,11,10
13168,49891,53,30480,53,788,108,680,2,31,1,1
13169,49348,53,25745,53,188,96,92,2,31,1,1
13170,55703,13836,54739,13836,70,70,0,2,8,2,0
13171,65516,53,4200,53,290,94,196,4,41,2,2
13172,46215,443,1828,443,161,101,60,2,5,1,1
13173,49569,80,41314,80,454,262,192,8,44,5,3
13174,49621,80,15641,80,318,192,126,6,42,4,2
13175,49563,80,12092,80,318,192,126,6,45,4,2
13176,49620,80,21542,80,318,192,126,6,42,4,2
13177,49652,80,63583,80,372,192,180,7,42,4,3
13178,49647,80,48193,80,318,192,126,6,42,4,2
13179,49556,80,42311,80,7002,5717,1285,15,45,9,6
13180,49623,80,12161,80,454,262,192,8,42,5,3
13181,49671,80,23759,80,2122,1018,1104,13,41,7,6
13182,51987,80,37675,80,2175,1532,643,10,22,7,3
13183,56543,53,18371,53,756,95,661,2,30,1,1
13184,62030,53,0,0,229,85,144,2,31,1,1
13185,49332,443,44143,443,142684,5997,136687,134,48,31,103
13186,8282,17435,17967,17435,73,73,0,1,30,1,0
13187,56314,53,2805,53,182,93,89,2,30,1,1
13188,39626,443,37265,443,5518,1323,4195,25,271,14,11
13189,58249,443,60364,443,4220,2048,2172,11,122,6,5
13190,65239,53,46235,53,198,101,97,2,31,1,1
13191,19008,31652,0,0,74,74,0,1,91,1,0
13192,43411,443,13391,443,2895,726,2169,10,121,5,5
13193,40009,443,48154,443,21785,5577,16208,35,362,16,19
13194,56575,53,50705,53,732,89,643,2,31,1,1
13195,62007,24184,0,0,66,66,0,1,91,1,0
13196,42076,443,12944,443,4295,2123,2172,11,121,6,5
13197,48737,443,47925,443,5220,2290,2930,15,121,7,8
13198,56925,53,7944,53,192,98,94,2,30,1,1
13199,55106,53,52896,53,184,94,90,2,31,1,1
13200,56612,53,25509,53,274,87,187,4,31,2,2
13201,26661,53,26661,53,217,87,130,2,31,1,1
13202,56592,53,10104,53,200,102,98,2,31,1,1
13203,53288,443,63225,443,4448,1654,2794,13,121,6,7
13204,48817,41768,48817,41768,511,152,359,2,1200,1,1
13205,64306,53,29347,53,216,110,106,2,31,1,1
13206,48810,443,34983,443,6478,2684,3794,18,122,8,10
13207,40204,40014,35119,40014,141,79,62,2,31,1,1
13208,49154,443,24167,443,3163100,158133,3004967,3863,264,1464,2399
13209,15503,50321,53712,50321,490,149,341,2,1200,1,1
13210,3981,23117,0,0,66,66,0,1,0,1,0
13211,64193,445,0,0,70,70,0,1,0,1,0
13212,5060,37965,0,0,66,66,0,1,0,1,0
13213,4232,50584,0,0,66,66,0,1,0,1,0
13214,52569,445,0,0,70,70,0,1,0,1,0
13215,52565,445,0,0,70,70,0,1,0,1,0
13216,52564,445,0,0,70,70,0,1,0,1,0
13217,48978,25174,0,0,66,66,0,1,0,1,0
13218,64347,445,0,0,66,66,0,1,0,1,0
13219,6881,6881,0,0,146,146,0,1,0,1,0
13220,3103,50584,0,0,62,62,0,1,0,1,0
13221,52562,445,0,0,70,70,0,1,0,1,0
13222,29145,8168,0,0,62,62,0,1,0,1,0
13223,1253,25174,0,0,146,146,0,1,0,1,0
13224,64344,445,0,0,66,66,0,1,0,1,0
13225,45964,9666,0,0,60,60,0,1,0,1,0
13226,1108,47807,0,0,159,159,0,1,0,1,0
13227,51783,50584,0,0,66,66,0,1,0,1,0
13228,49593,80,60078,80,7098,5692,1406,17,41,9,8
13229,60011,443,31949,443,6053,2582,3471,30,80,15,15
13230,49600,80,7933,80,312,192,120,6,41,4,2
13231,49569,53,19473,53,198,102,96,2,30,1,1
13232,57232,53,10597,53,821,102,719,2,30,1,1
13233,35194,57470,0,0,74,74,0,1,0,1,0
13234,64341,445,0,0,66,66,0,1,0,1,0
13235,64342,445,0,0,66,66,0,1,0,1,0
13236,43260,41615,0,0,145,145,0,1,0,1,0
13237,44856,51505,0,0,62,62,0,1,0,1,0
13238,64340,445,0,0,66,66,0,1,0,1,0
13239,55408,64147,0,0,66,66,0,1,0,1,0
13240,63741,50584,0,0,62,62,0,1,0,1,0
13241,56406,22114,0,0,62,62,0,1,0,1,0
13242,45535,25174,0,0,62,62,0,1,0,1,0
13243,35207,22114,0,0,146,146,0,1,0,1,0
13244,49689,22114,0,0,62,62,0,1,0,1,0
13245,6943,21162,0,0,100,100,0,1,0,1,0
13246,64180,445,0,0,70,70,0,1,0,1,0
13247,6943,1970,0,0,100,100,0,1,0,1,0
13248,6943,52290,0,0,100,100,0,1,0,1,0
13249,6943,14984,0,0,100,100,0,1,0,1,0
13250,52558,445,0,0,70,70,0,1,0,1,0
13251,6943,59353,0,0,100,100,0,1,0,1,0
13252,6943,57099,0,0,100,100,0,1,0,1,0
13253,12830,25174,0,0,62,62,0,1,0,1,0
13254,46532,17372,0,0,145,145,0,1,0,1,0
13255,52553,445,0,0,70,70,0,1,0,1,0
13256,52549,445,0,0,70,70,0,1,0,1,0
13257,64177,445,0,0,70,70,0,1,0,1,0
13258,51728,44847,0,0,62,62,0,1,0,1,0
13259,37887,22114,0,0,66,66,0,1,0,1,0
13260,64329,445,0,0,66,66,0,1,0,1,0
13261,33556,25174,0,0,62,62,0,1,0,1,0
13262,43815,50584,0,0,62,62,0,1,0,1,0
13263,55106,53,41822,53,177,94,83,2,30,1,1
13264,64306,53,23219,53,216,110,106,2,30,1,1
13265,51000,443,65422,443,6544,939,5605,17,17,10,7
13266,43864,443,38853,443,4922,2860,2062,25,39,14,11
13267,54118,443,28446,443,115373,6904,108469,171,117,87,84
13268,53913,28402,62039,28402,70,70,0,2,7,2,0
13269,65516,53,26663,53,290,94,196,4,40,2,2
13270,38633,443,38633,443,4378,1471,2907,19,29,11,8
13271,56782,53,44895,53,197,102,95,2,30,1,1
13272,51230,443,29300,443,33489,19602,13887,98,43,51,47
13273,49657,443,35292,443,2800,1557,1243,33,53,19,14
13274,53884,48754,22273,48754,70,70,0,1,4,1,0
13275,64025,26826,1858,26826,70,70,0,1,4,1,0
13276,39378,443,56513,443,494,342,152,4,5,2,2
13277,60786,443,40740,443,12106,2192,9914,38,38,19,19
13278,64022,60918,60664,60918,70,70,0,1,4,1,0
13279,50824,80,46115,80,36051,11695,24356,109,265,55,54
13280,35098,443,17186,443,7703,1606,6097,23,80,13,10
13281,49644,80,40102,80,318,192,126,6,41,4,2
13282,49874,53,61806,53,165,86,79,2,29,1,1
13283,65041,53,3296,53,200,94,106,2,29,1,1
13284,65501,53,16521,53,443,182,261,6,29,3,3
13285,55556,53,62239,53,183,94,89,2,29,1,1
13286,56037,53,56792,53,168,94,74,2,29,1,1
13287,54979,53,30018,53,207,97,110,3,64,2,1
13288,55106,53,22662,53,184,94,90,2,30,1,1
13289,49663,80,43225,80,8935,3175,5760,17,41,8,9
13290,49633,80,21073,80,318,192,126,6,41,4,2
13291,49564,80,48576,80,318,192,126,6,45,4,2
13292,37711,443,32947,443,8060,2166,5894,23,255,12,11
13293,50376,53,42212,53,819,102,717,2,30,1,1
13294,42053,443,49116,443,2351,1546,805,20,40,11,9
13295,56925,53,48692,53,196,102,94,2,30,1,1
13296,57007,53,5847,53,183,94,89,2,30,1,1
13297,49764,53,54622,53,199,102,97,2,30,1,1
13298,49480,80,65349,80,6811,3791,3020,23,115,13,10
13299,55538,53,6885,53,168,86,82,2,30,1,1
13300,49679,80,26556,80,7256,1682,5574,14,40,6,8
13301,55707,53,54526,53,811,94,717,2,30,1,1
13302,49666,80,13546,80,7270,3119,4151,14,41,7,7
13303,65351,53,49727,53,228,110,118,2,30,1,1
13304,49606,80,25049,80,454,262,192,8,41,5,3
13305,49594,80,30490,80,25430,15577,9853,37,41,19,18
13306,52126,56057,15046,56057,70,70,0,2,8,2,0
13307,40204,40029,46066,40029,148,86,62,2,30,1,1
13308,58424,443,34481,443,6020,2493,3527,29,80,14,15
13309,54627,443,30890,443,182017,6621,175396,189,181,55,134
13310,51599,443,24581,443,25546,5284,20262,48,149,26,22
13311,55700,26957,2984,26957,70,70,0,1,5,1,0
13312,54635,443,11319,443,11955,1861,10094,30,172,14,16
13313,49664,80,19625,80,7561,3181,4380,16,41,8,8
13314,35214,8635,35214,8635,138,78,60,2,5,1,1
13315,36404,80,8914,80,534,460,74,6,15,5,1
13316,49679,443,62696,443,7938,1721,6217,25,172,12,13
13317,49277,80,11702,80,13670,11470,2200,39,231,20,19
13318,49668,80,43673,80,318,192,126,6,41,4,2
13319,65516,53,20089,53,506,204,302,6,57,3,3
13320,54625,53,52244,53,168,78,90,2,30,1,1
13321,49575,80,43723,80,318,192,126,6,43,4,2
13322,49584,80,44285,80,318,192,126,6,42,4,2
13323,65481,53,60374,53,168,86,82,2,30,1,1
13324,56965,53,39310,53,183,94,89,2,30,1,1
13325,56491,53,2856,53,165,86,79,2,30,1,1
13326,38211,443,38211,443,4653,1746,2907,19,26,11,8
13327,64403,53,33316,53,193,102,91,2,30,1,1
13328,49487,53,55528,53,183,94,89,2,30,1,1
13329,64950,53,55366,53,183,94,89,2,30,1,1
13330,56314,53,10977,53,183,94,89,2,30,1,1
13331,49764,53,50844,53,199,102,97,2,30,1,1
13332,55947,53,4712,53,94,94,0,1,30,1,0
13333,57007,53,38539,53,183,94,89,2,30,1,1
13334,56592,53,38145,53,200,102,98,2,30,1,1
13335,64636,53,38894,53,182,102,80,2,30,1,1
13336,57232,53,8301,53,198,102,96,2,30,1,1
13337,37698,443,12829,443,1781,1062,719,16,275,8,8
13338,65239,53,27517,53,199,102,97,2,30,1,1
13339,56925,53,20388,53,196,102,94,2,30,1,1
13340,60863,443,21124,443,24452,12758,11694,39,129,23,16
13341,51819,80,5456,80,5368,946,4422,16,77,9,7
13342,49665,80,35482,80,8457,3062,5395,16,41,7,9
13343,49604,80,21319,80,454,262,192,8,41,5,3
13344,49607,80,52438,80,378,192,186,7,41,4,3
13345,49643,80,57400,80,312,192,120,6,41,4,2
13346,49649,80,26716,80,378,192,186,7,41,4,3
13347,61594,53,61594,53,235,90,145,2,33,1,1
13348,52093,40828,29609,40828,160,70,90,2,5,1,1
13349,50827,80,8180,80,35970,11674,24296,108,265,55,53
13350,49673,80,41313,80,318,192,126,6,41,4,2
13351,56791,53,55367,53,250,87,163,4,58,2,2
13352,60824,53,60824,53,220,90,130,2,30,1,1
13353,49569,53,26958,53,821,102,719,2,30,1,1
13354,50825,80,41226,80,35970,11674,24296,108,265,55,53
13355,53163,32834,49682,32834,70,70,0,1,5,1,0
13356,51263,443,57364,443,162,102,60,2,5,1,1
13357,49682,443,37715,443,9766,1633,8133,27,172,13,14
13358,42993,443,2255,443,14451,3012,11439,33,32,18,15
13359,35078,443,15189,443,7222,1768,5454,22,81,13,9
13360,49567,80,10114,80,2855,1388,1467,12,44,7,5
13361,55639,53,59060,53,196,102,94,2,30,1,1
13362,64893,53,6270,53,326,134,192,2,30,1,1
13363,55452,53,61292,53,184,94,90,2,30,1,1
13364,55084,443,30495,443,6936,819,6117,20,85,11,9
13365,46413,443,45352,443,8106,4839,3267,61,449,32,29
13366,37991,443,2941,443,9566,2592,6974,29,134,16,13
13367,54127,443,25652,443,148422,10568,137854,223,115,114,109
13368,43347,443,49384,443,9118,1699,7419,24,131,14,10
13369,58736,53,58736,53,235,90,145,2,32,1,1
13370,51372,80,40252,80,882,527,355,10,255,6,4
13371,54126,443,11328,443,147104,9481,137623,217,115,111,106
13372,65427,53,25865,53,677,188,489,6,57,3,3
13373,38460,443,18587,443,14768,3347,11421,69,1902,32,37
13374,50074,443,37111,443,1625,838,787,18,92,10,8
13375,51464,443,62248,443,7269,1978,5291,28,39,14,14
13376,53539,443,34866,443,2385,1462,923,18,200,10,8
13377,65516,53,41111,53,290,94,196,4,40,2,2
13378,56782,53,33216,53,197,102,95,2,33,1,1
13379,40288,80,46706,80,1195,763,432,10,32,6,4
13380,33047,443,1345,443,204,70,134,4,25,2,2
13381,59533,443,28553,443,448,78,370,6,24,1,5
13382,49645,80,12574,80,318,192,126,6,41,4,2
13383,49614,80,63774,80,374,192,182,7,41,4,3
13384,49599,80,35878,80,312,192,120,6,41,4,2
13385,49651,80,24642,80,318,192,126,6,41,4,2
13386,49642,80,32526,80,312,192,120,6,41,4,2
13387,49609,80,50781,80,318,192,126,6,41,4,2
13388,51829,80,1041,80,1484,928,556,13,76,8,5
13389,49608,80,48854,80,318,192,126,6,41,4,2
13390,49667,80,7772,80,27534,4859,22675,34,41,14,20
13391,49560,80,60008,80,318,192,126,6,45,4,2
13392,49672,80,15007,80,3749,2453,1296,15,41,9,6
13393,49662,80,35388,80,6753,3135,3618,17,41,8,9
13394,49592,80,33337,80,4173,2324,1849,14,42,8,6
13395,56596,53,55954,53,199,102,97,2,29,1,1
13396,64403,53,2916,53,193,102,91,2,29,1,1
13397,56312,53,29568,53,195,102,93,2,29,1,1
13398,49603,80,3315,80,378,192,186,7,41,4,3
13399,49548,53,2066,53,263,102,161,2,29,1,1
13400,56314,53,50014,53,183,94,89,2,30,1,1
13401,55538,53,33092,53,250,86,164,4,30,2,2
13402,58346,53,2203,53,209,102,107,2,30,1,1
13403,60187,53,13355,53,168,78,90,2,30,1,1
13404,64581,53,40086,53,214,110,104,2,30,1,1
13405,55818,443,58281,443,5100,2001,3099,15,119,7,8
13406,56791,53,43251,53,250,87,163,4,58,2,2
13407,49348,53,2617,53,194,102,92,2,30,1,1
13408,64076,53,25451,53,255,102,153,2,30,1,1
13409,49477,53,4842,53,178,94,84,2,31,1,1
13410,49466,53,63344,53,807,94,713,2,30,1,1
13411,42155,443,26461,443,70,70,0,1,5,1,0
13412,58095,80,30247,80,4468,1145,3323,15,16,9,6
13413,49648,80,25450,80,318,192,126,6,41,4,2
13414,49576,80,3769,80,318,192,126,6,43,4,2
13415,49605,80,22223,80,454,262,192,8,41,5,3
13416,49582,80,49496,80,25980,10637,15343,40,42,17,23
13417,49624,80,29847,80,3314,1478,1836,16,41,9,7
13418,49611,80,38044,80,378,192,186,7,41,4,3
13419,49610,80,55235,80,378,192,186,7,41,4,3
13420,49601,80,15488,80,378,192,186,7,41,4,3
13421,50376,53,40722,53,196,102,94,2,30,1,1
13422,55639,53,11030,53,819,102,717,2,30,1,1
13423,49611,53,5356,53,177,94,83,2,30,1,1
13424,55692,53,51127,53,198,102,96,2,30,1,1
13425,40476,443,53143,443,17360,5578,11782,71,281,39,32
13426,50826,80,48832,80,35970,11674,24296,108,265,55,53
13427,50823,80,36399,80,35970,11674,24296,108,265,55,53
13428,49580,443,38727,443,442,262,180,8,42,5,3
13429,49596,80,27800,80,312,192,120,6,41,4,2
13430,49598,80,32079,80,372,192,180,7,41,4,3
13431,49597,80,58897,80,372,192,180,7,41,4,3
13432,54967,80,54666,80,1848,851,997,10,515,6,4
13433,49650,80,5839,80,318,192,126,6,41,4,2
13434,49602,80,16412,80,378,192,186,7,41,4,3
13435,64950,53,1692,53,183,94,89,2,30,1,1
13436,65168,53,17811,53,185,102,83,2,30,1,1
13437,57007,53,22368,53,183,94,89,2,30,1,1
13438,54943,443,33087,443,7118,2618,4500,21,30,12,9
13439,55106,53,58487,53,177,94,83,2,30,1,1
13440,55538,53,2707,53,168,86,82,2,30,1,1
13441,57231,53,57692,53,168,86,82,2,32,1,1
13442,52125,49224,18364,49224,70,70,0,2,8,2,0
13443,49732,80,36115,80,5236,1070,4166,13,145,6,7
13444,49613,80,63557,80,374,192,182,7,41,4,3
13445,49615,80,42615,80,374,192,182,7,41,4,3
13446,9472,443,45589,443,5699,505,5194,14,15,7,7
13447,49562,80,14517,80,318,192,126,6,45,4,2
13448,49612,80,44677,80,378,192,186,7,41,4,3
13449,56314,53,22045,53,183,94,89,2,30,1,1
13450,55227,53,7352,53,183,102,81,2,30,1,1
13451,56293,53,53658,53,166,86,80,2,30,1,1
13452,49477,53,20665,53,178,94,84,2,30,1,1
13453,64716,53,1067,53,195,102,93,2,30,1,1
13454,49635,53,16265,53,458,188,270,6,30,3,3
13455,55021,443,43787,443,6724,3642,3082,18,133,10,8
13456,55692,53,9187,53,198,102,96,2,31,1,1
13457,33340,443,55389,443,3598,1118,2480,14,120,7,7
13458,64306,53,34963,53,216,110,106,2,31,1,1
13459,65212,53,6232,53,196,102,94,2,31,1,1
13460,53035,443,43721,443,3473,881,2592,13,121,6,7
13461,64086,443,16892,443,3289,1031,2258,13,121,6,7
13462,64716,53,18562,53,195,102,93,2,31,1,1
13463,55032,53,18500,53,458,188,270,6,31,3,3
13464,56612,53,30112,53,274,87,187,4,31,2,2
13465,49591,53,7823,53,402,118,284,2,30,1,1
13466,56226,53,8376,53,284,96,188,4,31,2,2
13467,64987,53,57288,53,196,102,94,2,31,1,1
13468,56612,53,25011,53,274,87,187,4,31,2,2
13469,38851,443,9016,443,5993,2348,3645,15,120,8,7
13470,46159,443,16876,443,4168,1128,3040,14,121,7,7
13471,55631,443,58192,443,6897,2509,4388,16,121,8,8
13472,8915,443,26790,443,7182,1016,6166,28,412,11,17
13473,56490,443,62341,443,11756,4004,7752,26,121,12,14
13474,41365,443,33138,443,27475,5634,21841,76,145,35,41
13475,55697,53,64657,53,193,102,91,2,31,1,1
13476,43596,80,25616,80,1947,1182,765,10,515,6,4
13477,49782,443,62911,443,70,70,0,1,5,1,0
13478,49658,443,46695,443,11880,2839,9041,30,48,16,14
13479,46412,53,4555,53,164,78,86,2,31,1,1
13480,9267,80,6787,80,318,192,126,6,27,4,2
13481,51535,443,59853,443,122,62,60,2,16,1,1
13482,50023,53,26218,53,166,86,80,2,31,1,1
13483,54965,80,28312,80,3419,2046,1373,12,515,7,5
13484,52091,4789,61902,4789,70,70,0,1,5,1,0
13485,55661,53,42015,53,213,102,111,2,30,1,1
13486,56925,53,23020,53,196,102,94,2,30,1,1
13487,55718,27025,38370,27025,1778,1386,392,8,30,4,4
13488,56082,53,20820,53,184,94,90,2,30,1,1
13489,64632,53,26914,53,224,94,130,2,30,1,1
13490,57300,53,58923,53,184,94,90,2,31,1,1
13491,57550,50584,0,0,66,66,0,1,0,1,0
13492,36258,23,0,0,60,60,0,1,0,1,0
13493,64172,445,0,0,70,70,0,1,0,1,0
13494,35626,22114,0,0,62,62,0,1,0,1,0
13495,27679,37965,0,0,62,62,0,1,0,1,0
13496,64171,445,0,0,70,70,0,1,0,1,0
13497,2707,37,0,0,60,60,0,1,0,1,0
13498,50106,30317,0,0,62,62,0,1,0,1,0
13499,28156,50584,0,0,146,146,0,1,0,1,0
13500,64321,445,0,0,66,66,0,1,0,1,0
13501,62799,25174,0,0,62,62,0,1,0,1,0
13502,52534,445,0,0,70,70,0,1,0,1,0
13503,64169,445,0,0,70,70,0,1,0,1,0
13504,36258,23,0,0,60,60,0,1,0,1,0
13505,36258,23,0,0,60,60,0,1,0,1,0
13506,62194,50584,0,0,66,66,0,1,0,1,0
13507,39583,37965,0,0,66,66,0,1,0,1,0
13508,45218,25174,0,0,62,62,0,1,0,1,0
13509,54917,60043,0,0,66,66,0,1,0,1,0
13510,64318,445,0,0,66,66,0,1,0,1,0
13511,63116,22114,0,0,146,146,0,1,0,1,0
13512,38776,25174,0,0,146,146,0,1,0,1,0
13513,26802,50584,0,0,62,62,0,1,0,1,0
13514,42722,56448,0,0,74,74,0,1,0,1,0
13515,64312,445,0,0,66,66,0,1,0,1,0
13516,64162,445,0,0,70,70,0,1,0,1,0
13517,443,63113,0,0,100,100,0,1,0,1,0
13518,64303,445,0,0,66,66,0,1,0,1,0
13519,64160,445,0,0,70,70,0,1,0,1,0
13520,27046,51505,0,0,66,66,0,1,0,1,0
13521,1041,25174,0,0,146,146,0,1,0,1,0
13522,52494,36237,0,0,146,146,0,1,0,1,0
13523,26698,25174,0,0,66,66,0,1,0,1,0
13524,64159,445,0,0,70,70,0,1,0,1,0
13525,20586,25174,0,0,62,62,0,1,0,1,0
13526,64158,445,0,0,70,70,0,1,0,1,0
13527,64157,445,0,0,70,70,0,1,0,1,0
13528,65159,37965,0,0,74,74,0,1,0,1,0
13529,64151,445,0,0,70,70,0,1,0,1,0
13530,64152,445,0,0,70,70,0,1,0,1,0
13531,6666,443,0,0,60,60,0,1,0,1,0
13532,39195,25174,0,0,146,146,0,1,0,1,0
13533,22856,22114,0,0,62,62,0,1,0,1,0
13534,2707,37,0,0,60,60,0,1,0,1,0
13535,61465,22114,0,0,62,62,0,1,0,1,0
13536,52526,445,0,0,70,70,0,1,0,1,0
13537,52523,445,0,0,70,70,0,1,0,1,0
13538,52522,445,0,0,70,70,0,1,0,1,0
13539,30303,30303,0,0,181,181,0,1,0,1,0
13540,64291,445,0,0,66,66,0,1,0,1,0
13541,64295,445,0,0,66,66,0,1,0,1,0
13542,64296,445,0,0,66,66,0,1,0,1,0
13543,64294,445,0,0,66,66,0,1,0,1,0
13544,64289,445,0,0,66,66,0,1,0,1,0
13545,64290,445,0,0,66,66,0,1,0,1,0
13546,64292,445,0,0,66,66,0,1,0,1,0
13547,64288,445,0,0,66,66,0,1,0,1,0
13548,52537,57866,0,0,62,62,0,1,0,1,0
13549,64139,445,0,0,70,70,0,1,0,1,0
13550,64138,445,0,0,70,70,0,1,0,1,0
13551,42981,44847,0,0,62,62,0,1,0,1,0
13552,64135,445,0,0,70,70,0,1,0,1,0
13553,51455,53733,0,0,66,66,0,1,0,1,0
13554,64129,445,0,0,70,70,0,1,0,1,0
13555,64128,445,0,0,70,70,0,1,0,1,0
13556,60579,25174,0,0,66,66,0,1,0,1,0
13557,15819,3389,0,0,60,60,0,1,0,1,0
13558,31609,25174,0,0,62,62,0,1,0,1,0
13559,51425,37450,0,0,62,62,0,1,0,1,0
13560,32171,50265,0,0,145,145,0,1,0,1,0
13561,61185,54532,0,0,62,62,0,1,0,1,0
13562,26263,8168,0,0,62,62,0,1,0,1,0
13563,52625,25174,0,0,66,66,0,1,0,1,0
13564,15319,51505,0,0,66,66,0,1,0,1,0
13565,52518,445,0,0,70,70,0,1,0,1,0
13566,52515,445,0,0,70,70,0,1,0,1,0
13567,52509,445,0,0,70,70,0,1,0,1,0
13568,52506,445,0,0,70,70,0,1,0,1,0
13569,50512,1212,0,0,145,145,0,1,0,1,0
13570,31172,22114,0,0,62,62,0,1,0,1,0
13571,22679,2323,0,0,60,60,0,1,0,1,0
13572,6929,35440,0,0,62,62,0,1,0,1,0
13573,38859,22114,0,0,66,66,0,1,0,1,0
13574,64276,445,0,0,66,66,0,1,0,1,0
13575,64273,445,0,0,66,66,0,1,0,1,0
13576,64274,445,0,0,66,66,0,1,0,1,0
13577,64117,445,0,0,70,70,0,1,0,1,0
13578,59734,5900,0,0,60,60,0,1,0,1,0
13579,6666,2222,0,0,60,60,0,1,0,1,0
13580,63136,25174,0,0,66,66,0,1,0,1,0
13581,52502,445,0,0,70,70,0,1,0,1,0
13582,52498,445,0,0,70,70,0,1,0,1,0
13583,52497,445,0,0,70,70,0,1,0,1,0
13584,52496,445,0,0,70,70,0,1,0,1,0
13585,5790,43890,0,0,62,62,0,1,0,1,0
13586,17101,25174,0,0,66,66,0,1,0,1,0
13587,64113,445,0,0,70,70,0,1,0,1,0
13588,10704,25174,0,0,62,62,0,1,0,1,0
13589,10909,30975,0,0,148,148,0,1,0,1,0
13590,51635,50265,0,0,66,66,0,1,0,1,0
13591,33973,50265,0,0,62,62,0,1,0,1,0
13592,64102,445,0,0,70,70,0,1,0,1,0
13593,64101,445,0,0,70,70,0,1,0,1,0
13594,64104,445,0,0,70,70,0,1,0,1,0
13595,13588,15503,0,0,62,62,0,1,0,1,0
13596,64100,445,0,0,70,70,0,1,0,1,0
13597,5955,55160,0,0,74,74,0,1,0,1,0
13598,64097,445,0,0,70,70,0,1,0,1,0
13599,0,0,0,0,70,70,0,1,0,1,0
13600,52485,445,0,0,70,70,0,1,0,1,0
13601,52482,445,0,0,70,70,0,1,0,1,0
13602,52480,445,0,0,70,70,0,1,0,1,0
13603,56999,25174,0,0,62,62,0,1,0,1,0
13604,64263,445,0,0,66,66,0,1,0,1,0
13605,1026,64147,0,0,145,145,0,1,0,1,0
13606,59937,18375,0,0,66,66,0,1,0,1,0
13607,9087,37965,0,0,62,62,0,1,0,1,0
13608,64090,445,0,0,70,70,0,1,0,1,0
13609,30729,22114,0,0,66,66,0,1,0,1,0
13610,52477,445,0,0,70,70,0,1,0,1,0
13611,27110,22114,0,0,60,60,0,1,0,1,0
13612,52474,445,0,0,70,70,0,1,0,1,0
13613,59060,50584,0,0,66,66,0,1,0,1,0
13614,33886,65504,0,0,162,162,0,1,0,1,0
13615,64083,445,0,0,70,70,0,1,0,1,0
13616,54914,51505,0,0,66,66,0,1,0,1,0
13617,51615,25174,0,0,66,66,0,1,0,1,0
13618,14777,25174,0,0,62,62,0,1,0,1,0
13619,64080,445,0,0,70,70,0,1,0,1,0
13620,59692,57470,0,0,78,78,0,1,0,1,0
13621,64246,445,0,0,66,66,0,1,0,1,0
13622,64248,445,0,0,66,66,0,1,0,1,0
13623,22528,25174,0,0,62,62,0,1,0,1,0
13624,50236,25174,0,0,66,66,0,1,0,1,0
13625,53563,35440,0,0,66,66,0,1,0,1,0
13626,2346,25174,0,0,66,66,0,1,0,1,0
13627,15585,64147,0,0,66,66,0,1,0,1,0
13628,64077,445,0,0,70,70,0,1,0,1,0
13629,22036,44847,0,0,62,62,0,1,0,1,0
13630,2938,64147,0,0,62,62,0,1,0,1,0
13631,64075,445,0,0,70,70,0,1,0,1,0
13632,52460,445,0,0,70,70,0,1,0,1,0
13633,52462,445,0,0,70,70,0,1,0,1,0
13634,52461,445,0,0,70,70,0,1,0,1,0
13635,52454,445,0,0,70,70,0,1,0,1,0
13636,60261,25174,0,0,66,66,0,1,0,1,0
13637,54976,15503,0,0,66,66,0,1,0,1,0
13638,64239,445,0,0,66,66,0,1,0,1,0
13639,57300,53,43157,53,184,94,90,2,30,1,1
13640,26944,443,13934,443,6861,2224,4637,19,19,9,10
13641,56226,53,12248,53,284,96,188,4,33,2,2
13642,49328,443,48321,443,77821,4380,73441,82,53,23,59
13643,64987,53,14036,53,192,98,94,2,30,1,1
13644,40422,53,0,0,82,82,0,1,30,1,0
13645,55348,53,40546,53,184,80,104,2,30,1,1
13646,64835,53,7153,53,174,89,85,2,30,1,1
13647,46830,80,6947,80,1764,751,1013,10,16,6,4
13648,33933,80,56054,80,1988,1072,916,12,515,7,5
13649,49213,443,9169,443,157994,4952,153042,186,255,68,118
13650,34326,443,28311,443,5692,1597,4095,19,18,11,8
13651,55551,53,54639,53,788,108,680,2,30,1,1
13652,50023,53,38403,53,164,84,80,2,31,1,1
13653,46963,443,17005,443,70,70,0,1,5,1,0
13654,51574,443,46080,443,400,70,330,6,25,1,5
13655,49622,443,38378,443,11139,3031,8108,30,176,14,16
13656,65212,53,35167,53,192,98,94,2,31,1,1
13657,58528,443,58528,443,4672,1765,2907,19,29,11,8
13658,52568,80,52568,80,16474,1881,14593,28,143,12,16
13659,45482,80,16084,80,1130,624,506,11,15,5,6
13660,56337,53,29643,53,268,89,179,4,45,2,2
13661,53164,48198,7411,48198,320,140,180,6,7,3,3
13662,52121,58933,17101,58933,70,70,0,2,8,2,0
13663,56202,53,48899,53,749,94,655,2,30,1,1
13664,55452,53,54913,53,184,94,90,2,30,1,1
13665,50236,443,50711,443,6661,1489,5172,26,270,13,13
13666,54054,443,10549,443,34629391,1109219,33520172,36863,278,12240,24623
13667,41603,443,56421,443,16028,3246,12782,37,272,19,18
13668,51576,443,46569,443,400,70,330,6,25,1,5
13669,55697,53,39982,53,186,95,91,2,31,1,1
13670,49331,443,35944,443,78663,4968,73695,85,47,24,61
13671,49327,443,21395,443,116686,4968,111718,116,53,31,85
13672,9270,80,20221,80,318,192,126,6,26,4,2
13673,55692,53,35310,53,196,100,96,2,30,1,1
13674,55222,53,19882,53,178,91,87,2,30,1,1
13675,55927,53,11810,53,711,87,624,2,30,1,1
13676,40544,53,0,0,82,82,0,1,30,1,0
13677,30960,45755,44633,45755,462,462,0,8,3631,8,0
13678,64974,53,44237,53,212,108,104,2,31,1,1
13679,57301,53,33321,53,170,87,83,2,31,1,1
13680,49234,53,17547,53,166,85,81,2,31,1,1
13681,48817,29614,48817,29614,506,152,354,2,1201,1,1
13682,49477,53,35970,53,172,88,84,2,30,1,1
13683,50095,53,54067,53,146,75,71,2,31,1,1
13684,56489,443,54085,443,75930,4291,71639,90,120,32,58
13685,58795,443,24808,443,10273,2573,7700,24,305,8,16
13686,57596,443,20240,443,8154,1791,6363,21,187,11,10
13687,55726,27015,8012,27015,628,462,166,4,31,2,2
13688,48817,23944,48817,23944,513,152,361,2,1201,1,1
13689,39434,5228,17809,5228,3505,2006,1499,30,3744,15,15
13690,64071,445,0,0,70,70,0,1,0,1,0
13691,6881,6881,0,0,146,146,0,1,0,1,0
13692,64236,445,0,0,66,66,0,1,0,1,0
13693,64229,445,0,0,66,66,0,1,0,1,0
13694,64235,445,0,0,66,66,0,1,0,1,0
13695,64232,445,0,0,66,66,0,1,0,1,0
13696,64233,445,0,0,66,66,0,1,0,1,0
13697,64227,445,0,0,66,66,0,1,0,1,0
13698,64226,445,0,0,66,66,0,1,0,1,0
13699,64070,445,0,0,70,70,0,1,0,1,0
13700,63545,25174,0,0,62,62,0,1,0,1,0
13701,52450,445,0,0,70,70,0,1,0,1,0
13702,52447,445,0,0,70,70,0,1,0,1,0
13703,52445,445,0,0,70,70,0,1,0,1,0
13704,52443,445,0,0,70,70,0,1,0,1,0
13705,56127,37965,0,0,62,62,0,1,0,1,0
13706,58900,37807,0,0,62,62,0,1,0,1,0
13707,35194,57470,0,0,74,74,0,1,0,1,0
13708,37672,5223,1351,5223,110,110,0,1,5,1,0
13709,52572,80,52572,80,1680,696,984,11,142,6,5
13710,51398,53,51398,53,197,90,107,2,30,1,1
13711,64835,53,59630,53,179,94,85,2,30,1,1
13712,64065,445,0,0,70,70,0,1,0,1,0
13713,54221,57470,0,0,66,66,0,1,0,1,0
13714,1537,22114,0,0,62,62,0,1,0,1,0
13715,37592,36829,0,0,146,146,0,1,0,1,0
13716,52112,22114,0,0,66,66,0,1,0,1,0
13717,52437,445,0,0,70,70,0,1,0,1,0
13718,52438,445,0,0,70,70,0,1,0,1,0
13719,52435,445,0,0,70,70,0,1,0,1,0
13720,18116,37807,0,0,66,66,0,1,0,1,0
13721,64220,445,0,0,66,66,0,1,0,1,0
13722,52434,445,0,0,70,70,0,1,0,1,0
13723,64216,445,0,0,66,66,0,1,0,1,0
13724,41861,5223,49797,5223,5169,1103,4066,26,214,10,16
13725,48798,443,34647,443,55560,11338,44222,90,23,41,49
13726,52097,443,17045,443,7246,3017,4229,21,15,11,10
13727,50669,443,61553,443,2985,1505,1480,16,20,9,7
13728,59485,80,39693,80,882,527,355,10,255,6,4
13729,56592,53,12698,53,200,102,98,2,29,1,1
13730,49367,53,30708,53,389,94,295,4,55,2,2
13731,64040,12226,39321,12226,66,66,0,2,7,2,0
13732,40204,40005,24841,40005,148,86,62,2,30,1,1
13733,64483,53,37576,53,300,90,210,4,30,2,2
13734,38863,443,38863,443,36313,5931,30382,72,108,36,36
13735,62722,443,49389,443,3491257,62261,3428996,3146,155,768,2378
13736,55452,53,8362,53,184,94,90,2,29,1,1
13737,65239,53,58774,53,199,102,97,2,29,1,1
13738,55692,53,4863,53,198,102,96,2,29,1,1
13739,56354,53,44261,53,182,102,80,2,29,1,1
13740,64452,53,37833,53,322,102,220,2,29,1,1
13741,55106,53,60018,53,184,94,90,2,29,1,1
13742,53907,45622,50876,45622,70,70,0,2,7,2,0
13743,49978,53,38632,53,195,102,93,2,29,1,1
13744,64462,53,49415,53,179,94,85,2,30,1,1
13745,55697,53,51781,53,193,102,91,2,30,1,1
13746,49397,53,53029,53,373,98,275,4,43,2,2
13747,56337,53,25650,53,268,89,179,4,45,2,2
13748,34787,443,34308,443,13074,2439,10635,46,279,22,24
13749,52867,53,61685,53,184,86,98,2,30,1,1
13750,56878,53,29099,53,94,94,0,1,30,1,0
13751,49234,53,44202,53,167,86,81,2,30,1,1
13752,55828,53,56117,53,177,94,83,2,30,1,1
13753,49556,53,62658,53,300,100,200,4,44,2,2
13754,55702,80,56730,80,70,70,0,2,8,2,0
13755,60912,443,25198,443,9959,2430,7529,27,46,16,11
13756,59486,80,17490,80,882,527,355,10,255,6,4
13757,56612,53,15256,53,274,87,187,4,30,2,2
13758,56773,443,51568,443,7941,1952,5989,20,15,11,9
13759,50621,443,42624,443,10905,4352,6553,30,18,18,12
13760,42811,443,38598,443,2766,1907,859,17,25,10,7
13761,59821,80,19887,80,1052,612,440,10,15,5,5
13762,56337,53,46173,53,268,89,179,4,45,2,2
13763,52119,49239,18789,49239,258,70,188,4,8,2,2
13764,57300,53,21469,53,184,94,90,2,30,1,1
13765,52122,43073,9475,43073,70,70,0,2,8,2,0
13766,65470,53,21136,53,226,94,132,2,30,1,1
13767,55222,53,4063,53,181,94,87,2,30,1,1
13768,60988,443,42425,443,8019,3298,4721,30,40,17,13
13769,64671,53,7191,53,294,102,192,2,30,1,1
13770,56873,53,25069,53,184,94,90,2,30,1,1
13771,37319,443,50657,443,70,70,0,1,5,1,0
13772,55452,53,7661,53,184,94,90,2,30,1,1
13773,41322,443,6156,443,994089,30018,964071,1058,350,373,685
13774,40249,443,14843,443,70,70,0,1,5,1,0
13775,51304,443,20155,443,7134,3081,4053,24,121,11,13
13776,52571,80,52571,80,10947,876,10071,21,142,9,12
13777,55208,443,24176,443,7224,114,7110,9,122,2,7
13778,56029,53,2806,53,346,94,252,2,30,1,1
13779,64987,53,4145,53,196,102,94,2,30,1,1
13780,56774,443,5880,443,7889,1900,5989,20,15,11,9
13781,37321,443,3162,443,70,70,0,1,5,1,0
13782,56675,80,35224,80,156,156,0,3,8,3,0
13783,52100,443,58970,443,190,70,120,4,15,2,2
13784,51576,443,34580,443,3323,2023,1300,17,255,9,8
13785,64356,53,40978,53,243,94,149,2,30,1,1
13786,50030,53,18076,53,209,110,99,2,30,1,1
13787,51033,443,39133,443,14697,3801,10896,52,120,24,28
13788,37675,53,37675,53,197,90,107,2,30,1,1
13789,46190,80,10092,80,5443,2529,2914,14,515,8,6
13790,52573,80,52573,80,3487,696,2791,13,142,6,7
13791,10063,443,38761,443,822903,35544,787359,1068,153,463,605
13792,64420,53,21949,53,362,94,268,2,30,1,1
13793,56592,53,24895,53,200,102,98,2,30,1,1
13794,52780,443,29664,443,122,62,60,2,15,1,1
13795,53085,443,17021,443,16024,3168,12856,56,76,31,25
13796,38922,443,18971,443,346170,16091,330079,454,16,225,229
13797,52247,443,52247,443,948720,23674,925046,988,26,349,639
13798,49348,53,28507,53,312,96,216,4,35,2,2
13799,52088,35605,27322,35605,70,70,0,1,5,1,0
13800,57906,80,15891,80,318,192,126,6,26,4,2
13801,62721,443,47170,443,5718309,117049,5601260,5287,155,1390,3897
13802,50672,80,6037,80,1718,1247,471,9,14,5,4
13803,65425,53,21278,53,473,94,379,4,36,2,2
13804,58831,443,40650,443,9378,2858,6520,48,196,21,27
13805,60798,40010,54476,40010,316,136,180,6,6,3,3
13806,52123,46261,34015,46261,70,70,0,2,7,2,0
13807,47051,443,3373,443,3304,2161,1143,21,16,11,10
13808,37320,443,60186,443,70,70,0,1,5,1,0
13809,39888,443,38398,443,1964,1171,793,20,25,11,9
13810,56226,53,44944,53,284,96,188,4,33,2,2
13811,64677,53,11788,53,334,93,241,4,50,2,2
13812,50023,53,49657,53,166,86,80,2,29,1,1
13813,55222,53,13241,53,181,94,87,2,29,1,1
13814,55222,53,63142,53,181,94,87,2,29,1,1
13815,64581,53,16875,53,214,110,104,2,29,1,1
13816,56497,53,23071,53,214,110,104,2,30,1,1
13817,46056,443,52673,443,80200,69062,11138,193,89,100,93
13818,50473,123,38470,123,184,94,90,2,30,1,1
13819,57352,53,7772,53,196,102,94,2,29,1,1
13820,44256,3389,44256,3389,4145,1976,2169,22,18,13,9
13821,55966,53,61391,53,86,86,0,1,29,1,0
13822,57590,80,57590,80,1165239,13055,1152184,977,149,193,784
13823,56082,53,33966,53,807,94,713,2,29,1,1
13824,61113,27045,31501,27045,1680,1386,294,7,30,4,3
13825,56497,53,5207,53,214,110,104,2,30,1,1
13826,34316,53,37625,53,168,78,90,2,29,1,1
13827,49466,53,52804,53,184,94,90,2,29,1,1
13828,56472,53,54930,53,167,86,81,2,30,1,1
13829,65444,53,41449,53,227,110,117,2,29,1,1
13830,49202,53,57613,53,226,86,140,2,30,1,1
13831,57065,53,13982,53,182,102,80,2,29,1,1
13832,64835,53,38888,53,179,94,85,2,30,1,1
13833,63943,53,31455,53,254,110,144,2,30,1,1
13834,59638,53,40619,53,714,454,260,2,30,1,1
13835,49886,53,51424,53,311,102,209,2,30,1,1
13836,64974,53,31114,53,214,110,104,2,30,1,1
13837,65031,53,34987,53,184,94,90,2,30,1,1
13838,49267,53,44367,53,184,94,90,2,31,1,1
13839,57470,1337,44694,1337,594,594,0,10,1199,10,0
13840,64974,53,53114,53,214,110,104,2,30,1,1
13841,50023,53,60476,53,166,86,80,2,31,1,1
13842,64602,53,49677,53,184,94,90,2,30,1,1
13843,64181,53,18587,53,194,102,92,2,31,1,1
13844,6881,12676,29408,12676,509,150,359,2,1199,1,1
13845,57470,35988,31535,35988,132,132,0,3,1199,3,0
13846,51221,57073,10928,57073,481,150,331,2,1200,1,1
13847,35052,443,8505,443,4652,3109,1543,25,95,14,11
13848,57266,443,58500,443,10174,2163,8011,25,81,14,11
13849,55106,53,36714,53,314,94,220,4,33,2,2
13850,56772,443,38284,443,7889,1900,5989,20,15,11,9
13851,55884,53,55884,53,197,90,107,2,30,1,1
13852,64835,53,41380,53,179,94,85,2,30,1,1
13853,39622,53,25768,53,168,78,90,2,30,1,1
13854,55828,53,14283,53,177,94,83,2,30,1,1
13855,64433,53,21792,53,257,94,163,2,30,1,1
13856,53036,443,2888,443,3039,1089,1950,9,120,5,4
13857,55031,5222,39174,5222,6192,3767,2425,53,64,29,24
13858,60684,80,43634,80,1737,796,941,12,16,7,5
13859,56676,80,29076,80,78,78,0,2,6,2,0
13860,32945,80,47829,80,234,234,0,4,12,4,0
13861,49046,5222,3706,5222,6910,3381,3529,50,323,26,24
13862,49477,53,9524,53,271,88,183,4,59,2,2
13863,55369,53,62193,53,376,94,282,2,30,1,1
13864,64225,53,35755,53,322,118,204,2,30,1,1
13865,56937,53,62951,53,181,94,87,2,30,1,1
13866,40204,40016,39697,40016,140,78,62,2,30,1,1
13867,56937,53,52000,53,181,94,87,2,33,1,1
13868,52120,42751,65345,42751,70,70,0,2,8,2,0
13869,52089,16543,15795,16543,70,70,0,1,5,1,0
13870,56337,53,7280,53,268,89,179,4,44,2,2
13871,52570,80,52570,80,3886,696,3190,13,142,6,7
13872,48872,443,20108,443,8143,3033,5110,26,18,14,12
13873,65212,53,45804,53,196,102,94,2,30,1,1
13874,54962,53,47568,53,241,102,139,2,31,1,1
13875,49849,53,37502,53,196,102,94,2,31,1,1
13876,55697,53,14156,53,193,102,91,2,31,1,1
13877,31683,53,31683,53,197,90,107,2,30,1,1
13878,20953,53,20953,53,295,90,205,2,30,1,1
13879,48817,45919,48817,45919,334,158,176,2,1200,1,1
13880,61833,443,42241,443,3429,784,2645,18,135,8,10
13881,55804,80,55804,80,424,198,226,7,143,4,3
13882,10151,40231,24979,40231,481,150,331,2,1200,1,1
13883,65031,53,49062,53,184,94,90,2,31,1,1
13884,50020,443,25948,443,9175,2213,6962,37,121,19,18
13885,60217,443,8028,443,6075,3806,2269,18,120,10,8
13886,57470,1337,52453,1337,594,594,0,10,1199,10,0
13887,64462,53,60220,53,329,94,235,4,31,2,2
13888,55763,8060,47887,8060,70,70,0,1,5,1,0
13889,43546,443,49269,443,5948,1664,4284,21,247,12,9
13890,50666,80,35544,80,2937,1241,1696,12,22,7,5
13891,35423,443,35423,443,4555,1648,2907,20,29,12,8
13892,49772,53,54364,53,181,94,87,2,31,1,1
13893,41243,443,21826,443,3697,2379,1318,26,16,14,12
13894,46507,443,10914,443,7068,2016,5052,32,18,17,15
13895,50364,443,37739,443,1727,926,801,15,30,7,8
13896,50384,80,18722,80,2537,783,1754,13,20,7,6
13897,46715,443,4396,443,2945,779,2166,10,121,5,5
13898,47454,443,6613,443,21782,2823,18959,42,16,20,22
13899,52253,443,52253,443,429263,14390,414873,449,24,159,290
13900,49706,53,17646,53,296,102,194,4,42,2,2
13901,53911,1025,45349,1025,130,70,60,3,6,2,1
13902,64038,28187,34899,28187,66,66,0,2,8,2,0
13903,64306,53,2693,53,216,110,106,2,30,1,1
13904,64214,445,0,0,66,66,0,1,0,1,0
13905,64212,445,0,0,66,66,0,1,0,1,0
13906,30303,30303,0,0,181,181,0,1,0,1,0
13907,64211,445,0,0,66,66,0,1,0,1,0
13908,2427,25174,0,0,62,62,0,1,0,1,0
13909,49370,11392,0,0,66,66,0,1,0,1,0
13910,64052,445,0,0,70,70,0,1,0,1,0
13911,52430,445,0,0,70,70,0,1,0,1,0
13912,64049,445,0,0,70,70,0,1,0,1,0
13913,6881,6881,0,0,146,146,0,1,0,1,0
13914,55079,25174,0,0,66,66,0,1,0,1,0
13915,30644,25174,0,0,62,62,0,1,0,1,0
13916,52420,445,0,0,70,70,0,1,0,1,0
13917,52415,445,0,0,70,70,0,1,0,1,0
13918,58715,64097,0,0,62,62,0,1,0,1,0
13919,61635,37965,0,0,66,66,0,1,0,1,0
13920,54883,51505,0,0,66,66,0,1,0,1,0
13921,59587,25174,0,0,62,62,0,1,0,1,0
13922,25063,64147,0,0,62,62,0,1,0,1,0
13923,64200,445,0,0,66,66,0,1,0,1,0
13924,7041,37965,0,0,62,62,0,1,0,1,0
13925,50235,5900,0,0,60,60,0,1,0,1,0
13926,46116,57470,0,0,74,74,0,1,0,1,0
13927,64045,445,0,0,70,70,0,1,0,1,0
13928,51966,25174,0,0,62,62,0,1,0,1,0
13929,30697,57866,0,0,62,62,0,1,0,1,0
13930,64043,445,0,0,70,70,0,1,0,1,0
13931,64041,445,0,0,70,70,0,1,0,1,0
13932,59096,57866,0,0,66,66,0,1,0,1,0
13933,58143,57866,0,0,66,66,0,1,0,1,0
13934,64192,445,0,0,66,66,0,1,0,1,0
13935,60869,48817,0,0,62,62,0,1,0,1,0
13936,52406,445,0,0,70,70,0,1,0,1,0
13937,63213,57866,0,0,66,66,0,1,0,1,0
13938,41898,22114,0,0,146,146,0,1,0,1,0
13939,64190,445,0,0,66,66,0,1,0,1,0
13940,54666,36237,0,0,66,66,0,1,0,1,0
13941,48706,23393,0,0,60,60,0,1,0,1,0
13942,39959,23117,0,0,146,146,0,1,0,1,0
13943,64034,445,0,0,70,70,0,1,0,1,0
13944,28110,22,0,0,60,60,0,1,0,1,0
13945,64183,445,0,0,66,66,0,1,0,1,0
13946,64032,445,0,0,70,70,0,1,0,1,0
13947,5830,22114,0,0,66,66,0,1,0,1,0
13948,1024,44847,0,0,62,62,0,1,0,1,0
13949,64172,445,0,0,66,66,0,1,0,1,0
13950,42030,25,0,0,74,74,0,1,0,1,0
13951,64031,445,0,0,70,70,0,1,0,1,0
13952,25202,25174,0,0,62,62,0,1,0,1,0
13953,4793,50584,0,0,62,62,0,1,0,1,0
13954,64030,445,0,0,70,70,0,1,0,1,0
13955,57164,50584,0,0,62,62,0,1,0,1,0
13956,37011,25174,0,0,62,62,0,1,0,1,0
13957,64029,445,0,0,70,70,0,1,0,1,0
13958,64023,445,0,0,70,70,0,1,0,1,0
13959,64024,445,0,0,70,70,0,1,0,1,0
13960,25523,35974,0,0,62,62,0,1,0,1,0
13961,29291,40108,0,0,150,150,0,1,0,1,0
13962,29291,62609,0,0,150,150,0,1,0,1,0
13963,48839,37807,0,0,146,146,0,1,0,1,0
13964,29291,48983,0,0,150,150,0,1,0,1,0
13965,18086,25174,0,0,62,62,0,1,0,1,0
13966,62550,51505,0,0,66,66,0,1,0,1,0
13967,52398,445,0,0,70,70,0,1,0,1,0
13968,52397,445,0,0,70,70,0,1,0,1,0
13969,52395,445,0,0,70,70,0,1,0,1,0
13970,27969,25174,0,0,62,62,0,1,0,1,0
13971,64011,445,0,0,70,70,0,1,0,1,0
13972,64010,445,0,0,70,70,0,1,0,1,0
13973,64160,445,0,0,66,66,0,1,0,1,0
13974,64164,445,0,0,66,66,0,1,0,1,0
13975,64163,445,0,0,66,66,0,1,0,1,0
13976,64166,445,0,0,66,66,0,1,0,1,0
13977,64167,445,0,0,66,66,0,1,0,1,0
13978,64165,445,0,0,66,66,0,1,0,1,0
13979,64161,445,0,0,66,66,0,1,0,1,0
13980,64159,445,0,0,66,66,0,1,0,1,0
13981,64007,445,0,0,70,70,0,1,0,1,0
13982,53015,64147,0,0,62,62,0,1,0,1,0
13983,64001,445,0,0,70,70,0,1,0,1,0
13984,64000,445,0,0,70,70,0,1,0,1,0
13985,61369,64147,0,0,66,66,0,1,0,1,0
13986,34811,56205,0,0,62,62,0,1,0,1,0
13987,61382,25174,0,0,66,66,0,1,0,1,0
13988,6889,8970,0,0,143,143,0,1,0,1,0
13989,48125,7558,0,0,60,60,0,1,0,1,0
13990,5222,64493,0,0,1514,1514,0,1,0,1,0
13991,38755,22114,0,0,66,66,0,1,0,1,0
13992,63032,22114,0,0,66,66,0,1,0,1,0
13993,43679,44847,0,0,62,62,0,1,0,1,0
13994,52389,445,0,0,70,70,0,1,0,1,0
13995,52387,445,0,0,70,70,0,1,0,1,0
13996,52386,445,0,0,70,70,0,1,0,1,0
13997,52378,445,0,0,70,70,0,1,0,1,0
13998,46604,57866,0,0,66,66,0,1,0,1,0
13999,63989,445,0,0,70,70,0,1,0,1,0
14000,58716,9694,0,0,62,62,0,1,0,1,0
14001,64144,445,0,0,66,66,0,1,0,1,0
14002,64145,445,0,0,66,66,0,1,0,1,0
14003,64146,445,0,0,66,66,0,1,0,1,0
14004,58926,25174,0,0,146,146,0,1,0,1,0
14005,19204,57866,0,0,66,66,0,1,0,1,0
14006,56578,25174,0,0,66,66,0,1,0,1,0
14007,28385,50584,0,0,62,62,0,1,0,1,0
14008,7905,22114,0,0,66,66,0,1,0,1,0
14009,62242,44512,0,0,66,66,0,1,0,1,0
14010,57471,62413,0,0,66,66,0,1,0,1,0
14011,52374,445,0,0,70,70,0,1,0,1,0
14012,19882,22114,0,0,146,146,0,1,0,1,0
14013,63985,445,0,0,70,70,0,1,0,1,0
14014,52373,445,0,0,70,70,0,1,0,1,0
14015,52371,445,0,0,70,70,0,1,0,1,0
14016,52369,445,0,0,70,70,0,1,0,1,0
14017,39661,23,0,0,60,60,0,1,0,1,0
14018,45964,2225,0,0,60,60,0,1,0,1,0
14019,63975,445,0,0,70,70,0,1,0,1,0
14020,63973,445,0,0,70,70,0,1,0,1,0
14021,63974,445,0,0,70,70,0,1,0,1,0
14022,55056,44512,0,0,62,62,0,1,0,1,0
14023,46808,25174,0,0,62,62,0,1,0,1,0
14024,63972,445,0,0,70,70,0,1,0,1,0
14025,36561,2767,0,0,62,62,0,1,0,1,0
14026,63969,445,0,0,70,70,0,1,0,1,0
14027,1024,64147,0,0,62,62,0,1,0,1,0
14028,50593,64147,0,0,66,66,0,1,0,1,0
14029,52699,25174,0,0,66,66,0,1,0,1,0
14030,32132,25174,0,0,66,66,0,1,0,1,0
14031,27055,25174,0,0,146,146,0,1,0,1,0
14032,52357,445,0,0,70,70,0,1,0,1,0
14033,52354,445,0,0,70,70,0,1,0,1,0
14034,52352,445,0,0,70,70,0,1,0,1,0
14035,27038,51505,0,0,62,62,0,1,0,1,0
14036,63786,25174,0,0,66,66,0,1,0,1,0
14037,49514,65504,0,0,162,162,0,1,0,1,0
14038,58744,1433,0,0,60,60,0,1,0,1,0
14039,51413,1,0,0,72,72,0,1,0,1,0
14040,51966,25174,0,0,146,146,0,1,0,1,0
14041,26531,25174,0,0,62,62,0,1,0,1,0
14042,64132,445,0,0,66,66,0,1,0,1,0
14043,19875,30170,0,0,145,145,0,1,0,1,0
14044,10072,25174,0,0,146,146,0,1,0,1,0
14045,63963,445,0,0,70,70,0,1,0,1,0
14046,55082,25174,0,0,66,66,0,1,0,1,0
14047,43345,51505,0,0,146,146,0,1,0,1,0
14048,10082,64147,0,0,62,62,0,1,0,1,0
14049,49651,37965,0,0,74,74,0,1,0,1,0
14050,11552,44847,0,0,146,146,0,1,0,1,0
14051,29016,25174,0,0,146,146,0,1,0,1,0
14052,8889,25033,0,0,60,60,0,1,0,1,0
14053,50321,48817,0,0,143,143,0,1,0,1,0
14054,52349,445,0,0,70,70,0,1,0,1,0
14055,443,21745,0,0,66,66,0,1,0,1,0
14056,63173,36237,0,0,66,66,0,1,0,1,0
14057,63955,445,0,0,70,70,0,1,0,1,0
14058,49036,44847,0,0,62,62,0,1,0,1,0
14059,52348,445,0,0,70,70,0,1,0,1,0
14060,63953,445,0,0,70,70,0,1,0,1,0
14061,22571,51505,0,0,66,66,0,1,0,1,0
14062,57761,30317,0,0,66,66,0,1,0,1,0
14063,18655,44847,0,0,66,66,0,1,0,1,0
14064,49250,53,20588,53,731,85,646,2,30,1,1
14065,64602,53,34002,53,184,94,90,2,30,1,1
14066,56491,53,1431,53,711,87,624,2,30,1,1
14067,65031,53,50837,53,184,94,90,2,30,1,1
14068,9243,80,7873,80,318,192,126,6,26,4,2
14069,56485,80,20851,80,569,365,204,6,16,3,3
14070,52115,10012,9221,10012,70,70,0,2,8,2,0
14071,48984,15000,36697,15000,130,70,60,2,5,1,1
14072,64462,53,6951,53,174,89,85,2,30,1,1
14073,50861,3389,50861,3389,4241,2521,1720,18,32,10,8
14074,9244,80,12299,80,318,192,126,6,26,4,2
14075,9260,80,58390,80,318,192,126,6,26,4,2
14076,49556,53,40428,53,300,100,200,4,44,2,2
14077,49365,80,10585,80,2361,1586,775,11,166,7,4
14078,59271,443,60275,443,26414,4349,22065,41,149,17,24
14079,55687,53,17643,53,731,85,646,2,31,1,1
14080,63834,27037,35809,27037,1130,924,206,5,30,3,2
14081,49267,53,65415,53,184,94,90,2,30,1,1
14082,50898,80,8835,80,21445,1605,19840,36,255,19,17
14083,58842,443,11917,443,8912,1537,7375,27,638,10,17
14084,9264,80,28949,80,318,192,126,6,26,4,2
14085,35939,443,12067,443,9111,2919,6192,27,19,14,13
14086,9469,80,38587,80,1641,483,1158,10,15,5,5
14087,53680,443,32656,443,7035,2364,4671,18,75,10,8
14088,40906,8434,40906,8434,156,156,0,3,8,3,0
14089,53260,443,37700,443,572,292,280,9,33,5,4
14090,55858,80,7371,80,104399,8436,95963,122,21,49,73
14091,41906,443,20652,443,181961,40579,141382,247,238,101,146
14092,54445,443,28246,443,2782,1778,1004,20,33,10,10
14093,65318,53,17829,53,184,94,90,2,31,1,1
14094,9262,80,26310,80,378,192,186,7,26,4,3
14095,9468,80,22561,80,1835,421,1414,9,15,4,5
14096,9263,80,41010,80,318,192,126,6,26,4,2
14097,50353,80,65364,80,8007,830,7177,17,30,8,9
14098,51656,53,51656,53,198,89,109,2,30,1,1
14099,48655,80,39370,80,956,541,415,11,315,6,5
14100,56248,53,47475,53,767,102,665,2,30,1,1
14101,56873,53,29966,53,184,94,90,2,30,1,1
14102,55503,53,13265,53,200,102,98,2,30,1,1
14103,57237,53,56776,53,701,88,613,2,30,1,1
14104,51401,443,31981,443,6537,3702,2835,34,170,17,17
14105,47087,443,29605,443,7187,2550,4637,20,18,10,10
14106,49706,53,30583,53,296,102,194,4,41,2,2
14107,58835,443,12321,443,9823,2600,7223,46,195,23,23
14108,49364,80,47748,80,2168,1031,1137,8,166,5,3
14109,53906,12051,34312,12051,258,70,188,4,9,2,2
14110,64181,53,25731,53,188,96,92,2,31,1,1
14111,54446,443,54881,443,2782,1778,1004,20,33,10,10
14112,49675,5900,49675,5900,124,60,64,2,5,1,1
14113,56281,443,8565,443,22352,9825,12527,111,370,55,56
14114,9261,80,32507,80,378,192,186,7,26,4,3
14115,9259,80,48036,80,318,192,126,6,26,4,2
14116,9265,80,10244,80,318,192,126,6,26,4,2
14117,9245,80,28513,80,378,192,186,7,26,4,3
14118,49772,53,60667,53,178,91,87,2,30,1,1
14119,49849,53,14013,53,192,98,94,2,31,1,1
14120,56519,53,63557,53,166,85,81,2,31,1,1
14121,49986,18242,0,0,66,66,0,1,90,1,0
14122,41254,443,60907,443,12757,4053,8704,39,522,14,25
14123,19473,28867,41961,28867,480,149,331,2,1200,1,1
14124,43185,443,5462,443,6951,1333,5618,26,271,14,12
14125,49564,53,46836,53,186,95,91,2,31,1,1
14126,53476,443,9051,443,3182,1568,1614,8,121,4,4
14127,52982,25174,0,0,146,146,0,1,0,1,0
14128,44334,26467,0,0,62,62,0,1,0,1,0
14129,57434,50584,0,0,146,146,0,1,0,1,0
14130,58091,51505,0,0,66,66,0,1,0,1,0
14131,64118,445,0,0,66,66,0,1,0,1,0
14132,64116,445,0,0,66,66,0,1,0,1,0
14133,63948,445,0,0,70,70,0,1,0,1,0
14134,63947,445,0,0,70,70,0,1,0,1,0
14135,54473,37807,0,0,66,66,0,1,0,1,0
14136,63364,57470,0,0,62,62,0,1,0,1,0
14137,2543,25174,0,0,62,62,0,1,0,1,0
14138,52339,445,0,0,70,70,0,1,0,1,0
14139,65318,53,18281,53,184,94,90,2,30,1,1
14140,60474,8999,5230,8999,70,70,0,1,5,1,0
14141,52334,445,0,0,70,70,0,1,0,1,0
14142,52332,445,0,0,70,70,0,1,0,1,0
14143,52327,445,0,0,70,70,0,1,0,1,0
14144,26881,25174,0,0,62,62,0,1,0,1,0
14145,38581,22114,0,0,62,62,0,1,0,1,0
14146,63943,445,0,0,70,70,0,1,0,1,0
14147,22636,30188,0,0,62,62,0,1,0,1,0
14148,64114,445,0,0,66,66,0,1,0,1,0
14149,45461,25174,0,0,62,62,0,1,0,1,0
14150,36151,22,0,0,60,60,0,1,0,1,0
14151,63941,445,0,0,70,70,0,1,0,1,0
14152,34146,1433,0,0,60,60,0,1,0,1,0
14153,64100,445,0,0,66,66,0,1,0,1,0
14154,64102,445,0,0,66,66,0,1,0,1,0
14155,64101,445,0,0,66,66,0,1,0,1,0
14156,64106,445,0,0,66,66,0,1,0,1,0
14157,64103,445,0,0,66,66,0,1,0,1,0
14158,64105,445,0,0,66,66,0,1,0,1,0
14159,64097,445,0,0,66,66,0,1,0,1,0
14160,60793,53733,0,0,66,66,0,1,0,1,0
14161,2437,23117,0,0,62,62,0,1,0,1,0
14162,52323,445,0,0,70,70,0,1,0,1,0
14163,11228,25174,0,0,66,66,0,1,0,1,0
14164,2437,23117,0,0,146,146,0,1,0,1,0
14165,48266,80,46749,80,130,70,60,2,15,1,1
14166,42107,443,39392,443,13704,2379,11325,47,279,22,25
14167,59685,443,54976,443,7747,1533,6214,27,31,13,14
14168,46438,53,32231,53,222,78,144,2,30,1,1
14169,54695,80,64600,80,2001,1107,894,13,150,7,6
14170,55707,26816,41675,26816,320,140,180,6,6,3,3
14171,37368,80,60512,80,554,258,296,9,13,5,4
14172,56769,443,25443,443,7941,1952,5989,20,15,11,9
14173,9253,443,42267,443,6135,770,5365,17,26,9,8
14174,50667,80,4915,80,3778,2082,1696,12,21,7,5
14175,49655,443,10531,443,31956,13344,18612,64,65,36,28
14176,33202,80,39571,80,1114,534,580,12,15,7,5
14177,49556,53,1572,53,300,100,200,4,43,2,2
14178,49368,443,28033,443,5224,1560,3664,15,165,9,6
14179,64037,18592,23660,18592,66,66,0,2,7,2,0
14180,64862,53,23535,53,223,94,129,2,29,1,1
14181,64462,53,14604,53,179,94,85,2,29,1,1
14182,57301,53,42748,53,177,94,83,2,29,1,1
14183,56771,443,16357,443,7941,1952,5989,20,15,11,9
14184,57300,53,9339,53,184,94,90,2,29,1,1
14185,37680,443,37680,443,4592,1685,2907,19,29,11,8
14186,49234,53,62807,53,167,86,81,2,29,1,1
14187,57301,53,40888,53,177,94,83,2,29,1,1
14188,4650,53,4650,53,300,90,210,2,29,1,1
14189,55503,53,12220,53,200,102,98,2,30,1,1
14190,65148,53,60062,53,498,204,294,6,29,3,3
14191,65078,53,48280,53,339,110,229,2,29,1,1
14192,49772,53,62355,53,181,94,87,2,29,1,1
14193,56873,53,37492,53,184,94,90,2,30,1,1
14194,64037,53,2722,53,215,94,121,2,29,1,1
14195,64602,53,19507,53,184,94,90,2,30,1,1
14196,38279,80,49834,80,122,62,60,2,15,1,1
14197,58152,443,52749,443,5584,1168,4416,19,17,11,8
14198,37671,53,37671,53,180,82,98,2,30,1,1
14199,49518,53,40851,53,167,86,81,2,30,1,1
14200,49849,53,11014,53,196,102,94,2,30,1,1
14201,52117,20600,30733,20600,70,70,0,2,8,2,0
14202,49518,53,65191,53,167,86,81,2,30,1,1
14203,52086,27156,8001,27156,136,136,0,3,14,3,0
14204,9257,443,25692,443,6327,833,5494,19,26,10,9
14205,39831,443,37659,443,7656,4286,3370,38,86,19,19
14206,47825,443,54151,443,932130,36511,895619,1142,167,465,677
14207,60797,28080,22385,28080,70,70,0,2,8,2,0
14208,56770,443,17971,443,7889,1900,5989,20,15,11,9
14209,9250,443,1319,443,6331,837,5494,19,26,10,9
14210,36008,80,27818,80,1614,1300,314,10,15,5,5
14211,54353,443,50678,443,9976,3230,6746,22,56,13,9
14212,9237,80,59192,80,378,192,186,7,26,4,3
14213,49693,53,17140,53,196,94,102,2,30,1,1
14214,64942,53,4876,53,284,102,182,4,37,2,2
14215,46503,443,50192,443,6492,1764,4728,56,996,20,36
14216,55503,53,55222,53,200,102,98,2,30,1,1
14217,49631,443,24213,443,6304,1793,4511,29,255,15,14
14218,56731,443,8891,443,7828,2313,5515,31,64,17,14
14219,49210,443,19575,443,9530,2183,7347,45,256,21,24
14220,64738,53,34025,53,402,118,284,2,30,1,1
14221,56843,53,63293,53,177,94,83,2,30,1,1
14222,50095,53,10662,53,168,86,82,2,30,1,1
14223,57301,53,28379,53,177,94,83,2,30,1,1
14224,49267,53,55947,53,184,94,90,2,30,1,1
14225,38402,443,34859,443,8119,1962,6157,24,360,11,13
14226,50095,53,20934,53,168,86,82,2,30,1,1
14227,55807,80,55807,80,424,198,226,7,142,4,3
14228,55806,80,55806,80,424,198,226,7,142,4,3
14229,9249,443,2759,443,6132,767,5365,17,26,9,8
14230,9239,80,63339,80,318,192,126,6,26,4,2
14231,52114,64853,12974,64853,70,70,0,2,8,2,0
14232,54162,443,34813,443,2680,1488,1192,19,41,10,9
14233,54160,443,65221,443,9464,1751,7713,29,48,13,16
14234,64181,53,43777,53,194,102,92,2,30,1,1
14235,49267,53,29003,53,184,94,90,2,30,1,1
14236,64388,53,41426,53,258,110,148,2,30,1,1
14237,56843,53,57824,53,177,94,83,2,30,1,1
14238,47725,443,52489,443,502,250,252,9,32,5,4
14239,60794,20010,2485,20010,70,70,0,1,5,1,0
14240,9234,80,38036,80,318,192,126,6,26,4,2
14241,37708,443,23854,443,8604,2228,6376,36,739,19,17
14242,33640,443,55083,443,10558,2530,8028,25,186,14,11
14243,51155,443,21340,443,54411,4588,49823,74,131,30,44
14244,49556,53,59272,53,300,100,200,4,44,2,2
14245,49626,443,38035,443,8266,1963,6303,28,175,14,14
14246,64974,53,23445,53,506,108,398,4,36,2,2
14247,52116,64692,45907,64692,70,70,0,2,8,2,0
14248,50365,80,49822,80,300,180,120,6,29,4,2
14249,55454,53,51580,53,168,86,82,2,33,1,1
14250,52087,52766,15525,52766,136,136,0,3,14,3,0
14251,44383,443,25298,443,14780,11289,3491,59,219,32,27
14252,45101,443,3854,443,7912,2739,5173,26,516,14,12
14253,62170,443,62170,443,28026,5723,22303,62,20,32,30
14254,9467,443,18809,443,5960,438,5522,16,15,6,10
14255,39127,6555,15189,6555,922,428,494,10,15,5,5
14256,34225,443,33698,443,256793,17776,239017,327,23,146,181
14257,50294,80,24616,80,1515,481,1034,11,15,6,5
14258,60995,443,11816,443,7583,2669,4914,31,17,16,15
14259,53964,443,36020,443,374,254,120,4,5,2,2
14260,46550,443,47907,443,3322,1760,1562,19,255,10,9
14261,33270,80,23251,80,1614,1300,314,10,15,5,5
14262,57341,53,40485,53,296,97,199,4,41,2,2
14263,41034,443,11072,443,6055,2800,3255,38,279,19,19
14264,49706,53,34052,53,296,102,194,4,41,2,2
14265,52118,33515,33207,33515,70,70,0,2,7,2,0
14266,9235,80,17442,80,318,192,126,6,26,4,2
14267,56672,80,18882,80,234,234,0,4,11,4,0
14268,50283,53,31898,53,767,102,665,2,29,1,1
14269,9238,80,17779,80,378,192,186,7,26,4,3
14270,48437,443,48848,443,934,420,514,15,30,7,8
14271,50095,53,59595,53,250,86,164,4,30,2,2
14272,65212,53,30386,53,196,102,94,2,30,1,1
14273,50629,443,10461,443,1048,1048,0,9,17,9,0
14274,49594,53,49594,53,199,90,109,2,30,1,1
14275,50638,443,50638,443,4544,1637,2907,19,26,11,8
14276,57807,443,57807,443,4434,1527,2907,19,29,11,8
14277,56873,53,11452,53,184,94,90,2,29,1,1
14278,57321,53,25115,53,498,204,294,6,29,3,3
14279,49179,53,18943,53,309,118,191,2,30,1,1
14280,6881,13487,50124,13487,228,118,110,2,1199,1,1
14281,56849,443,44408,443,7374,2085,5289,33,270,18,15
14282,64194,443,64194,443,27723,5572,22151,59,46,31,28
14283,60180,443,13880,443,3667,2243,1424,22,80,11,11
14284,9246,80,48818,80,318,192,126,6,26,4,2
14285,9251,443,22776,443,6132,767,5365,17,26,9,8
14286,55503,53,54842,53,200,102,98,2,30,1,1
14287,53950,123,31431,123,184,94,90,2,30,1,1
14288,49564,53,39263,53,193,102,91,2,30,1,1
14289,50116,80,62862,80,10094,1100,8994,20,33,10,10
14290,52085,29894,54507,29894,136,136,0,3,14,3,0
14291,54163,443,60868,443,2430,1416,1014,18,34,9,9
14292,53866,8999,60577,8999,372,186,186,6,15,3,3
14293,60711,443,10147,443,10569,3485,7084,27,515,15,12
14294,9256,443,44390,443,6327,833,5494,19,26,10,9
14295,53459,443,23457,443,88210,4564,83646,115,46,50,65
14296,65318,53,11252,53,184,94,90,2,30,1,1
14297,49234,53,17767,53,167,86,81,2,30,1,1
14298,58124,123,43315,123,184,94,90,2,30,1,1
14299,49577,53,36536,53,242,94,148,2,30,1,1
14300,59637,53,37515,53,273,94,179,2,30,1,1
14301,57987,443,16754,443,3264,1175,2089,14,120,7,7
14302,39817,443,13115,443,516080,28328,487752,660,95,305,355
14303,56628,443,8752,443,6654,3821,2833,60,3037,30,30
14304,64120,443,47176,443,3767437,87322,3680115,3675,52,1230,2445
14305,49665,53,16462,53,168,86,82,2,32,1,1
14306,50241,443,61373,443,27900,6291,21609,46,515,23,23
14307,9254,443,60082,443,6135,770,5365,17,26,9,8
14308,60059,53,45306,53,168,78,90,2,30,1,1
14309,65033,53,12694,53,214,94,120,2,30,1,1
14310,6881,25649,11591,25649,509,150,359,2,1200,1,1
14311,49849,53,61078,53,196,102,94,2,31,1,1
14312,63654,443,35757,443,9152483,314975,8837508,9599,206,3195,6404
14313,59189,443,26773,443,9050,4611,4439,37,222,20,17
14314,6881,6881,6157,6881,253,118,135,2,1200,1,1
14315,9289,443,57036,443,9051,3480,5571,31,23,17,14
14316,53902,55298,4313,55298,70,70,0,2,8,2,0
14317,53904,1024,57585,1024,70,70,0,2,8,2,0
14318,34680,9595,34680,9595,152,66,86,2,10,1,1
14319,38101,443,19198,443,350,210,140,6,15,4,2
14320,35430,443,18104,443,6267,1810,4457,25,18,14,11
14321,33688,80,62587,80,1638,1324,314,10,16,5,5
14322,53932,80,32355,80,1134,465,669,9,18,6,3
14323,63810,27064,25460,27064,1778,1386,392,8,31,4,4
14324,52113,19619,23788,19619,70,70,0,2,8,2,0
14325,56768,443,55318,443,7889,1900,5989,20,16,11,9
14326,56581,80,13177,80,1630,918,712,12,17,7,5
14327,40842,80,63836,80,1712,786,926,12,17,7,5
14328,9290,443,4925,443,8041,2882,5159,29,23,16,13
14329,9287,443,31377,443,5539,1486,4053,21,23,11,10
14330,49706,53,42213,53,296,102,194,4,41,2,2
14331,64942,53,36365,53,284,102,182,4,38,2,2
14332,52084,30863,5581,30863,70,70,0,1,5,1,0
14333,65031,53,9401,53,184,94,90,2,30,1,1
14334,49881,53,28896,53,213,102,111,2,30,1,1
14335,64602,53,4497,53,184,94,90,2,30,1,1
14336,57073,443,48824,443,7731,2016,5715,38,271,20,18
14337,65314,53,60905,53,402,118,284,2,30,1,1
14338,64181,53,17159,53,194,102,92,2,31,1,1
14339,1111,25174,0,0,62,62,0,1,0,1,0
14340,56793,56205,0,0,66,66,0,1,0,1,0
14341,52319,445,0,0,70,70,0,1,0,1,0
14342,52317,445,0,0,70,70,0,1,0,1,0
14343,52315,445,0,0,70,70,0,1,0,1,0
14344,60976,22114,0,0,66,66,0,1,0,1,0
14345,33401,51505,0,0,66,66,0,1,0,1,0
14346,63937,445,0,0,70,70,0,1,0,1,0
14347,34348,22114,0,0,146,146,0,1,0,1,0
14348,52091,11392,0,0,66,66,0,1,0,1,0
14349,34112,44847,0,0,66,66,0,1,0,1,0
14350,12545,25174,0,0,62,62,0,1,0,1,0
14351,64103,50265,0,0,66,66,0,1,0,1,0
14352,515,10214,0,0,62,62,0,1,0,1,0
14353,52313,445,0,0,70,70,0,1,0,1,0
14354,52311,445,0,0,70,70,0,1,0,1,0
14355,52307,445,0,0,70,70,0,1,0,1,0
14356,52358,30188,0,0,66,66,0,1,0,1,0
14357,61550,5529,0,0,145,145,0,1,0,1,0
14358,5213,44847,0,0,66,66,0,1,0,1,0
14359,64092,445,0,0,66,66,0,1,0,1,0
14360,45218,25174,0,0,146,146,0,1,0,1,0
14361,52306,445,0,0,70,70,0,1,0,1,0
14362,23119,41615,0,0,148,148,0,1,0,1,0
14363,59524,25174,0,0,62,62,0,1,0,1,0
14364,1035,57470,0,0,72,72,0,1,0,1,0
14365,64088,445,0,0,66,66,0,1,0,1,0
14366,33871,34476,0,0,137,137,0,1,0,1,0
14367,63062,11392,0,0,62,62,0,1,0,1,0
14368,44919,26467,0,0,62,62,0,1,0,1,0
14369,59493,44847,0,0,66,66,0,1,0,1,0
14370,64085,445,0,0,66,66,0,1,0,1,0
14371,64084,445,0,0,66,66,0,1,0,1,0
14372,12531,22114,0,0,62,62,0,1,0,1,0
14373,55451,56205,0,0,66,66,0,1,0,1,0
14374,41490,25174,0,0,146,146,0,1,0,1,0
14375,65231,50584,0,0,66,66,0,1,0,1,0
14376,63924,445,0,0,70,70,0,1,0,1,0
14377,45964,3111,0,0,60,60,0,1,0,1,0
14378,64082,445,0,0,66,66,0,1,0,1,0
14379,50512,24748,0,0,145,145,0,1,0,1,0
14380,46116,57470,0,0,74,74,0,1,0,1,0
14381,34485,81,0,0,60,60,0,1,0,1,0
14382,28795,37965,0,0,62,62,0,1,0,1,0
14383,1865,25174,0,0,62,62,0,1,0,1,0
14384,63921,445,0,0,70,70,0,1,0,1,0
14385,56326,56205,0,0,66,66,0,1,0,1,0
14386,58021,22114,0,0,66,66,0,1,0,1,0
14387,22542,30188,0,0,146,146,0,1,0,1,0
14388,42796,22114,0,0,62,62,0,1,0,1,0
14389,52305,445,0,0,70,70,0,1,0,1,0
14390,52292,445,0,0,70,70,0,1,0,1,0
14391,52291,445,0,0,70,70,0,1,0,1,0
14392,63916,445,0,0,70,70,0,1,0,1,0
14393,64072,445,0,0,66,66,0,1,0,1,0
14394,51042,22114,0,0,66,66,0,1,0,1,0
14395,63915,445,0,0,70,70,0,1,0,1,0
14396,63213,35440,0,0,146,146,0,1,0,1,0
14397,35524,34962,0,0,159,159,0,1,0,1,0
14398,63913,445,0,0,70,70,0,1,0,1,0
14399,63389,3389,63389,3389,293,223,70,4,0,3,1
14400,53904,443,54254,443,495,421,74,4,0,3,1
14401,24227,48817,0,0,160,160,0,1,0,1,0
14402,80,56289,0,0,578,578,0,1,0,1,0
14403,1024,25174,0,0,62,62,0,1,0,1,0
14404,64064,445,0,0,66,66,0,1,0,1,0
14405,52278,445,0,0,70,70,0,1,0,1,0
14406,54142,20541,0,0,66,66,0,1,0,1,0
14407,56949,22,0,0,60,60,0,1,0,1,0
14408,1918,25174,0,0,66,66,0,1,0,1,0
14409,64062,445,0,0,66,66,0,1,0,1,0
14410,63906,445,0,0,70,70,0,1,0,1,0
14411,6247,51221,0,0,62,62,0,1,0,1,0
14412,63904,445,0,0,70,70,0,1,0,1,0
14413,58022,88,0,0,60,60,0,1,0,1,0
14414,2383,37965,0,0,62,62,0,1,0,1,0
14415,57496,25174,0,0,62,62,0,1,0,1,0
14416,53073,32468,0,0,62,62,0,1,0,1,0
14417,64055,445,0,0,66,66,0,1,0,1,0
14418,63903,445,0,0,70,70,0,1,0,1,0
14419,64052,445,0,0,66,66,0,1,0,1,0
14420,63902,445,0,0,70,70,0,1,0,1,0
14421,63901,445,0,0,70,70,0,1,0,1,0
14422,63899,445,0,0,70,70,0,1,0,1,0
14423,63895,445,0,0,70,70,0,1,0,1,0
14424,55429,25174,0,0,66,66,0,1,0,1,0
14425,65025,57866,0,0,66,66,0,1,0,1,0
14426,54758,35993,0,0,66,66,0,1,0,1,0
14427,44154,22114,0,0,62,62,0,1,0,1,0
14428,58646,44847,0,0,66,66,0,1,0,1,0
14429,56205,51505,0,0,66,66,0,1,0,1,0
14430,63883,445,0,0,70,70,0,1,0,1,0
14431,63882,445,0,0,70,70,0,1,0,1,0
14432,63877,445,0,0,70,70,0,1,0,1,0
14433,63873,445,0,0,70,70,0,1,0,1,0
14434,63872,445,0,0,70,70,0,1,0,1,0
14435,52270,445,0,0,70,70,0,1,0,1,0
14436,52269,445,0,0,70,70,0,1,0,1,0
14437,52266,445,0,0,70,70,0,1,0,1,0
14438,45726,64147,0,0,62,62,0,1,0,1,0
14439,22574,44847,0,0,62,62,0,1,0,1,0
14440,64035,445,0,0,66,66,0,1,0,1,0
14441,64038,445,0,0,66,66,0,1,0,1,0
14442,64037,445,0,0,66,66,0,1,0,1,0
14443,64034,445,0,0,66,66,0,1,0,1,0
14444,64039,445,0,0,66,66,0,1,0,1,0
14445,64036,445,0,0,66,66,0,1,0,1,0
14446,64033,445,0,0,66,66,0,1,0,1,0
14447,5955,55160,0,0,74,74,0,1,0,1,0
14448,80,61486,0,0,66,66,0,1,0,1,0
14449,26879,37965,0,0,62,62,0,1,0,1,0
14450,63861,445,0,0,70,70,0,1,0,1,0
14451,6126,25174,0,0,66,66,0,1,0,1,0
14452,52264,445,0,0,70,70,0,1,0,1,0
14453,52263,445,0,0,70,70,0,1,0,1,0
14454,52254,445,0,0,70,70,0,1,0,1,0
14455,52253,445,0,0,70,70,0,1,0,1,0
14456,64017,445,0,0,66,66,0,1,0,1,0
14457,64019,445,0,0,66,66,0,1,0,1,0
14458,64016,445,0,0,66,66,0,1,0,1,0
14459,43025,23,0,0,60,60,0,1,0,1,0
14460,48301,25174,0,0,62,62,0,1,0,1,0
14461,10406,35440,0,0,146,146,0,1,0,1,0
14462,10910,57866,0,0,62,62,0,1,0,1,0
14463,63857,445,0,0,70,70,0,1,0,1,0
14464,54726,30041,0,0,62,62,0,1,0,1,0
14465,52247,445,0,0,70,70,0,1,0,1,0
14466,53097,25174,0,0,66,66,0,1,0,1,0
14467,52683,22114,0,0,62,62,0,1,0,1,0
14468,52240,445,0,0,70,70,0,1,0,1,0
14469,52236,445,0,0,70,70,0,1,0,1,0
14470,52238,445,0,0,70,70,0,1,0,1,0
14471,63855,25174,0,0,62,62,0,1,0,1,0
14472,56387,25174,0,0,66,66,0,1,0,1,0
14473,13235,44847,0,0,62,62,0,1,0,1,0
14474,39313,37965,0,0,62,62,0,1,0,1,0
14475,39453,15503,0,0,74,74,0,1,0,1,0
14476,45964,2228,0,0,60,60,0,1,0,1,0
14477,63846,445,0,0,70,70,0,1,0,1,0
14478,63848,445,0,0,70,70,0,1,0,1,0
14479,63847,445,0,0,70,70,0,1,0,1,0
14480,63843,445,0,0,70,70,0,1,0,1,0
14481,41463,20005,0,0,60,60,0,1,0,1,0
14482,63841,445,0,0,70,70,0,1,0,1,0
14483,35111,22114,0,0,66,66,0,1,0,1,0
14484,64733,35440,0,0,66,66,0,1,0,1,0
14485,51866,22114,0,0,62,62,0,1,0,1,0
14486,61660,64097,0,0,62,62,0,1,0,1,0
14487,28825,23,0,0,60,60,0,1,0,1,0
14488,52228,445,0,0,70,70,0,1,0,1,0
14489,52226,445,0,0,70,70,0,1,0,1,0
14490,29178,35440,0,0,66,66,0,1,0,1,0
14491,47178,53,0,0,82,82,0,2,40,2,0
14492,52108,20175,5769,20175,70,70,0,2,8,2,0
14493,52109,60841,37568,60841,258,70,188,4,8,2,2
14494,53454,443,37572,443,10416,3195,7221,32,46,18,14
14495,52472,443,52472,443,4400,1493,2907,19,31,11,8
14496,63385,443,63385,443,4659,1752,2907,19,30,11,8
14497,61792,443,46504,443,12526,7202,5324,28,99,15,13
14498,9448,443,19728,443,5691,503,5188,14,15,7,7
14499,52076,28895,29171,28895,66,66,0,1,5,1,0
14500,9451,443,45125,443,5699,505,5194,14,15,7,7
14501,40517,53,18726,53,284,79,205,2,30,1,1
14502,64850,53,13429,53,166,85,81,2,31,1,1
14503,38728,443,11034,443,560,280,280,9,27,5,4
14504,62249,443,58132,443,9251,6353,2898,25,120,13,12
14505,61433,443,33532,443,41274,18956,22318,90,171,43,47
14506,36828,80,12290,80,5189,2979,2210,19,136,12,7
14507,47613,53,0,0,82,82,0,1,30,1,0
14508,9460,80,52623,80,1641,483,1158,10,15,5,5
14509,53162,60352,6170,60352,70,70,0,1,5,1,0
14510,58872,443,51853,443,342665,10261,332404,369,90,117,252
14511,52106,41632,7529,41632,70,70,0,2,9,2,0
14512,53876,53380,47868,53380,70,70,0,1,5,1,0
14513,60518,80,21543,80,1915,797,1118,8,16,5,3
14514,52079,1024,39803,1024,66,66,0,1,5,1,0
14515,26227,23,26227,23,146,60,86,2,10,1,1
14516,54104,80,15819,80,214,140,74,4,15,3,1
14517,9454,443,57468,443,5699,505,5194,14,15,7,7
14518,52376,443,24814,443,33906,25094,8812,63,447,36,27
14519,21478,53,21478,53,625,79,546,2,30,1,1
14520,51661,443,59276,443,11558,3964,7594,37,17,15,22
14521,52110,35411,42303,35411,70,70,0,2,8,2,0
14522,50401,443,63156,443,256,136,120,5,9,3,2
14523,53878,55950,30797,55950,70,70,0,1,5,1,0
14524,53875,43611,37582,43611,70,70,0,1,5,1,0
14525,9450,443,24290,443,5691,503,5188,14,15,7,7
14526,9447,443,13084,443,5691,503,5188,14,15,7,7
14527,46570,443,45902,443,8897,2184,6713,24,516,13,11
14528,58953,443,9937,443,4051,2587,1464,18,16,9,9
14529,54314,53,25378,53,284,79,205,2,30,1,1
14530,56782,53,53429,53,194,99,95,2,30,1,1
14531,64942,53,24439,53,522,190,332,5,48,3,2
14532,30960,45763,2134,45763,330,330,0,6,3609,6,0
14533,30960,45752,44974,45752,462,462,0,8,3631,8,0
14534,58930,60038,0,0,66,66,0,1,91,1,0
14535,5060,37965,0,0,66,66,0,1,0,1,0
14536,15806,11392,0,0,66,66,0,1,0,1,0
14537,31539,37965,0,0,62,62,0,1,0,1,0
14538,63834,445,0,0,70,70,0,1,0,1,0
14539,13525,51505,0,0,62,62,0,1,0,1,0
14540,64005,445,0,0,66,66,0,1,0,1,0
14541,54796,22114,0,0,62,62,0,1,0,1,0
14542,3169,22114,0,0,62,62,0,1,0,1,0
14543,57251,37965,0,0,62,62,0,1,0,1,0
14544,51783,50584,0,0,66,66,0,1,0,1,0
14545,59282,51050,0,0,66,66,0,1,0,1,0
14546,58247,57866,0,0,66,66,0,1,0,1,0
14547,57599,80,57241,80,1526,972,554,10,75,6,4
14548,56388,443,22343,443,11093,2322,8771,40,17,23,17
14549,9458,443,4963,443,5695,505,5190,14,15,7,7
14550,64017,80,54075,80,314,192,122,6,15,4,2
14551,12942,10387,0,0,159,159,0,1,0,1,0
14552,56403,51505,0,0,62,62,0,1,0,1,0
14553,62217,37807,0,0,62,62,0,1,0,1,0
14554,63827,445,0,0,70,70,0,1,0,1,0
14555,41694,26296,0,0,145,145,0,1,0,1,0
14556,60113,22114,0,0,66,66,0,1,0,1,0
14557,63824,445,0,0,70,70,0,1,0,1,0
14558,26884,37965,0,0,66,66,0,1,0,1,0
14559,52221,445,0,0,70,70,0,1,0,1,0
14560,27081,10197,0,0,62,62,0,1,0,1,0
14561,59303,21247,0,0,66,66,0,1,0,1,0
14562,16057,51050,0,0,62,62,0,1,0,1,0
14563,60117,50934,0,0,62,62,0,1,0,1,0
14564,52220,445,0,0,70,70,0,1,0,1,0
14565,30332,48817,0,0,145,145,0,1,0,1,0
14566,63819,445,0,0,70,70,0,1,0,1,0
14567,42957,64147,0,0,145,145,0,1,0,1,0
14568,63817,445,0,0,70,70,0,1,0,1,0
14569,63988,445,0,0,66,66,0,1,0,1,0
14570,63989,445,0,0,66,66,0,1,0,1,0
14571,1036,64147,0,0,62,62,0,1,0,1,0
14572,44856,51505,0,0,62,62,0,1,0,1,0
14573,37887,22114,0,0,66,66,0,1,0,1,0
14574,63813,445,0,0,70,70,0,1,0,1,0
14575,44679,80,35749,80,3180,2317,863,12,11,7,5
14576,43815,50584,0,0,62,62,0,1,0,1,0
14577,64595,64147,0,0,62,62,0,1,0,1,0
14578,52210,445,0,0,70,70,0,1,0,1,0
14579,52206,445,0,0,70,70,0,1,0,1,0
14580,52204,445,0,0,70,70,0,1,0,1,0
14581,52198,445,0,0,70,70,0,1,0,1,0
14582,18750,57866,0,0,62,62,0,1,0,1,0
14583,63030,25174,0,0,62,62,0,1,0,1,0
14584,68,67,0,0,346,346,0,1,0,1,0
14585,34066,36829,0,0,146,146,0,1,0,1,0
14586,46734,50265,0,0,74,74,0,1,0,1,0
14587,63812,445,0,0,70,70,0,1,0,1,0
14588,63984,445,0,0,66,66,0,1,0,1,0
14589,16620,25174,0,0,62,62,0,1,0,1,0
14590,42722,56448,0,0,74,74,0,1,0,1,0
14591,1638,22114,0,0,62,62,0,1,0,1,0
14592,63979,445,0,0,66,66,0,1,0,1,0
14593,63976,445,0,0,66,66,0,1,0,1,0
14594,63967,445,0,0,66,66,0,1,0,1,0
14595,63972,445,0,0,66,66,0,1,0,1,0
14596,63971,445,0,0,66,66,0,1,0,1,0
14597,63968,445,0,0,66,66,0,1,0,1,0
14598,63969,445,0,0,66,66,0,1,0,1,0
14599,62194,50584,0,0,66,66,0,1,0,1,0
14600,39583,37965,0,0,66,66,0,1,0,1,0
14601,49993,37965,0,0,66,66,0,1,0,1,0
14602,47783,50432,0,0,62,62,0,1,0,1,0
14603,52196,445,0,0,70,70,0,1,0,1,0
14604,11382,43890,0,0,62,62,0,1,0,1,0
14605,46537,25174,0,0,62,62,0,1,0,1,0
14606,52191,445,0,0,70,70,0,1,0,1,0
14607,52187,445,0,0,70,70,0,1,0,1,0
14608,52189,445,0,0,70,70,0,1,0,1,0
14609,13518,25174,0,0,146,146,0,1,0,1,0
14610,63807,445,0,0,70,70,0,1,0,1,0
14611,11136,19910,0,0,62,62,0,1,0,1,0
14612,55931,53,3407,53,168,78,90,2,30,1,1
14613,64588,53,5541,53,264,102,162,2,30,1,1
14614,52359,443,35892,443,13972,2550,11422,29,954,11,18
14615,56470,28678,7618,28678,1806,1806,0,22,224,22,0
14616,57206,443,4994,443,1798,1223,575,13,28,8,5
14617,65318,53,63246,53,294,94,200,4,51,2,2
14618,56289,53,22157,53,351,110,241,2,29,1,1
14619,56767,443,38617,443,7941,1952,5989,20,15,11,9
14620,35978,443,55185,443,2959,793,2166,10,120,5,5
14621,61807,443,12289,443,6244,1855,4389,16,75,9,7
14622,55144,443,25818,443,6918,2826,4092,26,21,16,10
14623,52082,14804,24933,14804,70,70,0,1,4,1,0
14624,50864,80,3838,80,1888,1814,74,10,15,9,1
14625,56674,80,12315,80,156,156,0,3,8,3,0
14626,60929,28678,34471,28678,1806,1806,0,22,224,22,0
14627,49564,53,13171,53,193,102,91,2,29,1,1
14628,14441,443,20256,443,2629,1470,1159,18,15,8,10
14629,56853,53,24934,53,167,86,81,2,29,1,1
14630,55958,53,30538,53,275,86,189,2,29,1,1
14631,56519,53,20744,53,167,86,81,2,29,1,1
14632,56853,53,30375,53,167,86,81,2,29,1,1
14633,60708,53,53667,53,291,86,205,2,29,1,1
14634,56765,443,7248,443,7940,1951,5989,20,15,11,9
14635,58885,443,39873,443,354,294,60,2,15,1,1
14636,56766,443,55432,443,7888,1899,5989,20,15,11,9
14637,10007,443,53248,443,3811,1846,1965,20,330,9,11
14638,55346,53,15239,53,199,94,105,2,30,1,1
14639,65400,53,61482,53,211,102,109,2,30,1,1
14640,55805,80,55805,80,424,198,226,7,141,4,3
14641,52080,9554,43185,9554,70,70,0,1,5,1,0
14642,51243,80,3228,80,1451,949,502,12,46,7,5
14643,60607,53,60607,53,832,106,726,2,30,1,1
14644,60852,443,55582,443,7471,2914,4557,26,47,15,11
14645,64810,53,30848,53,257,126,131,2,30,1,1
14646,55360,80,13495,80,130,70,60,2,15,1,1
14647,37306,53,55019,53,168,78,90,2,30,1,1
14648,9449,443,11942,443,5693,499,5194,14,15,7,7
14649,49570,443,32958,443,6360,2483,3877,20,16,10,10
14650,54071,53,10458,53,207,86,121,2,30,1,1
14651,58316,443,4061,443,7493,1658,5835,22,255,12,10
14652,38705,443,49826,443,1248170,26899,1221271,1212,16,382,830
14653,56890,443,61166,443,6935,1415,5520,22,186,12,10
14654,49658,53,43401,53,211,102,109,2,30,1,1
14655,57343,443,46945,443,1607664,53945,1553719,1792,39,700,1092
14656,55337,443,21717,443,24341,15170,9171,78,461,39,39
14657,47637,443,16997,443,280,140,140,5,151,3,2
14658,35973,443,21497,443,4665045,113088,4551957,4511,421,1285,3226
14659,48778,80,16126,80,130,70,60,2,15,1,1
14660,33028,80,50046,80,130,70,60,2,15,1,1
14661,49207,443,35553,443,9852,2190,7662,49,257,22,27
14662,28036,443,58065,443,5780,4574,1206,20,16,11,9
14663,36829,443,57108,443,560,280,280,9,27,5,4
14664,38606,53,21514,53,168,78,90,2,30,1,1
14665,48817,50321,48817,50321,334,158,176,2,1203,1,1
14666,50265,443,33031,443,23684,13193,10491,84,63,44,40
14667,49836,53,59050,53,327,102,225,2,30,1,1
14668,65168,53,46023,53,239,94,145,2,30,1,1
14669,60862,443,5299,443,12604,6376,6228,27,133,16,11
14670,50286,443,48730,443,6414386,102255,6312131,5812,182,1634,4178
14671,48992,80,47525,80,1114,534,580,12,16,7,5
14672,22,44840,22,44840,1427,1170,257,8,15,4,4
14673,53903,51339,21513,51339,70,70,0,2,7,2,0
14674,39437,80,3186,80,2088,472,1616,15,155,3,12
14675,55103,53,23177,53,392,92,300,4,55,2,2
14676,56782,53,51814,53,197,102,95,2,33,1,1
14677,9459,443,54316,443,5695,505,5190,14,15,7,7
14678,49279,80,12266,80,254,128,126,5,15,3,2
14679,9453,443,40885,443,5693,499,5194,14,15,7,7
14680,9452,443,55218,443,5693,499,5194,14,15,7,7
14681,56519,53,14326,53,167,86,81,2,29,1,1
14682,21133,54508,26359,54508,323,150,173,2,1199,1,1
14683,57231,53,46027,53,168,86,82,2,30,1,1
14684,9457,443,13669,443,5316,488,4828,14,15,7,7
14685,57202,443,8164,443,1728,1153,575,12,28,7,5
14686,51613,443,47721,443,5052,2873,2179,26,15,14,12
14687,56519,53,28431,53,167,86,81,2,30,1,1
14688,52083,26607,58147,26607,70,70,0,1,4,1,0
14689,57203,443,49091,443,1798,1223,575,13,28,8,5
14690,56672,53,64193,53,177,94,83,2,30,1,1
14691,50442,80,50442,80,52791,4087,48704,66,24,26,40
14692,49564,53,61434,53,193,102,91,2,30,1,1
14693,54497,443,48697,443,8318,2068,6250,32,270,16,16
14694,52925,443,2164,443,114867,4243,110624,128,120,44,84
14695,64850,53,27196,53,167,86,81,2,30,1,1
14696,49661,53,62903,53,344,102,242,2,30,1,1
14697,60376,443,21896,443,9379,2092,7287,21,126,9,12
14698,54761,5228,49627,5228,12683,1205,11478,27,182,8,19
14699,35642,80,28559,80,1849,1015,834,11,150,6,5
14700,35136,443,3606,443,25542,17843,7699,58,59,34,24
14701,61279,443,14356,443,7424,3871,3553,26,160,12,14
14702,51598,443,10892,443,14194,4643,9551,34,30,19,15
14703,53159,58710,30090,58710,698,320,378,10,18,6,4
14704,59274,443,55424,443,8640,2329,6311,19,76,10,9
14705,35999,443,44617,443,670261,26523,643738,728,188,262,466
14706,58954,443,36028,443,5166,700,4466,16,15,7,9
14707,55363,53,15445,53,228,110,118,2,30,1,1
14708,65375,443,53764,443,2458316,102393,2355923,2942,241,1261,1681
14709,50040,53,62872,53,322,102,220,2,30,1,1
14710,64850,53,29250,53,167,86,81,2,30,1,1
14711,64962,53,48454,53,226,94,132,2,30,1,1
14712,56672,53,51134,53,177,94,83,2,30,1,1
14713,36430,443,61120,443,3777,1509,2268,18,120,9,9
14714,40781,443,17024,443,14327,1918,12409,37,270,17,20
14715,53865,64000,37089,64000,492,306,186,8,15,5,3
14716,44636,443,35730,443,6297,1831,4466,20,16,9,11
14717,53161,30013,56221,30013,70,70,0,1,5,1,0
14718,57584,443,14480,443,8937,3934,5003,18,120,9,9
14719,63355,443,59950,443,2870,343,2527,11,120,5,6
14720,55039,443,64407,443,10961,2666,8295,35,237,16,19
14721,56275,443,61048,443,513682,20015,493667,523,226,126,397
14722,50265,7205,64572,7205,1488,930,558,21,1200,12,9
14723,36628,80,54402,80,78,78,0,2,8,2,0
14724,53867,60272,36955,60272,70,70,0,1,5,1,0
14725,55294,3389,55294,3389,4470,2381,2089,23,19,13,10
14726,44162,80,44162,80,457843,10253,447590,452,26,152,300
14727,64593,53,46361,53,258,102,156,2,30,1,1
14728,52042,80,17014,80,70,70,0,2,8,2,0
14729,53871,43266,32431,43266,70,70,0,1,5,1,0
14730,56764,443,62218,443,8006,1986,6020,20,16,11,9
14731,56044,80,25395,80,1515,481,1034,11,16,6,5
14732,42927,443,28678,443,6921,1769,5152,22,24,13,9
14733,64033,29834,57709,29834,66,66,0,2,8,2,0
14734,53872,24710,13948,24710,70,70,0,1,5,1,0
14735,36278,7000,36278,7000,3578,1967,1611,16,16,8,8
14736,42162,80,42162,80,2941,1499,1442,10,16,6,4
14737,64850,53,55584,53,167,86,81,2,30,1,1
14738,59355,51505,0,0,66,66,0,1,0,1,0
14739,56323,57470,0,0,74,74,0,1,0,1,0
14740,37034,25174,0,0,62,62,0,1,0,1,0
14741,51726,64147,0,0,62,62,0,1,0,1,0
14742,2332,35440,0,0,66,66,0,1,0,1,0
14743,52184,445,0,0,70,70,0,1,0,1,0
14744,52183,445,0,0,70,70,0,1,0,1,0
14745,52179,445,0,0,70,70,0,1,0,1,0
14746,52503,50584,0,0,62,62,0,1,0,1,0
14747,10003,64147,0,0,62,62,0,1,0,1,0
14748,63962,445,0,0,66,66,0,1,0,1,0
14749,20586,25174,0,0,62,62,0,1,0,1,0
14750,52178,445,0,0,70,70,0,1,0,1,0
14751,58103,10197,0,0,66,66,0,1,0,1,0
14752,30800,25174,0,0,146,146,0,1,0,1,0
14753,63959,445,0,0,66,66,0,1,0,1,0
14754,63794,445,0,0,70,70,0,1,0,1,0
14755,63957,445,0,0,66,66,0,1,0,1,0
14756,63955,445,0,0,66,66,0,1,0,1,0
14757,59535,25174,0,0,62,62,0,1,0,1,0
14758,54173,23,0,0,60,60,0,1,0,1,0
14759,6666,138,0,0,60,60,0,1,0,1,0
14760,63953,445,0,0,66,66,0,1,0,1,0
14761,63791,445,0,0,70,70,0,1,0,1,0
14762,53902,443,2298,443,499,425,74,4,0,3,1
14763,44714,25174,0,0,146,146,0,1,0,1,0
14764,51455,53733,0,0,66,66,0,1,0,1,0
14765,52494,36237,0,0,62,62,0,1,0,1,0
14766,62579,57866,0,0,66,66,0,1,0,1,0
14767,37666,48817,0,0,146,146,0,1,0,1,0
14768,60579,25174,0,0,66,66,0,1,0,1,0
14769,52176,445,0,0,70,70,0,1,0,1,0
14770,1238,51505,0,0,62,62,0,1,0,1,0
14771,45941,23386,0,0,60,60,0,1,0,1,0
14772,52165,445,0,0,70,70,0,1,0,1,0
14773,52164,445,0,0,70,70,0,1,0,1,0
14774,63787,445,0,0,70,70,0,1,0,1,0
14775,65331,53,50741,53,732,89,643,2,0,1,1
14776,54754,50432,0,0,66,66,0,1,0,1,0
14777,50620,50584,0,0,62,62,0,1,0,1,0
14778,52625,25174,0,0,66,66,0,1,0,1,0
14779,63785,445,0,0,70,70,0,1,0,1,0
14780,60159,22114,0,0,66,66,0,1,0,1,0
14781,31172,22114,0,0,62,62,0,1,0,1,0
14782,63943,445,0,0,66,66,0,1,0,1,0
14783,63783,445,0,0,70,70,0,1,0,1,0
14784,6666,16010,0,0,60,60,0,1,0,1,0
14785,46512,63836,0,0,148,148,0,1,0,1,0
14786,64024,22114,0,0,66,66,0,1,0,1,0
14787,26527,25174,0,0,62,62,0,1,0,1,0
14788,53901,443,43794,443,499,425,74,4,0,3,1
14789,53903,443,40208,443,499,425,74,4,0,3,1
14790,53900,443,15989,443,499,425,74,4,0,3,1
14791,53897,443,53988,443,499,425,74,4,0,3,1
14792,53898,443,56204,443,499,425,74,4,0,3,1
14793,53899,443,57181,443,499,425,74,4,0,3,1
14794,53890,443,45559,443,499,425,74,4,0,3,1
14795,53895,443,53348,443,499,425,74,4,0,3,1
14796,53896,443,17824,443,499,425,74,4,0,3,1
14797,53894,443,56603,443,499,425,74,4,0,3,1
14798,53893,443,15377,443,499,425,74,4,0,3,1
14799,53885,443,38826,443,499,425,74,4,0,3,1
14800,53891,443,8709,443,499,425,74,4,0,3,1
14801,53892,443,6388,443,499,425,74,4,0,3,1
14802,53886,443,40309,443,499,425,74,4,0,3,1
14803,53887,443,39424,443,499,425,74,4,0,3,1
14804,53888,443,38577,443,499,425,74,4,0,3,1
14805,53889,443,11378,443,499,425,74,4,0,3,1
14806,63136,25174,0,0,66,66,0,1,0,1,0
14807,47424,25174,0,0,62,62,0,1,0,1,0
14808,63935,445,0,0,66,66,0,1,0,1,0
14809,52155,445,0,0,70,70,0,1,0,1,0
14810,63776,445,0,0,70,70,0,1,0,1,0
14811,56897,11446,0,0,62,62,0,1,0,1,0
14812,63932,445,0,0,66,66,0,1,0,1,0
14813,63774,445,0,0,70,70,0,1,0,1,0
14814,49918,26296,0,0,146,146,0,1,0,1,0
14815,10704,25174,0,0,62,62,0,1,0,1,0
14816,33556,25174,0,0,62,62,0,1,0,1,0
14817,36011,25174,0,0,66,66,0,1,0,1,0
14818,63773,445,0,0,70,70,0,1,0,1,0
14819,59018,22114,0,0,62,62,0,1,0,1,0
14820,6356,26467,0,0,62,62,0,1,0,1,0
14821,7288,25174,0,0,66,66,0,1,0,1,0
14822,63772,445,0,0,70,70,0,1,0,1,0
14823,63771,445,0,0,70,70,0,1,0,1,0
14824,63926,445,0,0,66,66,0,1,0,1,0
14825,5955,55160,0,0,74,74,0,1,0,1,0
14826,63766,445,0,0,70,70,0,1,0,1,0
14827,63765,445,0,0,70,70,0,1,0,1,0
14828,17982,11392,0,0,62,62,0,1,0,1,0
14829,54526,44847,0,0,62,62,0,1,0,1,0
14830,63918,445,0,0,66,66,0,1,0,1,0
14831,65389,26467,0,0,62,62,0,1,0,1,0
14832,62799,25174,0,0,62,62,0,1,0,1,0
14833,3064,44847,0,0,62,62,0,1,0,1,0
14834,54746,22114,0,0,146,146,0,1,0,1,0
14835,13285,29892,0,0,145,145,0,1,0,1,0
14836,0,0,0,0,400,204,196,4,0,2,2
14837,0,0,0,0,200,102,98,2,0,1,1
14838,0,0,0,0,600,306,294,6,0,3,3
14839,41462,2323,0,0,60,60,0,1,0,1,0
14840,63852,25174,0,0,146,146,0,1,0,1,0
14841,63753,445,0,0,70,70,0,1,0,1,0
14842,63752,445,0,0,70,70,0,1,0,1,0
14843,63749,445,0,0,70,70,0,1,0,1,0
14844,63743,445,0,0,70,70,0,1,0,1,0
14845,63742,445,0,0,70,70,0,1,0,1,0
14846,23939,41615,0,0,146,146,0,1,0,1,0
14847,59937,18375,0,0,66,66,0,1,0,1,0
14848,22783,64147,0,0,66,66,0,1,0,1,0
14849,52142,445,0,0,70,70,0,1,0,1,0
14850,52139,445,0,0,70,70,0,1,0,1,0
14851,52138,445,0,0,70,70,0,1,0,1,0
14852,1377,44847,0,0,62,62,0,1,0,1,0
14853,63901,445,0,0,66,66,0,1,0,1,0
14854,63905,445,0,0,66,66,0,1,0,1,0
14855,63908,445,0,0,66,66,0,1,0,1,0
14856,63907,445,0,0,66,66,0,1,0,1,0
14857,63902,445,0,0,66,66,0,1,0,1,0
14858,63904,445,0,0,66,66,0,1,0,1,0
14859,63903,445,0,0,66,66,0,1,0,1,0
14860,63900,445,0,0,66,66,0,1,0,1,0
14861,30729,22114,0,0,66,66,0,1,0,1,0
14862,59523,37965,0,0,62,62,0,1,0,1,0
14863,59060,50584,0,0,66,66,0,1,0,1,0
14864,52744,25174,0,0,62,62,0,1,0,1,0
14865,51615,25174,0,0,66,66,0,1,0,1,0
14866,14777,25174,0,0,62,62,0,1,0,1,0
14867,63731,445,0,0,70,70,0,1,0,1,0
14868,25532,35440,0,0,146,146,0,1,0,1,0
14869,15176,62413,0,0,62,62,0,1,0,1,0
14870,50236,25174,0,0,66,66,0,1,0,1,0
14871,52134,445,0,0,70,70,0,1,0,1,0
14872,52133,445,0,0,70,70,0,1,0,1,0
14873,52131,445,0,0,70,70,0,1,0,1,0
14874,52122,445,0,0,70,70,0,1,0,1,0
14875,48230,22114,0,0,146,146,0,1,0,1,0
14876,54914,51505,0,0,66,66,0,1,0,1,0
14877,10091,22114,0,0,62,62,0,1,0,1,0
14878,45964,2228,0,0,60,60,0,1,0,1,0
14879,59668,50584,0,0,62,62,0,1,0,1,0
14880,63886,445,0,0,66,66,0,1,0,1,0
14881,63885,445,0,0,66,66,0,1,0,1,0
14882,63884,445,0,0,66,66,0,1,0,1,0
14883,54976,15503,0,0,66,66,0,1,0,1,0
14884,13588,15503,0,0,62,62,0,1,0,1,0
14885,63727,445,0,0,70,70,0,1,0,1,0
14886,2346,25174,0,0,66,66,0,1,0,1,0
14887,443,63128,0,0,1514,1514,0,1,0,1,0
14888,52118,445,0,0,70,70,0,1,0,1,0
14889,50265,49893,64996,49893,480,149,331,2,1200,1,1
14890,50774,443,17270,443,4521,2256,2265,15,135,7,8
14891,36644,443,15948,443,9329,3935,5394,30,405,17,13
14892,49531,80,57829,80,78,78,0,1,5,1,0
14893,65421,443,16177,443,2494,1643,851,17,25,9,8
14894,52072,25595,16816,25595,66,66,0,1,5,1,0
14895,54941,80,51171,80,2513,567,1946,10,75,6,4
14896,59893,80,45322,80,130,70,60,2,15,1,1
14897,57410,53,64082,53,711,87,624,2,30,1,1
14898,58871,443,24562,443,405189,13572,391617,446,89,155,291
14899,9434,443,11212,443,5693,499,5194,14,15,7,7
14900,56082,53,58517,53,271,88,183,4,38,2,2
14901,53896,48027,7654,48027,70,70,0,2,8,2,0
14902,49158,443,4149,443,3655,1807,1848,17,15,9,8
14903,56467,53,49050,53,578,286,292,9,15,5,4
14904,56937,53,51825,53,178,91,87,2,30,1,1
14905,52104,51756,27820,51756,70,70,0,2,8,2,0
14906,54542,443,54542,443,150554,18764,131790,192,117,95,97
14907,46618,443,48794,443,9505,3214,6291,33,19,19,14
14908,39568,443,60001,443,4477,2605,1872,22,248,12,10
14909,55542,53,5716,53,170,87,83,2,30,1,1
14910,53862,36120,51667,36120,2254,1281,973,17,17,10,7
14911,45273,80,45273,80,18685,7141,11544,33,28,17,16
14912,62394,80,62394,80,29401,10036,19365,49,28,24,25
14913,9435,443,2463,443,5693,499,5194,14,15,7,7
14914,64117,53,64117,53,209,77,132,2,32,1,1
14915,57231,53,16422,53,168,86,82,2,31,1,1
14916,40806,443,37490,443,3287,2049,1238,12,31,7,5
14917,54942,80,32519,80,5696,703,4993,14,75,8,6
14918,63995,443,63995,443,4673,1766,2907,19,29,11,8
14919,46720,53,0,0,82,82,0,1,30,1,0
14920,47992,5228,27773,5228,2988,2036,952,16,3601,8,8
14921,54800,443,4050,443,9612,4324,5288,31,400,11,20
14922,49146,443,34396,443,3655,1807,1848,17,15,9,8
14923,56440,53,9792,53,711,87,624,2,31,1,1
14924,53894,2944,4121,2944,70,70,0,2,8,2,0
14925,17750,7579,37146,7579,490,149,341,2,1200,1,1
14926,52102,19604,10302,19604,70,70,0,2,8,2,0
14927,59952,80,58096,80,440081,8465,431616,424,24,137,287
14928,59000,443,15029,443,6362,1745,4617,25,18,13,12
14929,49341,443,6648,443,6882,1788,5094,15,16,9,6
14930,64034,17935,14010,17935,66,66,0,2,8,2,0
14931,9436,443,44079,443,5693,499,5194,14,15,7,7
14932,51076,443,8592,443,19880,4739,15141,58,187,26,32
14933,8282,25916,26002,25916,133,64,69,3,33,2,1
14934,57164,443,51715,443,522,78,444,8,22,2,6
14935,53870,24535,51626,24535,70,70,0,1,5,1,0
14936,59964,443,4370,443,48525,4928,43597,111,660,55,56
14937,53012,443,30523,443,4073,2039,2034,14,135,7,7
14938,45230,443,23452,443,33924,26047,7877,73,403,33,40
14939,48817,11602,48817,11602,152,152,0,1,1200,1,0
14940,48817,57451,48817,57451,152,152,0,1,1200,1,0
14941,56230,5228,8322,5228,2564,1546,1018,18,3600,9,9
14942,64691,25320,0,0,62,62,0,1,0,1,0
14943,63716,445,0,0,70,70,0,1,0,1,0
14944,63718,445,0,0,70,70,0,1,0,1,0
14945,63717,445,0,0,70,70,0,1,0,1,0
14946,55554,22114,0,0,146,146,0,1,0,1,0
14947,52117,445,0,0,70,70,0,1,0,1,0
14948,52110,445,0,0,70,70,0,1,0,1,0
14949,52109,445,0,0,70,70,0,1,0,1,0
14950,5228,3434,0,0,345,345,0,1,0,1,0
14951,63714,445,0,0,70,70,0,1,0,1,0
14952,63711,445,0,0,70,70,0,1,0,1,0
14953,51979,25174,0,0,66,66,0,1,0,1,0
14954,1847,64147,0,0,66,66,0,1,0,1,0
14955,59773,5900,0,0,60,60,0,1,0,1,0
14956,58022,8112,0,0,60,60,0,1,0,1,0
14957,41970,23,0,0,60,60,0,1,0,1,0
14958,6980,25604,0,0,100,100,0,1,0,1,0
14959,53207,50584,0,0,66,66,0,1,0,1,0
14960,57834,80,57834,80,2106,1657,449,10,20,6,4
14961,63704,445,0,0,70,70,0,1,0,1,0
14962,1537,22114,0,0,62,62,0,1,0,1,0
14963,52112,22114,0,0,66,66,0,1,0,1,0
14964,6881,6881,0,0,146,146,0,1,0,1,0
14965,52101,445,0,0,70,70,0,1,0,1,0
14966,52098,445,0,0,70,70,0,1,0,1,0
14967,52096,445,0,0,70,70,0,1,0,1,0
14968,5790,43890,0,0,62,62,0,1,0,1,0
14969,43260,41615,0,0,145,145,0,1,0,1,0
14970,63873,445,0,0,66,66,0,1,0,1,0
14971,56711,25174,0,0,62,62,0,1,0,1,0
14972,18116,37807,0,0,66,66,0,1,0,1,0
14973,38099,11392,0,0,62,62,0,1,0,1,0
14974,63697,445,0,0,70,70,0,1,0,1,0
14975,55425,37965,0,0,66,66,0,1,0,1,0
14976,49370,11392,0,0,66,66,0,1,0,1,0
14977,29884,25174,0,0,146,146,0,1,0,1,0
14978,63696,445,0,0,70,70,0,1,0,1,0
14979,34028,443,47575,443,7804,1583,6221,26,981,13,13
14980,58952,443,55046,443,5166,700,4466,16,15,7,9
14981,50041,443,48278,443,7924,1798,6126,26,15,14,12
14982,25833,53,31276,53,404,261,143,3,30,2,1
14983,32805,443,65246,443,438124,21529,416595,481,398,138,343
14984,30188,51419,27819,51419,502,150,352,2,1200,1,1
14985,64029,38651,56654,38651,66,66,0,2,7,2,0
14986,53898,12172,10905,12172,70,70,0,2,7,2,0
14987,53868,52706,53464,52706,70,70,0,1,4,1,0
14988,49781,53,35337,53,254,102,152,2,29,1,1
14989,50405,443,58184,443,612,280,332,10,26,5,5
14990,53873,52055,19487,52055,70,70,0,1,4,1,0
14991,54819,443,17467,443,70,70,0,1,4,1,0
14992,52078,15518,32282,15518,70,70,0,1,4,1,0
14993,60514,80,54084,80,1641,944,697,9,15,5,4
14994,50474,443,49167,443,17449456,390704,17058752,16816,383,4917,11899
14995,50584,51413,41920,51413,475,150,325,2,1200,1,1
14996,44680,80,65456,80,1658,922,736,10,17,6,4
14997,38704,443,15370,443,90097,3289,86808,93,15,28,65
14998,53899,45682,27773,45682,70,70,0,2,7,2,0
14999,52105,1024,36023,1024,70,70,0,2,7,2,0
15000,52077,51638,8361,51638,70,70,0,1,4,1,0
15001,54813,443,48795,443,1633,819,814,16,40,8,8
15002,56737,80,46127,80,194,128,66,4,25,3,1
15003,53869,17089,38908,17089,70,70,0,1,4,1,0
15004,55542,53,10496,53,177,94,83,2,29,1,1
15005,55130,27046,9695,27046,1798,1386,412,8,29,4,4
15006,34692,53,2143,53,271,102,169,2,30,1,1
15007,51913,443,46255,443,13337,10008,3329,47,185,23,24
15008,50671,80,18183,80,1658,1247,411,8,15,5,3
15009,56937,53,49569,53,181,94,87,2,33,1,1
15010,49773,80,31365,80,70,70,0,1,5,1,0
15011,28015,443,63063,443,6435,1089,5346,18,75,9,9
15012,28014,443,49655,443,6435,1089,5346,18,75,9,9
15013,28012,443,23129,443,6388,1112,5276,18,75,9,9
15014,50177,443,50177,443,5206,1389,3817,22,15,10,12
15015,53373,64147,0,0,66,66,0,1,0,1,0
15016,52093,445,0,0,70,70,0,1,0,1,0
15017,52090,445,0,0,70,70,0,1,0,1,0
15018,55951,30188,0,0,66,66,0,1,0,1,0
15019,30654,51221,0,0,72,72,0,1,0,1,0
15020,63690,445,0,0,70,70,0,1,0,1,0
15021,51077,443,6425,443,2997,1906,1091,29,186,17,12
15022,49558,53,42255,53,350,93,257,4,42,2,2
15023,46295,443,56188,443,7493,3793,3700,40,109,26,14
15024,56322,80,56322,80,27189,4515,22674,34,23,14,20
15025,56763,443,10844,443,8058,2038,6020,20,15,11,9
15026,33304,443,15471,443,1067,650,417,10,73,6,4
15027,41501,80,33952,80,306627,58973,247654,556,297,246,310
15028,36983,80,52569,80,130,70,60,2,15,1,1
15029,62353,80,60521,80,2895,771,2124,12,24,6,6
15030,34436,443,8261,443,9083,2087,6996,28,18,16,12
15031,65386,53,35268,53,197,102,95,2,33,1,1
15032,65507,53,1633,53,177,94,83,2,30,1,1
15033,55542,53,62446,53,177,94,83,2,30,1,1
15034,41640,8080,50397,8080,78,78,0,2,8,2,0
15035,53450,443,34036,443,10139,3656,6483,29,128,14,15
15036,49428,53,23705,53,200,94,106,2,30,1,1
15037,50484,443,37149,443,30475,26737,3738,62,26,35,27
15038,58966,443,39805,443,8209,2174,6035,25,210,12,13
15039,49994,80,9515,80,2618,591,2027,11,16,6,5
15040,57832,443,1165,443,91134,7506,83628,132,130,52,80
15041,48817,36292,48817,36292,519,158,361,2,1200,1,1
15042,65507,443,3045,443,453047,13340,439707,469,16,165,304
15043,50469,443,45578,443,19063941,342071,18721870,17124,384,4119,13005
15044,49996,80,14871,80,3007,604,2403,11,15,6,5
15045,56762,443,61918,443,8005,1985,6020,20,15,11,9
15046,49730,53,34301,53,539,100,439,4,54,2,2
15047,40587,53,36507,53,271,102,169,2,30,1,1
15048,57308,53,39831,53,302,110,192,2,30,1,1
15049,62246,443,21397,443,117314,4775,112539,144,120,51,93
15050,50656,80,17387,80,318,192,126,6,25,4,2
15051,56082,53,15374,53,271,88,183,4,37,2,2
15052,49634,53,57122,53,718,94,624,2,30,1,1
15053,55040,443,2837,443,8558,1869,6689,31,236,14,17
15054,37965,63728,43778,63728,1294,594,700,20,1781,10,10
15055,56483,443,20342,443,6463,3844,2619,39,135,21,18
15056,44847,9912,37796,9912,502,150,352,2,1200,1,1
15057,50462,443,22628,443,14264,4441,9823,74,386,38,36
15058,35991,443,8225,443,2509208,64544,2444664,2429,304,700,1729
15059,41336,443,51571,443,350,210,140,6,30,4,2
15060,48854,443,38265,443,2497156,63601,2433555,2465,17,852,1613
15061,52107,11191,13712,11191,70,70,0,2,7,2,0
15062,52075,37919,16771,37919,70,70,0,1,4,1,0
15063,52074,57947,9698,57947,70,70,0,1,5,1,0
15064,9433,443,31139,443,3299,441,2858,11,15,6,5
15065,56484,443,2923,443,1857,1218,639,18,135,11,7
15066,28013,443,29765,443,6130,1264,4866,18,75,9,9
15067,53895,36849,56387,36849,70,70,0,2,7,2,0
15068,56671,80,31736,80,234,234,0,4,12,4,0
15069,52252,443,52252,443,221672,9306,212366,249,21,97,152
15070,52073,16316,63189,16316,70,70,0,1,5,1,0
15071,49995,80,2817,80,2669,604,2065,11,16,6,5
15072,49993,443,14877,443,14857,1138,13719,26,17,10,16
15073,65508,443,2648,443,92884,4939,87945,111,16,45,66
15074,34215,443,33625,443,5341,1386,3955,19,649,11,8
15075,56736,80,11534,80,194,128,66,4,25,3,1
15076,41670,80,41670,80,3571,2892,679,13,23,8,5
15077,58715,80,58715,80,5140,4161,979,17,28,10,7
15078,38130,443,8733,443,717020,36766,680254,939,60,449,490
15079,65331,53,14108,53,308,102,206,2,30,1,1
15080,64687,53,30992,53,495,109,386,4,53,2,2
15081,56734,80,64954,80,194,128,66,4,25,3,1
15082,52020,80,52020,80,6764,5555,1209,20,28,12,8
15083,46456,443,58612,443,4921,2134,2787,21,95,10,11
15084,64458,53,4904,53,292,102,190,2,30,1,1
15085,55542,53,50778,53,177,94,83,2,30,1,1
15086,65293,53,50670,53,94,94,0,1,30,1,0
15087,10075,53,26138,53,229,86,143,2,30,1,1
15088,64981,27068,50495,27068,1680,1386,294,7,30,4,3
15089,52474,123,6683,123,184,94,90,2,30,1,1
15090,65507,53,62722,53,177,94,83,2,30,1,1
15091,33694,443,52274,443,18876,16514,2362,43,95,24,19
15092,50482,443,33515,443,6904692,144860,6759832,6483,140,1783,4700
15093,56735,80,63370,80,194,128,66,4,25,3,1
15094,50650,443,2408,443,9741,7503,2238,24,32,14,10
15095,52112,53559,37444,53559,316,136,180,6,6,3,3
15096,9421,443,1496,443,5699,505,5194,14,15,7,7
15097,48970,80,48970,80,24303,4898,19405,40,28,21,19
15098,42420,443,29433,443,8616,2683,5933,30,459,15,15
15099,55019,443,26461,443,6866,1983,4883,23,330,11,12
15100,54432,53,45895,53,168,78,90,2,30,1,1
15101,38649,443,32676,443,13463,5427,8036,24,121,11,13
15102,50634,80,58631,80,25670,13514,12156,46,36,21,25
15103,56082,53,31858,53,271,88,183,4,37,2,2
15104,49997,80,20317,80,2863,604,2259,11,15,6,5
15105,44992,80,44992,80,2091,1642,449,10,20,6,4
15106,38385,443,54542,443,5304,1112,4192,19,31,10,9
15107,60439,53,58321,53,70,70,0,1,30,1,0
15108,39236,80,55447,80,190,70,120,4,16,2,2
15109,49349,443,17096,443,5282,1090,4192,17,25,10,7
15110,54503,443,54503,443,157452,26878,130574,213,214,111,102
15111,33305,443,50193,443,1067,650,417,10,73,6,4
15112,52103,7172,64684,7172,70,70,0,2,7,2,0
15113,53160,39001,43902,39001,70,70,0,1,5,1,0
15114,52071,57491,38679,57491,70,70,0,1,5,1,0
15115,58950,443,1545,443,5108,700,4408,15,15,7,8
15116,50262,443,64245,443,11220,726,10494,18,75,8,10
15117,49498,53,33432,53,211,102,109,2,30,1,1
15118,56213,53,25430,53,168,78,90,2,30,1,1
15119,56274,53,38501,53,177,94,83,2,30,1,1
15120,57903,443,20952,443,4823,708,4115,19,240,6,13
15121,47636,443,43225,443,5921,1018,4903,21,150,11,10
15122,58685,443,52844,443,165763,5072,160691,181,120,61,120
15123,57470,1073,4669,1073,402,132,270,6,1209,3,3
15124,56082,53,50090,53,271,88,183,4,38,2,2
15125,52069,53446,32796,53446,70,70,0,1,5,1,0
15126,51558,443,41569,443,254,70,184,5,22,2,3
15127,58822,443,40826,443,3594,1787,1807,31,163,17,14
15128,52250,443,52250,443,162355,8745,153610,178,22,66,112
15129,56588,443,17428,443,15450,6149,9301,106,177,47,59
15130,65359,53,37489,53,210,102,108,2,30,1,1
15131,55232,53,52840,53,177,94,83,2,30,1,1
15132,49835,53,10267,53,199,94,105,2,31,1,1
15133,53890,23310,52916,23310,70,70,0,2,8,2,0
15134,52931,443,65247,443,8519,1687,6832,29,17,16,13
15135,22274,53,9607,53,278,78,200,2,30,1,1
15136,61417,443,25149,443,652760,608740,44020,734,432,496,238
15137,44068,443,30325,443,3947,1744,2203,16,361,8,8
15138,52329,443,64562,443,294025,14919,279106,401,42,192,209
15139,42386,443,56294,443,12516,2906,9610,41,427,17,24
15140,52424,443,16403,443,10070,5084,4986,41,16,24,17
15141,60796,40010,42755,40010,316,136,180,6,7,3,3
15142,60464,11385,6156,11385,1090,712,378,16,26,10,6
15143,52099,28401,4027,28401,70,70,0,2,8,2,0
15144,52100,54130,10499,54130,70,70,0,2,8,2,0
15145,45844,80,40841,80,152,78,74,2,5,1,1
15146,33829,443,29338,443,568,222,346,9,26,4,5
15147,16057,56205,0,0,62,62,0,1,0,1,0
15148,37647,36237,0,0,62,62,0,1,0,1,0
15149,64077,25174,0,0,66,66,0,1,0,1,0
15150,63689,445,0,0,70,70,0,1,0,1,0
15151,55079,25174,0,0,66,66,0,1,0,1,0
15152,52557,44847,0,0,62,62,0,1,0,1,0
15153,63860,445,0,0,66,66,0,1,0,1,0
15154,63855,445,0,0,66,66,0,1,0,1,0
15155,63245,26296,0,0,159,159,0,1,0,1,0
15156,59587,25174,0,0,62,62,0,1,0,1,0
15157,51966,25174,0,0,62,62,0,1,0,1,0
15158,27505,25174,0,0,62,62,0,1,0,1,0
15159,61635,37965,0,0,66,66,0,1,0,1,0
15160,63685,445,0,0,70,70,0,1,0,1,0
15161,7048,25174,0,0,66,66,0,1,0,1,0
15162,52083,445,0,0,70,70,0,1,0,1,0
15163,52080,445,0,0,70,70,0,1,0,1,0
15164,52076,445,0,0,70,70,0,1,0,1,0
15165,52072,445,0,0,70,70,0,1,0,1,0
15166,63684,445,0,0,70,70,0,1,0,1,0
15167,23331,25174,0,0,62,62,0,1,0,1,0
15168,13062,52274,0,0,66,66,0,1,0,1,0
15169,63852,445,0,0,66,66,0,1,0,1,0
15170,50651,25174,0,0,146,146,0,1,0,1,0
15171,22916,25174,0,0,146,146,0,1,0,1,0
15172,63838,445,0,0,66,66,0,1,0,1,0
15173,63847,445,0,0,66,66,0,1,0,1,0
15174,63844,445,0,0,66,66,0,1,0,1,0
15175,63841,445,0,0,66,66,0,1,0,1,0
15176,63843,445,0,0,66,66,0,1,0,1,0
15177,63839,445,0,0,66,66,0,1,0,1,0
15178,63846,445,0,0,66,66,0,1,0,1,0
15179,30574,64147,0,0,62,62,0,1,0,1,0
15180,32970,64147,0,0,145,145,0,1,0,1,0
15181,63679,445,0,0,70,70,0,1,0,1,0
15182,56581,25174,0,0,146,146,0,1,0,1,0
15183,52067,445,0,0,70,70,0,1,0,1,0
15184,49415,22114,0,0,62,62,0,1,0,1,0
15185,60311,30627,0,0,66,66,0,1,0,1,0
15186,52060,445,0,0,70,70,0,1,0,1,0
15187,52063,445,0,0,70,70,0,1,0,1,0
15188,52059,445,0,0,70,70,0,1,0,1,0
15189,54666,36237,0,0,66,66,0,1,0,1,0
15190,65233,23117,0,0,66,66,0,1,0,1,0
15191,24301,6881,0,0,62,62,0,1,0,1,0
15192,57164,50584,0,0,62,62,0,1,0,1,0
15193,63213,35440,0,0,62,62,0,1,0,1,0
15194,2083,25174,0,0,146,146,0,1,0,1,0
15195,5830,22114,0,0,66,66,0,1,0,1,0
15196,31683,35440,0,0,62,62,0,1,0,1,0
15197,52056,445,0,0,70,70,0,1,0,1,0
15198,52053,445,0,0,70,70,0,1,0,1,0
15199,52052,445,0,0,70,70,0,1,0,1,0
15200,64509,9571,0,0,62,62,0,1,0,1,0
15201,63666,445,0,0,70,70,0,1,0,1,0
15202,58627,64097,0,0,66,66,0,1,0,1,0
15203,63830,445,0,0,66,66,0,1,0,1,0
15204,52050,445,0,0,70,70,0,1,0,1,0
15205,50084,26672,0,0,62,62,0,1,0,1,0
15206,63827,445,0,0,66,66,0,1,0,1,0
15207,35657,48637,0,0,62,62,0,1,0,1,0
15208,63663,445,0,0,70,70,0,1,0,1,0
15209,63826,445,0,0,66,66,0,1,0,1,0
15210,63824,445,0,0,66,66,0,1,0,1,0
15211,36679,41864,0,0,148,148,0,1,0,1,0
15212,12527,50584,0,0,62,62,0,1,0,1,0
15213,63823,445,0,0,66,66,0,1,0,1,0
15214,47943,50584,0,0,74,74,0,1,0,1,0
15215,62550,51505,0,0,66,66,0,1,0,1,0
15216,55199,21247,0,0,62,62,0,1,0,1,0
15217,52045,445,0,0,70,70,0,1,0,1,0
15218,63658,445,0,0,70,70,0,1,0,1,0
15219,21606,80,0,0,60,60,0,1,0,1,0
15220,63657,445,0,0,70,70,0,1,0,1,0
15221,52039,445,0,0,70,70,0,1,0,1,0
15222,52036,445,0,0,70,70,0,1,0,1,0
15223,38755,22114,0,0,66,66,0,1,0,1,0
15224,63655,445,0,0,70,70,0,1,0,1,0
15225,55144,30188,0,0,66,66,0,1,0,1,0
15226,63811,445,0,0,66,66,0,1,0,1,0
15227,27995,22114,0,0,62,62,0,1,0,1,0
15228,2427,25174,0,0,62,62,0,1,0,1,0
15229,61382,25174,0,0,66,66,0,1,0,1,0
15230,17097,62413,0,0,62,62,0,1,0,1,0
15231,1074,25174,0,0,146,146,0,1,0,1,0
15232,47910,7454,0,0,60,60,0,1,0,1,0
15233,4706,36237,0,0,146,146,0,1,0,1,0
15234,443,38956,0,0,82,82,0,1,0,1,0
15235,17280,22114,0,0,146,146,0,1,0,1,0
15236,63804,445,0,0,66,66,0,1,0,1,0
15237,52024,445,0,0,70,70,0,1,0,1,0
15238,57860,23,0,0,60,60,0,1,0,1,0
15239,63648,445,0,0,70,70,0,1,0,1,0
15240,45682,37965,0,0,145,145,0,1,0,1,0
15241,52492,37965,0,0,66,66,0,1,0,1,0
15242,63832,25174,0,0,62,62,0,1,0,1,0
15243,0,0,0,0,244,244,0,2,0,2,0
15244,63646,445,0,0,70,70,0,1,0,1,0
15245,55116,7574,0,0,66,66,0,1,0,1,0
15246,5222,27389,0,0,66,66,0,1,0,1,0
15247,63802,445,0,0,66,66,0,1,0,1,0
15248,63645,445,0,0,70,70,0,1,0,1,0
15249,27110,22114,0,0,62,62,0,1,0,1,0
15250,33359,30188,0,0,62,62,0,1,0,1,0
15251,63644,445,0,0,70,70,0,1,0,1,0
15252,63643,445,0,0,70,70,0,1,0,1,0
15253,63640,445,0,0,70,70,0,1,0,1,0
15254,63639,445,0,0,70,70,0,1,0,1,0
15255,7000,23117,0,0,62,62,0,1,0,1,0
15256,63795,445,0,0,66,66,0,1,0,1,0
15257,54618,5900,0,0,60,60,0,1,0,1,0
15258,21542,57470,0,0,74,74,0,1,0,1,0
15259,63787,445,0,0,66,66,0,1,0,1,0
15260,14438,51505,0,0,146,146,0,1,0,1,0
15261,41210,23,0,0,60,60,0,1,0,1,0
15262,11876,22,0,0,60,60,0,1,0,1,0
15263,32132,25174,0,0,66,66,0,1,0,1,0
15264,63625,445,0,0,70,70,0,1,0,1,0
15265,63624,445,0,0,70,70,0,1,0,1,0
15266,63621,445,0,0,70,70,0,1,0,1,0
15267,33886,52255,0,0,162,162,0,1,0,1,0
15268,63614,445,0,0,70,70,0,1,0,1,0
15269,63615,445,0,0,70,70,0,1,0,1,0
15270,42344,48637,0,0,60,60,0,1,0,1,0
15271,27038,51505,0,0,62,62,0,1,0,1,0
15272,26531,25174,0,0,62,62,0,1,0,1,0
15273,26531,37965,0,0,62,62,0,1,0,1,0
15274,51755,5900,0,0,60,60,0,1,0,1,0
15275,52014,445,0,0,70,70,0,1,0,1,0
15276,52012,445,0,0,70,70,0,1,0,1,0
15277,52010,445,0,0,70,70,0,1,0,1,0
15278,57337,64147,0,0,66,66,0,1,0,1,0
15279,2074,32480,0,0,146,146,0,1,0,1,0
15280,63775,445,0,0,66,66,0,1,0,1,0
15281,63771,445,0,0,66,66,0,1,0,1,0
15282,63778,445,0,0,66,66,0,1,0,1,0
15283,63776,445,0,0,66,66,0,1,0,1,0
15284,63779,445,0,0,66,66,0,1,0,1,0
15285,63772,445,0,0,66,66,0,1,0,1,0
15286,63773,445,0,0,66,66,0,1,0,1,0
15287,63777,445,0,0,66,66,0,1,0,1,0
15288,51413,1,0,0,72,72,0,1,0,1,0
15289,54140,17372,0,0,66,66,0,1,0,1,0
15290,47040,25174,0,0,62,62,0,1,0,1,0
15291,63603,445,0,0,70,70,0,1,0,1,0
15292,34932,38608,0,0,62,62,0,1,0,1,0
15293,18086,25174,0,0,62,62,0,1,0,1,0
15294,54280,3396,0,0,60,60,0,1,0,1,0
15295,25871,53,25871,53,266,72,194,2,30,1,1
15296,39186,53,39186,53,371,237,134,3,33,2,1
15297,35201,443,64123,443,291,171,120,4,15,2,2
15298,50729,443,32293,443,10440,3521,6919,42,119,20,22
15299,56354,53,56354,53,214,97,117,2,30,1,1
15300,37906,443,56891,443,11293,3979,7314,29,125,17,12
15301,50727,443,38985,443,26161,3618,22543,80,119,31,49
15302,49665,53,35069,53,168,86,82,2,32,1,1
15303,60480,60519,7495,60519,320,140,180,6,8,3,3
15304,49206,443,56721,443,7875,1817,6058,41,255,19,22
15305,50598,80,50598,80,10463,6606,3857,36,27,20,16
15306,61509,443,47638,443,1506,984,522,14,27,8,6
15307,50574,80,15293,80,61763,2941,58822,75,135,33,42
15308,26852,443,37860,443,6701,2064,4637,19,19,9,10
15309,59652,443,50919,443,562,562,0,4,175,4,0
15310,38019,443,55149,443,884,464,420,13,28,7,6
15311,55014,443,4277,443,4962,1352,3610,19,135,9,10
15312,65003,27046,30438,27046,1749,924,825,6,31,3,3
15313,56303,53,13622,53,170,87,83,2,30,1,1
15314,61964,443,61964,443,4378,1471,2907,19,30,11,8
15315,58997,443,39971,443,3576,2319,1257,21,23,11,10
15316,64455,53,64455,53,257,101,156,2,33,1,1
15317,50602,80,50602,80,7596,5063,2533,28,27,16,12
15318,28557,53,28557,53,213,79,134,2,32,1,1
15319,49104,443,34299,443,7424,2381,5043,24,18,13,11
15320,60479,53928,50197,53928,70,70,0,2,8,2,0
15321,50305,443,11776,443,3325,1851,1474,19,16,9,10
15322,60481,40075,5787,40075,70,70,0,2,8,2,0
15323,64343,53,64343,53,216,98,118,2,30,1,1
15324,53858,6889,25438,6889,372,186,186,6,16,3,3
15325,44319,443,43736,443,13919,3349,10570,46,120,25,21
15326,53893,11344,37839,11344,70,70,0,2,8,2,0
15327,53860,33791,1451,33791,492,306,186,8,16,5,3
15328,40650,443,51106,443,7298,2661,4637,21,17,11,10
15329,65047,53,45819,53,206,91,115,2,30,1,1
15330,58999,443,30350,443,2687,1593,1094,20,20,11,9
15331,57870,7635,57870,7635,138,78,60,2,6,1,1
15332,49357,80,5006,80,3014,1052,1962,14,97,9,5
15333,52866,443,59183,443,3101,801,2300,13,136,6,7
15334,56737,53,36153,53,817,98,719,2,31,1,1
15335,63917,443,22910,443,9043,5948,3095,31,121,15,16
15336,35719,443,27839,443,9736,4347,5389,23,361,11,12
15337,65165,53,27998,53,783,96,687,2,31,1,1
15338,55193,53,60056,53,170,87,83,2,31,1,1
15339,63294,443,54054,443,9929,4574,5355,29,134,14,15
15340,59786,25174,0,0,62,62,0,1,0,1,0
15341,45202,23,0,0,60,60,0,1,0,1,0
15342,18086,25174,0,0,146,146,0,1,0,1,0
15343,52007,445,0,0,70,70,0,1,0,1,0
15344,52006,445,0,0,70,70,0,1,0,1,0
15345,52001,445,0,0,70,70,0,1,0,1,0
15346,51998,445,0,0,70,70,0,1,0,1,0
15347,54473,37807,0,0,66,66,0,1,0,1,0
15348,63599,445,0,0,70,70,0,1,0,1,0
15349,63756,445,0,0,66,66,0,1,0,1,0
15350,63758,445,0,0,66,66,0,1,0,1,0
15351,63755,445,0,0,66,66,0,1,0,1,0
15352,60954,443,45270,443,62583,3743,58840,88,32,40,48
15353,9230,443,20303,443,6020,792,5228,18,25,9,9
15354,64814,53,31747,53,565,215,350,6,37,3,3
15355,21424,53,21424,53,225,90,135,2,29,1,1
15356,59985,443,35984,443,55132,17147,37985,126,150,55,71
15357,57131,35776,0,0,145,145,0,1,0,1,0
15358,48676,53389,0,0,60,60,0,1,0,1,0
15359,38581,22114,0,0,62,62,0,1,0,1,0
15360,38581,22114,0,0,146,146,0,1,0,1,0
15361,35937,25174,0,0,66,66,0,1,0,1,0
15362,63588,445,0,0,70,70,0,1,0,1,0
15363,63589,445,0,0,70,70,0,1,0,1,0
15364,63590,445,0,0,70,70,0,1,0,1,0
15365,57220,26467,0,0,62,62,0,1,0,1,0
15366,62512,25174,0,0,62,62,0,1,0,1,0
15367,63584,445,0,0,70,70,0,1,0,1,0
15368,63582,445,0,0,70,70,0,1,0,1,0
15369,2062,35440,0,0,66,66,0,1,0,1,0
15370,51985,445,0,0,70,70,0,1,0,1,0
15371,51984,445,0,0,70,70,0,1,0,1,0
15372,51981,445,0,0,70,70,0,1,0,1,0
15373,11228,25174,0,0,66,66,0,1,0,1,0
15374,10547,57470,0,0,62,62,0,1,0,1,0
15375,65212,22114,0,0,146,146,0,1,0,1,0
15376,55678,32468,0,0,66,66,0,1,0,1,0
15377,29471,57470,0,0,145,145,0,1,0,1,0
15378,63576,445,0,0,70,70,0,1,0,1,0
15379,28385,50584,0,0,62,62,0,1,0,1,0
15380,25565,51337,0,0,60,60,0,1,0,1,0
15381,34112,44847,0,0,66,66,0,1,0,1,0
15382,9552,57470,0,0,66,66,0,1,0,1,0
15383,51973,445,0,0,70,70,0,1,0,1,0
15384,51972,445,0,0,70,70,0,1,0,1,0
15385,51968,445,0,0,70,70,0,1,0,1,0
15386,51578,44847,0,0,66,66,0,1,0,1,0
15387,63745,445,0,0,66,66,0,1,0,1,0
15388,63569,445,0,0,70,70,0,1,0,1,0
15389,44612,25174,0,0,66,66,0,1,0,1,0
15390,5213,44847,0,0,66,66,0,1,0,1,0
15391,63567,445,0,0,70,70,0,1,0,1,0
15392,45944,44847,0,0,146,146,0,1,0,1,0
15393,12531,22114,0,0,62,62,0,1,0,1,0
15394,23658,18375,0,0,62,62,0,1,0,1,0
15395,44919,26467,0,0,62,62,0,1,0,1,0
15396,55451,56205,0,0,66,66,0,1,0,1,0
15397,44334,26467,0,0,62,62,0,1,0,1,0
15398,11136,15503,0,0,62,62,0,1,0,1,0
15399,11136,15503,0,0,62,62,0,1,0,1,0
15400,65231,50584,0,0,66,66,0,1,0,1,0
15401,12841,37965,0,0,62,62,0,1,0,1,0
15402,54684,37965,0,0,62,62,0,1,0,1,0
15403,36034,35440,0,0,146,146,0,1,0,1,0
15404,63562,445,0,0,70,70,0,1,0,1,0
15405,60957,443,56619,443,68539,4175,64364,98,32,46,52
15406,48852,443,7799,443,38886,2134,36752,55,16,24,31
15407,50724,443,48529,443,12515,5891,6624,42,166,22,20
15408,57231,53,2071,53,168,86,82,2,31,1,1
15409,38140,443,44966,443,82608,3591,79017,101,15,39,62
15410,56761,443,28881,443,8057,2037,6020,20,15,11,9
15411,50605,80,50605,80,2909,1798,1111,14,23,8,6
15412,56274,53,29071,53,177,94,83,2,29,1,1
15413,58094,53,1806,53,249,102,147,2,29,1,1
15414,49278,80,1561,80,254,128,126,5,16,3,2
15415,60477,30889,55230,30889,70,70,0,2,8,2,0
15416,52067,46837,56641,46837,70,70,0,1,5,1,0
15417,2844,3389,2844,3389,4635,2460,2175,21,18,12,9
15418,51523,443,27460,443,4045,765,3280,11,45,5,6
15419,53135,80,21609,80,2959,610,2349,12,15,6,6
15420,51979,443,5164,443,11555,2620,8935,45,822,18,27
15421,38474,443,30004,443,53562,2314,51248,64,31,24,40
15422,53857,22796,40353,22796,492,306,186,8,15,5,3
15423,52096,55854,2133,55854,70,70,0,2,7,2,0
15424,38664,443,9528,443,6887,1076,5811,22,50,12,10
15425,54061,443,17849,443,126027,103934,22093,380,239,237,143
15426,49944,53,58340,53,334,90,244,4,38,2,2
15427,56387,443,8980,443,9569,2225,7344,28,15,15,13
15428,45565,443,30523,443,1784491,72960,1711531,1872,113,687,1185
15429,56760,443,12477,443,8006,1986,6020,20,15,11,9
15430,52094,443,49643,443,3296065,47110,3248955,2746,51,533,2213
15431,61660,443,61660,443,18829,1995,16834,33,17,17,16
15432,18333,53,18333,53,215,98,117,2,30,1,1
15433,53853,39723,8770,39723,1890,1010,880,13,16,8,5
15434,64708,53,37304,53,437,89,348,4,48,2,2
15435,49228,53,52033,53,209,110,99,2,30,1,1
15436,37625,443,14545,443,7766,1810,5956,24,46,14,10
15437,37628,443,37587,443,5783,1761,4022,24,46,14,10
15438,46310,443,24043,443,172,172,0,2,5,2,0
15439,53124,443,13902,443,7459,2962,4497,24,47,14,10
15440,58443,443,26143,443,12060,3749,8311,42,17,23,19
15441,64341,53,61484,53,355,118,237,2,30,1,1
15442,61155,443,61155,443,4575,1668,2907,19,27,11,8
15443,45020,443,16879,443,2293,1592,701,16,21,8,8
15444,55669,53,24694,53,195,94,101,2,30,1,1
15445,42305,443,8617,443,1262512,53286,1209226,1457,280,548,909
15446,51283,443,17367,443,638,292,346,10,28,5,5
15447,50597,80,50597,80,16296,9143,7153,48,27,26,22
15448,55697,14795,5674,14795,564,318,246,9,15,5,4
15449,49566,443,56246,443,2888,1389,1499,18,15,9,9
15450,51559,443,32426,443,254,70,184,5,21,2,3
15451,52097,23279,3582,23279,70,70,0,2,7,2,0
15452,52249,443,52249,443,152755,7304,145451,171,21,65,106
15453,50728,443,61192,443,34661,17810,16851,89,119,40,49
15454,65344,53,8855,53,180,94,86,2,35,1,1
15455,37622,443,52437,443,12542,2527,10015,31,48,18,13
15456,18749,53,18749,53,370,238,132,3,32,2,1
15457,52098,29067,36738,29067,70,70,0,2,7,2,0
15458,56303,53,31666,53,177,94,83,2,30,1,1
15459,18331,53,15455,53,376,94,282,2,30,1,1
15460,64996,27034,9075,27034,1761,924,837,6,30,3,3
15461,49631,53,6299,53,198,102,96,2,33,1,1
15462,49362,443,33824,443,9551,6129,3422,35,47,19,16
15463,55232,53,34536,53,177,94,83,2,29,1,1
15464,44720,53,0,0,86,86,0,1,29,1,0
15465,65224,53,29187,53,232,110,122,2,30,1,1
15466,49665,53,15025,53,168,86,82,2,29,1,1
15467,56303,53,55286,53,177,94,83,2,30,1,1
15468,56557,443,11082,443,36053,3513,32540,54,96,25,29
15469,40662,53,39686,53,223,78,145,2,30,1,1
15470,55223,1053,57960,1053,1210,950,260,2,30,1,1
15471,52422,443,1583,443,1043,556,487,10,15,6,4
15472,60476,55100,21039,55100,70,70,0,2,8,2,0
15473,52066,60118,49058,60118,70,70,0,1,5,1,0
15474,36499,443,51972,443,1159756,1123031,36725,1206,26,753,453
15475,49527,53,63553,53,415,98,317,4,51,2,2
15476,11816,53,11816,53,240,98,142,2,30,1,1
15477,51971,53,51971,53,240,98,142,2,30,1,1
15478,49824,53,50073,53,198,94,104,2,30,1,1
15479,51912,443,41941,443,186,70,116,2,120,1,1
15480,58867,443,37875,443,16230,11127,5103,69,330,34,35
15481,60575,80,18847,80,9034,1860,7174,17,16,8,9
15482,55454,53,64127,53,168,86,82,2,32,1,1
15483,64249,53,6288,53,181,94,87,2,33,1,1
15484,52068,39864,30686,39864,70,70,0,1,5,1,0
15485,59282,443,30587,443,5413,968,4445,20,15,11,9
15486,37621,443,45461,443,27993,2483,25510,51,48,25,26
15487,37600,443,40571,443,19917,8751,11166,51,56,32,19
15488,65071,53,53845,53,411,99,312,4,52,2,2
15489,49819,53,24234,53,94,94,0,1,30,1,0
15490,59189,53,53487,53,222,94,128,2,30,1,1
15491,51944,53,51944,53,832,106,726,2,30,1,1
15492,60986,443,43448,443,7231,2305,4926,32,40,18,14
15493,56759,443,10401,443,8058,2038,6020,20,15,11,9
15494,37626,443,10434,443,7766,1810,5956,24,46,14,10
15495,55133,53,55133,53,228,90,138,2,30,1,1
15496,52854,53,0,0,86,86,0,1,30,1,0
15497,52018,53,53682,53,164,78,86,2,30,1,1
15498,36661,53,19439,53,164,78,86,2,31,1,1
15499,42306,443,42899,443,449862,38989,410873,644,280,286,358
15500,42308,443,54120,443,433261,34730,398531,604,279,258,346
15501,6881,61404,13734,61404,228,118,110,2,1200,1,1
15502,55868,53,18445,53,177,94,83,2,30,1,1
15503,48020,443,61756,443,33481,5635,27846,73,287,32,41
15504,64651,443,22018,443,317618,11688,305930,350,164,118,232
15505,55319,443,12527,443,6210,2720,3490,15,121,7,8
15506,57470,61467,29646,61467,479,150,329,2,1199,1,1
15507,37965,6881,46281,6881,479,150,329,2,1199,1,1
15508,65128,443,26680,443,3055,1759,1296,22,126,12,10
15509,53126,443,58223,443,11811,4242,7569,27,46,15,12
15510,49705,80,19257,80,2733,591,2142,11,45,6,5
15511,25295,53,30242,53,200,94,106,2,30,1,1
15512,53581,53,57842,53,231,94,137,2,30,1,1
15513,33053,53,52435,53,164,78,86,2,31,1,1
15514,56758,443,1030,443,8005,1985,6020,20,16,11,9
15515,53888,39204,30742,39204,70,70,0,2,8,2,0
15516,49767,53,4502,53,177,94,83,2,30,1,1
15517,49562,53,28687,53,198,94,104,2,30,1,1
15518,64030,53,24656,53,338,110,228,2,30,1,1
15519,51965,445,0,0,70,70,0,1,0,1,0
15520,53640,25174,0,0,62,62,0,1,0,1,0
15521,63561,445,0,0,70,70,0,1,0,1,0
15522,31235,22114,0,0,62,62,0,1,0,1,0
15523,51963,445,0,0,70,70,0,1,0,1,0
15524,39110,50584,0,0,62,62,0,1,0,1,0
15525,40481,22114,0,0,66,66,0,1,0,1,0
15526,22439,25174,0,0,66,66,0,1,0,1,0
15527,26235,37965,0,0,66,66,0,1,0,1,0
15528,1865,25174,0,0,62,62,0,1,0,1,0
15529,63557,445,0,0,70,70,0,1,0,1,0
15530,63731,445,0,0,66,66,0,1,0,1,0
15531,63726,445,0,0,66,66,0,1,0,1,0
15532,48706,23393,0,0,60,60,0,1,0,1,0
15533,44674,25174,0,0,62,62,0,1,0,1,0
15534,43207,26467,0,0,62,62,0,1,0,1,0
15535,63556,445,0,0,70,70,0,1,0,1,0
15536,51042,22114,0,0,66,66,0,1,0,1,0
15537,51948,445,0,0,70,70,0,1,0,1,0
15538,51946,445,0,0,70,70,0,1,0,1,0
15539,51944,445,0,0,70,70,0,1,0,1,0
15540,51945,445,0,0,70,70,0,1,0,1,0
15541,1111,25174,0,0,62,62,0,1,0,1,0
15542,6843,42873,0,0,62,62,0,1,0,1,0
15543,63724,445,0,0,66,66,0,1,0,1,0
15544,2083,25174,0,0,62,62,0,1,0,1,0
15545,42030,25,0,0,74,74,0,1,0,1,0
15546,51479,25174,0,0,62,62,0,1,0,1,0
15547,63551,445,0,0,70,70,0,1,0,1,0
15548,42632,44847,0,0,146,146,0,1,0,1,0
15549,54142,20541,0,0,66,66,0,1,0,1,0
15550,63715,445,0,0,66,66,0,1,0,1,0
15551,63713,445,0,0,66,66,0,1,0,1,0
15552,63712,445,0,0,66,66,0,1,0,1,0
15553,63717,445,0,0,66,66,0,1,0,1,0
15554,63719,445,0,0,66,66,0,1,0,1,0
15555,63711,445,0,0,66,66,0,1,0,1,0
15556,63708,445,0,0,66,66,0,1,0,1,0
15557,51706,25174,0,0,66,66,0,1,0,1,0
15558,51938,445,0,0,70,70,0,1,0,1,0
15559,443,38956,0,0,82,82,0,1,0,1,0
15560,51935,445,0,0,70,70,0,1,0,1,0
15561,51932,445,0,0,70,70,0,1,0,1,0
15562,51931,445,0,0,70,70,0,1,0,1,0
15563,50328,22114,0,0,66,66,0,1,0,1,0
15564,62489,23117,0,0,62,62,0,1,0,1,0
15565,55508,64147,0,0,62,62,0,1,0,1,0
15566,64587,43890,0,0,66,66,0,1,0,1,0
15567,25207,48817,0,0,62,62,0,1,0,1,0
15568,54236,36829,0,0,66,66,0,1,0,1,0
15569,55570,44847,0,0,62,62,0,1,0,1,0
15570,1620,53567,0,0,66,66,0,1,0,1,0
15571,55012,25174,0,0,66,66,0,1,0,1,0
15572,56676,37965,0,0,62,62,0,1,0,1,0
15573,63538,445,0,0,70,70,0,1,0,1,0
15574,51930,445,0,0,70,70,0,1,0,1,0
15575,51928,445,0,0,70,70,0,1,0,1,0
15576,51927,445,0,0,70,70,0,1,0,1,0
15577,65025,57866,0,0,66,66,0,1,0,1,0
15578,50052,65008,0,0,60,60,0,1,0,1,0
15579,61643,22114,0,0,62,62,0,1,0,1,0
15580,63702,445,0,0,66,66,0,1,0,1,0
15581,51922,445,0,0,70,70,0,1,0,1,0
15582,63535,445,0,0,70,70,0,1,0,1,0
15583,54121,25174,0,0,62,62,0,1,0,1,0
15584,1114,37965,0,0,62,62,0,1,0,1,0
15585,11878,37807,0,0,62,62,0,1,0,1,0
15586,63699,445,0,0,66,66,0,1,0,1,0
15587,55341,39004,0,0,74,74,0,1,0,1,0
15588,63696,445,0,0,66,66,0,1,0,1,0
15589,63695,445,0,0,66,66,0,1,0,1,0
15590,54373,26467,0,0,62,62,0,1,0,1,0
15591,63694,445,0,0,66,66,0,1,0,1,0
15592,22574,44847,0,0,62,62,0,1,0,1,0
15593,30304,26467,0,0,62,62,0,1,0,1,0
15594,63531,445,0,0,70,70,0,1,0,1,0
15595,63529,445,0,0,70,70,0,1,0,1,0
15596,51918,445,0,0,70,70,0,1,0,1,0
15597,0,0,0,0,200,102,98,2,0,1,1
15598,63527,445,0,0,70,70,0,1,0,1,0
15599,51904,445,0,0,70,70,0,1,0,1,0
15600,47913,25174,0,0,62,62,0,1,0,1,0
15601,28192,50584,0,0,66,66,0,1,0,1,0
15602,60058,25174,0,0,66,66,0,1,0,1,0
15603,63683,445,0,0,66,66,0,1,0,1,0
15604,62097,57470,0,0,146,146,0,1,0,1,0
15605,34914,26467,0,0,62,62,0,1,0,1,0
15606,22948,26467,0,0,62,62,0,1,0,1,0
15607,56872,21247,0,0,74,74,0,1,0,1,0
15608,63520,445,0,0,70,70,0,1,0,1,0
15609,63675,445,0,0,66,66,0,1,0,1,0
15610,63518,445,0,0,70,70,0,1,0,1,0
15611,51894,445,0,0,70,70,0,1,0,1,0
15612,53097,25174,0,0,66,66,0,1,0,1,0
15613,42344,48637,0,0,60,60,0,1,0,1,0
15614,56387,25174,0,0,66,66,0,1,0,1,0
15615,63517,445,0,0,70,70,0,1,0,1,0
15616,63516,445,0,0,70,70,0,1,0,1,0
15617,49514,52255,0,0,162,162,0,1,0,1,0
15618,63515,445,0,0,70,70,0,1,0,1,0
15619,63672,445,0,0,66,66,0,1,0,1,0
15620,54883,60043,0,0,62,62,0,1,0,1,0
15621,63509,445,0,0,70,70,0,1,0,1,0
15622,63510,445,0,0,70,70,0,1,0,1,0
15623,62189,64147,0,0,62,62,0,1,0,1,0
15624,57991,22114,0,0,66,66,0,1,0,1,0
15625,19875,30170,0,0,145,145,0,1,0,1,0
15626,54578,26467,0,0,66,66,0,1,0,1,0
15627,443,38956,0,0,82,82,0,1,0,1,0
15628,49752,50584,0,0,62,62,0,1,0,1,0
15629,51490,30228,0,0,100,100,0,1,0,1,0
15630,6842,42873,0,0,66,66,0,1,0,1,0
15631,17947,36237,0,0,62,62,0,1,0,1,0
15632,64036,23718,0,0,62,62,0,1,0,1,0
15633,63666,445,0,0,66,66,0,1,0,1,0
15634,63595,51050,0,0,62,62,0,1,0,1,0
15635,18683,26467,0,0,62,62,0,1,0,1,0
15636,63497,445,0,0,70,70,0,1,0,1,0
15637,63495,445,0,0,70,70,0,1,0,1,0
15638,63658,445,0,0,66,66,0,1,0,1,0
15639,63494,445,0,0,70,70,0,1,0,1,0
15640,22408,22114,0,0,62,62,0,1,0,1,0
15641,63487,445,0,0,70,70,0,1,0,1,0
15642,63486,445,0,0,70,70,0,1,0,1,0
15643,38018,443,11782,443,1851,1222,629,16,27,10,6
15644,57578,80,57578,80,55886,2728,53158,68,148,25,43
15645,27179,53,27179,53,398,255,143,3,34,2,1
15646,61572,53,61572,53,213,79,134,2,33,1,1
15647,1485,53,1485,53,194,87,107,2,30,1,1
15648,49767,53,37135,53,170,87,83,2,30,1,1
15649,52094,55986,52536,55986,70,70,0,2,8,2,0
15650,38857,443,38857,443,115031,5628,109403,143,104,55,88
15651,51410,443,1294,443,619870,220857,399013,1045,123,531,514
15652,58946,443,24412,443,3990,2586,1404,17,16,9,8
15653,50400,443,40237,443,316,136,180,6,6,3,3
15654,2527,53,2527,53,371,237,134,3,34,2,1
15655,21772,443,21772,443,17221,1314,15907,31,44,16,15
15656,38860,443,38860,443,15584,2721,12863,44,103,21,23
15657,57749,15000,61462,15000,130,70,60,2,6,1,1
15658,35717,443,25554,443,8290,2954,5336,24,361,13,11
15659,38862,443,38862,443,23553,2583,20970,46,103,19,27
15660,52095,48896,12899,48896,70,70,0,2,8,2,0
15661,56324,53,56324,53,257,101,156,2,34,1,1
15662,38140,443,56534,443,11484,3842,7642,30,31,16,14
15663,38858,443,38858,443,226465,10306,216159,292,104,135,157
15664,60415,53,60415,53,257,101,156,2,33,1,1
15665,59812,443,39961,443,6412,1530,4882,24,255,11,13
15666,58943,443,29236,443,6611,4273,2338,22,17,11,11
15667,62044,443,20776,443,10530,2001,8529,29,47,14,15
15668,57577,80,57577,80,172548,4355,168193,172,148,53,119
15669,48150,443,17947,443,502,222,280,8,28,4,4
15670,29226,80,29226,80,490,264,226,8,35,5,3
15671,50868,443,26459,443,7646,1697,5949,31,271,15,16
15672,54776,443,51403,443,9501,1502,7999,24,29,13,11
15673,55698,45710,57579,45710,70,70,0,1,5,1,0
15674,54774,443,8128,443,9501,1502,7999,24,29,13,11
15675,40196,443,61662,443,24750,1845,22905,39,171,17,22
15676,55216,443,23383,443,8058,5498,2560,20,120,11,9
15677,54775,443,48406,443,9501,1502,7999,24,29,13,11
15678,51762,443,40334,443,5048,2345,2703,13,121,7,6
15679,55038,443,38606,443,30239,8906,21333,61,32,34,27
15680,58994,443,55812,443,3284,1878,1406,20,27,11,9
15681,49749,80,64733,80,230959,4381,226578,217,91,60,157
15682,56705,53,36648,53,711,87,624,2,30,1,1
15683,55854,443,29147,443,3387,1672,1715,24,270,11,13
15684,42378,443,63662,443,1970,1231,739,14,30,8,6
15685,58987,443,9430,443,3730,2378,1352,23,28,12,11
15686,41882,443,10450,443,7218,4166,3052,38,133,19,19
15687,64913,53,45280,53,188,96,92,2,30,1,1
15688,56285,53,40728,53,711,87,624,2,30,1,1
15689,49420,53,3179,53,170,87,83,2,31,1,1
15690,30960,45762,15257,45762,330,330,0,6,3609,6,0
15691,57051,53,63796,53,783,96,687,2,30,1,1
15692,55423,53,61643,53,711,87,624,2,31,1,1
15693,38049,53,38049,53,213,87,126,2,31,1,1
15694,65388,53,55189,53,764,99,665,2,31,1,1
15695,40549,443,33434,443,5591,3194,2397,16,122,8,8
15696,4483,53,4483,53,213,87,126,2,31,1,1
15697,44274,53,0,0,82,82,0,1,31,1,0
15698,60432,443,46333,443,4355,2135,2220,15,136,7,8
15699,57978,5228,59102,5228,2725,1610,1115,20,3600,10,10
15700,59360,53,6794,53,429,116,313,2,31,1,1
15701,49676,53,60800,53,322,110,212,4,31,2,2
15702,55897,53,62688,53,711,87,624,2,31,1,1
15703,50280,53,20623,53,916,86,830,2,31,1,1
15704,54691,443,33638,443,4851,1269,3582,21,148,9,12
15705,48817,1024,48817,1024,152,152,0,1,1200,1,0
15706,40204,40001,61401,40001,244,181,63,2,31,1,1
15707,48817,32794,48817,32794,152,152,0,1,1200,1,0
15708,61660,64097,0,0,62,62,0,1,0,1,0
15709,15806,11392,0,0,66,66,0,1,0,1,0
15710,55600,22,0,0,60,60,0,1,0,1,0
15711,55167,48817,0,0,66,66,0,1,0,1,0
15712,31609,26296,0,0,148,148,0,1,0,1,0
15713,4019,50584,0,0,66,66,0,1,0,1,0
15714,9836,22114,0,0,62,62,0,1,0,1,0
15715,51887,445,0,0,70,70,0,1,0,1,0
15716,51885,445,0,0,70,70,0,1,0,1,0
15717,51882,445,0,0,70,70,0,1,0,1,0
15718,59282,51050,0,0,66,66,0,1,0,1,0
15719,63646,445,0,0,66,66,0,1,0,1,0
15720,56755,443,40162,443,8059,2039,6020,20,15,11,9
15721,63644,445,0,0,66,66,0,1,0,1,0
15722,63645,445,0,0,66,66,0,1,0,1,0
15723,63647,445,0,0,66,66,0,1,0,1,0
15724,63643,445,0,0,66,66,0,1,0,1,0
15725,63642,445,0,0,66,66,0,1,0,1,0
15726,63649,445,0,0,66,66,0,1,0,1,0
15727,63641,445,0,0,66,66,0,1,0,1,0
15728,26884,37965,0,0,66,66,0,1,0,1,0
15729,6828,64322,0,0,60,60,0,1,0,1,0
15730,26879,37965,0,0,62,62,0,1,0,1,0
15731,51490,17500,0,0,100,100,0,1,0,1,0
15732,42231,57470,0,0,78,78,0,1,0,1,0
15733,63475,445,0,0,70,70,0,1,0,1,0
15734,55408,64147,0,0,66,66,0,1,0,1,0
15735,60113,22114,0,0,66,66,0,1,0,1,0
15736,63741,50584,0,0,66,66,0,1,0,1,0
15737,59303,21247,0,0,66,66,0,1,0,1,0
15738,61550,5529,0,0,145,145,0,1,0,1,0
15739,54021,25174,0,0,62,62,0,1,0,1,0
15740,16620,25174,0,0,62,62,0,1,0,1,0
15741,45169,14037,0,0,74,74,0,1,0,1,0
15742,443,38956,0,0,82,82,0,1,0,1,0
15743,13294,64147,0,0,145,145,0,1,0,1,0
15744,45535,25174,0,0,66,66,0,1,0,1,0
15745,13525,51505,0,0,62,62,0,1,0,1,0
15746,10949,22114,0,0,62,62,0,1,0,1,0
15747,57369,1433,0,0,60,60,0,1,0,1,0
15748,59209,25174,0,0,62,62,0,1,0,1,0
15749,51490,57587,0,0,100,100,0,1,0,1,0
15750,51880,445,0,0,70,70,0,1,0,1,0
15751,51879,445,0,0,70,70,0,1,0,1,0
15752,51877,445,0,0,70,70,0,1,0,1,0
15753,51866,445,0,0,70,70,0,1,0,1,0
15754,63471,445,0,0,70,70,0,1,0,1,0
15755,51490,50432,0,0,100,100,0,1,0,1,0
15756,49694,5900,0,0,60,60,0,1,0,1,0
15757,51728,44847,0,0,66,66,0,1,0,1,0
15758,50052,65010,0,0,60,60,0,1,0,1,0
15759,63628,445,0,0,66,66,0,1,0,1,0
15760,63627,445,0,0,66,66,0,1,0,1,0
15761,63626,445,0,0,66,66,0,1,0,1,0
15762,35626,22114,0,0,66,66,0,1,0,1,0
15763,60885,443,31610,443,887,542,345,11,15,6,5
15764,50895,80,56986,80,9046,1139,7907,20,255,11,9
15765,60849,80,64699,80,9729,876,8853,21,45,11,10
15766,53859,34334,7486,34334,492,306,186,8,14,5,3
15767,55868,53,41641,53,177,94,83,2,29,1,1
15768,56741,443,24400,443,9868,2027,7841,24,20,12,12
15769,38861,443,38861,443,90303,5838,84465,140,103,68,72
15770,9418,443,37541,443,5691,503,5188,14,15,7,7
15771,34495,80,62171,80,1026,417,609,7,19,5,2
15772,60480,80,35551,80,7406,1038,6368,18,16,10,8
15773,49193,443,7514,443,3283,665,2618,16,160,7,9
15774,55700,26957,33294,26957,70,70,0,2,8,2,0
15775,56670,80,44971,80,234,234,0,4,12,4,0
15776,58894,443,4103,443,152,86,66,2,4,1,1
15777,55695,28182,59050,28182,504,318,186,8,16,5,3
15778,65129,443,48258,443,1765,1126,639,17,125,10,7
15779,57587,80,57587,80,218150,5323,212827,218,145,69,149
15780,56303,53,63690,53,177,94,83,2,29,1,1
15781,49704,80,54649,80,2058,589,1469,10,44,6,4
15782,64913,53,33116,53,194,102,92,2,30,1,1
15783,64022,60918,37297,60918,66,66,0,2,7,2,0
15784,9824,53,59579,53,179,86,93,2,29,1,1
15785,55193,53,27254,53,177,94,83,2,30,1,1
15786,42101,443,25094,443,4904,1934,2970,17,135,8,9
15787,48861,53,40652,53,164,78,86,2,30,1,1
15788,34105,443,37693,443,43883,3446,40437,57,122,22,35
15789,38866,443,54319,443,16577,10269,6308,33,17,20,13
15790,49214,443,63008,443,7177,2666,4511,20,15,11,9
15791,50662,443,50298,443,4190,1882,2308,17,19,10,7
15792,56604,443,32761,443,7314,2061,5253,29,92,15,14
15793,52246,443,52246,443,1615,941,674,15,21,7,8
15794,64787,53,13133,53,299,101,198,4,34,2,2
15795,56756,443,23896,443,8007,1987,6020,20,15,11,9
15796,49222,443,64126,443,476852,12774,464078,491,17,177,314
15797,60882,443,27723,443,4485,794,3691,17,25,9,8
15798,65209,53,43414,53,585,206,379,6,79,3,3
15799,49386,53,12060,53,332,102,230,2,30,1,1
15800,49420,53,37701,53,185,102,83,2,30,1,1
15801,54199,443,3753,443,26903,3579,23324,72,278,33,39
15802,58640,443,44043,443,4440,114,4326,7,122,2,5
15803,55228,443,61820,443,12645,4916,7729,39,94,22,17
15804,58140,53,58140,53,262,106,156,2,34,1,1
15805,55699,21063,52402,21063,70,70,0,1,5,1,0
15806,63201,53,63201,53,262,106,156,2,32,1,1
15807,57204,443,62645,443,340,140,200,6,25,3,3
15808,49925,53,18861,53,953,215,738,6,46,3,3
15809,56360,443,55866,443,188316,24744,163572,302,172,119,183
15810,55193,53,2306,53,177,94,83,2,30,1,1
15811,64636,53,4639,53,325,102,223,2,30,1,1
15812,65336,53,64946,53,275,94,181,2,30,1,1
15813,49367,53,52320,53,718,94,624,2,30,1,1
15814,64528,53,42814,53,353,118,235,2,30,1,1
15815,55347,443,36174,443,3811,2320,1491,33,735,18,15
15816,56510,443,37047,443,8742,2483,6259,41,114,22,19
15817,50670,80,2254,80,1658,1247,411,8,15,5,3
15818,41916,443,13885,443,8634,3251,5383,24,17,14,10
15819,32837,443,39597,443,3167,1498,1669,19,315,10,9
15820,53125,443,2099,443,7738,2230,5508,24,45,14,10
15821,44641,80,65447,80,1354,850,504,13,256,8,5
15822,24988,53,24988,53,214,82,132,2,33,1,1
15823,54197,443,61116,443,190,70,120,4,15,2,2
15824,52093,40828,32567,40828,258,70,188,4,8,2,2
15825,64025,26826,22306,26826,66,66,0,2,7,2,0
15826,53883,24830,47697,24830,258,70,188,4,7,2,2
15827,50360,80,38167,80,5307,2694,2613,17,25,9,8
15828,57604,443,23765,443,2614,1689,925,18,21,10,8
15829,57544,7000,57544,7000,3502,1935,1567,15,15,8,7
15830,38822,80,14880,80,810,413,397,7,19,5,2
15831,57592,80,57592,80,3118,689,2429,13,144,6,7
15832,53884,48754,60851,48754,70,70,0,2,7,2,0
15833,52065,52021,23578,52021,70,70,0,1,4,1,0
15834,43892,443,53731,443,9754,4277,5477,27,330,14,13
15835,45077,443,30343,443,9599,1234,8365,27,29,15,12
15836,57444,53,13400,53,198,94,104,2,29,1,1
15837,49767,53,3628,53,177,94,83,2,29,1,1
15838,32578,443,32578,443,25033,2433,22600,42,25,21,21
15839,50616,53,45129,53,177,94,83,2,30,1,1
15840,64913,53,23262,53,194,102,92,2,29,1,1
15841,55222,53,59150,53,1210,950,260,2,29,1,1
15842,64773,53,48477,53,328,150,178,2,30,1,1
15843,33080,53,44512,53,86,86,0,1,29,1,0
15844,42318,53,4117,53,164,78,86,2,30,1,1
15845,65117,53,25899,53,230,94,136,2,30,1,1
15846,59753,27016,15718,27016,1718,1386,332,8,30,4,4
15847,44757,53,59516,53,179,86,93,2,30,1,1
15848,49491,443,61216,443,33157,17446,15711,66,135,38,28
15849,49666,53,7037,53,325,126,199,2,30,1,1
15850,64750,53,14070,53,276,102,174,2,30,1,1
15851,55542,443,7716,443,11550,3336,8214,52,130,25,27
15852,57307,443,55707,443,35035,5135,29900,81,216,33,48
15853,36411,443,59094,443,10691,3704,6987,25,181,13,12
15854,56757,443,9849,443,8057,2037,6020,20,15,11,9
15855,53163,32834,24170,32834,70,70,0,2,8,2,0
15856,41269,443,9096,443,78,78,0,1,5,1,0
15857,57591,80,57591,80,144228,2522,141706,135,144,36,99
15858,49490,53,51051,53,246,94,152,2,30,1,1
15859,33546,53,33546,53,400,257,143,3,32,2,1
15860,50659,80,44031,80,24433,3378,21055,31,21,12,19
15861,50358,80,6074,80,306,180,126,6,25,4,2
15862,46193,53,56530,53,311,86,225,2,30,1,1
15863,43539,53,26606,53,168,78,90,2,30,1,1
15864,38700,53,38476,53,164,78,86,2,30,1,1
15865,64173,53,16220,53,210,94,116,2,30,1,1
15866,64986,27049,14066,27049,1764,924,840,6,31,3,3
15867,47400,80,8007,80,9083,1822,7261,20,257,5,15
15868,48817,13259,48817,13259,460,150,310,2,1200,1,1
15869,50654,123,28946,123,184,94,90,2,30,1,1
15870,50616,53,27498,53,177,94,83,2,30,1,1
15871,55026,53,14938,53,177,94,83,2,30,1,1
15872,57044,53,54820,53,177,94,83,2,31,1,1
15873,57169,53,45860,53,177,94,83,2,31,1,1
15874,50265,15402,25420,15402,1450,747,703,16,1200,9,7
15875,49160,16767,65061,16767,854,150,704,4,1200,2,2
15876,50265,57799,36521,57799,1450,747,703,16,1200,9,7
15877,55063,5223,9362,5223,4336,1518,2818,23,3002,14,9
15878,37965,63666,47723,63666,10717,6715,4002,121,4588,71,50
15879,49453,53,64414,53,227,110,117,2,31,1,1
15880,34179,80,3058,80,2137,1258,879,11,150,6,5
15881,55877,56299,54578,56299,481,150,331,2,1200,1,1
15882,52089,16543,21777,16543,70,70,0,2,9,2,0
15883,53863,8999,63067,8999,70,70,0,1,5,1,0
15884,64012,40642,7765,40642,70,70,0,1,5,1,0
15885,55185,443,43469,443,6389,1163,5226,19,25,11,8
15886,51414,443,57873,443,8292,2164,6128,31,120,17,14
15887,56754,443,15698,443,8006,1986,6020,20,16,11,9
15888,58949,443,63115,443,5166,700,4466,16,15,7,9
15889,53722,443,28671,443,70,70,0,1,5,1,0
15890,52064,43273,64418,43273,70,70,0,1,5,1,0
15891,51412,443,35247,443,200230,8733,191497,250,122,106,144
15892,50379,80,42640,80,1083,653,430,8,16,5,3
15893,65323,27047,12346,27047,1233,924,309,6,31,3,3
15894,37336,443,19104,443,995086,50081,945005,1281,216,515,766
15895,64123,443,56759,443,1411,852,559,13,25,7,6
15896,65451,53,3084,53,728,234,494,6,67,3,3
15897,55026,53,50435,53,177,94,83,2,30,1,1
15898,8949,53,8949,53,832,106,726,2,30,1,1
15899,57306,53,57306,53,220,90,130,2,30,1,1
15900,57452,53,57452,53,203,82,121,2,30,1,1
15901,63462,445,0,0,70,70,0,1,0,1,0
15902,63459,445,0,0,70,70,0,1,0,1,0
15903,63460,445,0,0,70,70,0,1,0,1,0
15904,29145,8168,0,0,62,62,0,1,0,1,0
15905,63030,25174,0,0,62,62,0,1,0,1,0
15906,63458,445,0,0,70,70,0,1,0,1,0
15907,58120,25174,0,0,62,62,0,1,0,1,0
15908,50609,2323,0,0,60,60,0,1,0,1,0
15909,1500,10387,0,0,157,157,0,1,0,1,0
15910,63455,445,0,0,70,70,0,1,0,1,0
15911,51863,445,0,0,70,70,0,1,0,1,0
15912,50106,30317,0,0,66,66,0,1,0,1,0
15913,27679,37965,0,0,62,62,0,1,0,1,0
15914,51861,445,0,0,70,70,0,1,0,1,0
15915,51858,445,0,0,70,70,0,1,0,1,0
15916,51852,445,0,0,70,70,0,1,0,1,0
15917,49993,37965,0,0,66,66,0,1,0,1,0
15918,57251,37965,0,0,62,62,0,1,0,1,0
15919,1024,63737,0,0,518,518,0,1,0,1,0
15920,29045,41864,0,0,159,159,0,1,0,1,0
15921,443,38956,0,0,82,82,0,1,0,1,0
15922,19747,37965,0,0,62,62,0,1,0,1,0
15923,54917,60043,0,0,66,66,0,1,0,1,0
15924,63385,25174,0,0,66,66,0,1,0,1,0
15925,45682,37965,0,0,62,62,0,1,0,1,0
15926,2837,25174,0,0,62,62,0,1,0,1,0
15927,63449,445,0,0,70,70,0,1,0,1,0
15928,50549,43890,0,0,62,62,0,1,0,1,0
15929,1827,64147,0,0,66,66,0,1,0,1,0
15930,2991,23,0,0,60,60,0,1,0,1,0
15931,50321,48817,0,0,143,143,0,1,0,1,0
15932,38586,3855,0,0,145,145,0,1,0,1,0
15933,10910,57866,0,0,62,62,0,1,0,1,0
15934,10910,57866,0,0,146,146,0,1,0,1,0
15935,51845,445,0,0,70,70,0,1,0,1,0
15936,33328,25174,0,0,62,62,0,1,0,1,0
15937,51843,445,0,0,70,70,0,1,0,1,0
15938,51841,445,0,0,70,70,0,1,0,1,0
15939,63441,445,0,0,70,70,0,1,0,1,0
15940,2332,35440,0,0,66,66,0,1,0,1,0
15941,63438,445,0,0,70,70,0,1,0,1,0
15942,50857,26467,0,0,66,66,0,1,0,1,0
15943,37034,25174,0,0,62,62,0,1,0,1,0
15944,63615,445,0,0,66,66,0,1,0,1,0
15945,52166,26467,0,0,66,66,0,1,0,1,0
15946,65159,37965,0,0,74,74,0,1,0,1,0
15947,22856,22114,0,0,66,66,0,1,0,1,0
15948,22677,25174,0,0,66,66,0,1,0,1,0
15949,50563,37965,0,0,66,66,0,1,0,1,0
15950,63435,445,0,0,70,70,0,1,0,1,0
15951,59535,25174,0,0,62,62,0,1,0,1,0
15952,7423,22114,0,0,146,146,0,1,0,1,0
15953,63433,445,0,0,70,70,0,1,0,1,0
15954,52537,57866,0,0,66,66,0,1,0,1,0
15955,10128,23718,0,0,146,146,0,1,0,1,0
15956,51837,445,0,0,70,70,0,1,0,1,0
15957,443,38956,0,0,82,82,0,1,0,1,0
15958,26263,8168,0,0,66,66,0,1,0,1,0
15959,60869,48817,0,0,66,66,0,1,0,1,0
15960,52494,36237,0,0,62,62,0,1,0,1,0
15961,51836,445,0,0,70,70,0,1,0,1,0
15962,47089,22114,0,0,146,146,0,1,0,1,0
15963,63888,25174,0,0,62,62,0,1,0,1,0
15964,63429,445,0,0,70,70,0,1,0,1,0
15965,51602,22114,0,0,66,66,0,1,0,1,0
15966,59599,62413,0,0,146,146,0,1,0,1,0
15967,4788,53,4788,53,825,99,726,2,0,1,1
15968,51425,37450,0,0,66,66,0,1,0,1,0
15969,63599,445,0,0,66,66,0,1,0,1,0
15970,63598,445,0,0,66,66,0,1,0,1,0
15971,63428,445,0,0,70,70,0,1,0,1,0
15972,56590,25174,0,0,66,66,0,1,0,1,0
15973,49333,25174,0,0,62,62,0,1,0,1,0
15974,60159,22114,0,0,66,66,0,1,0,1,0
15975,1238,51505,0,0,62,62,0,1,0,1,0
15976,64922,26296,0,0,148,148,0,1,0,1,0
15977,51815,445,0,0,70,70,0,1,0,1,0
15978,62579,57866,0,0,66,66,0,1,0,1,0
15979,6929,35440,0,0,66,66,0,1,0,1,0
15980,51825,445,0,0,70,70,0,1,0,1,0
15981,51823,445,0,0,70,70,0,1,0,1,0
15982,51822,445,0,0,70,70,0,1,0,1,0
15983,6247,51221,0,0,78,78,0,1,0,1,0
15984,48605,50584,0,0,146,146,0,1,0,1,0
15985,63423,445,0,0,70,70,0,1,0,1,0
15986,63596,445,0,0,66,66,0,1,0,1,0
15987,42034,28189,0,0,62,62,0,1,0,1,0
15988,25296,51505,0,0,66,66,0,1,0,1,0
15989,64024,22114,0,0,66,66,0,1,0,1,0
15990,61185,54532,0,0,62,62,0,1,0,1,0
15991,27300,6881,0,0,62,62,0,1,0,1,0
15992,63586,445,0,0,66,66,0,1,0,1,0
15993,63590,445,0,0,66,66,0,1,0,1,0
15994,63585,445,0,0,66,66,0,1,0,1,0
15995,63579,445,0,0,66,66,0,1,0,1,0
15996,63588,445,0,0,66,66,0,1,0,1,0
15997,63582,445,0,0,66,66,0,1,0,1,0
15998,63581,445,0,0,66,66,0,1,0,1,0
15999,5222,32859,0,0,66,66,0,1,0,1,0
16000,51811,445,0,0,70,70,0,1,0,1,0
16001,51806,445,0,0,70,70,0,1,0,1,0
16002,51805,445,0,0,70,70,0,1,0,1,0
16003,51803,445,0,0,70,70,0,1,0,1,0
16004,1190,25174,0,0,62,62,0,1,0,1,0
16005,11136,19910,0,0,62,62,0,1,0,1,0
16006,18750,57866,0,0,62,62,0,1,0,1,0
16007,443,2629,0,0,135,135,0,1,0,1,0
16008,63410,445,0,0,70,70,0,1,0,1,0
16009,65289,25174,0,0,66,66,0,1,0,1,0
16010,17982,11392,0,0,62,62,0,1,0,1,0
16011,26301,22114,0,0,146,146,0,1,0,1,0
16012,7288,25174,0,0,66,66,0,1,0,1,0
16013,21064,25174,0,0,146,146,0,1,0,1,0
16014,56800,23,0,0,60,60,0,1,0,1,0
16015,1264,26296,0,0,143,143,0,1,0,1,0
16016,1638,22114,0,0,62,62,0,1,0,1,0
16017,1356,57470,0,0,72,72,0,1,0,1,0
16018,63407,445,0,0,70,70,0,1,0,1,0
16019,35011,37965,0,0,62,62,0,1,0,1,0
16020,51800,445,0,0,70,70,0,1,0,1,0
16021,51799,445,0,0,70,70,0,1,0,1,0
16022,51798,445,0,0,70,70,0,1,0,1,0
16023,63573,445,0,0,66,66,0,1,0,1,0
16024,51794,445,0,0,70,70,0,1,0,1,0
16025,63569,445,0,0,66,66,0,1,0,1,0
16026,53495,37807,0,0,66,66,0,1,0,1,0
16027,46537,25174,0,0,62,62,0,1,0,1,0
16028,63568,445,0,0,66,66,0,1,0,1,0
16029,63566,445,0,0,66,66,0,1,0,1,0
16030,22783,64147,0,0,66,66,0,1,0,1,0
16031,10003,64147,0,0,62,62,0,1,0,1,0
16032,56621,50584,0,0,62,62,0,1,0,1,0
16033,65389,26467,0,0,62,62,0,1,0,1,0
16034,63564,445,0,0,66,66,0,1,0,1,0
16035,56629,25174,0,0,66,66,0,1,0,1,0
16036,64162,22114,0,0,146,146,0,1,0,1,0
16037,63403,445,0,0,70,70,0,1,0,1,0
16038,63401,445,0,0,70,70,0,1,0,1,0
16039,48125,7548,0,0,60,60,0,1,0,1,0
16040,63399,445,0,0,70,70,0,1,0,1,0
16041,12545,43890,0,0,146,146,0,1,0,1,0
16042,51789,445,0,0,70,70,0,1,0,1,0
16043,1114,37965,0,0,62,62,0,1,0,1,0
16044,5228,3434,0,0,345,345,0,1,0,1,0
16045,51783,445,0,0,70,70,0,1,0,1,0
16046,51777,445,0,0,70,70,0,1,0,1,0
16047,42344,48637,0,0,60,60,0,1,0,1,0
16048,9087,37965,0,0,62,62,0,1,0,1,0
16049,63553,445,0,0,66,66,0,1,0,1,0
16050,10091,22114,0,0,62,62,0,1,0,1,0
16051,63587,22114,0,0,62,62,0,1,0,1,0
16052,63392,445,0,0,70,70,0,1,0,1,0
16053,60261,25174,0,0,66,66,0,1,0,1,0
16054,63390,445,0,0,70,70,0,1,0,1,0
16055,48019,22114,0,0,66,66,0,1,0,1,0
16056,10273,21247,0,0,62,62,0,1,0,1,0
16057,27144,25174,0,0,66,66,0,1,0,1,0
16058,53822,25174,0,0,66,66,0,1,0,1,0
16059,63546,445,0,0,66,66,0,1,0,1,0
16060,58228,53733,0,0,62,62,0,1,0,1,0
16061,51767,445,0,0,70,70,0,1,0,1,0
16062,63389,445,0,0,70,70,0,1,0,1,0
16063,34396,443,45872,443,6214,1750,4464,24,316,12,12
16064,64803,80,9867,80,5518,527,4991,13,75,6,7
16065,9413,443,2971,443,3510,430,3080,10,15,6,4
16066,44205,443,40929,443,13019,4593,8426,71,350,34,37
16067,60470,51413,5081,51413,741,435,306,10,16,5,5
16068,51960,443,28367,443,2648,1797,851,19,23,11,8
16069,51618,15000,8356,15000,130,70,60,2,5,1,1
16070,34704,443,48562,443,10207,3126,7081,26,24,14,12
16071,10036,80,8198,80,2058,589,1469,10,46,6,4
16072,49676,53,19443,53,216,110,106,2,30,1,1
16073,58910,443,57868,443,27575,18478,9097,64,22,36,28
16074,48275,15000,58699,15000,130,70,60,2,5,1,1
16075,55563,443,55563,443,4628,1721,2907,19,30,11,8
16076,49655,80,10831,80,6485767,147003,6338764,6221,320,2024,4197
16077,57001,53,10240,53,170,87,83,2,31,1,1
16078,40204,40039,52941,40039,152,90,62,2,31,1,1
16079,54950,443,18760,443,5281,1393,3888,22,16,13,9
16080,53891,1056,54785,1056,260,140,120,5,6,3,2
16081,45122,15000,56634,15000,130,70,60,2,5,1,1
16082,49994,443,47759,443,352,292,60,2,5,1,1
16083,53838,15000,39426,15000,130,70,60,2,5,1,1
16084,9414,443,33463,443,5689,501,5188,14,15,7,7
16085,62693,443,62693,443,4788,1881,2907,19,31,11,8
16086,52245,443,52245,443,1615,941,674,15,21,7,8
16087,57965,443,27190,443,8366,2018,6348,32,104,17,15
16088,59084,443,59084,443,4598,1691,2907,19,30,11,8
16089,50387,443,3636,443,2227,1018,1209,17,16,8,9
16090,64802,80,15134,80,2424,529,1895,11,75,6,5
16091,41278,443,28567,443,7238,2601,4637,20,17,10,10
16092,50354,80,47927,80,306,180,126,6,25,4,2
16093,54516,53,54516,53,235,90,145,2,33,1,1
16094,55454,53,60300,53,168,86,82,2,33,1,1
16095,51408,443,61197,443,1576,789,787,17,122,9,8
16096,49450,443,10791,443,5792,1511,4281,19,77,11,8
16097,42023,443,45040,443,42402,3988,38414,82,89,39,43
16098,47091,15000,23609,15000,138,78,60,2,6,1,1
16099,47168,15000,16770,15000,130,70,60,2,5,1,1
16100,57912,443,57912,443,4559,1652,2907,19,27,11,8
16101,50604,80,50604,80,1707,1007,700,11,21,6,5
16102,51959,443,27606,443,2648,1797,851,19,23,11,8
16103,58939,443,28561,443,6403,4065,2338,22,16,11,11
16104,32866,443,34870,443,23467,16522,6945,51,161,29,22
16105,49721,80,41494,80,340,140,200,6,15,3,3
16106,6960,53,6960,53,186,83,103,2,30,1,1
16107,56225,53,16256,53,188,96,92,2,30,1,1
16108,49696,443,61815,443,42348,4871,37477,71,150,40,31
16109,49330,443,4383,443,7913,2091,5822,23,42,11,12
16110,52138,443,52138,443,80933,20860,60073,121,324,66,55
16111,56800,443,5999,443,8337,2820,5517,19,30,10,9
16112,53861,53065,56189,53065,70,70,0,1,5,1,0
16113,52058,8329,7251,8329,66,66,0,1,5,1,0
16114,58936,443,15489,443,10014,6664,3350,28,17,14,14
16115,58874,443,39745,443,21478,2212,19266,47,86,19,28
16116,56528,443,48835,443,158084,6138,151946,173,95,64,109
16117,56553,53,20095,53,701,88,613,2,30,1,1
16118,57169,53,44732,53,170,87,83,2,30,1,1
16119,56879,53,15909,53,780,93,687,2,31,1,1
16120,6881,51413,48817,51413,200,111,89,2,1200,1,1
16121,65528,53,47715,53,217,75,142,4,30,2,2
16122,55065,53,19490,53,711,87,624,2,30,1,1
16123,56181,53,54189,53,764,99,665,2,31,1,1
16124,49485,53,58732,53,752,93,659,2,31,1,1
16125,56728,53,40582,53,744,95,649,2,31,1,1
16126,54692,443,45906,443,5907,2630,3277,21,147,10,11
16127,55036,53,30063,53,733,93,640,2,31,1,1
16128,50038,53,5932,53,170,87,83,2,31,1,1
16129,52707,443,49592,443,39551,4663,34888,60,357,27,33
16130,64877,53,24917,53,182,93,89,2,31,1,1
16131,55214,53,41945,53,711,87,624,2,31,1,1
16132,57246,53,12706,53,752,93,659,2,31,1,1
16133,39717,5228,64597,5228,7587,2099,5488,26,3602,14,12
16134,64931,53,32751,53,174,89,85,2,31,1,1
16135,57109,53,44560,53,711,87,624,2,31,1,1
16136,50645,53,43858,53,256,93,163,2,31,1,1
16137,55318,53,46114,53,711,87,624,2,31,1,1
16138,50550,5228,24310,5228,2661,1518,1143,18,3600,9,9
16139,63388,445,0,0,70,70,0,1,0,1,0
16140,63387,445,0,0,70,70,0,1,0,1,0
16141,25457,25604,0,0,145,145,0,1,0,1,0
16142,63384,445,0,0,70,70,0,1,0,1,0
16143,63385,445,0,0,70,70,0,1,0,1,0
16144,63545,25174,0,0,66,66,0,1,0,1,0
16145,63543,445,0,0,66,66,0,1,0,1,0
16146,1847,64147,0,0,66,66,0,1,0,1,0
16147,56127,37965,0,0,66,66,0,1,0,1,0
16148,47357,50584,0,0,62,62,0,1,0,1,0
16149,63369,445,0,0,70,70,0,1,0,1,0
16150,63368,445,0,0,70,70,0,1,0,1,0
16151,44993,53,47761,53,168,78,90,2,30,1,1
16152,57136,53,53104,53,177,94,83,2,30,1,1
16153,65513,53,25094,53,178,94,84,2,30,1,1
16154,36191,443,31290,443,9386,1934,7452,32,135,17,15
16155,60475,443,46189,443,5888,1175,4713,19,43,11,8
16156,60721,22114,0,0,62,62,0,1,0,1,0
16157,63362,445,0,0,70,70,0,1,0,1,0
16158,63536,445,0,0,66,66,0,1,0,1,0
16159,58900,37807,0,0,66,66,0,1,0,1,0
16160,63359,445,0,0,70,70,0,1,0,1,0
16161,63358,445,0,0,70,70,0,1,0,1,0
16162,63527,445,0,0,66,66,0,1,0,1,0
16163,59523,37965,0,0,62,62,0,1,0,1,0
16164,55425,37965,0,0,66,66,0,1,0,1,0
16165,53207,50584,0,0,66,66,0,1,0,1,0
16166,50126,23117,0,0,62,62,0,1,0,1,0
16167,62796,37807,0,0,62,62,0,1,0,1,0
16168,12830,25174,0,0,146,146,0,1,0,1,0
16169,56711,25174,0,0,62,62,0,1,0,1,0
16170,48230,57866,0,0,62,62,0,1,0,1,0
16171,51759,445,0,0,70,70,0,1,0,1,0
16172,51754,445,0,0,70,70,0,1,0,1,0
16173,51755,445,0,0,70,70,0,1,0,1,0
16174,63347,445,0,0,70,70,0,1,0,1,0
16175,50446,26467,0,0,66,66,0,1,0,1,0
16176,63517,445,0,0,66,66,0,1,0,1,0
16177,63518,445,0,0,66,66,0,1,0,1,0
16178,63515,445,0,0,66,66,0,1,0,1,0
16179,63520,445,0,0,66,66,0,1,0,1,0
16180,63513,445,0,0,66,66,0,1,0,1,0
16181,63514,445,0,0,66,66,0,1,0,1,0
16182,63519,445,0,0,66,66,0,1,0,1,0
16183,63512,445,0,0,66,66,0,1,0,1,0
16184,59018,22114,0,0,62,62,0,1,0,1,0
16185,68,67,0,0,346,346,0,1,0,1,0
16186,58509,21247,0,0,66,66,0,1,0,1,0
16187,53373,64147,0,0,66,66,0,1,0,1,0
16188,64077,25174,0,0,66,66,0,1,0,1,0
16189,56713,25174,0,0,146,146,0,1,0,1,0
16190,10914,35974,0,0,60,60,0,1,0,1,0
16191,63342,445,0,0,70,70,0,1,0,1,0
16192,7041,37965,0,0,66,66,0,1,0,1,0
16193,51752,445,0,0,70,70,0,1,0,1,0
16194,51753,445,0,0,70,70,0,1,0,1,0
16195,51751,445,0,0,70,70,0,1,0,1,0
16196,51738,445,0,0,70,70,0,1,0,1,0
16197,46734,50265,0,0,74,74,0,1,0,1,0
16198,5223,14446,0,0,220,220,0,1,0,1,0
16199,1377,44847,0,0,62,62,0,1,0,1,0
16200,63333,445,0,0,70,70,0,1,0,1,0
16201,63334,445,0,0,70,70,0,1,0,1,0
16202,63332,445,0,0,70,70,0,1,0,1,0
16203,44293,23,0,0,60,60,0,1,0,1,0
16204,44797,53,29838,53,179,86,93,2,29,1,1
16205,50102,53,50102,53,216,90,126,2,29,1,1
16206,57100,53,13292,53,402,118,284,2,30,1,1
16207,36277,443,45497,443,14212,8194,6018,38,104,21,17
16208,44649,443,58778,443,7013,1092,5921,21,31,12,9
16209,42294,443,1257,443,10384,4353,6031,29,251,16,13
16210,51155,443,7506,443,8351,2366,5985,41,185,20,21
16211,64104,53,1753,53,855,311,544,8,79,4,4
16212,41902,443,1832,443,6511,1866,4645,21,17,12,9
16213,56282,3389,56282,3389,3425,1470,1955,16,16,8,8
16214,50898,443,4601,443,8480,2236,6244,27,81,15,12
16215,52062,60388,22555,60388,70,70,0,1,5,1,0
16216,56733,80,32206,80,214,140,74,4,25,3,1
16217,51411,443,3217,443,1444,723,721,15,121,8,7
16218,64013,48970,31452,48970,70,70,0,1,4,1,0
16219,51990,443,58670,443,2094,1402,692,14,15,8,6
16220,35649,53,35649,53,220,90,130,2,29,1,1
16221,56225,53,65429,53,194,102,92,2,29,1,1
16222,57044,53,13631,53,177,94,83,2,29,1,1
16223,33415,53,42301,53,164,78,86,2,29,1,1
16224,39186,443,31509,443,8126,2183,5943,29,270,14,15
16225,55193,53,10853,53,177,94,83,2,29,1,1
16226,47681,443,29966,443,6790,1336,5454,20,187,11,9
16227,51606,443,52418,443,3013,1661,1352,14,20,8,6
16228,58784,443,58898,443,41305,2456,38849,63,30,29,34
16229,52470,443,33189,443,7915,1213,6702,23,50,12,11
16230,57169,53,49234,53,177,94,83,2,30,1,1
16231,39735,53,51086,53,223,78,145,2,30,1,1
16232,44313,53,51644,53,199,94,105,2,30,1,1
16233,64967,53,44002,53,751,102,649,2,30,1,1
16234,57017,53,22107,53,177,94,83,2,30,1,1
16235,52059,47363,55015,47363,70,70,0,1,5,1,0
16236,64024,57825,29804,57825,312,132,180,6,6,3,3
16237,60356,443,15398,443,8079,2282,5797,26,17,15,11
16238,49665,53,61260,53,361,118,243,4,33,2,2
16239,60501,443,35631,443,12006,3698,8308,23,15,13,10
16240,55694,62954,52341,62954,504,318,186,8,15,5,3
16241,49042,443,19321,443,5792,1764,4028,24,31,14,10
16242,59252,443,29438,443,8442,1134,7308,23,15,13,10
16243,65513,53,49907,53,186,102,84,2,30,1,1
16244,62487,443,47119,443,14840,3978,10862,32,33,15,17
16245,50820,80,16954,80,550,476,74,6,15,5,1
16246,56970,443,55404,443,16378,3002,13376,35,17,17,18
16247,52471,443,64710,443,8398,1552,6846,27,50,14,13
16248,36097,443,29806,443,6131,1384,4747,27,50,15,12
16249,46750,443,52499,443,350,210,140,6,25,4,2
16250,56752,443,37907,443,8007,1987,6020,20,15,11,9
16251,53849,17580,55160,17580,492,306,186,8,15,5,3
16252,49717,53,61877,53,781,94,687,2,30,1,1
16253,51878,443,1905,443,7241,1972,5269,28,68,16,12
16254,50822,80,16918,80,550,476,74,6,15,5,1
16255,43677,443,7474,443,7698,2373,5325,21,159,12,9
16256,52214,443,59996,443,10898,3170,7728,33,331,14,19
16257,55696,64301,60133,64301,316,190,126,5,15,3,2
16258,49715,53,2852,53,734,94,640,2,30,1,1
16259,57169,53,55485,53,177,94,83,2,30,1,1
16260,58207,443,31795,443,10209,2530,7679,33,223,17,16
16261,64583,443,48873,443,9150,2109,7041,27,32,15,12
16262,42951,443,65078,443,6513,1609,4904,26,303,14,12
16263,53016,80,9240,80,4419,271,4148,13,28,3,10
16264,54598,53,30660,53,168,78,90,2,30,1,1
16265,5380,53,15988,53,377,94,283,2,30,1,1
16266,50680,443,36184,443,2993,866,2127,10,120,5,5
16267,53844,16925,27697,16925,940,502,438,14,18,7,7
16268,52092,48658,51084,48658,316,136,180,6,7,3,3
16269,53076,443,8791,443,96850,6037,90813,150,177,55,95
16270,54953,53,34688,53,263,94,169,2,30,1,1
16271,49676,53,26255,53,216,110,106,2,30,1,1
16272,57136,53,3723,53,177,94,83,2,30,1,1
16273,54749,443,23422,443,273283,194709,78574,1567,3312,746,821
16274,42993,443,4203,443,7821,3237,4584,39,149,19,20
16275,43231,443,33460,443,56226,4852,51374,71,106,30,41
16276,57380,443,31912,443,5553,927,4626,16,15,10,6
16277,51409,443,17023,443,1442,721,721,15,122,8,7
16278,39651,443,15343,443,18514,4506,14008,72,105,41,31
16279,38528,443,36554,443,13608,3518,10090,48,217,24,24
16280,58744,443,58147,443,14878,4225,10653,83,330,41,42
16281,51175,443,19417,443,2132473,55149,2077324,2144,63,731,1413
16282,52091,4789,12478,4789,70,70,0,2,7,2,0
16283,58945,443,49273,443,5168,700,4468,16,15,7,9
16284,52088,35605,28933,35605,70,70,0,2,8,2,0
16285,49782,443,53470,443,70,70,0,2,7,2,0
16286,52096,443,13873,443,4747,3601,1146,18,15,10,8
16287,49826,443,11659,443,6105,852,5253,17,77,9,8
16288,52060,29868,29510,29868,70,70,0,1,5,1,0
16289,52061,35717,37968,35717,70,70,0,1,5,1,0
16290,65378,53,29573,53,476,121,355,4,40,2,2
16291,50603,80,50603,80,1706,1006,700,11,21,6,5
16292,62486,443,21615,443,10390,7057,3333,27,33,15,12
16293,48265,443,59042,443,4138,2416,1722,31,80,16,15
16294,36098,443,41283,443,5901,1324,4577,25,50,14,11
16295,56225,53,8973,53,194,102,92,2,29,1,1
16296,43861,123,6210,123,184,94,90,2,29,1,1
16297,58942,443,33385,443,5168,700,4468,16,15,7,9
16298,49800,53,35452,53,485,93,392,4,48,2,2
16299,64040,53,17235,53,226,102,124,2,29,1,1
16300,5588,5588,0,0,3562,1936,1626,48,194,24,24
16301,40495,53,8395,53,168,78,90,2,29,1,1
16302,54998,53,24555,53,168,78,90,2,30,1,1
16303,65110,53,31746,53,406,142,264,2,30,1,1
16304,41153,53,8565,53,168,78,90,2,30,1,1
16305,64950,53,51754,53,728,102,626,2,30,1,1
16306,65314,53,39947,53,195,102,93,2,30,1,1
16307,50130,53,10528,53,183,94,89,2,30,1,1
16308,56703,53,62070,53,183,94,89,2,31,1,1
16309,49858,53,41757,53,177,94,83,2,30,1,1
16310,47135,53,52086,53,199,94,105,2,30,1,1
16311,56367,53,30541,53,194,102,92,2,30,1,1
16312,64974,27054,45428,27054,3142,1386,1756,8,31,4,4
16313,56970,443,7987,443,6815,3817,2998,23,143,11,12
16314,51910,443,52422,443,29367,10171,19196,66,184,32,34
16315,65139,53,58108,53,754,94,660,2,31,1,1
16316,58785,443,2616,443,37165,2164,35001,58,29,28,30
16317,65386,53,49656,53,197,102,95,2,33,1,1
16318,62488,443,33482,443,1326,876,450,11,32,6,5
16319,46862,443,48242,443,6162,925,5237,18,179,10,8
16320,36099,443,35934,443,5901,1324,4577,25,50,14,11
16321,36815,443,48632,443,416,210,206,7,29,4,3
16322,65314,53,31001,53,195,102,93,2,30,1,1
16323,51081,53,49643,53,168,78,90,2,30,1,1
16324,57017,53,16260,53,177,94,83,2,30,1,1
16325,44864,443,47449,443,8779,1861,6918,34,120,17,17
16326,55404,443,57333,443,2352,1394,958,17,275,9,8
16327,57027,53,59688,53,177,94,83,2,31,1,1
16328,49675,7000,49675,7000,3132,815,2317,14,15,7,7
16329,58743,443,24933,443,14819,3993,10826,80,330,36,44
16330,52063,7886,16483,7886,70,70,0,1,5,1,0
16331,51989,80,9142,80,1344,899,445,8,15,6,2
16332,53077,443,54152,443,6173,924,5249,18,177,10,8
16333,52358,443,40970,443,4145,2738,1407,29,27,16,13
16334,64585,443,46353,443,24686,1935,22751,36,18,17,19
16335,50352,80,51125,80,2537,783,1754,13,25,7,6
16336,50477,443,60268,443,130,70,60,2,15,1,1
16337,40806,8000,37524,8000,195,71,124,4,58,2,2
16338,51756,53,33754,53,168,78,90,2,30,1,1
16339,42066,443,21363,443,377544,10569,366975,414,221,152,262
16340,49858,53,34344,53,177,94,83,2,30,1,1
16341,49657,53,23289,53,198,94,104,2,30,1,1
16342,57001,53,43521,53,177,94,83,2,30,1,1
16343,40880,443,42551,443,8142,2090,6052,22,360,10,12
16344,57027,53,37270,53,177,94,83,2,30,1,1
16345,49700,443,6522,443,39240,3804,35436,72,133,38,34
16346,56753,443,16519,443,8058,2038,6020,20,15,11,9
16347,53848,43725,33158,43725,552,306,246,9,15,5,4
16348,58944,443,12374,443,5166,700,4466,16,15,7,9
16349,46500,443,37783,443,494,280,214,8,29,5,3
16350,53437,6057,54615,6057,245,245,0,2,30,2,0
16351,57115,53,44854,53,728,102,626,2,30,1,1
16352,57001,53,25113,53,177,94,83,2,30,1,1
16353,50499,53,23624,53,718,94,624,2,30,1,1
16354,52434,53,49925,53,183,86,97,2,30,1,1
16355,65528,53,44314,53,168,86,82,2,30,1,1
16356,57833,443,7309,443,215996,13055,202941,265,127,96,169
16357,50091,53,1529,53,172,94,78,2,31,1,1
16358,50038,53,46782,53,177,94,83,2,31,1,1
16359,6881,6992,61749,6992,150,150,0,1,1200,1,0
16360,33227,53,32032,53,177,86,91,2,30,1,1
16361,49676,53,4887,53,216,110,106,2,30,1,1
16362,43366,53,27594,53,168,78,90,2,30,1,1
16363,50038,53,24889,53,177,94,83,2,30,1,1
16364,57387,53,49331,53,178,94,84,2,30,1,1
16365,42903,53,55150,53,168,78,90,2,30,1,1
16366,57001,53,51576,53,177,94,83,2,31,1,1
16367,40192,443,40192,443,11928,3226,8702,23,160,11,12
16368,52136,443,52136,443,298081,63335,234746,337,323,145,192
16369,65367,53,17484,53,271,94,177,2,30,1,1
16370,40204,40025,3762,40025,148,86,62,2,30,1,1
16371,64741,53,19831,53,420,110,310,2,30,1,1
16372,59218,53,41217,53,511,126,385,2,31,1,1
16373,65528,53,30567,53,168,86,82,2,31,1,1
16374,34244,443,6672,443,3528,1045,2483,13,120,6,7
16375,50461,443,13300,443,78333,12774,65559,140,128,59,81
16376,57470,50321,60490,50321,5231,5231,0,79,5173,79,0
16377,37658,16385,25619,16385,130,70,60,2,30,1,1
16378,64955,443,38956,443,2279,1129,1150,25,120,12,13
16379,64525,443,3519,443,5981,1902,4079,14,120,7,7
16380,15503,55878,37795,55878,481,150,331,2,1200,1,1
16381,37135,443,52476,443,16921,7469,9452,40,138,19,21
16382,37653,5223,43344,5223,142,142,0,1,5,1,0
16383,45755,443,42960,443,1625,1038,587,14,26,8,6
16384,37565,443,55641,443,4898,1119,3779,17,30,9,8
16385,37564,443,37233,443,1386,924,462,12,30,7,5
16386,51215,443,16837,443,11490,3671,7819,33,93,18,15
16387,37566,443,61835,443,1386,924,462,12,30,7,5
16388,40204,40038,53758,40038,585,86,499,2,30,1,1
16389,37658,16384,24782,16384,130,70,60,2,30,1,1
16390,63500,445,0,0,66,66,0,1,0,1,0
16391,63498,445,0,0,66,66,0,1,0,1,0
16392,63497,445,0,0,66,66,0,1,0,1,0
16393,63328,445,0,0,70,70,0,1,0,1,0
16394,51923,22114,0,0,146,146,0,1,0,1,0
16395,63326,445,0,0,70,70,0,1,0,1,0
16396,13062,52274,0,0,66,66,0,1,0,1,0
16397,31738,51505,0,0,62,62,0,1,0,1,0
16398,1080,8391,0,0,66,66,0,1,0,1,0
16399,53389,23,0,0,60,60,0,1,0,1,0
16400,51734,445,0,0,70,70,0,1,0,1,0
16401,51732,445,0,0,70,70,0,1,0,1,0
16402,51727,445,0,0,70,70,0,1,0,1,0
16403,51724,445,0,0,70,70,0,1,0,1,0
16404,51291,25174,0,0,62,62,0,1,0,1,0
16405,7048,25174,0,0,66,66,0,1,0,1,0
16406,13120,25174,0,0,62,62,0,1,0,1,0
16407,60311,30627,0,0,66,66,0,1,0,1,0
16408,56328,36237,0,0,62,62,0,1,0,1,0
16409,45964,55559,0,0,60,60,0,1,0,1,0
16410,1042,33175,0,0,145,145,0,1,0,1,0
16411,52781,57470,0,0,62,62,0,1,0,1,0
16412,45941,23386,0,0,60,60,0,1,0,1,0
16413,65233,23117,0,0,66,66,0,1,0,1,0
16414,37034,25174,0,0,146,146,0,1,0,1,0
16415,63320,445,0,0,70,70,0,1,0,1,0
16416,51271,37965,0,0,66,66,0,1,0,1,0
16417,63213,35440,0,0,62,62,0,1,0,1,0
16418,60980,5900,0,0,60,60,0,1,0,1,0
16419,63313,445,0,0,70,70,0,1,0,1,0
16420,63310,445,0,0,70,70,0,1,0,1,0
16421,42030,25,0,0,74,74,0,1,0,1,0
16422,51717,445,0,0,70,70,0,1,0,1,0
16423,51716,445,0,0,70,70,0,1,0,1,0
16424,51711,445,0,0,70,70,0,1,0,1,0
16425,65015,22114,0,0,62,62,0,1,0,1,0
16426,58627,64097,0,0,66,66,0,1,0,1,0
16427,31683,35440,0,0,62,62,0,1,0,1,0
16428,63488,445,0,0,66,66,0,1,0,1,0
16429,39061,22114,0,0,146,146,0,1,0,1,0
16430,50063,35776,0,0,148,148,0,1,0,1,0
16431,63307,445,0,0,70,70,0,1,0,1,0
16432,1114,37965,0,0,62,62,0,1,0,1,0
16433,36477,40740,0,0,145,145,0,1,0,1,0
16434,63305,445,0,0,70,70,0,1,0,1,0
16435,49797,25174,0,0,66,66,0,1,0,1,0
16436,27348,22114,0,0,62,62,0,1,0,1,0
16437,27969,25174,0,0,66,66,0,1,0,1,0
16438,62911,36237,0,0,62,62,0,1,0,1,0
16439,30304,64147,0,0,62,62,0,1,0,1,0
16440,12527,50584,0,0,62,62,0,1,0,1,0
16441,51709,445,0,0,70,70,0,1,0,1,0
16442,4793,50584,0,0,66,66,0,1,0,1,0
16443,21482,22114,0,0,62,62,0,1,0,1,0
16444,63301,445,0,0,70,70,0,1,0,1,0
16445,51708,445,0,0,70,70,0,1,0,1,0
16446,34811,56205,0,0,66,66,0,1,0,1,0
16447,25523,35974,0,0,62,62,0,1,0,1,0
16448,16570,25174,0,0,62,62,0,1,0,1,0
16449,24931,25174,0,0,146,146,0,1,0,1,0
16450,55161,37807,0,0,62,62,0,1,0,1,0
16451,63300,445,0,0,70,70,0,1,0,1,0
16452,53389,23,0,0,60,60,0,1,0,1,0
16453,63472,445,0,0,66,66,0,1,0,1,0
16454,63468,445,0,0,66,66,0,1,0,1,0
16455,55130,25174,0,0,62,62,0,1,0,1,0
16456,63032,22114,0,0,66,66,0,1,0,1,0
16457,61961,11392,0,0,66,66,0,1,0,1,0
16458,27995,22114,0,0,62,62,0,1,0,1,0
16459,51695,445,0,0,70,70,0,1,0,1,0
16460,51692,445,0,0,70,70,0,1,0,1,0
16461,51691,445,0,0,70,70,0,1,0,1,0
16462,51686,445,0,0,70,70,0,1,0,1,0
16463,63295,445,0,0,70,70,0,1,0,1,0
16464,54166,25174,0,0,62,62,0,1,0,1,0
16465,25063,64147,0,0,62,62,0,1,0,1,0
16466,63467,445,0,0,66,66,0,1,0,1,0
16467,59755,44512,0,0,66,66,0,1,0,1,0
16468,63457,445,0,0,66,66,0,1,0,1,0
16469,63459,445,0,0,66,66,0,1,0,1,0
16470,63455,445,0,0,66,66,0,1,0,1,0
16471,63453,445,0,0,66,66,0,1,0,1,0
16472,63452,445,0,0,66,66,0,1,0,1,0
16473,63450,445,0,0,66,66,0,1,0,1,0
16474,0,0,0,0,124,64,60,2,0,1,1
16475,13285,29892,0,0,145,145,0,1,0,1,0
16476,55116,7574,0,0,66,66,0,1,0,1,0
16477,51684,445,0,0,70,70,0,1,0,1,0
16478,51678,445,0,0,70,70,0,1,0,1,0
16479,51676,445,0,0,70,70,0,1,0,1,0
16480,51675,445,0,0,70,70,0,1,0,1,0
16481,27505,25174,0,0,62,62,0,1,0,1,0
16482,63282,445,0,0,70,70,0,1,0,1,0
16483,51834,35440,0,0,66,66,0,1,0,1,0
16484,27110,22114,0,0,62,62,0,1,0,1,0
16485,63279,445,0,0,70,70,0,1,0,1,0
16486,51609,37807,0,0,62,62,0,1,0,1,0
16487,55056,44512,0,0,62,62,0,1,0,1,0
16488,51674,445,0,0,70,70,0,1,0,1,0
16489,51672,445,0,0,70,70,0,1,0,1,0
16490,51669,445,0,0,70,70,0,1,0,1,0
16491,42344,48637,0,0,60,60,0,1,0,1,0
16492,63442,445,0,0,66,66,0,1,0,1,0
16493,49824,25174,0,0,146,146,0,1,0,1,0
16494,51666,445,0,0,70,70,0,1,0,1,0
16495,15113,25174,0,0,146,146,0,1,0,1,0
16496,25565,43088,0,0,60,60,0,1,0,1,0
16497,63440,445,0,0,66,66,0,1,0,1,0
16498,9552,57470,0,0,66,66,0,1,0,1,0
16499,59696,57470,0,0,62,62,0,1,0,1,0
16500,6036,51505,0,0,66,66,0,1,0,1,0
16501,63474,48817,0,0,62,62,0,1,0,1,0
16502,63438,445,0,0,66,66,0,1,0,1,0
16503,63437,445,0,0,66,66,0,1,0,1,0
16504,10547,57470,0,0,62,62,0,1,0,1,0
16505,50084,26672,0,0,62,62,0,1,0,1,0
16506,63274,445,0,0,70,70,0,1,0,1,0
16507,35657,48637,0,0,62,62,0,1,0,1,0
16508,63273,445,0,0,70,70,0,1,0,1,0
16509,49651,37965,0,0,74,74,0,1,0,1,0
16510,63436,445,0,0,66,66,0,1,0,1,0
16511,61738,2767,0,0,62,62,0,1,0,1,0
16512,42075,36237,0,0,146,146,0,1,0,1,0
16513,8229,22114,0,0,62,62,0,1,0,1,0
16514,7210,22114,0,0,62,62,0,1,0,1,0
16515,63271,445,0,0,70,70,0,1,0,1,0
16516,47040,25174,0,0,62,62,0,1,0,1,0
16517,23021,25174,0,0,62,62,0,1,0,1,0
16518,51663,445,0,0,70,70,0,1,0,1,0
16519,57761,30317,0,0,66,66,0,1,0,1,0
16520,48817,21939,48817,21939,513,152,361,2,1200,1,1
16521,56367,53,52598,53,188,96,92,2,31,1,1
16522,49601,53,48706,53,762,97,665,2,30,1,1
16523,55892,53,8349,53,182,93,89,2,30,1,1
16524,56370,443,46541,443,3715,1791,1924,23,203,12,11
16525,56361,443,32525,443,3775,1791,1984,24,203,12,12
16526,57809,53,57809,53,213,79,134,2,33,1,1
16527,41850,53,41850,53,257,101,156,2,33,1,1
16528,35485,443,29586,443,1633,1038,595,14,34,8,6
16529,5588,5588,0,0,3562,1936,1626,48,195,24,24
16530,55388,53,60267,53,170,87,83,2,31,1,1
16531,53918,53,0,0,222,82,140,2,30,1,1
16532,50078,443,50829,443,7418,2721,4697,23,17,12,11
16533,62042,80,65130,80,10924,548,10376,17,48,6,11
16534,56353,443,16805,443,3775,1791,1984,24,203,12,12
16535,56365,443,26003,443,3734,1750,1984,24,203,12,12
16536,56356,443,29331,443,3734,1750,1984,24,203,12,12
16537,33734,53,33734,53,257,101,156,2,33,1,1
16538,9405,443,45039,443,5691,503,5188,14,15,7,7
16539,52261,5222,10119,5222,5380,2214,3166,55,503,26,29
16540,57196,53,50893,53,182,93,89,2,30,1,1
16541,51439,443,28008,443,10119,1855,8264,26,28,15,11
16542,47034,443,4001,443,4531,3268,1263,23,27,13,10
16543,53512,443,1529,443,1625,1038,587,14,34,8,6
16544,58463,53,64645,53,380,88,292,2,30,1,1
16545,38677,443,26000,443,5306,1619,3687,20,29,12,8
16546,55693,45341,22935,45341,70,70,0,1,5,1,0
16547,58930,443,60456,443,10413,7123,3290,30,18,17,13
16548,49236,443,49236,443,554853,293345,261508,600,69,317,283
16549,56369,443,26395,443,3674,1750,1924,23,203,12,11
16550,56359,443,2986,443,3734,1750,1984,24,203,12,12
16551,56360,443,15487,443,3734,1750,1984,24,203,12,12
16552,58928,443,59647,443,6548,4210,2338,23,18,12,11
16553,64988,27052,9710,27052,735,462,273,2,31,1,1
16554,48817,46429,48817,46429,763,296,467,4,1200,2,2
16555,56355,443,33571,443,3734,1750,1984,24,203,12,12
16556,38676,443,10906,443,5306,1619,3687,20,29,12,8
16557,50443,80,50443,80,73400,3702,69698,77,19,26,51
16558,56362,443,16235,443,3734,1750,1984,24,203,12,12
16559,53513,443,7067,443,1625,1038,587,14,34,8,6
16560,52632,443,52632,443,4351,1444,2907,19,28,11,8
16561,56363,443,61094,443,3734,1750,1984,24,203,12,12
16562,53516,443,26441,443,560,280,280,9,34,5,4
16563,14605,53,14605,53,209,77,132,2,32,1,1
16564,56354,443,18179,443,3775,1791,1984,24,203,12,12
16565,41252,53,41252,53,398,255,143,3,32,2,1
16566,56368,443,23641,443,3734,1750,1984,24,203,12,12
16567,64877,53,58345,53,182,93,89,2,30,1,1
16568,56358,443,57449,443,3734,1750,1984,24,203,12,12
16569,49611,19000,49520,19000,594,174,420,2,31,1,1
16570,55046,443,52512,443,3804,1099,2705,19,137,8,11
16571,46441,443,33380,443,416,210,206,7,28,4,3
16572,48817,6881,48817,6881,863,363,500,4,1200,2,2
16573,53146,443,41053,443,29874004,955051,28918953,31844,303,10580,21264
16574,38675,443,48538,443,5236,1549,3687,19,29,11,8
16575,35484,443,11377,443,1633,1038,595,14,34,8,6
16576,49237,443,49237,443,33985,8645,25340,53,35,28,25
16577,57442,2258,57442,2258,156,156,0,3,8,3,0
16578,56367,443,45911,443,3674,1750,1924,23,203,12,11
16579,56366,443,31914,443,3715,1791,1924,23,203,12,11
16580,56357,443,45710,443,3674,1750,1924,23,203,12,11
16581,56364,443,6103,443,3775,1791,1984,24,203,12,12
16582,56312,53,62143,53,711,87,624,2,30,1,1
16583,56615,53,58132,53,170,87,83,2,30,1,1
16584,39017,443,58610,443,5176,861,4315,16,26,9,7
16585,57027,53,52973,53,170,87,83,2,30,1,1
16586,50619,53,43137,53,815,95,720,2,30,1,1
16587,63440,53,0,0,206,95,111,2,30,1,1
16588,48817,33028,48817,33028,152,152,0,1,1200,1,0
16589,48817,13073,48817,13073,787,296,491,4,1200,2,2
16590,56088,53,23327,53,256,93,163,2,31,1,1
16591,55179,53,34684,53,182,93,89,2,31,1,1
16592,35708,443,18676,443,8264,1910,6354,21,361,10,11
16593,50176,53,47477,53,768,99,669,2,31,1,1
16594,38287,443,17803,443,424,210,214,7,131,4,3
16595,48817,27003,48817,27003,839,296,543,4,1200,2,2
16596,6881,6881,29502,6881,231,111,120,2,1200,1,1
16597,48817,16156,48817,16156,513,152,361,2,1200,1,1
16598,55349,53,40115,53,701,88,613,2,31,1,1
16599,48817,6884,48817,6884,479,277,202,4,1200,2,2
16600,48817,6881,48817,6881,479,277,202,4,1200,2,2
16601,45184,5228,38008,5228,9107,2358,6749,24,3600,13,11
16602,62988,60038,0,0,66,66,0,1,90,1,0
16603,51656,445,0,0,70,70,0,1,0,1,0
16604,51652,445,0,0,70,70,0,1,0,1,0
16605,54140,17372,0,0,66,66,0,1,0,1,0
16606,2543,25174,0,0,66,66,0,1,0,1,0
16607,55464,22114,0,0,62,62,0,1,0,1,0
16608,63264,445,0,0,70,70,0,1,0,1,0
16609,63423,445,0,0,66,66,0,1,0,1,0
16610,63364,57470,0,0,66,66,0,1,0,1,0
16611,52925,64147,0,0,62,62,0,1,0,1,0
16612,63262,445,0,0,70,70,0,1,0,1,0
16613,43639,26467,0,0,66,66,0,1,0,1,0
16614,26881,25174,0,0,66,66,0,1,0,1,0
16615,40128,80,6000,80,2437,1277,1160,12,16,7,5
16616,19944,22114,0,0,62,62,0,1,0,1,0
16617,63261,445,0,0,70,70,0,1,0,1,0
16618,22636,30188,0,0,66,66,0,1,0,1,0
16619,63260,445,0,0,70,70,0,1,0,1,0
16620,35937,25174,0,0,66,66,0,1,0,1,0
16621,63416,445,0,0,66,66,0,1,0,1,0
16622,63259,445,0,0,70,70,0,1,0,1,0
16623,19662,22114,0,0,62,62,0,1,0,1,0
16624,51638,445,0,0,70,70,0,1,0,1,0
16625,63253,445,0,0,70,70,0,1,0,1,0
16626,63254,445,0,0,70,70,0,1,0,1,0
16627,45169,14037,0,0,74,74,0,1,0,1,0
16628,60793,53733,0,0,66,66,0,1,0,1,0
16629,63414,445,0,0,66,66,0,1,0,1,0
16630,63239,445,0,0,70,70,0,1,0,1,0
16631,63237,445,0,0,70,70,0,1,0,1,0
16632,63234,445,0,0,70,70,0,1,0,1,0
16633,63229,445,0,0,70,70,0,1,0,1,0
16634,37555,16385,34137,16385,130,70,60,2,30,1,1
16635,56367,53,38735,53,194,102,92,2,30,1,1
16636,50980,443,12783,443,3964,1908,2056,23,94,13,10
16637,56751,443,1821,443,8059,2039,6020,20,15,11,9
16638,50038,53,65055,53,286,87,199,4,59,2,2
16639,34200,443,26443,443,7341,2121,5220,18,135,8,10
16640,56477,443,27592,443,5638,2934,2704,15,120,7,8
16641,54762,53,0,0,86,86,0,1,30,1,0
16642,46767,443,3623,443,8376,2231,6145,25,330,12,13
16643,45754,443,17919,443,1625,1038,587,14,25,8,6
16644,49558,443,48351,443,12704,3459,9245,50,1336,18,32
16645,34456,80,16801,80,2913,633,2280,15,16,8,7
16646,44293,443,16772,443,5880,2280,3600,31,76,14,17
16647,49928,443,19902,443,4904,864,4040,17,28,10,7
16648,49929,443,10803,443,7069,2667,4402,22,28,13,9
16649,40634,443,26237,443,4917,1273,3644,17,34,10,7
16650,41821,80,46291,80,1056,362,694,10,49,6,4
16651,64877,53,56552,53,183,94,89,2,29,1,1
16652,41613,80,21847,80,6003,691,5312,13,16,7,6
16653,41612,80,44236,80,2016,552,1464,8,16,5,3
16654,56615,53,39007,53,177,94,83,2,29,1,1
16655,57111,53,59340,53,199,94,105,2,30,1,1
16656,39924,443,50465,443,5229,1002,4227,21,16,11,10
16657,60794,20010,30261,20010,70,70,0,2,8,2,0
16658,56669,80,21282,80,234,234,0,4,12,4,0
16659,55794,443,55794,443,4578,1671,2907,19,28,11,8
16660,64723,53,45766,53,329,118,211,2,30,1,1
16661,38360,53,56266,53,168,78,90,2,30,1,1
16662,57027,53,33808,53,177,94,83,2,30,1,1
16663,56985,443,5059,443,2281,1126,1155,25,120,12,13
16664,55388,53,1153,53,177,94,83,2,30,1,1
16665,56747,53,48027,53,226,110,116,2,30,1,1
16666,56492,53,39207,53,177,94,83,2,30,1,1
16667,56747,53,24796,53,172,94,78,2,30,1,1
16668,55171,53,4183,53,79,79,0,2,34,2,0
16669,51911,80,54033,80,5474,1920,3554,20,65,12,8
16670,54743,80,43064,80,6453,1316,5137,16,315,9,7
16671,60337,443,11026,443,1862,1223,639,18,89,11,7
16672,56437,80,52294,80,17128,1499,15629,24,21,9,15
16673,55535,80,6697,80,18450,1862,16588,29,17,15,14
16674,34952,53,65291,53,177,94,83,2,30,1,1
16675,60553,443,11360,443,7981,1867,6114,32,313,17,15
16676,56221,443,24462,443,129824,16359,113465,185,459,79,106
16677,64009,80,25096,80,314,192,122,6,15,4,2
16678,56703,53,54677,53,183,94,89,2,30,1,1
16679,58938,443,4576,443,6035,770,5265,18,15,8,10
16680,34452,80,18909,80,6260,696,5564,17,16,9,8
16681,55258,53,4040,53,177,94,83,2,30,1,1
16682,56615,53,33953,53,177,94,83,2,30,1,1
16683,64443,53,23166,53,878,184,694,6,71,3,3
16684,57235,53,31902,53,210,102,108,2,30,1,1
16685,64971,27026,15730,27026,1012,462,550,4,30,2,2
16686,55179,53,18189,53,183,94,89,2,30,1,1
16687,56492,53,3429,53,177,94,83,2,30,1,1
16688,63989,53,19416,53,259,110,149,2,30,1,1
16689,65528,53,21468,53,168,86,82,2,30,1,1
16690,56490,443,32124,443,163763,5320,158443,178,120,60,118
16691,40146,443,31443,443,280,140,140,5,130,3,2
16692,40877,443,50860,443,6451,1003,5448,21,360,11,10
16693,48817,47005,48817,47005,158,158,0,1,1200,1,0
16694,55937,53,13424,53,177,94,83,2,30,1,1
16695,34454,80,29541,80,2913,633,2280,15,16,8,7
16696,9394,443,24044,443,3613,433,3180,11,15,6,5
16697,43166,80,43166,80,26540,1137,25403,36,136,15,21
16698,65480,53,23239,53,211,102,109,2,30,1,1
16699,37555,16384,61049,16384,130,70,60,2,30,1,1
16700,65263,53,53101,53,232,110,122,2,30,1,1
16701,56747,53,24392,53,172,94,78,2,30,1,1
16702,44080,443,25950,443,7476,2315,5161,18,135,8,10
16703,50986,443,50781,443,67798,17043,50755,202,146,110,92
16704,10125,443,63386,443,6151,2939,3212,28,332,13,15
16705,8890,443,57332,443,4367,1108,3259,37,426,11,26
16706,51979,443,24826,443,10613,3156,7457,42,15,24,18
16707,56396,443,27935,443,4239,1850,2389,25,179,12,13
16708,35265,80,15083,80,3524,2698,826,14,16,8,6
16709,5588,5588,0,0,3562,1936,1626,48,194,24,24
16710,51221,65427,56298,65427,460,150,310,2,1200,1,1
16711,60338,443,20283,443,3648,2251,1397,28,89,16,12
16712,9404,443,30760,443,5693,499,5194,14,15,7,7
16713,9407,443,42706,443,5697,503,5194,14,15,7,7
16714,49158,80,49158,80,10922,816,10106,19,18,8,11
16715,49935,443,48016,443,366,180,186,7,28,4,3
16716,49631,53,64330,53,198,102,96,2,33,1,1
16717,65422,53,8384,53,448,84,364,4,54,2,2
16718,54955,443,20454,443,10265,1831,8434,34,319,17,17
16719,52070,80,56531,80,3572,2746,826,14,15,8,6
16720,61406,443,61406,443,4529,1622,2907,19,27,11,8
16721,45727,443,38522,443,1625,1038,587,14,29,8,6
16722,41820,80,9493,80,1056,362,694,10,49,6,4
16723,32961,80,43846,80,480,258,222,8,12,5,3
16724,57913,443,45296,443,9578079,276384,9301695,9817,153,2984,6833
16725,38142,53,38142,53,404,259,145,3,32,2,1
16726,55763,8060,49115,8060,70,70,0,2,7,2,0
16727,56749,443,28025,443,8058,2038,6020,20,15,11,9
16728,50657,80,54275,80,23292,2267,21025,28,21,10,18
16729,59779,443,11374,443,142,142,0,1,5,1,0
16730,50441,80,50441,80,79227,5480,73747,89,19,32,57
16731,56279,443,27594,443,15248,5524,9724,54,364,27,27
16732,49566,443,36540,443,10225,5069,5156,30,106,17,13
16733,58420,53,57046,53,351,78,273,2,29,1,1
16734,56615,53,15642,53,177,94,83,2,29,1,1
16735,5588,5588,0,0,3562,1936,1626,48,193,24,24
16736,50130,53,58704,53,183,94,89,2,29,1,1
16737,50130,53,12691,53,183,94,89,2,29,1,1
16738,49008,53,13913,53,168,78,90,2,29,1,1
16739,58940,443,24448,443,5108,700,4408,15,15,7,8
16740,37658,16386,64660,16386,130,70,60,2,29,1,1
16741,34458,80,25271,80,6260,696,5564,17,16,9,8
16742,57387,53,39674,53,178,94,84,2,30,1,1
16743,48933,443,5665,443,4372,2402,1970,27,53,14,13
16744,50091,53,50600,53,164,86,78,2,30,1,1
16745,64927,53,2368,53,315,110,205,2,30,1,1
16746,55545,3389,55545,3389,3527,1638,1889,18,18,11,7
16747,55388,53,28391,53,177,94,83,2,30,1,1
16748,55258,53,48782,53,177,94,83,2,30,1,1
16749,50439,80,50439,80,96018,5956,90062,107,20,41,66
16750,64938,53,18539,53,210,102,108,2,30,1,1
16751,49545,53,14108,53,195,102,93,2,30,1,1
16752,40878,443,41466,443,6517,1003,5514,22,360,11,11
16753,50265,16082,44635,16082,858,858,0,14,1200,14,0
16754,60449,80,21730,80,50477,10880,39597,69,16,33,36
16755,45289,80,45289,80,144717,5580,139137,180,20,81,99
16756,56750,443,39492,443,8006,1986,6020,20,15,11,9
16757,58021,443,29855,443,8075,4109,3966,42,91,19,23
16758,38702,443,49260,443,1117339,17881,1099458,1006,16,256,750
16759,47508,443,1346,443,5778,1095,4683,17,26,10,7
16760,56748,443,11472,443,8007,1987,6020,20,15,11,9
16761,49653,80,47758,80,2815,1605,1210,17,166,9,8
16762,37555,16386,23177,16386,130,70,60,2,30,1,1
16763,57196,53,25390,53,183,94,89,2,30,1,1
16764,59732,27036,24754,27036,1218,924,294,6,30,3,3
16765,54951,443,21945,443,69882,3520,66362,96,320,38,58
16766,64249,53,23999,53,181,94,87,2,33,1,1
16767,48728,80,37214,80,3524,2698,826,14,16,8,6
16768,47643,80,39174,80,3524,2698,826,14,16,8,6
16769,55544,3389,55544,3389,3657,1638,2019,20,18,11,9
16770,56513,53,54850,53,215,102,113,2,30,1,1
16771,64975,27033,50776,27033,734,462,272,2,30,1,1
16772,56703,53,38555,53,183,94,89,2,30,1,1
16773,55840,53,36401,53,199,94,105,2,30,1,1
16774,56559,53,54013,53,177,94,83,2,30,1,1
16775,41554,53,50330,53,199,94,105,2,30,1,1
16776,59773,53,11146,53,218,78,140,2,31,1,1
16777,56134,53,62024,53,183,94,89,2,31,1,1
16778,55283,443,55908,443,2964,1657,1307,18,47,9,9
16779,60474,8999,37889,8999,70,70,0,2,8,2,0
16780,65455,53,29477,53,564,108,456,4,50,2,2
16781,50635,53,9293,53,199,94,105,2,30,1,1
16782,43818,53,4303,53,168,78,90,2,30,1,1
16783,51958,443,6859,443,9994,8270,1724,34,68,19,15
16784,64931,53,5623,53,179,94,85,2,30,1,1
16785,56588,53,8372,53,197,102,95,2,30,1,1
16786,56559,53,63676,53,177,94,83,2,30,1,1
16787,65390,53,64921,53,387,134,253,2,30,1,1
16788,64023,53,29476,53,179,94,85,2,30,1,1
16789,40876,443,14567,443,6450,1003,5447,21,360,11,10
16790,65427,53,2149,53,238,94,144,2,30,1,1
16791,55759,53,49971,53,177,94,83,2,30,1,1
16792,64707,53,25293,53,216,102,114,2,30,1,1
16793,10151,6889,16341,6889,481,150,331,2,1200,1,1
16794,48817,6889,48817,6889,158,158,0,1,1200,1,0
16795,48817,6881,48817,6881,334,158,176,2,1200,1,1
16796,48817,63615,48817,63615,765,296,469,4,1200,2,2
16797,61140,443,36707,443,10803,2906,7897,20,135,10,10
16798,57441,443,53245,443,9774,3034,6740,29,19,14,15
16799,60795,40010,57308,40010,316,136,180,6,6,3,3
16800,50077,80,42513,80,804,380,424,9,15,5,4
16801,55937,53,36384,53,177,94,83,2,30,1,1
16802,55643,53,52917,53,183,94,89,2,31,1,1
16803,38703,443,53775,443,90561,3481,87080,96,16,31,65
16804,52082,14804,9932,14804,70,70,0,2,8,2,0
16805,55179,53,17808,53,183,94,89,2,30,1,1
16806,43681,443,22567,443,40598,5313,35285,83,97,43,40
16807,56747,443,61148,443,8059,2039,6020,20,16,11,9
16808,63228,445,0,0,70,70,0,1,0,1,0
16809,63407,445,0,0,66,66,0,1,0,1,0
16810,63404,445,0,0,66,66,0,1,0,1,0
16811,21064,25174,0,0,62,62,0,1,0,1,0
16812,51578,44847,0,0,66,66,0,1,0,1,0
16813,14397,37965,0,0,62,62,0,1,0,1,0
16814,10914,35974,0,0,60,60,0,1,0,1,0
16815,61767,25174,0,0,62,62,0,1,0,1,0
16816,515,10214,0,0,66,66,0,1,0,1,0
16817,36696,25174,0,0,62,62,0,1,0,1,0
16818,63217,445,0,0,70,70,0,1,0,1,0
16819,59524,25174,0,0,66,66,0,1,0,1,0
16820,1262,23,0,0,60,60,0,1,0,1,0
16821,63062,11392,0,0,66,66,0,1,0,1,0
16822,5228,3434,0,0,1093,1093,0,1,0,1,0
16823,51630,445,0,0,70,70,0,1,0,1,0
16824,51626,445,0,0,70,70,0,1,0,1,0
16825,51627,445,0,0,70,70,0,1,0,1,0
16826,63387,445,0,0,66,66,0,1,0,1,0
16827,63389,445,0,0,66,66,0,1,0,1,0
16828,63391,445,0,0,66,66,0,1,0,1,0
16829,63390,445,0,0,66,66,0,1,0,1,0
16830,63388,445,0,0,66,66,0,1,0,1,0
16831,63385,445,0,0,66,66,0,1,0,1,0
16832,63386,445,0,0,66,66,0,1,0,1,0
16833,63384,445,0,0,66,66,0,1,0,1,0
16834,52483,1433,0,0,60,60,0,1,0,1,0
16835,60403,22114,0,0,66,66,0,1,0,1,0
16836,26531,37965,0,0,62,62,0,1,0,1,0
16837,443,61686,0,0,1484,1484,0,1,0,1,0
16838,31235,22114,0,0,62,62,0,1,0,1,0
16839,63213,445,0,0,70,70,0,1,0,1,0
16840,22439,25174,0,0,66,66,0,1,0,1,0
16841,52340,64147,0,0,66,66,0,1,0,1,0
16842,1865,25174,0,0,62,62,0,1,0,1,0
16843,26235,37965,0,0,66,66,0,1,0,1,0
16844,63203,445,0,0,70,70,0,1,0,1,0
16845,63204,445,0,0,70,70,0,1,0,1,0
16846,51621,445,0,0,70,70,0,1,0,1,0
16847,51622,445,0,0,70,70,0,1,0,1,0
16848,51609,445,0,0,70,70,0,1,0,1,0
16849,51610,445,0,0,70,70,0,1,0,1,0
16850,63200,445,0,0,70,70,0,1,0,1,0
16851,63196,445,0,0,70,70,0,1,0,1,0
16852,16454,25174,0,0,62,62,0,1,0,1,0
16853,63369,445,0,0,66,66,0,1,0,1,0
16854,63370,445,0,0,66,66,0,1,0,1,0
16855,63368,445,0,0,66,66,0,1,0,1,0
16856,9089,55108,0,0,148,148,0,1,0,1,0
16857,32736,22114,0,0,66,66,0,1,0,1,0
16858,34152,11119,0,0,148,148,0,1,0,1,0
16859,28795,37965,0,0,62,62,0,1,0,1,0
16860,22220,25174,0,0,146,146,0,1,0,1,0
16861,59476,23,0,0,60,60,0,1,0,1,0
16862,50046,22114,0,0,62,62,0,1,0,1,0
16863,48706,23393,0,0,60,60,0,1,0,1,0
16864,42030,25,0,0,74,74,0,1,0,1,0
16865,51607,445,0,0,70,70,0,1,0,1,0
16866,57131,35776,0,0,145,145,0,1,0,1,0
16867,51604,445,0,0,70,70,0,1,0,1,0
16868,51600,445,0,0,70,70,0,1,0,1,0
16869,51597,445,0,0,70,70,0,1,0,1,0
16870,63191,445,0,0,70,70,0,1,0,1,0
16871,1860,25174,0,0,66,66,0,1,0,1,0
16872,2849,30188,0,0,62,62,0,1,0,1,0
16873,2083,25174,0,0,62,62,0,1,0,1,0
16874,64587,43890,0,0,66,66,0,1,0,1,0
16875,50328,22114,0,0,66,66,0,1,0,1,0
16876,54236,36829,0,0,66,66,0,1,0,1,0
16877,1620,53567,0,0,66,66,0,1,0,1,0
16878,6247,51221,0,0,78,78,0,1,0,1,0
16879,63183,445,0,0,70,70,0,1,0,1,0
16880,53073,32468,0,0,66,66,0,1,0,1,0
16881,25878,25174,0,0,66,66,0,1,0,1,0
16882,57496,25174,0,0,66,66,0,1,0,1,0
16883,63182,445,0,0,70,70,0,1,0,1,0
16884,51414,22,0,0,60,60,0,1,0,1,0
16885,62512,25174,0,0,62,62,0,1,0,1,0
16886,2383,37965,0,0,66,66,0,1,0,1,0
16887,51588,445,0,0,70,70,0,1,0,1,0
16888,51587,445,0,0,70,70,0,1,0,1,0
16889,51584,445,0,0,70,70,0,1,0,1,0
16890,29972,50584,0,0,62,62,0,1,0,1,0
16891,63176,445,0,0,70,70,0,1,0,1,0
16892,25570,35440,0,0,146,146,0,1,0,1,0
16893,6729,51505,0,0,62,62,0,1,0,1,0
16894,63357,445,0,0,66,66,0,1,0,1,0
16895,11878,37807,0,0,62,62,0,1,0,1,0
16896,63175,445,0,0,70,70,0,1,0,1,0
16897,55341,39004,0,0,74,74,0,1,0,1,0
16898,58627,25174,0,0,62,62,0,1,0,1,0
16899,63171,445,0,0,70,70,0,1,0,1,0
16900,11136,15503,0,0,62,62,0,1,0,1,0
16901,24144,57470,0,0,62,62,0,1,0,1,0
16902,51581,445,0,0,70,70,0,1,0,1,0
16903,52238,26467,0,0,62,62,0,1,0,1,0
16904,51579,445,0,0,70,70,0,1,0,1,0
16905,63170,445,0,0,70,70,0,1,0,1,0
16906,5228,3434,0,0,1093,1093,0,1,0,1,0
16907,5228,3434,0,0,601,601,0,1,0,1,0
16908,5228,3434,0,0,345,345,0,1,0,1,0
16909,40312,55442,0,0,62,62,0,1,0,1,0
16910,47788,30170,0,0,146,146,0,1,0,1,0
16911,30373,23,0,0,60,60,0,1,0,1,0
16912,42285,57470,0,0,62,62,0,1,0,1,0
16913,50734,37965,0,0,62,62,0,1,0,1,0
16914,28192,50584,0,0,66,66,0,1,0,1,0
16915,45726,64147,0,0,62,62,0,1,0,1,0
16916,0,0,0,0,198,128,70,3,0,2,1
16917,47913,25174,0,0,62,62,0,1,0,1,0
16918,52038,50584,0,0,62,62,0,1,0,1,0
16919,63339,445,0,0,66,66,0,1,0,1,0
16920,63341,445,0,0,66,66,0,1,0,1,0
16921,56127,37965,0,0,66,66,0,1,0,1,0
16922,23658,18375,0,0,62,62,0,1,0,1,0
16923,30500,26296,0,0,159,159,0,1,0,1,0
16924,34073,37965,0,0,62,62,0,1,0,1,0
16925,63165,445,0,0,70,70,0,1,0,1,0
16926,54280,3385,0,0,60,60,0,1,0,1,0
16927,51569,445,0,0,70,70,0,1,0,1,0
16928,51567,445,0,0,70,70,0,1,0,1,0
16929,51566,445,0,0,70,70,0,1,0,1,0
16930,51560,445,0,0,70,70,0,1,0,1,0
16931,1943,48817,0,0,62,62,0,1,0,1,0
16932,48301,25174,0,0,66,66,0,1,0,1,0
16933,63336,445,0,0,66,66,0,1,0,1,0
16934,39110,50584,0,0,62,62,0,1,0,1,0
16935,56872,21247,0,0,74,74,0,1,0,1,0
16936,3399,25174,0,0,66,66,0,1,0,1,0
16937,54726,30041,0,0,66,66,0,1,0,1,0
16938,63325,445,0,0,66,66,0,1,0,1,0
16939,63331,445,0,0,66,66,0,1,0,1,0
16940,63330,445,0,0,66,66,0,1,0,1,0
16941,63328,445,0,0,66,66,0,1,0,1,0
16942,63320,445,0,0,66,66,0,1,0,1,0
16943,63329,445,0,0,66,66,0,1,0,1,0
16944,63326,445,0,0,66,66,0,1,0,1,0
16945,52682,22114,0,0,66,66,0,1,0,1,0
16946,60097,22114,0,0,62,62,0,1,0,1,0
16947,32746,50584,0,0,146,146,0,1,0,1,0
16948,42986,25174,0,0,66,66,0,1,0,1,0
16949,13235,44847,0,0,66,66,0,1,0,1,0
16950,51554,445,0,0,70,70,0,1,0,1,0
16951,27038,51505,0,0,146,146,0,1,0,1,0
16952,45118,39004,0,0,74,74,0,1,0,1,0
16953,49824,25174,0,0,62,62,0,1,0,1,0
16954,36663,22114,0,0,146,146,0,1,0,1,0
16955,51551,445,0,0,70,70,0,1,0,1,0
16956,51548,445,0,0,70,70,0,1,0,1,0
16957,51547,445,0,0,70,70,0,1,0,1,0
16958,39313,37965,0,0,62,62,0,1,0,1,0
16959,63152,445,0,0,70,70,0,1,0,1,0
16960,6843,42873,0,0,62,62,0,1,0,1,0
16961,57991,22114,0,0,66,66,0,1,0,1,0
16962,6842,42873,0,0,66,66,0,1,0,1,0
16963,43207,26467,0,0,62,62,0,1,0,1,0
16964,54021,25174,0,0,62,62,0,1,0,1,0
16965,35111,22114,0,0,66,66,0,1,0,1,0
16966,36804,25174,0,0,66,66,0,1,0,1,0
16967,39959,23117,0,0,62,62,0,1,0,1,0
16968,39839,22114,0,0,146,146,0,1,0,1,0
16969,43814,34476,0,0,146,146,0,1,0,1,0
16970,63149,445,0,0,70,70,0,1,0,1,0
16971,56289,25174,0,0,66,66,0,1,0,1,0
16972,51866,22114,0,0,66,66,0,1,0,1,0
16973,30304,26467,0,0,62,62,0,1,0,1,0
16974,52166,26467,0,0,66,66,0,1,0,1,0
16975,51543,445,0,0,70,70,0,1,0,1,0
16976,51544,445,0,0,70,70,0,1,0,1,0
16977,51540,445,0,0,70,70,0,1,0,1,0
16978,63316,445,0,0,66,66,0,1,0,1,0
16979,45964,2225,0,0,60,60,0,1,0,1,0
16980,26940,443,35054,443,7599,2842,4757,27,22,15,12
16981,57702,53,57702,53,398,255,143,3,32,2,1
16982,58929,443,63640,443,6160,4121,2039,22,17,11,11
16983,56149,53,12166,53,174,89,85,2,30,1,1
16984,56902,53,41488,53,768,99,669,2,30,1,1
16985,55609,53,45313,53,172,88,84,2,30,1,1
16986,58986,443,33028,443,2894,1653,1241,24,26,12,12
16987,44661,443,11205,443,9468,2242,7226,23,15,12,11
16988,59923,53,59923,53,365,233,132,3,33,2,1
16989,6159,53,6159,53,404,259,145,3,32,2,1
16990,53875,43611,35716,43611,70,70,0,2,8,2,0
16991,43784,443,17789,443,10458,1688,8770,30,15,17,13
16992,50134,53,55373,53,748,106,642,2,30,1,1
16993,56803,53,43368,53,182,93,89,2,30,1,1
16994,49718,53,39555,53,793,101,692,2,30,1,1
16995,38662,15000,56543,15000,138,78,60,2,6,1,1
16996,137,137,55406,137,114,114,0,2,32,2,0
16997,53878,55950,58060,55950,70,70,0,2,8,2,0
16998,56503,53,37647,53,578,286,292,9,15,5,4
16999,34996,5222,11344,5222,8140,2222,5918,42,201,22,20
17000,53876,53380,35736,53380,70,70,0,2,8,2,0
17001,56556,53,39317,53,762,97,665,2,30,1,1
17002,64023,53,59287,53,174,89,85,2,30,1,1
17003,64628,53,26706,53,753,93,660,2,30,1,1
17004,44967,443,36379,443,7474,1946,5528,33,270,18,15
17005,57163,443,13914,443,1779,1375,404,11,40,5,6
17006,56354,53,25392,53,753,93,660,2,30,1,1
17007,53162,60352,25976,60352,70,70,0,2,8,2,0
17008,55156,53,48355,53,256,87,169,4,37,2,2
17009,25309,53,25309,53,371,237,134,3,33,2,1
17010,29599,443,15239,443,2227,1018,1209,17,16,8,9
17011,56588,53,28936,53,194,99,95,2,30,1,1
17012,52385,53,0,0,138,69,69,2,30,1,1
17013,51606,443,32165,443,9979,4380,5599,26,256,12,14
17014,50108,53,31749,53,174,89,85,2,30,1,1
17015,56668,53,61467,53,701,88,613,2,30,1,1
17016,58922,443,2924,443,14553,9653,4900,38,19,22,16
17017,64950,53,8334,53,186,95,91,2,31,1,1
17018,50176,443,54312,443,6081,844,5237,17,15,9,8
17019,52079,1024,34017,1024,70,70,0,2,8,2,0
17020,37569,443,55677,443,120566,15345,105221,173,125,72,101
17021,55759,53,57416,53,170,87,83,2,30,1,1
17022,50552,53,56537,53,710,89,621,2,30,1,1
17023,56926,53,27418,53,711,87,624,2,30,1,1
17024,55376,53,48930,53,789,110,679,2,31,1,1
17025,56375,53,7555,53,216,110,106,2,31,1,1
17026,55489,53,34902,53,748,106,642,2,31,1,1
17027,56373,53,1027,53,181,98,83,2,31,1,1
17028,49313,53,6801,53,295,101,194,4,31,2,2
17029,64787,53,4166,53,174,89,85,2,31,1,1
17030,59005,443,25143,443,4921,2525,2396,14,135,7,7
17031,48817,32897,48817,32897,152,152,0,1,1200,1,0
17032,56185,53,24061,53,168,86,82,2,31,1,1
17033,55058,53,41146,53,216,110,106,2,31,1,1
17034,56712,443,43897,443,1540037,36876,1503161,1511,62,511,1000
17035,56960,53,22344,53,192,98,94,2,31,1,1
17036,56272,53,26836,53,186,95,91,2,31,1,1
17037,64668,53,32390,53,772,103,669,2,31,1,1
17038,57119,53,0,0,318,95,223,2,31,1,1
17039,50504,53,13475,53,168,86,82,2,31,1,1
17040,56260,53,39887,53,170,87,83,2,31,1,1
17041,64787,53,24820,53,740,93,647,2,31,1,1
17042,55251,53,62666,53,208,106,102,2,31,1,1
17043,54959,53,17105,53,206,105,101,2,31,1,1
17044,24929,53,24929,53,217,87,130,2,31,1,1
17045,55383,443,17690,443,40612,4090,36522,71,150,31,40
17046,57063,53,16093,53,186,95,91,2,31,1,1
17047,55829,53,4732,53,208,106,102,2,31,1,1
17048,64551,53,55757,53,755,94,661,2,31,1,1
17049,56375,53,32161,53,216,110,106,2,31,1,1
17050,55190,53,7214,53,733,86,647,2,31,1,1
17051,57083,53,56856,53,755,94,661,2,31,1,1
17052,63090,53,11762,53,510,164,346,2,31,1,1
17053,65354,53,6099,53,168,86,82,2,31,1,1
17054,56762,53,35908,53,168,86,82,2,31,1,1
17055,56810,53,54787,53,170,87,83,2,31,1,1
17056,51538,445,0,0,70,70,0,1,0,1,0
17057,63145,445,0,0,70,70,0,1,0,1,0
17058,54796,22114,0,0,66,66,0,1,0,1,0
17059,63311,445,0,0,66,66,0,1,0,1,0
17060,3169,22114,0,0,66,66,0,1,0,1,0
17061,63143,445,0,0,70,70,0,1,0,1,0
17062,49577,57470,0,0,62,62,0,1,0,1,0
17063,56403,51505,0,0,66,66,0,1,0,1,0
17064,4019,50584,0,0,66,66,0,1,0,1,0
17065,63308,445,0,0,66,66,0,1,0,1,0
17066,63310,445,0,0,66,66,0,1,0,1,0
17067,63141,445,0,0,70,70,0,1,0,1,0
17068,51567,443,62736,443,400,70,330,7,17,2,5
17069,55156,53,47566,53,256,87,169,4,37,2,2
17070,65506,443,5450,443,92243,4519,87724,105,16,39,66
17071,61643,22114,0,0,62,62,0,1,0,1,0
17072,47812,30627,0,0,62,62,0,1,0,1,0
17073,63307,445,0,0,66,66,0,1,0,1,0
17074,7912,35440,0,0,146,146,0,1,0,1,0
17075,62217,37807,0,0,66,66,0,1,0,1,0
17076,55408,64147,0,0,66,66,0,1,0,1,0
17077,62189,64147,0,0,62,62,0,1,0,1,0
17078,58247,57866,0,0,66,66,0,1,0,1,0
17079,16057,51050,0,0,66,66,0,1,0,1,0
17080,63741,50584,0,0,66,66,0,1,0,1,0
17081,17173,23,0,0,60,60,0,1,0,1,0
17082,60117,50934,0,0,66,66,0,1,0,1,0
17083,51532,445,0,0,70,70,0,1,0,1,0
17084,45169,14037,0,0,74,74,0,1,0,1,0
17085,58193,23,0,0,60,60,0,1,0,1,0
17086,51522,445,0,0,70,70,0,1,0,1,0
17087,51525,445,0,0,70,70,0,1,0,1,0
17088,45682,8055,0,0,159,159,0,1,0,1,0
17089,22948,26467,0,0,62,62,0,1,0,1,0
17090,27081,10197,0,0,62,62,0,1,0,1,0
17091,63134,445,0,0,70,70,0,1,0,1,0
17092,10949,22114,0,0,62,62,0,1,0,1,0
17093,45535,25174,0,0,66,66,0,1,0,1,0
17094,63132,445,0,0,70,70,0,1,0,1,0
17095,51728,44847,0,0,66,66,0,1,0,1,0
17096,63294,445,0,0,66,66,0,1,0,1,0
17097,62348,65348,0,0,145,145,0,1,0,1,0
17098,6872,23,0,0,60,60,0,1,0,1,0
17099,63131,445,0,0,70,70,0,1,0,1,0
17100,64595,64147,0,0,66,66,0,1,0,1,0
17101,29742,50584,0,0,146,146,0,1,0,1,0
17102,6712,5060,0,0,410,410,0,1,0,1,0
17103,63130,445,0,0,70,70,0,1,0,1,0
17104,63717,37965,0,0,62,62,0,1,0,1,0
17105,1030,35776,0,0,139,139,0,1,0,1,0
17106,63129,445,0,0,70,70,0,1,0,1,0
17107,64963,53,58073,53,453,186,267,6,30,3,3
17108,52083,26607,11051,26607,70,70,0,2,7,2,0
17109,49791,53,37520,53,412,90,322,4,34,2,2
17110,60471,19776,4815,19776,70,70,0,1,5,1,0
17111,55388,53,11740,53,292,87,205,4,42,2,2
17112,60334,443,17024,443,7506,4789,2717,28,130,16,12
17113,36816,1812,36816,1812,204,138,66,2,29,1,1
17114,56803,53,52529,53,183,94,89,2,30,1,1
17115,57264,53,53973,53,197,102,95,2,30,1,1
17116,50204,80,48586,80,1221,781,440,11,14,6,5
17117,54519,443,53980,443,8413,2503,5910,23,16,13,10
17118,64735,53,3296,53,730,102,628,2,30,1,1
17119,53042,443,14232,443,5452,1545,3907,22,16,13,9
17120,56446,443,26551,443,8620,2018,6602,34,80,18,16
17121,56703,80,22325,80,41915,4128,37787,59,64,29,30
17122,52084,30863,64593,30863,70,70,0,2,7,2,0
17123,52056,50328,41814,50328,70,70,0,1,4,1,0
17124,55156,53,28197,53,256,87,169,4,36,2,2
17125,46892,443,33257,443,12488,5447,7041,28,16,16,12
17126,55828,443,33777,443,8420,4472,3948,63,450,32,31
17127,123,123,13425,123,184,94,90,2,29,1,1
17128,61066,53,0,0,283,78,205,2,29,1,1
17129,55156,53,47092,53,256,87,169,4,36,2,2
17130,23613,53,55694,53,177,94,83,2,29,1,1
17131,61230,53,16263,53,177,94,83,2,29,1,1
17132,64069,53,35417,53,183,86,97,2,29,1,1
17133,52413,53,24477,53,168,78,90,2,30,1,1
17134,64967,27051,5112,27051,1020,462,558,4,29,2,2
17135,53801,53,14956,53,167,78,89,2,30,1,1
17136,58935,443,64941,443,5167,700,4467,16,15,7,9
17137,63034,443,51705,443,37694,8319,29375,85,153,36,49
17138,58173,993,62958,993,430,60,370,7,24,2,5
17139,49786,443,10389,443,8941,1816,7125,27,15,15,12
17140,36604,443,8659,443,6506,1532,4974,28,16,14,14
17141,34432,80,52921,80,6260,696,5564,17,16,9,8
17142,49376,53,15412,53,391,134,257,2,30,1,1
17143,55641,53,43709,53,70,70,0,1,30,1,0
17144,49686,53,47017,53,183,94,89,2,30,1,1
17145,46674,53,59897,53,168,78,90,2,30,1,1
17146,52080,9554,2824,9554,70,70,0,2,7,2,0
17147,60333,443,9820,443,8945,5766,3179,30,130,18,12
17148,48778,443,13282,443,6770,2047,4723,26,16,14,12
17149,34298,53,58428,53,199,94,105,2,30,1,1
17150,55643,53,36774,53,183,94,89,2,30,1,1
17151,56746,443,25716,443,8006,1986,6020,20,15,11,9
17152,49830,443,24513,443,8471,2343,6128,30,240,15,15
17153,56067,53,5556,53,195,102,93,2,30,1,1
17154,58934,443,63790,443,5167,700,4467,16,15,7,9
17155,64900,53,45787,53,197,102,95,2,30,1,1
17156,49447,53,53080,53,168,78,90,2,30,1,1
17157,50056,27018,46603,27018,468,390,78,5,30,4,1
17158,55669,53,38123,53,177,94,83,2,30,1,1
17159,55759,53,16569,53,177,94,83,2,30,1,1
17160,46707,443,23817,443,9723,1780,7943,35,120,17,18
17161,49777,53,52771,53,216,110,106,2,30,1,1
17162,49747,53,22028,53,278,94,184,2,30,1,1
17163,63884,53,63884,53,400,257,143,3,33,2,1
17164,55609,53,21760,53,178,94,84,2,30,1,1
17165,38564,443,56432,443,1312,651,661,13,185,7,6
17166,33947,443,18903,443,25302,10587,14715,88,123,37,51
17167,45679,53,45679,53,262,106,156,2,33,1,1
17168,60469,60092,63327,60092,70,70,0,1,5,1,0
17169,63848,80,63848,80,555419,4827,550592,451,21,64,387
17170,57206,53,29989,53,292,85,207,4,50,2,2
17171,59782,53,21953,53,168,78,90,2,30,1,1
17172,55179,53,32980,53,183,94,89,2,30,1,1
17173,55609,53,6401,53,178,94,84,2,30,1,1
17174,49251,53,13051,53,94,94,0,1,30,1,0
17175,49908,53,39258,53,789,110,679,2,30,1,1
17176,56149,53,1500,53,179,94,85,2,30,1,1
17177,64787,53,33533,53,179,94,85,2,30,1,1
17178,36621,443,53395,443,2239099,75601,2163498,2512,71,983,1529
17179,56770,443,61506,443,5829,2962,2867,35,89,17,18
17180,56588,53,38290,53,305,99,206,4,49,2,2
17181,51218,5223,10817,5223,11005,5789,5216,34,23,18,16
17182,38405,80,54534,80,1114,534,580,12,16,7,5
17183,53882,13613,12263,13613,320,140,180,6,5,3,3
17184,17428,3389,17428,3389,4695,2520,2175,22,19,13,9
17185,54816,443,23557,443,130,70,60,3,4,2,1
17186,60472,20273,4062,20273,70,70,0,1,5,1,0
17187,55701,31543,58312,31543,320,140,180,6,5,3,3
17188,37116,80,37116,80,2971,1509,1462,10,15,6,4
17189,53964,443,1978,443,152,78,74,2,5,1,1
17190,56700,80,19955,80,51889,4253,47636,68,64,31,37
17191,56745,443,12454,443,8058,2038,6020,20,15,11,9
17192,49545,53,14394,53,195,102,93,2,29,1,1
17193,52164,443,1593,443,161883,8848,153035,177,54,64,113
17194,51709,53,0,0,201,94,107,2,29,1,1
17195,55643,53,52326,53,183,94,89,2,29,1,1
17196,37611,443,31494,443,3936,1618,2318,26,146,14,12
17197,54550,53,0,0,188,86,102,2,29,1,1
17198,9742,80,9742,80,1384,648,736,9,15,5,4
17199,56803,53,37278,53,183,94,89,2,29,1,1
17200,43910,443,49945,443,10506,2984,7522,30,15,17,13
17201,56134,53,59241,53,183,94,89,2,29,1,1
17202,40026,443,36114,443,6058,1749,4309,22,200,13,9
17203,58841,443,21745,443,18238,3980,14258,61,152,27,34
17204,50654,80,39837,80,3728,1504,2224,13,21,7,6
17205,55759,53,35937,53,177,94,83,2,30,1,1
17206,50655,80,2422,80,2108,1167,941,10,20,6,4
17207,61956,80,61956,80,2102,1583,519,11,23,6,5
17208,5588,5588,0,0,3562,1936,1626,48,194,24,24
17209,56588,53,41777,53,197,102,95,2,29,1,1
17210,64023,53,2522,53,179,94,85,2,29,1,1
17211,64987,27042,62086,27042,1012,462,550,4,30,2,2
17212,64900,53,46043,53,197,102,95,2,30,1,1
17213,58764,53,65299,53,268,94,174,2,30,1,1
17214,50108,53,40711,53,179,94,85,2,30,1,1
17215,64023,53,57287,53,179,94,85,2,30,1,1
17216,50376,53,47622,53,167,78,89,2,30,1,1
17217,55609,53,4360,53,178,94,84,2,30,1,1
17218,50077,53,35101,53,787,110,677,2,30,1,1
17219,49777,53,28087,53,216,110,106,2,30,1,1
17220,49620,53,15285,53,211,110,101,2,30,1,1
17221,56267,53,59732,53,453,186,267,6,30,3,3
17222,49686,53,55592,53,183,94,89,2,30,1,1
17223,54974,53,5978,53,212,102,110,2,30,1,1
17224,56260,53,6502,53,177,94,83,2,30,1,1
17225,64892,53,23593,53,772,102,670,2,30,1,1
17226,47512,443,61793,443,8785,2057,6728,31,396,10,21
17227,55058,53,43398,53,216,110,106,2,31,1,1
17228,56960,53,21026,53,196,102,94,2,31,1,1
17229,50584,6881,29773,6881,502,150,352,2,1200,1,1
17230,44847,22467,39791,22467,150,150,0,1,1200,1,0
17231,19473,40959,26703,40959,491,150,341,2,1200,1,1
17232,65381,53,27857,53,317,102,215,2,31,1,1
17233,62345,443,13195,443,6343025,74037,6268988,5018,58,765,4253
17234,53270,443,54512,443,12757,4360,8397,41,17,23,18
17235,43880,80,10125,80,2693,841,1852,13,16,8,5
17236,56809,53,56809,53,404,259,145,3,33,2,1
17237,9227,443,31374,443,5146,960,4186,17,25,9,8
17238,49385,443,34796,443,44437,2600,41837,62,16,28,34
17239,52092,443,18467,443,13078,7055,6023,114,162,59,55
17240,56109,53,22951,53,177,94,83,2,30,1,1
17241,54528,53,37583,53,197,94,103,2,30,1,1
17242,46331,53,26643,53,199,94,105,2,30,1,1
17243,65506,53,15371,53,197,102,95,2,30,1,1
17244,38562,443,22999,443,1310,649,661,13,185,7,6
17245,65505,443,12963,443,458741,13270,445471,469,16,164,305
17246,58614,53,27966,53,168,78,90,2,30,1,1
17247,49866,53,19774,53,225,110,115,2,30,1,1
17248,64546,53,63352,53,889,404,485,10,30,5,5
17249,49359,53,28261,53,718,94,624,2,30,1,1
17250,55669,53,15952,53,177,94,83,2,30,1,1
17251,51622,53,52520,53,260,86,174,2,30,1,1
17252,64549,53,44048,53,273,86,187,2,30,1,1
17253,57338,443,27463,443,8126,1887,6239,32,732,17,15
17254,56067,53,40948,53,195,102,93,2,30,1,1
17255,55961,53,7584,53,214,102,112,2,30,1,1
17256,49224,53,60967,53,177,94,83,2,30,1,1
17257,49598,53,15528,53,214,102,112,2,30,1,1
17258,49255,53,62654,53,212,102,110,2,30,1,1
17259,56160,53,58234,53,195,102,93,2,31,1,1
17260,48817,57013,48817,57013,158,158,0,1,1200,1,0
17261,51221,3054,33559,3054,870,330,540,12,1320,6,6
17262,49977,53,38356,53,209,110,99,2,30,1,1
17263,64950,53,65250,53,193,102,91,2,30,1,1
17264,65335,53,50606,53,216,102,114,2,30,1,1
17265,55417,53,42244,53,179,94,85,2,30,1,1
17266,56367,53,31807,53,194,102,92,2,30,1,1
17267,56160,53,61640,53,195,102,93,2,30,1,1
17268,64357,53,56985,53,183,94,89,2,30,1,1
17269,57210,53,57210,53,628,82,546,2,30,1,1
17270,55660,53,31252,53,177,94,83,2,30,1,1
17271,63095,443,9067,443,571,166,405,2,30,1,1
17272,63094,53,39482,53,384,166,218,2,30,1,1
17273,63092,53,40692,53,304,86,218,2,30,1,1
17274,55945,53,49702,53,177,94,83,2,31,1,1
17275,54959,53,55132,53,211,110,101,2,31,1,1
17276,55417,53,15668,53,179,94,85,2,31,1,1
17277,56272,53,13597,53,193,102,91,2,31,1,1
17278,54540,443,17427,443,6680,3784,2896,18,135,9,9
17279,56560,53,25642,53,900,110,790,2,31,1,1
17280,64357,53,37789,53,183,94,89,2,31,1,1
17281,56373,53,9374,53,177,94,83,2,30,1,1
17282,56260,53,30984,53,177,94,83,2,31,1,1
17283,50999,53,58447,53,214,78,136,2,30,1,1
17284,65506,53,20953,53,197,102,95,2,30,1,1
17285,49828,53,30864,53,340,110,230,2,31,1,1
17286,63631,443,40886,443,8640,5157,3483,17,120,10,7
17287,49656,443,4978,443,182624,7130,175494,212,132,77,135
17288,62287,443,17565,443,3644,610,3034,13,119,6,7
17289,45908,443,37140,443,507235,15454,491781,534,136,188,346
17290,55320,53,54468,53,304,94,210,2,30,1,1
17291,55417,53,40418,53,179,94,85,2,30,1,1
17292,55750,53,13328,53,211,110,101,2,30,1,1
17293,63093,443,45246,443,304,86,218,2,30,1,1
17294,50098,53,35550,53,199,102,97,2,31,1,1
17295,55795,443,23533,443,5283,2688,2595,14,135,7,7
17296,58029,443,3427,443,1312,651,661,13,185,7,6
17297,58031,443,14165,443,1314,653,661,13,185,7,6
17298,30188,49786,29335,49786,502,150,352,2,1200,1,1
17299,60596,53,45720,53,300,86,214,2,31,1,1
17300,55942,53,19231,53,197,102,95,2,31,1,1
17301,52077,51638,13368,51638,70,70,0,2,8,2,0
17302,59875,443,49654,443,6922,2214,4708,32,136,20,12
17303,54960,443,1507,443,17670,2044,15626,53,316,21,32
17304,42158,443,61169,443,6865,3366,3499,39,206,15,24
17305,63319,53,8378,53,315,102,213,2,31,1,1
17306,55454,53,12163,53,168,86,82,2,32,1,1
17307,52075,37919,58563,37919,70,70,0,2,8,2,0
17308,53873,52055,21698,52055,70,70,0,2,8,2,0
17309,56699,80,7390,80,64386,3122,61264,79,64,35,44
17310,49221,36069,51500,36069,1941,1009,932,10,16,6,4
17311,55989,53,49458,53,205,86,119,2,30,1,1
17312,53800,53,27732,53,260,86,174,2,30,1,1
17313,64472,53,59070,53,183,94,89,2,31,1,1
17314,63087,443,39607,443,448,166,282,2,31,1,1
17315,64576,53,14840,53,194,102,92,2,31,1,1
17316,63076,443,26735,443,304,86,218,2,31,1,1
17317,56661,443,39690,443,7900,3324,4576,28,139,13,15
17318,50458,53,29574,53,177,94,83,2,31,1,1
17319,57359,53,20340,53,458,188,270,6,31,3,3
17320,53867,60272,19562,60272,70,70,0,2,8,2,0
17321,49763,53,30741,53,258,110,148,2,30,1,1
17322,49224,53,31598,53,177,94,83,2,30,1,1
17323,63126,445,0,0,70,70,0,1,0,1,0
17324,63124,445,0,0,70,70,0,1,0,1,0
17325,1036,64147,0,0,62,62,0,1,0,1,0
17326,63287,445,0,0,66,66,0,1,0,1,0
17327,50321,18593,0,0,143,143,0,1,0,1,0
17328,35626,22114,0,0,66,66,0,1,0,1,0
17329,51511,445,0,0,70,70,0,1,0,1,0
17330,50106,30317,0,0,66,66,0,1,0,1,0
17331,10914,35974,0,0,60,60,0,1,0,1,0
17332,11382,43890,0,0,66,66,0,1,0,1,0
17333,63111,445,0,0,70,70,0,1,0,1,0
17334,63110,445,0,0,70,70,0,1,0,1,0
17335,54917,60043,0,0,66,66,0,1,0,1,0
17336,54883,60043,0,0,62,62,0,1,0,1,0
17337,63106,445,0,0,70,70,0,1,0,1,0
17338,3717,25174,0,0,62,62,0,1,0,1,0
17339,63285,445,0,0,66,66,0,1,0,1,0
17340,63101,445,0,0,70,70,0,1,0,1,0
17341,63100,445,0,0,70,70,0,1,0,1,0
17342,47783,50432,0,0,62,62,0,1,0,1,0
17343,11136,19910,0,0,62,62,0,1,0,1,0
17344,63278,445,0,0,66,66,0,1,0,1,0
17345,59355,51505,0,0,66,66,0,1,0,1,0
17346,63272,445,0,0,66,66,0,1,0,1,0
17347,51310,64147,0,0,62,62,0,1,0,1,0
17348,27679,37965,0,0,62,62,0,1,0,1,0
17349,65006,26467,0,0,62,62,0,1,0,1,0
17350,51413,57470,0,0,72,72,0,1,0,1,0
17351,18113,22114,0,0,62,62,0,1,0,1,0
17352,33328,25174,0,0,62,62,0,1,0,1,0
17353,33328,25174,0,0,146,146,0,1,0,1,0
17354,46734,50265,0,0,74,74,0,1,0,1,0
17355,63089,445,0,0,70,70,0,1,0,1,0
17356,12318,36866,0,0,139,139,0,1,0,1,0
17357,6666,16010,0,0,60,60,0,1,0,1,0
17358,15701,37965,0,0,146,146,0,1,0,1,0
17359,52503,50584,0,0,66,66,0,1,0,1,0
17360,54769,50584,0,0,146,146,0,1,0,1,0
17361,51726,64147,0,0,66,66,0,1,0,1,0
17362,51045,25174,0,0,62,62,0,1,0,1,0
17363,65159,37965,0,0,74,74,0,1,0,1,0
17364,58103,10197,0,0,66,66,0,1,0,1,0
17365,51503,445,0,0,70,70,0,1,0,1,0
17366,51501,445,0,0,70,70,0,1,0,1,0
17367,51499,445,0,0,70,70,0,1,0,1,0
17368,61840,25174,0,0,62,62,0,1,0,1,0
17369,22856,22114,0,0,66,66,0,1,0,1,0
17370,17947,36237,0,0,62,62,0,1,0,1,0
17371,63262,445,0,0,66,66,0,1,0,1,0
17372,63260,445,0,0,66,66,0,1,0,1,0
17373,63259,445,0,0,66,66,0,1,0,1,0
17374,63255,445,0,0,66,66,0,1,0,1,0
17375,63257,445,0,0,66,66,0,1,0,1,0
17376,63258,445,0,0,66,66,0,1,0,1,0
17377,63261,445,0,0,66,66,0,1,0,1,0
17378,63254,445,0,0,66,66,0,1,0,1,0
17379,7356,25174,0,0,62,62,0,1,0,1,0
17380,14614,25174,0,0,62,62,0,1,0,1,0
17381,52537,57866,0,0,66,66,0,1,0,1,0
17382,56249,55442,0,0,66,66,0,1,0,1,0
17383,26263,8168,0,0,66,66,0,1,0,1,0
17384,29145,8168,0,0,62,62,0,1,0,1,0
17385,63085,445,0,0,70,70,0,1,0,1,0
17386,54418,22114,0,0,62,62,0,1,0,1,0
17387,21604,50201,0,0,62,62,0,1,0,1,0
17388,63076,445,0,0,70,70,0,1,0,1,0
17389,63075,445,0,0,70,70,0,1,0,1,0
17390,63074,445,0,0,70,70,0,1,0,1,0
17391,56621,50584,0,0,62,62,0,1,0,1,0
17392,50620,50584,0,0,66,66,0,1,0,1,0
17393,63071,445,0,0,70,70,0,1,0,1,0
17394,51425,37450,0,0,66,66,0,1,0,1,0
17395,63068,445,0,0,70,70,0,1,0,1,0
17396,63982,25174,0,0,62,62,0,1,0,1,0
17397,54754,50432,0,0,66,66,0,1,0,1,0
17398,51492,445,0,0,70,70,0,1,0,1,0
17399,51487,445,0,0,70,70,0,1,0,1,0
17400,51485,445,0,0,70,70,0,1,0,1,0
17401,51480,445,0,0,70,70,0,1,0,1,0
17402,45964,3111,0,0,60,60,0,1,0,1,0
17403,6712,123,0,0,90,90,0,1,0,1,0
17404,63241,445,0,0,66,66,0,1,0,1,0
17405,63240,445,0,0,66,66,0,1,0,1,0
17406,63239,445,0,0,66,66,0,1,0,1,0
17407,6929,35440,0,0,66,66,0,1,0,1,0
17408,31172,22114,0,0,146,146,0,1,0,1,0
17409,6247,51221,0,0,78,78,0,1,0,1,0
17410,15442,22114,0,0,62,62,0,1,0,1,0
17411,26527,25174,0,0,66,66,0,1,0,1,0
17412,37429,25174,0,0,62,62,0,1,0,1,0
17413,7810,25174,0,0,62,62,0,1,0,1,0
17414,51478,445,0,0,70,70,0,1,0,1,0
17415,63062,445,0,0,70,70,0,1,0,1,0
17416,52430,35440,0,0,146,146,0,1,0,1,0
17417,51471,445,0,0,70,70,0,1,0,1,0
17418,51470,445,0,0,70,70,0,1,0,1,0
17419,51468,445,0,0,70,70,0,1,0,1,0
17420,23021,2222,0,0,60,60,0,1,0,1,0
17421,47424,25174,0,0,66,66,0,1,0,1,0
17422,56897,11446,0,0,66,66,0,1,0,1,0
17423,1190,25174,0,0,62,62,0,1,0,1,0
17424,63055,445,0,0,70,70,0,1,0,1,0
17425,56397,26467,0,0,62,62,0,1,0,1,0
17426,63053,445,0,0,70,70,0,1,0,1,0
17427,36011,25174,0,0,66,66,0,1,0,1,0
17428,6356,26467,0,0,62,62,0,1,0,1,0
17429,54526,44847,0,0,66,66,0,1,0,1,0
17430,52359,23,0,0,60,60,0,1,0,1,0
17431,63049,445,0,0,70,70,0,1,0,1,0
17432,51461,445,0,0,70,70,0,1,0,1,0
17433,51457,445,0,0,70,70,0,1,0,1,0
17434,51458,445,0,0,70,70,0,1,0,1,0
17435,48025,44847,0,0,146,146,0,1,0,1,0
17436,63047,445,0,0,70,70,0,1,0,1,0
17437,0,0,0,0,70,70,0,1,0,1,0
17438,0,0,0,0,480,244,236,4,0,2,2
17439,51414,22,0,0,60,60,0,1,0,1,0
17440,63230,445,0,0,66,66,0,1,0,1,0
17441,53577,35894,0,0,62,62,0,1,0,1,0
17442,3064,44847,0,0,62,62,0,1,0,1,0
17443,63043,445,0,0,70,70,0,1,0,1,0
17444,53199,30188,0,0,66,66,0,1,0,1,0
17445,1356,57470,0,0,72,72,0,1,0,1,0
17446,49893,25174,0,0,66,66,0,1,0,1,0
17447,63041,445,0,0,70,70,0,1,0,1,0
17448,55826,42771,0,0,62,62,0,1,0,1,0
17449,55825,52700,0,0,62,62,0,1,0,1,0
17450,51453,445,0,0,70,70,0,1,0,1,0
17451,48826,25174,0,0,62,62,0,1,0,1,0
17452,53022,25174,0,0,62,62,0,1,0,1,0
17453,51451,445,0,0,70,70,0,1,0,1,0
17454,30598,37965,0,0,62,62,0,1,0,1,0
17455,11488,22114,0,0,62,62,0,1,0,1,0
17456,52744,25174,0,0,66,66,0,1,0,1,0
17457,17415,25174,0,0,62,62,0,1,0,1,0
17458,62056,30317,0,0,146,146,0,1,0,1,0
17459,63211,445,0,0,66,66,0,1,0,1,0
17460,63212,445,0,0,66,66,0,1,0,1,0
17461,63037,445,0,0,70,70,0,1,0,1,0
17462,52808,57470,0,0,146,146,0,1,0,1,0
17463,15176,62413,0,0,66,66,0,1,0,1,0
17464,61017,64147,0,0,62,62,0,1,0,1,0
17465,1733,65448,0,0,62,62,0,1,0,1,0
17466,42238,25174,0,0,62,62,0,1,0,1,0
17467,61185,54532,0,0,62,62,0,1,0,1,0
17468,19875,30170,0,0,145,145,0,1,0,1,0
17469,59668,50584,0,0,66,66,0,1,0,1,0
17470,51441,445,0,0,70,70,0,1,0,1,0
17471,51434,445,0,0,70,70,0,1,0,1,0
17472,51433,445,0,0,70,70,0,1,0,1,0
17473,51431,445,0,0,70,70,0,1,0,1,0
17474,22036,44847,0,0,146,146,0,1,0,1,0
17475,18203,23,0,0,60,60,0,1,0,1,0
17476,60261,25174,0,0,66,66,0,1,0,1,0
17477,63587,22114,0,0,62,62,0,1,0,1,0
17478,63208,445,0,0,66,66,0,1,0,1,0
17479,54216,64147,0,0,66,66,0,1,0,1,0
17480,59373,22,59373,22,295,126,169,4,1,2,2
17481,63202,445,0,0,66,66,0,1,0,1,0
17482,64691,25320,0,0,66,66,0,1,0,1,0
17483,63200,445,0,0,66,66,0,1,0,1,0
17484,63203,445,0,0,66,66,0,1,0,1,0
17485,63083,53,63784,53,303,85,218,2,30,1,1
17486,64357,53,46898,53,182,93,89,2,30,1,1
17487,63091,443,18908,443,382,164,218,2,30,1,1
17488,49197,53,13288,53,777,87,690,2,30,1,1
17489,65506,53,39413,53,194,99,95,2,30,1,1
17490,50641,53,60493,53,760,97,663,2,30,1,1
17491,56714,443,11426,443,579769,15036,564733,578,61,199,379
17492,57148,443,64280,443,12000,9252,2748,34,273,17,17
17493,51437,80,35977,80,1703,538,1165,8,177,5,3
17494,64472,53,7630,53,182,93,89,2,30,1,1
17495,50052,53,19645,53,738,86,652,2,30,1,1
17496,55945,53,26703,53,170,87,83,2,30,1,1
17497,51432,80,62424,80,1675,539,1136,8,178,5,3
17498,60343,80,4297,80,2005,1094,911,11,87,6,5
17499,9296,443,44194,443,3792,488,3304,14,16,7,7
17500,9314,443,56500,443,3792,488,3304,14,16,7,7
17501,42379,443,33462,443,1622,1137,485,11,26,7,4
17502,47647,443,47647,443,4565,1658,2907,19,28,11,8
17503,25436,53,25436,53,235,90,145,2,32,1,1
17504,45416,80,25189,80,2713,753,1960,12,15,7,5
17505,36339,443,4245,443,7295,1830,5465,23,316,13,10
17506,53463,29500,1810,29500,877,577,300,10,143,5,5
17507,65147,53,28135,53,763,101,662,2,30,1,1
17508,55039,443,27278,443,8209,2789,5420,24,42,14,10
17509,45308,443,7277,443,3657,1867,1790,22,391,7,15
17510,9305,443,52742,443,3616,429,3187,11,16,6,5
17511,60341,80,24741,80,2005,1094,911,11,87,6,5
17512,60336,443,57486,443,6613,4394,2219,50,122,29,21
17513,53877,32737,64789,32737,320,140,180,6,7,3,3
17514,52072,25595,25464,25595,70,70,0,2,8,2,0
17515,53870,24535,42849,24535,70,70,0,2,8,2,0
17516,9373,80,65080,80,1643,485,1158,10,15,5,5
17517,9377,80,44297,80,1643,485,1158,10,15,5,5
17518,38280,443,38280,443,3333,2072,1261,21,148,12,9
17519,9319,443,38033,443,5687,499,5188,14,16,7,7
17520,56582,53,23626,53,711,87,624,2,31,1,1
17521,64995,27023,24538,27023,1773,924,849,6,30,3,3
17522,9303,443,49206,443,3616,429,3187,11,16,6,5
17523,55965,53,22177,53,184,94,90,2,30,1,1
17524,60346,80,8391,80,2124,1158,966,13,87,7,6
17525,56020,53,29198,53,711,87,624,2,30,1,1
17526,60344,80,63030,80,2005,1094,911,11,87,6,5
17527,49756,53,23691,53,264,89,175,4,48,2,2
17528,45394,80,27437,80,4886,1260,3626,17,17,10,7
17529,9317,443,63611,443,5687,499,5188,14,16,7,7
17530,45414,80,30413,80,2873,753,2120,12,15,7,5
17531,39233,53,39233,53,235,90,145,2,33,1,1
17532,63150,443,63150,443,6792,1521,5271,18,28,11,7
17533,41036,443,13628,443,153,93,60,2,5,1,1
17534,53880,61393,8542,61393,320,140,180,6,6,3,3
17535,60345,80,36242,80,2124,1158,966,13,87,7,6
17536,45021,53,45021,53,213,79,134,2,32,1,1
17537,52076,28895,42169,28895,70,70,0,2,8,2,0
17538,54977,53,19132,53,275,93,182,4,32,2,2
17539,50663,80,56397,80,1366,865,501,8,15,5,3
17540,49531,80,27250,80,78,78,0,2,8,2,0
17541,42377,443,33699,443,1622,1137,485,11,26,7,4
17542,49304,443,52179,443,932965,16289,916676,768,65,148,620
17543,52054,50513,53866,50513,66,66,0,1,5,1,0
17544,55907,53,13623,53,711,87,624,2,30,1,1
17545,49363,53,12270,53,208,106,102,2,30,1,1
17546,55417,53,13088,53,174,89,85,2,30,1,1
17547,57082,53,0,0,82,82,0,1,30,1,0
17548,13237,53,13237,53,823,98,725,2,30,1,1
17549,36352,443,46352,443,3256,1753,1503,17,315,10,7
17550,41576,443,2351,443,2227,1018,1209,17,15,8,9
17551,31090,53,31090,53,365,233,132,3,34,2,1
17552,64135,53,50232,53,192,98,94,2,31,1,1
17553,60342,80,14869,80,2005,1094,911,11,87,6,5
17554,42380,443,32272,443,1622,1137,485,11,26,7,4
17555,53041,443,37580,443,7263,1834,5429,27,16,15,12
17556,38368,15000,38283,15000,130,70,60,2,5,1,1
17557,28234,36653,45143,36653,64,64,0,1,10,1,0
17558,42631,443,38369,443,153,93,60,2,5,1,1
17559,51855,7700,11959,7700,12087,9521,2566,76,32,38,38
17560,65315,53,25931,53,770,101,669,2,30,1,1
17561,9304,443,28860,443,3922,552,3370,16,16,8,8
17562,55566,53,37015,53,740,93,647,2,30,1,1
17563,49686,53,35211,53,182,93,89,2,30,1,1
17564,63082,443,41312,443,303,85,218,2,30,1,1
17565,55772,53,9529,53,782,105,677,2,30,1,1
17566,60089,53,50988,53,297,83,214,2,30,1,1
17567,55134,53,55134,53,825,99,726,2,31,1,1
17568,56294,53,56294,53,229,89,140,2,31,1,1
17569,64746,53,11815,53,186,95,91,2,31,1,1
17570,48817,6881,48817,6881,773,279,494,4,1200,2,2
17571,48817,6884,48817,6884,328,152,176,2,1200,1,1
17572,48817,7294,48817,7294,479,152,327,2,1200,1,1
17573,55275,53,41187,53,770,101,669,2,30,1,1
17574,65386,53,25163,53,194,99,95,2,30,1,1
17575,56912,53,9519,53,198,101,97,2,31,1,1
17576,59720,443,13294,443,3346,1219,2127,15,136,7,8
17577,48817,45682,48817,45682,513,152,361,2,1200,1,1
17578,48817,42099,48817,42099,479,152,327,2,1200,1,1
17579,56160,53,63340,53,190,97,93,2,30,1,1
17580,56845,53,56845,53,825,99,726,2,30,1,1
17581,60384,53,44713,53,234,96,138,2,31,1,1
17582,56246,53,10681,53,816,97,719,2,31,1,1
17583,64414,53,56894,53,182,93,89,2,31,1,1
17584,63952,53,34336,53,206,105,101,2,31,1,1
17585,57681,53,57681,53,220,100,120,2,31,1,1
17586,55942,53,46906,53,194,99,95,2,31,1,1
17587,57371,53,9888,53,755,93,662,2,31,1,1
17588,56805,53,62222,53,815,95,720,2,31,1,1
17589,64318,53,59823,53,182,93,89,2,31,1,1
17590,48817,49490,48817,49490,513,152,361,2,1200,1,1
17591,55230,53,36374,53,182,93,89,2,30,1,1
17592,54980,53,25043,53,763,101,662,2,30,1,1
17593,57294,53,3249,53,760,97,663,2,31,1,1
17594,35191,53,35191,53,825,99,726,2,31,1,1
17595,58390,53,44510,53,240,76,164,2,31,1,1
17596,56913,53,30099,53,772,103,669,2,31,1,1
17597,56561,53,2642,53,216,110,106,2,31,1,1
17598,49802,53,5262,53,755,93,662,2,31,1,1
17599,49978,53,54478,53,760,97,663,2,31,1,1
17600,57384,53,45393,53,752,93,659,2,31,1,1
17601,64970,27055,4626,27055,735,462,273,2,31,1,1
17602,49286,53,16984,53,184,94,90,2,31,1,1
17603,55024,53,56157,53,168,86,82,2,31,1,1
17604,55194,53,53010,53,190,97,93,2,31,1,1
17605,49631,53,31277,53,196,100,96,2,31,1,1
17606,48817,18529,48817,18529,152,152,0,1,1200,1,0
17607,56497,53,2084,53,170,87,83,2,31,1,1
17608,65336,53,14965,53,732,89,643,2,31,1,1
17609,48817,51413,48817,51413,479,152,327,2,1200,1,1
17610,48817,51413,48817,51413,479,152,327,2,1200,1,1
17611,48817,6882,48817,6882,152,152,0,1,1200,1,0
17612,48817,49157,48817,49157,328,152,176,2,1200,1,1
17613,55786,53,65115,53,186,95,91,2,31,1,1
17614,48817,8621,48817,8621,152,152,0,1,1200,1,0
17615,48817,63838,48817,63838,513,152,361,2,1200,1,1
17616,48817,37028,48817,37028,513,152,361,2,1200,1,1
17617,48817,26484,48817,26484,513,152,361,2,1200,1,1
17618,48817,51413,48817,51413,479,152,327,2,1200,1,1
17619,48817,6881,48817,6881,494,152,342,2,1200,1,1
17620,48817,6881,48817,6881,506,152,354,2,1200,1,1
17621,48817,41706,48817,41706,513,152,361,2,1200,1,1
17622,48817,6881,48817,6881,506,152,354,2,1200,1,1
17623,63195,445,0,0,66,66,0,1,0,1,0
17624,63197,445,0,0,66,66,0,1,0,1,0
17625,63201,445,0,0,66,66,0,1,0,1,0
17626,63192,445,0,0,66,66,0,1,0,1,0
17627,63024,445,0,0,70,70,0,1,0,1,0
17628,51427,445,0,0,70,70,0,1,0,1,0
17629,63545,25174,0,0,66,66,0,1,0,1,0
17630,51423,445,0,0,70,70,0,1,0,1,0
17631,51419,445,0,0,70,70,0,1,0,1,0
17632,51420,445,0,0,70,70,0,1,0,1,0
17633,7222,57470,0,0,62,62,0,1,0,1,0
17634,51979,25174,0,0,66,66,0,1,0,1,0
17635,20576,37965,0,0,62,62,0,1,0,1,0
17636,56127,37965,0,0,66,66,0,1,0,1,0
17637,63021,445,0,0,70,70,0,1,0,1,0
17638,45783,22114,0,0,62,62,0,1,0,1,0
17639,58900,37807,0,0,66,66,0,1,0,1,0
17640,61550,5529,0,0,145,145,0,1,0,1,0
17641,56762,53,10998,53,168,86,82,2,30,1,1
17642,9338,443,8556,443,4462,500,3962,13,15,7,6
17643,50098,53,37375,53,199,102,97,2,30,1,1
17644,63089,53,1694,53,512,166,346,2,30,1,1
17645,64135,53,40678,53,196,102,94,2,30,1,1
17646,50491,443,32943,443,28729,1634,27095,40,120,16,24
17647,56863,80,39475,80,13608,783,12825,21,45,9,12
17648,37613,443,61713,443,10042,3117,6925,28,47,16,12
17649,60129,80,34372,80,2910,1439,1471,12,31,7,5
17650,49270,80,7008,80,254,128,126,5,15,3,2
17651,53881,11513,24027,11513,320,140,180,6,5,3,3
17652,34430,80,5069,80,2913,633,2280,15,15,8,7
17653,34436,80,7684,80,6260,696,5564,17,15,9,8
17654,41611,80,9523,80,1860,712,1148,8,15,5,3
17655,56744,443,27482,443,8008,1988,6020,20,15,11,9
17656,55829,53,51099,53,177,94,83,2,30,1,1
17657,53161,30013,6313,30013,70,70,0,2,7,2,0
17658,41790,443,32230,443,232,172,60,3,4,2,1
17659,9318,443,40235,443,3649,424,3225,12,15,6,6
17660,49765,443,5454,443,11588,4383,7205,39,46,22,17
17661,49773,80,19021,80,70,70,0,2,8,2,0
17662,56698,80,23963,80,176644,9435,167209,266,65,104,162
17663,56940,53,20579,53,316,97,219,4,33,2,2
17664,53869,17089,2091,17089,70,70,0,2,7,2,0
17665,49363,53,19246,53,212,110,102,2,29,1,1
17666,57063,53,6247,53,193,102,91,2,29,1,1
17667,55492,53,7520,53,216,110,106,2,29,1,1
17668,56082,53,1185,53,730,102,628,2,29,1,1
17669,49620,53,9957,53,211,110,101,2,29,1,1
17670,55492,53,34032,53,216,110,106,2,29,1,1
17671,55945,53,7616,53,177,94,83,2,29,1,1
17672,55660,53,60167,53,177,94,83,2,30,1,1
17673,37561,443,20164,443,9766,3093,6673,37,270,21,16
17674,9308,443,57827,443,3837,488,3349,15,15,7,8
17675,9339,443,39172,443,3614,434,3180,11,15,6,5
17676,49702,443,53414,443,42430,4111,38319,79,130,42,37
17677,49756,53,23582,53,264,89,175,4,47,2,2
17678,49875,53,51820,53,399,86,313,4,49,2,2
17679,56375,53,4140,53,322,110,212,4,30,2,2
17680,56810,53,11762,53,177,94,83,2,30,1,1
17681,56960,53,26282,53,196,102,94,2,30,1,1
17682,64746,53,35675,53,193,102,91,2,30,1,1
17683,65248,53,49147,53,212,110,102,2,30,1,1
17684,65225,53,20120,53,822,102,720,2,30,1,1
17685,56561,53,19091,53,216,110,106,2,30,1,1
17686,56741,443,30975,443,8059,2039,6020,20,15,11,9
17687,52071,57491,41650,57491,70,70,0,2,8,2,0
17688,63079,443,63360,443,304,86,218,2,30,1,1
17689,9341,443,61165,443,3835,501,3334,14,15,7,7
17690,59394,443,52019,443,5993,1987,4006,17,26,9,8
17691,55528,80,12209,80,3868,2218,1650,19,39,11,8
17692,53161,443,60488,443,9458,4646,4812,26,25,14,12
17693,53271,443,21027,443,1544,1073,471,13,15,8,5
17694,64699,53,61689,53,338,110,228,2,30,1,1
17695,55058,53,31545,53,216,110,106,2,30,1,1
17696,50504,53,41149,53,168,86,82,2,30,1,1
17697,57431,53,12535,53,994,86,908,2,30,1,1
17698,49620,53,32011,53,198,110,88,2,30,1,1
17699,49172,53,13814,53,305,94,211,2,30,1,1
17700,54959,53,28413,53,211,110,101,2,30,1,1
17701,50458,53,25707,53,177,94,83,2,30,1,1
17702,56375,53,25593,53,216,110,106,2,30,1,1
17703,55251,53,16099,53,212,110,102,2,30,1,1
17704,42025,443,50486,443,70,70,0,1,5,1,0
17705,39055,53,10136,53,289,86,203,2,30,1,1
17706,8896,123,46598,123,94,94,0,1,30,1,0
17707,39114,443,44592,443,1238821,42695,1196126,1389,72,535,854
17708,64384,53,46498,53,350,94,256,2,30,1,1
17709,64486,53,21384,53,290,102,188,2,30,1,1
17710,56272,53,41462,53,193,102,91,2,30,1,1
17711,49313,53,49710,53,199,102,97,2,30,1,1
17712,55251,53,49536,53,212,110,102,2,30,1,1
17713,57778,443,43252,443,6182,3879,2303,53,3828,31,22
17714,56668,80,5597,80,234,234,0,4,12,4,0
17715,9331,443,37171,443,3616,429,3187,11,15,6,5
17716,9340,443,64311,443,3835,501,3334,14,15,7,7
17717,53851,443,36931,443,11779,3603,8176,42,142,21,21
17718,9325,443,25037,443,3616,429,3187,11,15,6,5
17719,9326,443,61009,443,3616,429,3187,11,15,6,5
17720,42457,5222,64493,5222,35380,2898,32482,63,227,22,41
17721,45077,443,32205,443,6533,1777,4756,24,271,13,11
17722,56771,53,50189,53,166,86,80,2,30,1,1
17723,64318,53,51027,53,183,94,89,2,30,1,1
17724,63081,53,24594,53,304,86,218,2,30,1,1
17725,63080,443,52084,443,304,86,218,2,30,1,1
17726,53160,39001,22070,39001,70,70,0,2,8,2,0
17727,55531,80,42208,80,3277,2255,1022,18,39,10,8
17728,9315,443,40509,443,3649,424,3225,12,15,6,6
17729,53163,443,28652,443,12979,4609,8370,27,25,15,12
17730,49293,53,34843,53,382,95,287,4,48,2,2
17731,49686,53,23134,53,183,94,89,2,30,1,1
17732,63088,443,45061,443,512,166,346,2,30,1,1
17733,60203,53,37285,53,328,86,242,2,30,1,1
17734,55230,53,3013,53,183,94,89,2,30,1,1
17735,64472,53,45709,53,183,94,89,2,30,1,1
17736,63078,53,5697,53,304,86,218,2,30,1,1
17737,56769,53,50586,53,195,102,93,2,30,1,1
17738,55942,53,36132,53,197,102,95,2,30,1,1
17739,56629,443,36618,443,22938,14436,8502,43,35,23,20
17740,52073,16316,19866,16316,70,70,0,2,8,2,0
17741,53872,24710,60030,24710,70,70,0,2,7,2,0
17742,49840,443,58601,443,6998,1906,5092,22,24,12,10
17743,60883,443,43627,443,5710,1228,4482,21,16,12,9
17744,49756,53,1585,53,264,89,175,4,48,2,2
17745,55560,443,48574,443,7047,1994,5053,20,24,12,8
17746,53157,34841,3594,34841,698,320,378,10,16,6,4
17747,38358,80,53485,80,409,289,120,5,15,3,2
17748,54447,443,59840,443,9818,2008,7810,23,317,12,11
17749,54977,53,63603,53,275,93,182,4,32,2,2
17750,54977,53,36032,53,275,93,182,4,31,2,2
17751,9332,443,23835,443,3616,429,3187,11,15,6,5
17752,53868,52706,33006,52706,70,70,0,2,7,2,0
17753,9321,443,54415,443,3345,432,2913,11,15,6,5
17754,51968,443,63060,443,5315,3154,2161,56,47,32,24
17755,52053,34411,40436,34411,70,70,0,1,4,1,0
17756,51443,443,42123,443,322,262,60,2,15,1,1
17757,34434,80,45920,80,2913,633,2280,15,15,8,7
17758,50041,443,6754,443,17237,1717,15520,36,152,16,20
17759,59405,443,1405,443,276,70,206,5,26,2,3
17760,52078,15518,47758,15518,70,70,0,2,7,2,0
17761,53871,43266,33475,43266,70,70,0,2,7,2,0
17762,56276,443,23651,443,154,94,60,2,4,1,1
17763,56803,53,3207,53,429,93,336,4,44,2,2
17764,55750,53,45785,53,211,110,101,2,29,1,1
17765,9333,443,63777,443,5200,499,4701,13,15,7,6
17766,64787,53,58679,53,179,94,85,2,29,1,1
17767,9329,443,17986,443,3255,430,2825,11,15,6,5
17768,55829,53,11417,53,212,110,102,2,29,1,1
17769,25608,53,25608,53,823,98,725,2,30,1,1
17770,57023,443,30630,443,10514,2031,8483,28,149,12,16
17771,55530,80,60637,80,3334,2314,1020,19,39,11,8
17772,47149,443,19883,443,5995,1092,4903,22,72,12,10
17773,9327,443,1143,443,3616,429,3187,11,15,6,5
17774,64318,53,45436,53,183,94,89,2,30,1,1
17775,38322,443,57596,443,10632,3838,6794,37,256,18,19
17776,50541,53,14016,53,458,188,270,6,30,3,3
17777,56771,53,26482,53,166,86,80,2,30,1,1
17778,31214,53,31214,53,216,90,126,2,30,1,1
17779,9295,443,22317,443,3837,488,3349,15,15,7,8
17780,63086,53,16338,53,512,166,346,2,30,1,1
17781,64804,53,12585,53,383,97,286,4,58,2,2
17782,57264,53,5808,53,197,102,95,2,29,1,1
17783,56109,53,49882,53,177,94,83,2,29,1,1
17784,55251,53,30492,53,212,110,102,2,30,1,1
17785,63085,53,50123,53,448,166,282,2,30,1,1
17786,64135,53,23762,53,196,102,94,2,30,1,1
17787,55669,53,4616,53,784,94,690,2,30,1,1
17788,65354,53,12903,53,168,86,82,2,30,1,1
17789,56333,53,17825,53,199,102,97,2,30,1,1
17790,55520,443,13062,443,272841,13586,259255,353,176,164,189
17791,64414,53,2206,53,183,94,89,2,30,1,1
17792,56078,53,23353,53,168,86,82,2,30,1,1
17793,55024,53,28341,53,168,86,82,2,30,1,1
17794,43882,443,18318,443,10494,2409,8085,21,137,9,12
17795,37965,6224,9493,6224,38098,12284,25814,207,2433,100,107
17796,56550,53,42634,53,166,86,80,2,30,1,1
17797,55871,53,4127,53,177,94,83,2,30,1,1
17798,9336,443,60185,443,4702,674,4028,15,15,8,7
17799,56743,443,64118,443,8060,2040,6020,20,15,11,9
17800,52074,57947,10118,57947,70,70,0,2,8,2,0
17801,65386,53,26119,53,1160,392,768,10,66,5,5
17802,49313,53,45650,53,199,102,97,2,30,1,1
17803,56185,53,61715,53,168,86,82,2,30,1,1
17804,54959,53,14757,53,211,110,101,2,30,1,1
17805,56260,53,19443,53,177,94,83,2,30,1,1
17806,56769,53,26341,53,195,102,93,2,30,1,1
17807,50074,53,31884,53,168,86,82,2,30,1,1
17808,65506,53,16583,53,197,102,95,2,30,1,1
17809,55020,443,50900,443,670633,656612,14021,657,146,465,192
17810,64576,53,5234,53,194,102,92,2,31,1,1
17811,57219,5223,28908,5223,9687,5105,4582,30,298,16,14
17812,9330,443,63077,443,3255,430,2825,11,15,6,5
17813,48919,443,27329,443,10338,3346,6992,27,19,15,12
17814,56742,443,47140,443,8007,1987,6020,20,15,11,9
17815,55532,80,8734,80,3367,2346,1021,19,39,11,8
17816,9316,443,33323,443,3649,424,3225,12,15,6,6
17817,28033,443,38606,443,6305,2124,4181,20,16,10,10
17818,56762,53,42811,53,168,86,82,2,30,1,1
17819,55058,53,37390,53,216,110,106,2,30,1,1
17820,55965,53,4442,53,184,94,90,2,30,1,1
17821,50074,53,48010,53,168,86,82,2,30,1,1
17822,63084,443,51859,443,571,166,405,2,30,1,1
17823,56272,53,7235,53,193,102,91,2,30,1,1
17824,63077,53,21461,53,304,86,218,2,30,1,1
17825,58463,443,33811,443,19057,9308,9749,111,307,53,58
17826,64746,53,28024,53,193,102,91,2,31,1,1
17827,8283,52443,34417,52443,130,70,60,2,30,1,1
17828,9328,443,4611,443,5198,504,4694,13,15,7,6
17829,58933,443,10888,443,5167,700,4467,16,15,7,9
17830,51513,443,63128,443,10839,705,10134,14,46,4,10
17831,34244,80,38249,80,656,398,258,11,39,7,4
17832,55533,80,6176,80,3386,2365,1021,19,39,11,8
17833,55534,80,1439,80,3335,2314,1021,19,38,11,8
17834,9324,443,33759,443,3255,430,2825,11,15,6,5
17835,54352,443,22800,443,6854,2318,4536,20,16,11,9
17836,9320,443,10901,443,3599,566,3033,15,15,8,7
17837,52498,80,52498,80,15453,911,14542,25,16,11,14
17838,56862,80,27370,80,2058,589,1469,10,45,6,4
17839,49756,53,28013,53,264,89,175,4,47,2,2
17840,65237,53,38520,53,733,86,647,2,30,1,1
17841,56960,53,36561,53,196,102,94,2,30,1,1
17842,57375,53,58111,53,247,102,145,2,30,1,1
17843,56810,53,28804,53,177,94,83,2,30,1,1
17844,49313,53,30091,53,199,102,97,2,30,1,1
17845,64472,53,42723,53,183,94,89,2,30,1,1
17846,64273,53,36287,53,239,94,145,2,30,1,1
17847,50462,53,31547,53,299,94,205,2,30,1,1
17848,55230,53,6138,53,183,94,89,2,30,1,1
17849,65225,53,58694,53,199,102,97,2,30,1,1
17850,56561,53,15305,53,216,110,106,2,30,1,1
17851,55711,53,17367,53,177,94,83,2,30,1,1
17852,49855,53,34570,53,177,94,83,2,30,1,1
17853,56522,53,55041,53,177,94,83,2,30,1,1
17854,49286,53,40231,53,184,94,90,2,31,1,1
17855,56522,53,65076,53,177,94,83,2,31,1,1
17856,48817,1025,48817,1025,334,158,176,2,1199,1,1
17857,48817,60483,48817,60483,519,158,361,2,1199,1,1
17858,48817,39388,48817,39388,1267,631,636,6,1199,3,3
17859,48817,51413,48817,51413,485,158,327,2,1199,1,1
17860,48817,51234,48817,51234,158,158,0,1,1200,1,0
17861,48817,8999,48817,8999,512,158,354,2,1200,1,1
17862,37263,53,37263,53,220,90,130,2,30,1,1
17863,52533,53,8262,53,242,78,164,2,30,1,1
17864,64135,53,37160,53,196,102,94,2,30,1,1
17865,56160,53,39836,53,195,102,93,2,30,1,1
17866,49246,53,41120,53,172,94,78,2,30,1,1
17867,55194,53,9824,53,195,102,93,2,31,1,1
17868,64926,53,21011,53,166,86,80,2,31,1,1
17869,65428,53,31541,53,195,102,93,2,31,1,1
17870,47656,443,30620,443,684,140,544,11,165,3,8
17871,52888,5223,32740,5223,12302,5509,6793,43,1061,16,27
17872,21133,21689,35631,21689,481,150,331,2,1199,1,1
17873,48817,1049,48817,1049,334,158,176,2,1199,1,1
17874,48817,38081,48817,38081,863,363,500,4,1200,2,2
17875,48817,7131,48817,7131,158,158,0,1,1200,1,0
17876,48817,51417,48817,51417,485,158,327,2,1200,1,1
17877,63952,53,14655,53,211,110,101,2,30,1,1
17878,55965,53,49770,53,184,94,90,2,30,1,1
17879,55945,53,48545,53,177,94,83,2,30,1,1
17880,56910,53,3209,53,199,102,97,2,30,1,1
17881,56810,53,31641,53,177,94,83,2,30,1,1
17882,49954,53,59869,53,753,94,659,2,30,1,1
17883,51880,8001,36976,8001,86,86,0,1,30,1,0
17884,56561,53,31365,53,216,110,106,2,31,1,1
17885,49246,53,51289,53,164,86,78,2,31,1,1
17886,65006,53,63104,53,994,86,908,2,30,1,1
17887,55453,443,3812,443,3015948,160028,2855920,3852,218,1499,2353
17888,56963,53,8410,53,199,102,97,2,31,1,1
17889,54644,443,51226,443,6440,3492,2948,19,135,9,10
17890,54539,443,15655,443,4552,2230,2322,14,134,7,7
17891,33525,443,32155,443,8088,2191,5897,28,508,13,15
17892,48817,58518,48817,58518,580,121,459,4,1199,2,2
17893,48817,1722,48817,1722,158,158,0,1,1200,1,0
17894,48817,23456,48817,23456,485,158,327,2,1200,1,1
17895,57648,443,58910,443,35696,3196,32500,48,121,19,29
17896,51088,443,60075,443,14025,7301,6724,38,171,22,16
17897,54977,53,39208,53,275,93,182,4,31,2,2
17898,61141,443,38623,443,383052,17263,365789,396,132,119,277
17899,6881,6889,7381,6889,228,118,110,2,1200,1,1
17900,48817,6889,48817,6889,502,158,344,2,1200,1,1
17901,48817,51413,48817,51413,485,158,327,2,1200,1,1
17902,49717,53,48239,53,444,96,348,4,44,2,2
17903,55881,443,18861,443,25586,4360,21226,57,81,29,28
17904,53879,43702,31911,43702,320,140,180,6,6,3,3
17905,52081,51835,33500,51835,316,136,180,6,6,3,3
17906,52050,31648,38816,31648,70,70,0,1,5,1,0
17907,35961,80,62048,80,11575,902,10673,20,46,11,9
17908,63963,53,7667,53,262,86,176,4,46,2,2
17909,63963,53,46328,53,262,86,176,4,46,2,2
17910,50606,80,30995,80,83795,22317,61478,117,43,52,65
17911,27739,7000,27739,7000,2163,676,1487,14,15,7,7
17912,60167,80,41576,80,6017,5209,808,12,30,7,5
17913,50940,443,27136,443,29500,27698,1802,51,17,29,22
17914,61876,443,60944,443,3776,1446,2330,20,153,9,11
17915,52049,52557,23041,52557,70,70,0,1,5,1,0
17916,52048,44059,7624,44059,160,70,90,2,5,1,1
17917,63952,53,42119,53,358,105,253,4,44,2,2
17918,57655,56205,0,0,62,62,0,1,0,1,0
17919,44815,36829,0,0,62,62,0,1,0,1,0
17920,42231,57470,0,0,78,78,0,1,0,1,0
17921,63016,445,0,0,70,70,0,1,0,1,0
17922,49417,38558,0,0,66,66,0,1,0,1,0
17923,51417,445,0,0,70,70,0,1,0,1,0
17924,51416,445,0,0,70,70,0,1,0,1,0
17925,51414,445,0,0,70,70,0,1,0,1,0
17926,63015,445,0,0,70,70,0,1,0,1,0
17927,14023,37965,0,0,62,62,0,1,0,1,0
17928,63186,445,0,0,66,66,0,1,0,1,0
17929,59192,25174,0,0,66,66,0,1,0,1,0
17930,51410,445,0,0,70,70,0,1,0,1,0
17931,48706,23394,0,0,60,60,0,1,0,1,0
17932,49931,25174,0,0,62,62,0,1,0,1,0
17933,63181,445,0,0,66,66,0,1,0,1,0
17934,63013,445,0,0,70,70,0,1,0,1,0
17935,63180,445,0,0,66,66,0,1,0,1,0
17936,63178,445,0,0,66,66,0,1,0,1,0
17937,45424,23,0,0,60,60,0,1,0,1,0
17938,63176,445,0,0,66,66,0,1,0,1,0
17939,48230,57866,0,0,62,62,0,1,0,1,0
17940,60075,41705,0,0,62,62,0,1,0,1,0
17941,38475,11392,0,0,66,66,0,1,0,1,0
17942,9102,29635,0,0,148,148,0,1,0,1,0
17943,55951,30188,0,0,66,66,0,1,0,1,0
17944,30280,37965,0,0,66,66,0,1,0,1,0
17945,50052,65008,0,0,60,60,0,1,0,1,0
17946,16057,56205,0,0,66,66,0,1,0,1,0
17947,51404,445,0,0,70,70,0,1,0,1,0
17948,47910,7454,0,0,60,60,0,1,0,1,0
17949,63006,445,0,0,70,70,0,1,0,1,0
17950,51401,445,0,0,70,70,0,1,0,1,0
17951,51394,445,0,0,70,70,0,1,0,1,0
17952,10914,35974,0,0,60,60,0,1,0,1,0
17953,63004,445,0,0,70,70,0,1,0,1,0
17954,52557,44847,0,0,66,66,0,1,0,1,0
17955,28156,50584,0,0,62,62,0,1,0,1,0
17956,63166,445,0,0,66,66,0,1,0,1,0
17957,63003,445,0,0,70,70,0,1,0,1,0
17958,63002,445,0,0,70,70,0,1,0,1,0
17959,9087,37965,0,0,62,62,0,1,0,1,0
17960,7041,37965,0,0,66,66,0,1,0,1,0
17961,64755,31573,0,0,62,62,0,1,0,1,0
17962,63001,445,0,0,70,70,0,1,0,1,0
17963,62995,445,0,0,70,70,0,1,0,1,0
17964,62996,445,0,0,70,70,0,1,0,1,0
17965,23331,25174,0,0,66,66,0,1,0,1,0
17966,2422,62507,0,0,62,62,0,1,0,1,0
17967,443,32698,0,0,89,89,0,1,0,1,0
17968,54048,25174,0,0,62,62,0,1,0,1,0
17969,63158,445,0,0,66,66,0,1,0,1,0
17970,51383,445,0,0,70,70,0,1,0,1,0
17971,62983,445,0,0,70,70,0,1,0,1,0
17972,62981,445,0,0,70,70,0,1,0,1,0
17973,37647,36237,0,0,66,66,0,1,0,1,0
17974,62980,445,0,0,70,70,0,1,0,1,0
17975,51291,25174,0,0,62,62,0,1,0,1,0
17976,62973,445,0,0,70,70,0,1,0,1,0
17977,62972,445,0,0,70,70,0,1,0,1,0
17978,61002,37965,0,0,145,145,0,1,0,1,0
17979,63156,445,0,0,66,66,0,1,0,1,0
17980,46734,50265,0,0,74,74,0,1,0,1,0
17981,49415,22114,0,0,66,66,0,1,0,1,0
17982,61591,22114,0,0,62,62,0,1,0,1,0
17983,13120,25174,0,0,62,62,0,1,0,1,0
17984,26435,39004,0,0,62,62,0,1,0,1,0
17985,59234,21247,0,0,62,62,0,1,0,1,0
17986,52973,57470,0,0,74,74,0,1,0,1,0
17987,51271,37965,0,0,66,66,0,1,0,1,0
17988,63149,445,0,0,66,66,0,1,0,1,0
17989,53567,64147,0,0,62,62,0,1,0,1,0
17990,58022,9200,0,0,60,60,0,1,0,1,0
17991,63146,445,0,0,66,66,0,1,0,1,0
17992,42144,30170,0,0,146,146,0,1,0,1,0
17993,50442,25174,0,0,62,62,0,1,0,1,0
17994,7482,57470,0,0,66,66,0,1,0,1,0
17995,62961,445,0,0,70,70,0,1,0,1,0
17996,60269,443,14941,443,499,425,74,4,0,3,1
17997,30574,64147,0,0,62,62,0,1,0,1,0
17998,26752,64147,0,0,62,62,0,1,0,1,0
17999,64509,9571,0,0,62,62,0,1,0,1,0
18000,1024,44847,0,0,146,146,0,1,0,1,0
18001,30654,51221,0,0,72,72,0,1,0,1,0
18002,51374,445,0,0,70,70,0,1,0,1,0
18003,51372,445,0,0,70,70,0,1,0,1,0
18004,51370,445,0,0,70,70,0,1,0,1,0
18005,1238,51505,0,0,146,146,0,1,0,1,0
18006,54817,47993,0,0,66,66,0,1,0,1,0
18007,63133,445,0,0,66,66,0,1,0,1,0
18008,63131,445,0,0,66,66,0,1,0,1,0
18009,63127,445,0,0,66,66,0,1,0,1,0
18010,63128,445,0,0,66,66,0,1,0,1,0
18011,63126,445,0,0,66,66,0,1,0,1,0
18012,63130,445,0,0,66,66,0,1,0,1,0
18013,63125,445,0,0,66,66,0,1,0,1,0
18014,63129,445,0,0,66,66,0,1,0,1,0
18015,27969,25174,0,0,66,66,0,1,0,1,0
18016,30861,46783,0,0,62,62,0,1,0,1,0
18017,62957,445,0,0,70,70,0,1,0,1,0
18018,47943,50584,0,0,74,74,0,1,0,1,0
18019,4793,50584,0,0,66,66,0,1,0,1,0
18020,21482,22114,0,0,62,62,0,1,0,1,0
18021,6247,51221,0,0,78,78,0,1,0,1,0
18022,63708,25174,0,0,62,62,0,1,0,1,0
18023,21496,50265,0,0,62,62,0,1,0,1,0
18024,45837,25174,0,0,146,146,0,1,0,1,0
18025,62948,445,0,0,70,70,0,1,0,1,0
18026,62945,445,0,0,70,70,0,1,0,1,0
18027,62946,445,0,0,70,70,0,1,0,1,0
18028,16570,25174,0,0,62,62,0,1,0,1,0
18029,34811,56205,0,0,66,66,0,1,0,1,0
18030,62944,445,0,0,70,70,0,1,0,1,0
18031,62940,445,0,0,70,70,0,1,0,1,0
18032,51367,445,0,0,70,70,0,1,0,1,0
18033,51365,445,0,0,70,70,0,1,0,1,0
18034,51354,445,0,0,70,70,0,1,0,1,0
18035,51353,445,0,0,70,70,0,1,0,1,0
18036,63032,22114,0,0,66,66,0,1,0,1,0
18037,55144,30188,0,0,66,66,0,1,0,1,0
18038,25031,25174,0,0,62,62,0,1,0,1,0
18039,63113,445,0,0,66,66,0,1,0,1,0
18040,63111,445,0,0,66,66,0,1,0,1,0
18041,63112,445,0,0,66,66,0,1,0,1,0
18042,6141,23,0,0,60,60,0,1,0,1,0
18043,55199,21247,0,0,66,66,0,1,0,1,0
18044,35666,22114,0,0,62,62,0,1,0,1,0
18045,60869,48817,0,0,66,66,0,1,0,1,0
18046,62934,445,0,0,70,70,0,1,0,1,0
18047,20167,1550,0,0,104,104,0,1,0,1,0
18048,44889,23,0,0,60,60,0,1,0,1,0
18049,17097,62413,0,0,62,62,0,1,0,1,0
18050,51351,445,0,0,70,70,0,1,0,1,0
18051,25063,64147,0,0,62,62,0,1,0,1,0
18052,30707,30317,0,0,62,62,0,1,0,1,0
18053,53257,37450,0,0,62,62,0,1,0,1,0
18054,51344,445,0,0,70,70,0,1,0,1,0
18055,51341,445,0,0,70,70,0,1,0,1,0
18056,51339,445,0,0,70,70,0,1,0,1,0
18057,63832,25174,0,0,66,66,0,1,0,1,0
18058,59949,44847,0,0,62,62,0,1,0,1,0
18059,62927,445,0,0,70,70,0,1,0,1,0
18060,62926,445,0,0,70,70,0,1,0,1,0
18061,50936,22114,0,0,62,62,0,1,0,1,0
18062,33359,30188,0,0,66,66,0,1,0,1,0
18063,63347,25174,0,0,62,62,0,1,0,1,0
18064,52024,25174,0,0,62,62,0,1,0,1,0
18065,7877,22114,0,0,62,62,0,1,0,1,0
18066,7000,23117,0,0,66,66,0,1,0,1,0
18067,62920,445,0,0,70,70,0,1,0,1,0
18068,62919,445,0,0,70,70,0,1,0,1,0
18069,59755,44512,0,0,66,66,0,1,0,1,0
18070,55056,44512,0,0,62,62,0,1,0,1,0
18071,51332,445,0,0,70,70,0,1,0,1,0
18072,51329,445,0,0,70,70,0,1,0,1,0
18073,51327,445,0,0,70,70,0,1,0,1,0
18074,63101,445,0,0,66,66,0,1,0,1,0
18075,56306,17500,0,0,146,146,0,1,0,1,0
18076,62915,445,0,0,70,70,0,1,0,1,0
18077,61400,64147,0,0,62,62,0,1,0,1,0
18078,25523,35974,0,0,62,62,0,1,0,1,0
18079,62885,62413,0,0,62,62,0,1,0,1,0
18080,62913,445,0,0,70,70,0,1,0,1,0
18081,59988,64147,0,0,66,66,0,1,0,1,0
18082,50566,22114,0,0,62,62,0,1,0,1,0
18083,57337,64147,0,0,66,66,0,1,0,1,0
18084,51396,56205,0,0,62,62,0,1,0,1,0
18085,49651,37965,0,0,74,74,0,1,0,1,0
18086,33886,65504,0,0,162,162,0,1,0,1,0
18087,51325,445,0,0,70,70,0,1,0,1,0
18088,51320,445,0,0,70,70,0,1,0,1,0
18089,2543,25174,0,0,66,66,0,1,0,1,0
18090,62909,445,0,0,70,70,0,1,0,1,0
18091,50951,53,0,0,82,82,0,1,30,1,0
18092,50972,3544,50946,3544,258,107,151,2,30,1,1
18093,56522,53,28369,53,170,87,83,2,30,1,1
18094,64249,53,29634,53,178,91,87,2,30,1,1
18095,28132,53,28132,53,176,78,98,2,30,1,1
18096,54858,443,53726,443,5252,3392,1860,22,316,12,10
18097,45406,80,51652,80,573,499,74,6,15,5,1
18098,32864,53,32864,53,404,259,145,3,32,2,1
18099,58926,443,61395,443,5329,3428,1901,20,16,10,10
18100,56916,443,36796,443,13829,2472,11357,30,243,13,17
18101,55945,53,36008,53,760,97,663,2,30,1,1
18102,63963,53,56258,53,262,86,176,4,46,2,2
18103,55102,80,41246,80,46215,1615,44600,57,18,24,33
18104,59366,443,63784,443,59122,7352,51770,85,322,41,44
18105,56680,443,28221,443,8942,1817,7125,23,77,13,10
18106,55024,53,61199,53,174,89,85,2,30,1,1
18107,49449,53,12310,53,216,110,106,2,30,1,1
18108,55487,53,4696,53,732,89,643,2,30,1,1
18109,52929,443,62112,443,5582,1388,4194,19,15,9,10
18110,60191,80,55591,80,2589,1231,1358,9,28,5,4
18111,64576,53,33878,53,188,96,92,2,31,1,1
18112,33122,80,28324,80,9055,863,8192,18,45,10,8
18113,56192,53,15421,53,170,87,83,2,30,1,1
18114,36560,3142,36560,3142,138,78,60,2,5,1,1
18115,38406,80,52487,80,52105,1615,50490,61,18,24,37
18116,60500,443,54155,443,103479,7755,95724,165,19,70,95
18117,56832,80,37022,80,54049,2036,52013,69,18,31,38
18118,49298,443,58144,443,3949,2535,1414,24,75,12,12
18119,28035,443,12518,443,5458,1390,4068,17,15,9,8
18120,39776,443,45893,443,6283,1439,4844,25,316,13,12
18121,52529,80,44880,80,1056,682,374,10,15,6,4
18122,51037,443,13769,443,7298,2661,4637,21,17,11,10
18123,45404,80,36835,80,574,500,74,6,15,5,1
18124,56786,443,44559,443,9096,4394,4702,26,256,15,11
18125,60065,80,60065,80,246733,5745,240988,246,144,80,166
18126,58881,443,10013,443,1413,876,537,12,26,6,6
18127,64340,53,64340,53,847,110,737,2,30,1,1
18128,5588,5588,0,0,3562,1936,1626,48,193,24,24
18129,45533,80,45533,80,52365,3013,49352,53,51,13,40
18130,57417,53,14881,53,295,101,194,4,31,2,2
18131,55602,443,15216,443,7360,2298,5062,22,255,12,10
18132,52930,443,20378,443,5584,1390,4194,19,15,9,10
18133,28034,443,40574,443,5456,1388,4068,17,15,9,8
18134,34353,53,34353,53,213,79,134,2,33,1,1
18135,45400,80,25751,80,574,500,74,6,15,5,1
18136,49733,443,61095,443,204,70,134,4,26,2,2
18137,34493,443,37498,443,11771,2624,9147,50,20,25,25
18138,46617,53,46617,53,213,87,126,2,30,1,1
18139,45402,80,27119,80,573,499,74,6,15,5,1
18140,37542,53,41860,53,240,76,164,2,30,1,1
18141,65248,53,20664,53,208,106,102,2,30,1,1
18142,41672,53,20887,53,240,76,164,2,30,1,1
18143,52711,443,58119,443,15118,3979,11139,34,353,17,17
18144,49855,53,31460,53,170,87,83,2,30,1,1
18145,50443,53,37606,53,788,108,680,2,31,1,1
18146,64681,443,43290,443,2924,653,2271,13,135,6,7
18147,64965,27049,54387,27049,747,462,285,2,31,1,1
18148,2267,53,42274,53,204,118,86,2,31,1,1
18149,2267,53,57413,53,204,118,86,2,31,1,1
18150,2267,53,31811,53,204,118,86,2,31,1,1
18151,56963,53,56853,53,198,101,97,2,31,1,1
18152,49111,443,50826,443,43887,3283,40604,60,398,21,39
18153,50265,56845,47720,56845,480,149,331,2,1200,1,1
18154,56091,53,8508,53,771,101,670,2,31,1,1
18155,57322,53,27268,53,192,98,94,2,31,1,1
18156,2267,53,17239,53,204,118,86,2,31,1,1
18157,56340,53,14544,53,196,100,96,2,31,1,1
18158,46770,443,32021,443,90614,3825,86789,108,214,42,66
18159,49484,53,47845,53,742,88,654,2,31,1,1
18160,56603,53,59539,53,168,86,82,2,31,1,1
18161,64106,53,59908,53,190,97,93,2,31,1,1
18162,65279,53,56734,53,182,93,89,2,31,1,1
18163,65428,53,32499,53,190,97,93,2,31,1,1
18164,64960,27021,59267,27021,742,462,280,2,31,1,1
18165,2267,53,29941,53,204,118,86,2,31,1,1
18166,54924,3478,57299,3478,432,200,232,6,31,3,3
18167,54924,3478,25286,3478,312,140,172,4,31,2,2
18168,65099,53,63994,53,198,101,97,2,31,1,1
18169,64146,53,41885,53,194,99,95,2,31,1,1
18170,59061,443,25060,443,5464,3984,1480,35,221,20,15
18171,44063,443,1759,443,7762,2601,5161,18,137,8,10
18172,49891,53,42483,53,164,84,80,2,31,1,1
18173,64963,27037,16564,27037,741,462,279,2,31,1,1
18174,57761,30317,0,0,66,66,0,1,0,1,0
18175,50251,35440,0,0,66,66,0,1,0,1,0
18176,63085,445,0,0,66,66,0,1,0,1,0
18177,63083,445,0,0,66,66,0,1,0,1,0
18178,59786,25174,0,0,66,66,0,1,0,1,0
18179,1024,37450,0,0,62,62,0,1,0,1,0
18180,60786,25174,0,0,66,66,0,1,0,1,0
18181,55464,22114,0,0,62,62,0,1,0,1,0
18182,63364,57470,0,0,66,66,0,1,0,1,0
18183,34932,38608,0,0,62,62,0,1,0,1,0
18184,54438,62413,0,0,66,66,0,1,0,1,0
18185,51315,445,0,0,70,70,0,1,0,1,0
18186,52078,443,12860,443,9757,2051,7706,34,256,15,19
18187,57442,66,38674,66,70,70,0,1,5,1,0
18188,53152,443,33270,443,116790,7062,109728,166,144,85,81
18189,49449,53,15422,53,216,110,106,2,30,1,1
18190,59032,53,50252,53,295,86,209,2,30,1,1
18191,56912,53,3525,53,199,102,97,2,30,1,1
18192,53158,17234,38811,17234,70,70,0,1,4,1,0
18193,63952,53,32922,53,211,110,101,2,29,1,1
18194,56912,53,5094,53,199,102,97,2,29,1,1
18195,55965,53,59955,53,184,94,90,2,29,1,1
18196,37918,443,47034,443,6521,2079,4442,32,3827,19,13
18197,64318,53,41262,53,499,183,316,6,57,3,3
18198,49302,53,61464,53,234,94,140,2,30,1,1
18199,38460,443,14446,443,272822,10124,262698,330,81,126,204
18200,55194,53,43998,53,195,102,93,2,30,1,1
18201,54912,80,63649,80,1992,1350,642,10,15,5,5
18202,62293,443,17682,443,598,598,0,8,40,8,0
18203,42108,80,8576,80,8370,1025,7345,18,80,10,8
18204,55238,443,7974,443,6186,1650,4536,20,16,11,9
18205,64414,53,13029,53,183,94,89,2,29,1,1
18206,55194,53,21353,53,195,102,93,2,29,1,1
18207,52541,53,60922,53,242,78,164,2,29,1,1
18208,49363,53,56997,53,309,94,215,2,29,1,1
18209,55871,53,54584,53,177,94,83,2,29,1,1
18210,49286,53,40508,53,184,94,90,2,29,1,1
18211,64414,53,36942,53,183,94,89,2,29,1,1
18212,65248,53,6844,53,446,106,340,4,47,2,2
18213,55699,53,3858,53,271,103,168,4,59,2,2
18214,51531,443,29173,443,898,460,438,12,39,5,7
18215,54022,443,20800,443,121935,7839,114096,175,255,82,93
18216,49218,443,54857,443,590577,16239,574338,610,23,222,388
18217,45374,80,46773,80,806,463,343,9,15,6,3
18218,53619,443,9096,443,24190,18242,5948,43,330,25,18
18219,49497,443,34229,443,185560,47806,137754,421,295,217,204
18220,64146,53,31528,53,197,102,95,2,30,1,1
18221,65002,27064,63916,27064,735,462,273,2,30,1,1
18222,55024,53,59987,53,179,94,85,2,30,1,1
18223,3580,53,3580,53,832,106,726,2,30,1,1
18224,45886,80,22615,80,6959,2024,4935,14,148,8,6
18225,56336,53,29646,53,178,94,84,2,30,1,1
18226,61856,443,61856,443,4918,1626,3292,17,17,10,7
18227,55024,53,16229,53,179,94,85,2,30,1,1
18228,36998,80,39862,80,130,70,60,2,15,1,1
18229,9247,80,43064,80,860,794,66,6,17,5,1
18230,64140,53,22655,53,306,94,212,4,33,2,2
18231,49286,53,14433,53,184,94,90,2,30,1,1
18232,65116,53,63214,53,200,94,106,2,30,1,1
18233,63137,47117,19060,47117,574,448,126,10,25,8,2
18234,49631,53,56350,53,198,102,96,2,30,1,1
18235,44235,443,40190,443,2863,1501,1362,20,317,10,10
18236,57669,443,51063,443,12569,8228,4341,28,256,16,12
18237,60793,40010,33213,40010,316,136,180,6,6,3,3
18238,64985,27037,29129,27037,734,462,272,2,30,1,1
18239,12364,80,12364,80,7282,653,6629,16,16,8,8
18240,65011,53,59179,53,168,86,82,2,30,1,1
18241,50609,53,13488,53,766,102,664,2,30,1,1
18242,65245,53,31425,53,184,102,82,2,30,1,1
18243,56603,53,39210,53,168,86,82,2,30,1,1
18244,56522,53,51170,53,177,94,83,2,30,1,1
18245,64746,53,23146,53,193,102,91,2,30,1,1
18246,49855,53,65525,53,177,94,83,2,30,1,1
18247,61675,443,61675,443,8512,2483,6029,21,18,12,9
18248,52066,60118,24886,60118,70,70,0,2,8,2,0
18249,52068,39864,59001,39864,70,70,0,2,8,2,0
18250,56739,443,41966,443,7914,1925,5989,20,15,11,9
18251,55699,53,30470,53,271,103,168,4,59,2,2
18252,39785,53,39785,53,229,98,131,2,30,1,1
18253,55942,53,15569,53,197,102,95,2,30,1,1
18254,65000,27019,62331,27019,728,462,266,2,30,1,1
18255,55786,53,31916,53,102,102,0,1,30,1,0
18256,50837,443,12077,443,3292,2022,1270,16,16,9,7
18257,51505,443,22811,443,7211,823,6388,16,15,10,6
18258,58169,443,39268,443,30845,9943,20902,172,133,73,99
18259,49538,80,51947,80,2050,1691,359,9,75,6,3
18260,50644,80,26132,80,314,192,122,6,25,4,2
18261,63963,53,20929,53,262,86,176,4,46,2,2
18262,64935,53,16580,53,765,102,663,2,30,1,1
18263,50520,53,48841,53,183,94,89,2,30,1,1
18264,65011,53,42934,53,168,86,82,2,30,1,1
18265,58681,123,50487,123,184,94,90,2,30,1,1
18266,64249,53,32881,53,181,94,87,2,30,1,1
18267,53831,54676,36346,54676,492,306,186,8,16,5,3
18268,60449,443,18490,443,26571,2432,24139,42,30,21,21
18269,39802,443,46895,443,2863801,103667,2760134,3193,182,1240,1953
18270,53807,443,5620,443,4622,860,3762,16,17,9,7
18271,57221,53,53360,53,184,102,82,2,30,1,1
18272,38145,443,38145,443,4599,1692,2907,19,29,11,8
18273,60422,443,51829,443,7274,1925,5349,24,138,12,12
18274,55526,80,64372,80,6138,1242,4896,15,40,7,8
18275,46318,443,20839,443,6373,1744,4629,22,15,13,9
18276,43827,443,64958,443,130,70,60,2,14,1,1
18277,53874,43922,52145,43922,320,140,180,6,6,3,3
18278,53842,57861,18155,57861,492,306,186,8,14,5,3
18279,33143,80,14116,80,7406,1038,6368,18,15,10,8
18280,52067,46837,12452,46837,70,70,0,2,8,2,0
18281,56740,443,16895,443,7862,1873,5989,20,15,11,9
18282,50938,443,19392,443,37198,29093,8105,64,17,34,30
18283,52069,53446,38596,53446,70,70,0,2,7,2,0
18284,50646,80,29942,80,1328,917,411,10,25,6,4
18285,52051,29868,57987,29868,70,70,0,1,4,1,0
18286,58927,443,34485,443,5168,700,4468,16,15,7,9
18287,56125,80,62901,80,2091,799,1292,10,15,6,4
18288,56333,53,9058,53,822,102,720,2,29,1,1
18289,65248,53,43627,53,212,110,102,2,29,1,1
18290,55829,53,27683,53,177,94,83,2,29,1,1
18291,56762,53,10015,53,168,86,82,2,29,1,1
18292,64357,53,31050,53,183,94,89,2,29,1,1
18293,50661,80,15216,80,1658,1247,411,8,15,5,3
18294,52261,53,10393,53,195,94,101,2,29,1,1
18295,64477,53,60345,53,211,102,109,2,29,1,1
18296,44157,53,44157,53,216,90,126,2,29,1,1
18297,56550,53,19597,53,166,86,80,2,29,1,1
18298,10947,53,10947,53,197,90,107,2,29,1,1
18299,49620,53,16282,53,198,110,88,2,29,1,1
18300,49855,53,48096,53,177,94,83,2,30,1,1
18301,56192,53,47862,53,177,94,83,2,30,1,1
18302,55711,53,26039,53,177,94,83,2,29,1,1
18303,56912,53,8353,53,199,102,97,2,30,1,1
18304,62306,53,46053,53,387,94,293,2,30,1,1
18305,56910,53,22546,53,199,102,97,2,29,1,1
18306,56497,53,16693,53,177,94,83,2,30,1,1
18307,49332,53,35822,53,276,118,158,2,30,1,1
18308,56078,53,11255,53,168,86,82,2,30,1,1
18309,50520,53,8153,53,183,94,89,2,30,1,1
18310,55751,53,8390,53,216,94,122,2,30,1,1
18311,51001,53,26424,53,183,86,97,2,30,1,1
18312,64245,53,16068,53,344,94,250,2,30,1,1
18313,53833,53,46684,53,211,78,133,2,30,1,1
18314,56500,53,38812,53,164,86,78,2,30,1,1
18315,17750,8953,36082,8953,491,150,341,2,1200,1,1
18316,49160,51413,36529,51413,800,150,650,4,1200,2,2
18317,65064,53,46432,53,198,102,96,2,30,1,1
18318,63972,53,46168,53,193,102,91,2,30,1,1
18319,64966,27051,35392,27051,736,462,274,2,30,1,1
18320,65279,53,28048,53,183,94,89,2,31,1,1
18321,2267,53,18224,53,204,118,86,2,31,1,1
18322,47244,443,21922,443,5953,1848,4105,18,17,10,8
18323,53806,443,60221,443,12788,2594,10194,40,17,20,20
18324,9225,443,21069,443,5510,901,4609,15,25,8,7
18325,64287,53,27313,53,497,90,407,4,33,2,2
18326,60970,80,26224,80,912,472,440,8,15,3,5
18327,56281,53,56281,53,851,114,737,2,30,1,1
18328,64894,53,8238,53,195,102,93,2,30,1,1
18329,64926,53,24382,53,166,86,80,2,30,1,1
18330,64894,53,19330,53,195,102,93,2,30,1,1
18331,56192,53,30886,53,177,94,83,2,30,1,1
18332,65245,53,21925,53,184,102,82,2,30,1,1
18333,49304,53,30791,53,214,102,112,2,30,1,1
18334,55786,53,13962,53,193,102,91,2,30,1,1
18335,54673,443,44962,443,10244,2295,7949,38,121,20,18
18336,49776,443,33796,443,214,140,74,4,15,3,1
18337,58883,443,51515,443,1115,591,524,12,25,6,6
18338,51505,443,27614,443,1210,450,760,17,54,5,12
18339,49449,53,11737,53,216,110,106,2,30,1,1
18340,60711,53,53816,53,211,78,133,2,30,1,1
18341,55211,53,36249,53,183,94,89,2,30,1,1
18342,49637,53,0,0,86,86,0,1,30,1,0
18343,56752,53,41172,53,183,94,89,2,30,1,1
18344,46128,443,47204,443,9814,2331,7483,38,255,19,19
18345,52856,443,43323,443,5495,1303,4192,17,15,9,8
18346,37185,443,49991,443,14035,8420,5615,31,256,18,13
18347,56738,443,13897,443,7863,1874,5989,20,15,11,9
18348,42810,443,64537,443,9265,2134,7131,24,123,12,12
18349,56740,80,35362,80,1462,703,759,8,17,5,3
18350,55211,53,32834,53,183,94,89,2,30,1,1
18351,56497,53,37841,53,177,94,83,2,30,1,1
18352,35459,443,23832,443,119911,5690,114221,153,173,63,90
18353,60580,53,20280,53,181,86,95,2,30,1,1
18354,64573,53,37433,53,757,102,655,2,30,1,1
18355,56121,53,26656,53,338,110,228,2,30,1,1
18356,65036,53,4183,53,199,102,97,2,30,1,1
18357,56500,53,54568,53,164,86,78,2,30,1,1
18358,49226,53,3367,53,194,102,92,2,30,1,1
18359,55024,53,31814,53,179,94,85,2,30,1,1
18360,64829,53,40836,53,213,102,111,2,30,1,1
18361,51689,53,34111,53,198,86,112,2,30,1,1
18362,61830,443,61830,443,88574,15708,72866,114,176,52,62
18363,49804,53,30225,53,209,102,107,2,30,1,1
18364,56497,53,27099,53,177,94,83,2,30,1,1
18365,55865,53,64490,53,168,86,82,2,30,1,1
18366,49180,53,27807,53,359,118,241,2,30,1,1
18367,2267,53,1779,53,204,118,86,2,31,1,1
18368,2267,53,42129,53,204,118,86,2,31,1,1
18369,50559,53,4402,53,216,110,106,2,31,1,1
18370,2267,53,1251,53,204,118,86,2,31,1,1
18371,55591,53,39527,53,195,102,93,2,31,1,1
18372,2267,53,46205,53,204,118,86,2,31,1,1
18373,2267,53,54928,53,204,118,86,2,31,1,1
18374,64106,53,27158,53,195,102,93,2,31,1,1
18375,59478,443,44670,443,9310,2994,6316,25,122,11,14
18376,64576,53,63457,53,194,102,92,2,31,1,1
18377,57470,37395,27238,37395,1566,332,1234,11,1199,5,6
18378,56100,53,57045,53,216,110,106,2,31,1,1
18379,2267,53,13385,53,204,118,86,2,31,1,1
18380,2267,53,11454,53,204,118,86,2,31,1,1
18381,56752,53,15313,53,183,94,89,2,31,1,1
18382,56019,53,28168,53,194,102,92,2,31,1,1
18383,65099,53,22746,53,199,102,97,2,31,1,1
18384,57331,53,47400,53,178,94,84,2,31,1,1
18385,55069,53,13593,53,195,102,93,2,31,1,1
18386,49563,443,54610,443,6462,2102,4360,18,180,8,10
18387,57470,1031,51778,1031,402,132,270,6,1209,3,3
18388,64051,53,51013,53,430,172,258,6,61,3,3
18389,40302,443,5180,443,7586,3785,3801,20,30,11,9
18390,55015,443,24425,443,22687,6933,15754,50,50,26,24
18391,54592,80,24898,80,1113,534,579,12,16,7,5
18392,53198,53,24028,53,365,86,279,2,30,1,1
18393,63972,53,35839,53,193,102,91,2,30,1,1
18394,56192,53,42935,53,177,94,83,2,30,1,1
18395,64146,53,63495,53,197,102,95,2,30,1,1
18396,64188,53,45023,53,194,94,100,2,30,1,1
18397,57322,53,63683,53,196,102,94,2,31,1,1
18398,47836,443,38604,443,36324,2308,34016,55,81,22,33
18399,55865,53,56298,53,168,86,82,2,30,1,1
18400,63103,53,6941,53,222,86,136,2,30,1,1
18401,64535,53,33577,53,734,86,648,2,31,1,1
18402,48724,443,22721,443,4371,2036,2335,18,24,10,8
18403,56737,443,49751,443,7915,1926,5989,20,16,11,9
18404,52070,55946,25301,55946,316,136,180,6,7,3,3
18405,51314,445,0,0,70,70,0,1,0,1,0
18406,51308,445,0,0,70,70,0,1,0,1,0
18407,51307,445,0,0,70,70,0,1,0,1,0
18408,45964,2225,0,0,60,60,0,1,0,1,0
18409,45964,2225,0,0,60,60,0,1,0,1,0
18410,63079,445,0,0,66,66,0,1,0,1,0
18411,49754,35440,0,0,146,146,0,1,0,1,0
18412,22636,30188,0,0,66,66,0,1,0,1,0
18413,57220,26467,0,0,66,66,0,1,0,1,0
18414,62896,445,0,0,70,70,0,1,0,1,0
18415,56306,57587,0,0,146,146,0,1,0,1,0
18416,19662,22114,0,0,62,62,0,1,0,1,0
18417,63067,445,0,0,66,66,0,1,0,1,0
18418,63069,445,0,0,66,66,0,1,0,1,0
18419,63068,445,0,0,66,66,0,1,0,1,0
18420,63072,445,0,0,66,66,0,1,0,1,0
18421,63066,445,0,0,66,66,0,1,0,1,0
18422,63065,445,0,0,66,66,0,1,0,1,0
18423,63063,445,0,0,66,66,0,1,0,1,0
18424,2062,35440,0,0,66,66,0,1,0,1,0
18425,51298,445,0,0,70,70,0,1,0,1,0
18426,26881,25174,0,0,66,66,0,1,0,1,0
18427,60793,53733,0,0,66,66,0,1,0,1,0
18428,62893,445,0,0,70,70,0,1,0,1,0
18429,51292,445,0,0,70,70,0,1,0,1,0
18430,51295,445,0,0,70,70,0,1,0,1,0
18431,51291,445,0,0,70,70,0,1,0,1,0
18432,55678,32468,0,0,66,66,0,1,0,1,0
18433,41541,25174,0,0,66,66,0,1,0,1,0
18434,68,67,0,0,346,346,0,1,0,1,0
18435,59213,25174,0,0,66,66,0,1,0,1,0
18436,8889,21251,0,0,60,60,0,1,0,1,0
18437,60104,30188,0,0,62,62,0,1,0,1,0
18438,62888,445,0,0,70,70,0,1,0,1,0
18439,51560,46783,0,0,62,62,0,1,0,1,0
18440,62887,445,0,0,70,70,0,1,0,1,0
18441,515,10214,0,0,66,66,0,1,0,1,0
18442,51289,445,0,0,70,70,0,1,0,1,0
18443,51287,445,0,0,70,70,0,1,0,1,0
18444,51286,445,0,0,70,70,0,1,0,1,0
18445,62885,445,0,0,70,70,0,1,0,1,0
18446,63057,445,0,0,66,66,0,1,0,1,0
18447,51282,445,0,0,70,70,0,1,0,1,0
18448,56306,1,0,0,146,146,0,1,0,1,0
18449,44612,25174,0,0,66,66,0,1,0,1,0
18450,63053,445,0,0,66,66,0,1,0,1,0
18451,59524,25174,0,0,66,66,0,1,0,1,0
18452,63051,445,0,0,66,66,0,1,0,1,0
18453,63050,445,0,0,66,66,0,1,0,1,0
18454,11136,15503,0,0,62,62,0,1,0,1,0
18455,63048,445,0,0,66,66,0,1,0,1,0
18456,62878,445,0,0,70,70,0,1,0,1,0
18457,53640,25174,0,0,66,66,0,1,0,1,0
18458,64214,25174,0,0,62,62,0,1,0,1,0
18459,51281,445,0,0,70,70,0,1,0,1,0
18460,63062,11392,0,0,66,66,0,1,0,1,0
18461,62876,445,0,0,70,70,0,1,0,1,0
18462,40481,22114,0,0,66,66,0,1,0,1,0
18463,6881,46776,0,0,146,146,0,1,0,1,0
18464,53197,25174,0,0,62,62,0,1,0,1,0
18465,51267,445,0,0,70,70,0,1,0,1,0
18466,51265,445,0,0,70,70,0,1,0,1,0
18467,62875,445,0,0,70,70,0,1,0,1,0
18468,62874,445,0,0,70,70,0,1,0,1,0
18469,53470,22114,0,0,66,66,0,1,0,1,0
18470,62873,445,0,0,70,70,0,1,0,1,0
18471,62867,445,0,0,70,70,0,1,0,1,0
18472,62870,445,0,0,70,70,0,1,0,1,0
18473,63037,445,0,0,66,66,0,1,0,1,0
18474,8889,53670,0,0,60,60,0,1,0,1,0
18475,6880,31359,0,0,107,107,0,1,0,1,0
18476,50822,50584,0,0,62,62,0,1,0,1,0
18477,2383,37965,0,0,66,66,0,1,0,1,0
18478,62855,445,0,0,70,70,0,1,0,1,0
18479,62854,445,0,0,70,70,0,1,0,1,0
18480,62852,445,0,0,70,70,0,1,0,1,0
18481,63030,445,0,0,66,66,0,1,0,1,0
18482,25150,25174,0,0,62,62,0,1,0,1,0
18483,51255,445,0,0,70,70,0,1,0,1,0
18484,62844,445,0,0,70,70,0,1,0,1,0
18485,62845,445,0,0,70,70,0,1,0,1,0
18486,46280,5900,0,0,60,60,0,1,0,1,0
18487,55012,25174,0,0,66,66,0,1,0,1,0
18488,54530,46776,0,0,66,66,0,1,0,1,0
18489,55385,53,61909,53,710,89,621,2,0,1,1
18490,55643,53,39402,53,182,93,89,2,0,1,1
18491,18642,42707,0,0,145,145,0,1,0,1,0
18492,28795,37965,0,0,62,62,0,1,0,1,0
18493,51706,25174,0,0,66,66,0,1,0,1,0
18494,45941,23387,0,0,60,60,0,1,0,1,0
18495,63027,445,0,0,66,66,0,1,0,1,0
18496,54684,37965,0,0,62,62,0,1,0,1,0
18497,1860,25174,0,0,66,66,0,1,0,1,0
18498,1027,25174,0,0,62,62,0,1,0,1,0
18499,51479,25174,0,0,66,66,0,1,0,1,0
18500,62489,23117,0,0,66,66,0,1,0,1,0
18501,43185,50584,0,0,146,146,0,1,0,1,0
18502,25207,48817,0,0,62,62,0,1,0,1,0
18503,63019,445,0,0,66,66,0,1,0,1,0
18504,55570,44847,0,0,66,66,0,1,0,1,0
18505,33941,37807,0,0,62,62,0,1,0,1,0
18506,62833,445,0,0,70,70,0,1,0,1,0
18507,53073,32468,0,0,66,66,0,1,0,1,0
18508,63017,445,0,0,66,66,0,1,0,1,0
18509,6247,51221,0,0,78,78,0,1,0,1,0
18510,60260,22114,0,0,62,62,0,1,0,1,0
18511,56306,15503,0,0,146,146,0,1,0,1,0
18512,55711,26467,0,0,62,62,0,1,0,1,0
18513,29972,50584,0,0,62,62,0,1,0,1,0
18514,80,8562,0,0,74,74,0,1,0,1,0
18515,56424,53,24013,53,711,87,624,2,0,1,1
18516,51746,25174,0,0,62,62,0,1,0,1,0
18517,54121,25174,0,0,66,66,0,1,0,1,0
18518,62828,445,0,0,70,70,0,1,0,1,0
18519,51246,445,0,0,70,70,0,1,0,1,0
18520,51242,445,0,0,70,70,0,1,0,1,0
18521,51243,445,0,0,70,70,0,1,0,1,0
18522,57496,25174,0,0,66,66,0,1,0,1,0
18523,63004,445,0,0,66,66,0,1,0,1,0
18524,63005,445,0,0,66,66,0,1,0,1,0
18525,63003,445,0,0,66,66,0,1,0,1,0
18526,63002,445,0,0,66,66,0,1,0,1,0
18527,63001,445,0,0,66,66,0,1,0,1,0
18528,63000,445,0,0,66,66,0,1,0,1,0
18529,62999,445,0,0,66,66,0,1,0,1,0
18530,62997,445,0,0,66,66,0,1,0,1,0
18531,15281,25174,0,0,146,146,0,1,0,1,0
18532,50459,62413,0,0,62,62,0,1,0,1,0
18533,56676,37965,0,0,66,66,0,1,0,1,0
18534,15605,50265,0,0,62,62,0,1,0,1,0
18535,58022,5560,0,0,60,60,0,1,0,1,0
18536,62820,445,0,0,70,70,0,1,0,1,0
18537,62819,445,0,0,70,70,0,1,0,1,0
18538,62818,445,0,0,70,70,0,1,0,1,0
18539,62815,445,0,0,70,70,0,1,0,1,0
18540,32997,22,0,0,60,60,0,1,0,1,0
18541,62812,445,0,0,70,70,0,1,0,1,0
18542,21064,25174,0,0,62,62,0,1,0,1,0
18543,54373,26467,0,0,62,62,0,1,0,1,0
18544,43828,44847,0,0,62,62,0,1,0,1,0
18545,13285,29892,0,0,145,145,0,1,0,1,0
18546,64392,25174,0,0,62,62,0,1,0,1,0
18547,64190,2767,0,0,62,62,0,1,0,1,0
18548,51238,445,0,0,70,70,0,1,0,1,0
18549,51233,445,0,0,70,70,0,1,0,1,0
18550,51236,445,0,0,70,70,0,1,0,1,0
18551,51226,445,0,0,70,70,0,1,0,1,0
18552,43584,24748,0,0,156,156,0,1,0,1,0
18553,23594,48983,0,0,159,159,0,1,0,1,0
18554,60058,25174,0,0,66,66,0,1,0,1,0
18555,62982,445,0,0,66,66,0,1,0,1,0
18556,62984,445,0,0,66,66,0,1,0,1,0
18557,62983,445,0,0,66,66,0,1,0,1,0
18558,57284,22114,0,0,62,62,0,1,0,1,0
18559,62806,445,0,0,70,70,0,1,0,1,0
18560,60823,25174,0,0,62,62,0,1,0,1,0
18561,48301,25174,0,0,66,66,0,1,0,1,0
18562,22714,30188,0,0,146,146,0,1,0,1,0
18563,28306,25604,0,0,62,62,0,1,0,1,0
18564,62064,22114,0,0,66,66,0,1,0,1,0
18565,55508,64147,0,0,62,62,0,1,0,1,0
18566,61523,37807,0,0,66,66,0,1,0,1,0
18567,51222,445,0,0,70,70,0,1,0,1,0
18568,35111,22114,0,0,66,66,0,1,0,1,0
18569,54726,30041,0,0,66,66,0,1,0,1,0
18570,51218,445,0,0,70,70,0,1,0,1,0
18571,51216,445,0,0,70,70,0,1,0,1,0
18572,51213,445,0,0,70,70,0,1,0,1,0
18573,62799,445,0,0,70,70,0,1,0,1,0
18574,62797,445,0,0,70,70,0,1,0,1,0
18575,13235,44847,0,0,66,66,0,1,0,1,0
18576,12841,37965,0,0,62,62,0,1,0,1,0
18577,52682,22114,0,0,66,66,0,1,0,1,0
18578,49752,50584,0,0,62,62,0,1,0,1,0
18579,62793,445,0,0,70,70,0,1,0,1,0
18580,63323,54369,0,0,78,78,0,1,0,1,0
18581,55167,48817,0,0,66,66,0,1,0,1,0
18582,62791,445,0,0,70,70,0,1,0,1,0
18583,49514,65504,0,0,162,162,0,1,0,1,0
18584,64036,23718,0,0,66,66,0,1,0,1,0
18585,51866,22114,0,0,66,66,0,1,0,1,0
18586,49824,25174,0,0,62,62,0,1,0,1,0
18587,63595,51050,0,0,66,66,0,1,0,1,0
18588,22408,22114,0,0,66,66,0,1,0,1,0
18589,51205,445,0,0,70,70,0,1,0,1,0
18590,51204,445,0,0,70,70,0,1,0,1,0
18591,51203,445,0,0,70,70,0,1,0,1,0
18592,62787,445,0,0,70,70,0,1,0,1,0
18593,62972,445,0,0,66,66,0,1,0,1,0
18594,7160,34317,0,0,146,146,0,1,0,1,0
18595,63998,11372,44405,11372,504,382,122,8,16,6,2
18596,49571,443,45165,443,3972,887,3085,13,31,6,7
18597,2267,53,35610,53,204,118,86,2,30,1,1
18598,64739,53,44159,53,172,88,84,2,30,1,1
18599,52045,16853,9076,16853,66,66,0,1,5,1,0
18600,38766,53,38766,53,371,237,134,3,32,2,1
18601,49731,443,10101,443,4484,1063,3421,15,25,7,8
18602,5588,5588,0,0,3562,1936,1626,48,195,24,24
18603,56761,53,40671,53,788,108,680,2,30,1,1
18604,57357,443,47242,443,126,60,66,3,11,2,1
18605,49341,80,65147,80,1969,463,1506,13,55,7,6
18606,55069,53,8912,53,190,97,93,2,31,1,1
18607,56703,53,61350,53,198,101,97,2,31,1,1
18608,56134,53,39668,53,93,93,0,1,30,1,0
18609,55944,53,48983,53,762,98,664,2,30,1,1
18610,51621,443,45721,443,5964,1007,4957,18,16,11,7
18611,55591,53,58697,53,190,97,93,2,31,1,1
18612,54924,3478,2909,3478,312,140,172,4,30,2,2
18613,57318,443,57308,443,10504,1787,8717,27,364,12,15
18614,61827,443,61827,443,56634,10853,45781,76,175,34,42
18615,58077,443,14905,443,9138,4704,4434,24,315,13,11
18616,27322,443,7841,443,5235,1839,3396,22,48,10,12
18617,42382,443,39819,443,4844,1099,3745,18,25,10,8
18618,56633,53,42067,53,164,84,80,2,31,1,1
18619,45837,443,61728,443,39986,3118,36868,72,82,30,42
18620,55879,53,24811,53,749,94,655,2,30,1,1
18621,64051,53,14293,53,430,172,258,6,60,3,3
18622,56752,53,57000,53,182,93,89,2,30,1,1
18623,51071,443,30007,443,13412,5710,7702,50,257,24,26
18624,2267,53,32396,53,204,118,86,2,30,1,1
18625,50116,22,50116,22,146,60,86,2,9,1,1
18626,56308,53,17371,53,814,110,704,2,30,1,1
18627,57168,53,20859,53,760,96,664,2,30,1,1
18628,55896,53,31620,53,168,86,82,2,30,1,1
18629,57331,53,59568,53,172,88,84,2,30,1,1
18630,63972,53,23173,53,186,95,91,2,30,1,1
18631,55441,443,55441,443,4423,1516,2907,19,30,11,8
18632,37151,80,11771,80,130,70,60,2,15,1,1
18633,58921,443,47044,443,10782,7193,3589,30,16,17,13
18634,36017,443,12463,443,4883,3524,1359,20,200,11,9
18635,13553,53,13553,53,235,90,145,2,32,1,1
18636,49732,443,33979,443,4414,993,3421,14,25,6,8
18637,59933,80,6671,80,582,138,444,9,25,3,6
18638,61831,443,61831,443,530764,27638,503126,528,175,179,349
18639,27318,443,31101,443,16040,2126,13914,40,50,21,19
18640,55698,45710,26352,45710,70,70,0,2,8,2,0
18641,58912,443,7357,443,7941,5160,2781,25,17,13,12
18642,58913,443,48481,443,5264,3357,1907,21,17,11,10
18643,51614,443,28714,443,3833,867,2966,14,16,9,5
18644,58909,443,25795,443,7671,4890,2781,25,17,13,12
18645,51619,443,5811,443,3894,863,3031,15,16,9,6
18646,56336,53,24893,53,172,88,84,2,30,1,1
18647,60581,53,60581,53,197,76,121,2,30,1,1
18648,2267,53,10348,53,204,118,86,2,30,1,1
18649,56040,53,54233,53,761,100,661,2,30,1,1
18650,56231,53,34438,53,757,98,659,2,30,1,1
18651,2267,53,10522,53,204,118,86,2,30,1,1
18652,49797,53,55138,53,767,102,665,2,31,1,1
18653,56677,53,31185,53,767,102,665,2,31,1,1
18654,49112,443,21171,443,6319,877,5442,23,396,8,15
18655,57470,26944,61791,26944,480,149,331,2,1200,1,1
18656,55940,53,33630,53,742,88,654,2,30,1,1
18657,52716,443,35091,443,69951,4941,65010,95,351,45,50
18658,57341,53,29078,53,184,94,90,2,31,1,1
18659,35981,53,35981,53,227,89,138,2,31,1,1
18660,57200,53,22685,53,770,102,668,2,31,1,1
18661,52040,53,52040,53,251,98,153,2,31,1,1
18662,65048,53,54954,53,754,94,660,2,31,1,1
18663,49944,53,20178,53,192,98,94,2,31,1,1
18664,55735,53,13880,53,198,101,97,2,31,1,1
18665,49110,443,4488,443,43476,3775,39701,67,397,28,39
18666,57470,17690,10017,17690,1818,1188,630,26,2804,19,7
18667,49885,53,17170,53,760,97,663,2,31,1,1
18668,55323,53,14352,53,172,88,84,2,31,1,1
18669,64964,27035,57797,27035,996,462,534,4,31,2,2
18670,64679,53,50625,53,172,88,84,2,31,1,1
18671,56490,53,61381,53,744,89,655,2,31,1,1
18672,56377,53,45673,53,793,101,692,2,31,1,1
18673,56940,53,36969,53,200,102,98,2,31,1,1
18674,56349,53,17487,53,216,110,106,2,31,1,1
18675,49823,53,45548,53,202,103,99,2,31,1,1
18676,49113,443,18821,443,6318,877,5441,23,396,8,15
18677,39775,443,49168,443,6883,1887,4996,23,361,12,11
18678,46776,443,41505,443,7389,1786,5603,26,211,14,12
18679,55920,53,34293,53,810,108,702,2,31,1,1
18680,55468,53,52823,53,754,94,660,2,31,1,1
18681,64068,53,56393,53,168,86,82,2,31,1,1
18682,55624,53,14345,53,198,101,97,2,31,1,1
18683,55419,53,50922,53,760,97,663,2,31,1,1
18684,55520,53,33643,53,188,96,92,2,31,1,1
18685,56852,53,36624,53,762,101,661,2,31,1,1
18686,60483,443,59259,443,3089,866,2223,11,121,6,5
18687,15503,23852,58898,23852,10840,6789,4051,143,4379,82,61
18688,6881,6883,20913,6883,259,150,109,2,1200,1,1
18689,54578,26467,0,0,66,66,0,1,0,1,0
18690,62786,445,0,0,70,70,0,1,0,1,0
18691,3169,22114,0,0,66,66,0,1,0,1,0
18692,54796,22114,0,0,66,66,0,1,0,1,0
18693,34914,26467,0,0,62,62,0,1,0,1,0
18694,9836,22114,0,0,66,66,0,1,0,1,0
18695,52227,64147,0,0,62,62,0,1,0,1,0
18696,56403,51505,0,0,66,66,0,1,0,1,0
18697,47812,30627,0,0,62,62,0,1,0,1,0
18698,62217,37807,0,0,66,66,0,1,0,1,0
18699,55435,25174,0,0,62,62,0,1,0,1,0
18700,51197,445,0,0,70,70,0,1,0,1,0
18701,50145,53,7031,53,184,94,90,2,30,1,1
18702,54924,3478,47718,3478,312,140,172,4,30,2,2
18703,51612,443,60658,443,5677,918,4759,18,15,10,8
18704,51194,445,0,0,70,70,0,1,0,1,0
18705,62781,445,0,0,70,70,0,1,0,1,0
18706,60117,50934,0,0,66,66,0,1,0,1,0
18707,5227,50584,0,0,62,62,0,1,0,1,0
18708,63577,30188,0,0,66,66,0,1,0,1,0
18709,58247,57866,0,0,66,66,0,1,0,1,0
18710,16057,51050,0,0,66,66,0,1,0,1,0
18711,62956,445,0,0,66,66,0,1,0,1,0
18712,62953,445,0,0,66,66,0,1,0,1,0
18713,41486,1433,0,0,60,60,0,1,0,1,0
18714,52230,50265,0,0,62,62,0,1,0,1,0
18715,42231,57470,0,0,78,78,0,1,0,1,0
18716,55210,53,63664,53,969,86,883,2,30,1,1
18717,65275,53,12888,53,370,126,244,2,30,1,1
18718,56019,53,13898,53,194,102,92,2,30,1,1
18719,16403,16385,49252,16385,548,248,300,10,30,5,5
18720,64739,53,17167,53,178,94,84,2,30,1,1
18721,49514,53,53009,53,749,94,655,2,30,1,1
18722,57379,443,26122,443,7211,823,6388,16,15,10,6
18723,56336,53,15481,53,489,88,401,4,46,2,2
18724,49762,53,30143,53,819,102,717,2,29,1,1
18725,59833,53,30174,53,377,86,291,2,29,1,1
18726,54981,53,59429,53,757,102,655,2,29,1,1
18727,64999,27034,10678,27034,735,462,273,2,29,1,1
18728,56202,53,55288,53,819,102,717,2,29,1,1
18729,65283,53,11652,53,333,102,231,2,29,1,1
18730,57322,53,53567,53,196,102,94,2,29,1,1
18731,64806,53,37126,53,211,102,109,2,29,1,1
18732,50035,53,20021,53,308,102,206,2,29,1,1
18733,53609,53,21780,53,385,94,291,2,30,1,1
18734,57417,53,39419,53,199,102,97,2,30,1,1
18735,61826,443,61826,443,95212,17857,77355,119,175,53,66
18736,53453,443,33620,443,17494,6818,10676,46,46,25,21
18737,54948,443,58033,443,493685,14728,478957,612,316,213,399
18738,49639,443,42419,443,21062,2202,18860,34,80,15,19
18739,49341,53,21121,53,392,86,306,2,29,1,1
18740,64106,53,52132,53,195,102,93,2,29,1,1
18741,64790,53,60024,53,178,94,84,2,29,1,1
18742,49746,53,29622,53,185,102,83,2,30,1,1
18743,49203,53,4131,53,403,99,304,4,32,2,2
18744,2267,53,35940,53,204,118,86,2,30,1,1
18745,55786,53,64576,53,193,102,91,2,29,1,1
18746,2267,53,48892,53,204,118,86,2,30,1,1
18747,64994,27032,29881,27032,737,462,275,2,29,1,1
18748,49762,53,6291,53,196,102,94,2,29,1,1
18749,2267,53,13716,53,204,118,86,2,30,1,1
18750,49449,53,37523,53,216,110,106,2,29,1,1
18751,63972,53,24077,53,193,102,91,2,29,1,1
18752,51328,443,46063,443,6021,1981,4040,21,15,9,12
18753,57221,53,46489,53,184,102,82,2,29,1,1
18754,49226,53,7327,53,194,102,92,2,29,1,1
18755,64065,53,56733,53,264,94,170,2,29,1,1
18756,52046,59791,21148,59791,70,70,0,1,4,1,0
18757,52047,42805,53752,42805,70,70,0,1,4,1,0
18758,2267,53,32602,53,204,118,86,2,30,1,1
18759,49165,5938,24586,5938,143727,72050,71677,1106,10824,655,451
18760,2267,53,54801,53,204,118,86,2,30,1,1
18761,50972,3544,54977,3544,409,107,302,4,29,2,2
18762,56336,53,34970,53,178,94,84,2,29,1,1
18763,57331,53,50054,53,178,94,84,2,30,1,1
18764,50286,53,44602,53,766,102,664,2,30,1,1
18765,49364,80,23008,80,1614,1300,314,10,15,5,5
18766,47453,443,47453,443,4475,1568,2907,19,28,11,8
18767,49673,53,51744,53,421,88,333,4,39,2,2
18768,65261,53,11148,53,313,97,216,4,56,2,2
18769,2267,53,18938,53,204,118,86,2,30,1,1
18770,56560,53,3085,53,199,102,97,2,30,1,1
18771,65279,53,39619,53,183,94,89,2,30,1,1
18772,57339,53,52334,53,196,94,102,2,30,1,1
18773,55896,53,34756,53,168,86,82,2,30,1,1
18774,64068,53,31141,53,168,86,82,2,30,1,1
18775,49746,53,23888,53,177,94,83,2,30,1,1
18776,56100,53,6720,53,216,110,106,2,30,1,1
18777,64068,53,47417,53,168,86,82,2,31,1,1
18778,55855,443,32782,443,11485,3525,7960,32,33,18,14
18779,56667,80,26674,80,234,234,0,4,12,4,0
18780,64962,27048,15901,27048,747,462,285,2,30,1,1
18781,49604,53,29008,53,969,86,883,2,30,1,1
18782,50145,53,3618,53,807,94,713,2,30,1,1
18783,49567,5223,11151,5223,9705,5123,4582,29,74,15,14
18784,54924,3478,45480,3478,452,280,172,5,30,3,2
18785,49782,80,45830,80,130,70,60,2,15,1,1
18786,2267,53,56692,53,204,118,86,2,30,1,1
18787,51327,443,49417,443,8433,3066,5367,21,17,10,11
18788,49900,443,19208,443,52800,13228,39572,134,154,64,70
18789,64980,27047,61209,27047,735,462,273,2,30,1,1
18790,56560,53,4551,53,199,102,97,2,30,1,1
18791,46908,80,46908,80,5464,713,4751,15,16,8,7
18792,65106,53,10929,53,193,102,91,2,30,1,1
18793,50234,53,13512,53,242,78,164,2,30,1,1
18794,64715,53,60767,53,315,98,217,4,58,2,2
18795,49910,53,38613,53,218,94,124,2,30,1,1
18796,65279,53,57423,53,183,94,89,2,30,1,1
18797,57417,53,7685,53,199,102,97,2,30,1,1
18798,49652,53,26066,53,229,110,119,2,30,1,1
18799,15561,53,15561,53,199,90,109,2,30,1,1
18800,35915,80,21762,80,1283,644,639,9,146,5,4
18801,16403,16384,8455,16384,426,186,240,8,30,4,4
18802,58925,443,39506,443,5167,700,4467,16,15,7,9
18803,49220,2710,38165,2710,70,70,0,1,5,1,0
18804,65111,53,19274,53,355,96,259,4,38,2,2
18805,50660,80,51110,80,1658,1247,411,8,15,5,3
18806,55989,53,12782,53,821,102,719,2,30,1,1
18807,50559,53,61943,53,216,110,106,2,30,1,1
18808,65099,53,58455,53,199,102,97,2,30,1,1
18809,65174,53,57194,53,214,110,104,2,30,1,1
18810,43348,443,43348,443,46356,1595,44761,52,17,15,37
18811,34911,443,4016,443,414843,13933,400910,459,136,160,299
18812,27448,5222,60213,5222,8039,1649,6390,41,357,13,28
18813,34901,443,15952,443,70,70,0,1,5,1,0
18814,50151,80,25475,80,1915831,46544,1869287,1569,166,311,1258
18815,56734,443,60875,443,7889,1900,5989,20,15,11,9
18816,58322,53,41674,53,352,78,274,2,30,1,1
18817,50829,53,16960,53,168,78,90,2,30,1,1
18818,49965,53,5956,53,257,110,147,2,30,1,1
18819,55896,53,64776,53,168,86,82,2,30,1,1
18820,55591,53,22310,53,195,102,93,2,30,1,1
18821,56736,443,32910,443,7890,1901,5989,20,15,11,9
18822,7701,80,7701,80,900,519,381,7,141,4,3
18823,64051,53,27383,53,430,172,258,6,59,3,3
18824,56108,53,60144,53,298,92,206,4,41,2,2
18825,55268,53,38039,53,318,91,227,4,33,2,2
18826,55699,21063,32423,21063,70,70,0,2,8,2,0
18827,53841,8999,39565,8999,70,70,0,1,4,1,0
18828,60166,80,1732,80,186,64,122,4,28,2,2
18829,60466,64337,26945,64337,70,70,0,1,5,1,0
18830,49628,53,16334,53,168,86,82,2,31,1,1
18831,47828,443,14141,443,143399,8522,134877,208,153,101,107
18832,33826,443,52979,443,416,210,206,7,57,4,3
18833,40464,80,50769,80,15535,2173,13362,30,21,17,13
18834,55830,443,44368,443,62,62,0,1,5,1,0
18835,52065,52021,26408,52021,70,70,0,2,7,2,0
18836,52147,443,32446,443,27251,9966,17285,70,73,35,35
18837,34166,443,10129,443,1984,1233,751,16,20,8,8
18838,54018,443,16505,443,13330,3836,9494,53,255,29,24
18839,47075,80,40568,80,1614,1300,314,10,15,5,5
18840,65036,53,9458,53,199,102,97,2,29,1,1
18841,49426,53,14946,53,492,91,401,4,56,2,2
18842,49412,53,45661,53,761,102,659,2,29,1,1
18843,64853,53,57521,53,814,110,704,2,29,1,1
18844,57174,53,49887,53,293,86,207,2,29,1,1
18845,56963,53,37570,53,199,102,97,2,29,1,1
18846,49456,53,27659,53,360,110,250,2,29,1,1
18847,56603,53,47573,53,168,86,82,2,29,1,1
18848,65428,53,15132,53,195,102,93,2,29,1,1
18849,64791,53,19745,53,763,102,661,2,29,1,1
18850,65064,53,48752,53,821,102,719,2,29,1,1
18851,64790,53,14045,53,178,94,84,2,29,1,1
18852,65036,53,55693,53,199,102,97,2,29,1,1
18853,57331,53,57928,53,178,94,84,2,29,1,1
18854,65008,53,11411,53,276,118,158,2,29,1,1
18855,56560,53,17987,53,199,102,97,2,30,1,1
18856,65099,53,38778,53,199,102,97,2,29,1,1
18857,2267,53,43002,53,204,118,86,2,30,1,1
18858,56340,53,44693,53,198,102,96,2,30,1,1
18859,64742,53,7062,53,338,110,228,2,30,1,1
18860,2267,53,21811,53,204,118,86,2,30,1,1
18861,56202,53,15464,53,196,102,94,2,29,1,1
18862,50559,53,13725,53,216,110,106,2,29,1,1
18863,65518,53,57051,53,198,94,104,2,30,1,1
18864,63780,28124,24113,28124,4536,2883,1653,27,94,15,12
18865,36088,443,55123,443,7229,2357,4872,26,270,14,12
18866,2267,53,16452,53,204,118,86,2,30,1,1
18867,49697,53,7185,53,195,94,101,2,30,1,1
18868,55069,53,50203,53,195,102,93,2,30,1,1
18869,49504,53,3816,53,198,94,104,2,30,1,1
18870,49823,53,39665,53,209,110,99,2,31,1,1
18871,47582,443,49001,443,6214,1733,4481,13,120,6,7
18872,56340,53,42393,53,198,102,96,2,30,1,1
18873,49238,53,61405,53,274,94,180,2,30,1,1
18874,65028,53,41163,53,265,94,171,2,30,1,1
18875,50045,53,44466,53,168,86,82,2,31,1,1
18876,56349,53,28965,53,216,110,106,2,31,1,1
18877,64627,53,12613,53,184,102,82,2,31,1,1
18878,50515,80,58648,80,7871,1409,6462,17,75,7,10
18879,34902,443,35566,443,70,70,0,1,5,1,0
18880,34900,443,21666,443,70,70,0,1,5,1,0
18881,37672,5223,8222,5223,110,110,0,1,5,1,0
18882,50652,443,65076,443,2477,1505,972,15,20,9,6
18883,64641,53,15849,53,193,94,99,2,30,1,1
18884,65106,53,42197,53,193,102,91,2,30,1,1
18885,2267,53,1505,53,204,118,86,2,30,1,1
18886,57417,53,46711,53,199,102,97,2,30,1,1
18887,55896,53,48962,53,168,86,82,2,30,1,1
18888,54225,53,12389,53,274,78,196,2,30,1,1
18889,65406,53,43109,53,273,102,171,2,30,1,1
18890,49891,53,34490,53,166,86,80,2,30,1,1
18891,56703,53,53438,53,199,102,97,2,30,1,1
18892,56603,53,32862,53,168,86,82,2,30,1,1
18893,55684,53,8013,53,214,110,104,2,30,1,1
18894,55134,53,13756,53,214,110,104,2,30,1,1
18895,56703,53,19999,53,199,102,97,2,30,1,1
18896,55134,53,17370,53,214,110,104,2,30,1,1
18897,56772,53,46490,53,185,102,83,2,31,1,1
18898,56633,53,58541,53,166,86,80,2,30,1,1
18899,65499,53,27799,53,167,86,81,2,30,1,1
18900,9222,443,6216,443,6676,1097,5579,21,26,11,10
18901,51620,443,44132,443,4320,932,3388,16,15,10,6
18902,49918,53,55343,53,396,88,308,4,59,2,2
18903,64934,53,9879,53,216,94,122,2,30,1,1
18904,44014,53,29782,53,199,94,105,2,30,1,1
18905,65248,53,32569,53,779,86,693,2,30,1,1
18906,65174,53,23443,53,214,110,104,2,30,1,1
18907,64969,27044,17492,27044,741,462,279,2,30,1,1
18908,50346,53,1416,53,168,78,90,2,30,1,1
18909,54286,123,33034,123,184,94,90,2,30,1,1
18910,56100,53,20590,53,216,110,106,2,30,1,1
18911,16403,16386,35244,16386,426,186,240,8,30,4,4
18912,56963,53,36385,53,199,102,97,2,30,1,1
18913,64393,53,12221,53,183,94,89,2,31,1,1
18914,50207,53,41164,53,189,102,87,2,30,1,1
18915,10016,443,37717,443,6575,1263,5312,22,315,12,10
18916,51326,443,48019,443,6250,1422,4828,20,17,10,10
18917,58288,443,25819,443,6438,2646,3792,18,37,11,7
18918,9968,53,9968,53,370,238,132,3,32,2,1
18919,57316,53,57316,53,216,82,134,2,32,1,1
18920,56735,443,32808,443,7942,1953,5989,20,15,11,9
18921,55989,53,12123,53,198,102,96,2,30,1,1
18922,54167,53,8254,53,210,94,116,2,30,1,1
18923,64979,27050,52278,27050,735,462,273,2,30,1,1
18924,55684,53,46714,53,214,110,104,2,30,1,1
18925,55551,53,53923,53,180,94,86,2,30,1,1
18926,62067,443,12137,443,4833,2196,2637,13,120,7,6
18927,56231,53,22476,53,779,86,693,2,30,1,1
18928,57322,53,59513,53,196,102,94,2,30,1,1
18929,49348,53,21322,53,749,94,655,2,30,1,1
18930,55624,53,50480,53,199,102,97,2,30,1,1
18931,49156,53,59173,53,195,102,93,2,30,1,1
18932,65428,53,61145,53,195,102,93,2,30,1,1
18933,56340,53,40288,53,198,102,96,2,30,1,1
18934,50218,53,36162,53,165,86,79,2,31,1,1
18935,49156,53,49438,53,195,102,93,2,30,1,1
18936,50267,53,48112,53,734,94,640,2,31,1,1
18937,65038,53,49241,53,173,94,79,2,31,1,1
18938,55591,53,62499,53,195,102,93,2,31,1,1
18939,56117,53,32150,53,178,94,84,2,31,1,1
18940,8907,443,50464,443,7594,1457,6137,26,404,10,16
18941,57341,53,25205,53,184,94,90,2,30,1,1
18942,64679,53,60915,53,178,94,84,2,30,1,1
18943,55323,53,20826,53,178,94,84,2,30,1,1
18944,49606,53,26399,53,231,110,121,2,31,1,1
18945,49944,53,39307,53,196,102,94,2,31,1,1
18946,55134,53,55976,53,214,110,104,2,31,1,1
18947,56272,53,59359,53,167,86,81,2,31,1,1
18948,65471,53,50193,53,498,204,294,6,31,3,3
18949,50207,53,12070,53,189,102,87,2,31,1,1
18950,55887,53,54286,53,166,86,80,2,31,1,1
18951,38262,80,2079,80,3843,1312,2531,19,227,6,13
18952,6881,6889,24381,6889,228,118,110,2,1199,1,1
18953,51083,5223,18916,5223,4070,1456,2614,26,2889,15,11
18954,64979,53,62369,53,754,94,660,2,30,1,1
18955,64130,53,8273,53,215,94,121,2,31,1,1
18956,57341,53,32411,53,184,94,90,2,31,1,1
18957,49203,53,46082,53,168,86,82,2,31,1,1
18958,65187,53,58684,53,199,102,97,2,31,1,1
18959,47661,443,40195,443,3718,420,3298,13,120,6,7
18960,37965,7765,33226,7765,460,150,310,2,1199,1,1
18961,51969,80,21230,80,622,70,552,10,1117,2,8
18962,41332,80,41332,80,230861,5063,225798,227,18,74,153
18963,55069,53,19618,53,195,102,93,2,31,1,1
18964,56703,53,34394,53,199,102,97,2,31,1,1
18965,64012,40642,36772,40642,66,66,0,2,8,2,0
18966,59179,80,14130,80,1399,762,637,10,76,6,4
18967,54270,443,24840,443,6620,672,5948,17,128,8,9
18968,33229,443,52661,443,2161,1231,930,17,180,9,8
18969,49156,443,29780,443,8569,2165,6404,23,34,12,11
18970,45926,443,11767,443,9153,4216,4937,29,331,16,13
18971,58924,443,40571,443,5168,700,4468,16,15,7,9
18972,64013,48970,1892,48970,66,66,0,2,8,2,0
18973,64503,53,62802,53,477,87,390,4,37,2,2
18974,59209,25174,0,0,66,66,0,1,0,1,0
18975,53376,22114,0,0,62,62,0,1,0,1,0
18976,16013,61903,0,0,145,145,0,1,0,1,0
18977,51184,445,0,0,70,70,0,1,0,1,0
18978,51177,445,0,0,70,70,0,1,0,1,0
18979,51176,445,0,0,70,70,0,1,0,1,0
18980,51175,445,0,0,70,70,0,1,0,1,0
18981,64595,64147,0,0,66,66,0,1,0,1,0
18982,45726,64147,0,0,62,62,0,1,0,1,0
18983,62951,445,0,0,66,66,0,1,0,1,0
18984,62768,445,0,0,70,70,0,1,0,1,0
18985,19747,37965,0,0,62,62,0,1,0,1,0
18986,58120,25174,0,0,66,66,0,1,0,1,0
18987,8889,49138,0,0,60,60,0,1,0,1,0
18988,6943,1,0,0,100,100,0,1,0,1,0
18989,62941,445,0,0,66,66,0,1,0,1,0
18990,62939,445,0,0,66,66,0,1,0,1,0
18991,62944,445,0,0,66,66,0,1,0,1,0
18992,62945,445,0,0,66,66,0,1,0,1,0
18993,62940,445,0,0,66,66,0,1,0,1,0
18994,62937,445,0,0,66,66,0,1,0,1,0
18995,62935,445,0,0,66,66,0,1,0,1,0
18996,62765,445,0,0,70,70,0,1,0,1,0
18997,63895,44847,0,0,62,62,0,1,0,1,0
18998,39313,37965,0,0,62,62,0,1,0,1,0
18999,51171,445,0,0,70,70,0,1,0,1,0
19000,42951,22114,0,0,62,62,0,1,0,1,0
19001,22530,23718,0,0,62,62,0,1,0,1,0
19002,51167,445,0,0,70,70,0,1,0,1,0
19003,51164,445,0,0,70,70,0,1,0,1,0
19004,51163,445,0,0,70,70,0,1,0,1,0
19005,63385,25174,0,0,66,66,0,1,0,1,0
19006,41388,1433,0,0,60,60,0,1,0,1,0
19007,2837,25174,0,0,66,66,0,1,0,1,0
19008,59355,51505,0,0,66,66,0,1,0,1,0
19009,62760,445,0,0,70,70,0,1,0,1,0
19010,50549,43890,0,0,66,66,0,1,0,1,0
19011,11382,43890,0,0,66,66,0,1,0,1,0
19012,62759,445,0,0,70,70,0,1,0,1,0
19013,80,5101,0,0,78,78,0,1,0,1,0
19014,1827,64147,0,0,66,66,0,1,0,1,0
19015,63083,25174,0,0,62,62,0,1,0,1,0
19016,18683,26467,0,0,62,62,0,1,0,1,0
19017,62757,445,0,0,70,70,0,1,0,1,0
19018,50316,25604,0,0,62,62,0,1,0,1,0
19019,50563,37965,0,0,66,66,0,1,0,1,0
19020,51160,445,0,0,70,70,0,1,0,1,0
19021,51159,445,0,0,70,70,0,1,0,1,0
19022,51158,445,0,0,70,70,0,1,0,1,0
19023,58022,7474,0,0,60,60,0,1,0,1,0
19024,62929,445,0,0,66,66,0,1,0,1,0
19025,51413,57470,0,0,72,72,0,1,0,1,0
19026,50857,26467,0,0,66,66,0,1,0,1,0
19027,51154,445,0,0,70,70,0,1,0,1,0
19028,52503,50584,0,0,66,66,0,1,0,1,0
19029,51726,64147,0,0,66,66,0,1,0,1,0
19030,1036,64147,0,0,62,62,0,1,0,1,0
19031,62926,445,0,0,66,66,0,1,0,1,0
19032,58103,10197,0,0,66,66,0,1,0,1,0
19033,62923,445,0,0,66,66,0,1,0,1,0
19034,62922,445,0,0,66,66,0,1,0,1,0
19035,27081,10197,0,0,62,62,0,1,0,1,0
19036,39959,23117,0,0,62,62,0,1,0,1,0
19037,62921,445,0,0,66,66,0,1,0,1,0
19038,22677,25174,0,0,66,66,0,1,0,1,0
19039,16092,50265,0,0,62,62,0,1,0,1,0
19040,62750,445,0,0,70,70,0,1,0,1,0
19041,31627,64147,0,0,62,62,0,1,0,1,0
19042,51109,11392,0,0,62,62,0,1,0,1,0
19043,14740,26467,0,0,62,62,0,1,0,1,0
19044,62748,445,0,0,70,70,0,1,0,1,0
19045,63888,25174,0,0,66,66,0,1,0,1,0
19046,51149,445,0,0,70,70,0,1,0,1,0
19047,62747,445,0,0,70,70,0,1,0,1,0
19048,51145,445,0,0,70,70,0,1,0,1,0
19049,51143,445,0,0,70,70,0,1,0,1,0
19050,62746,445,0,0,70,70,0,1,0,1,0
19051,59424,50265,0,0,70,70,0,1,0,1,0
19052,51602,22114,0,0,66,66,0,1,0,1,0
19053,62745,445,0,0,70,70,0,1,0,1,0
19054,62743,445,0,0,70,70,0,1,0,1,0
19055,62739,445,0,0,70,70,0,1,0,1,0
19056,50620,50584,0,0,66,66,0,1,0,1,0
19057,40819,30975,0,0,157,157,0,1,0,1,0
19058,56590,25174,0,0,66,66,0,1,0,1,0
19059,54754,50432,0,0,66,66,0,1,0,1,0
19060,47783,50432,0,0,62,62,0,1,0,1,0
19061,62909,445,0,0,66,66,0,1,0,1,0
19062,63920,64147,0,0,66,66,0,1,0,1,0
19063,3766,25174,0,0,62,62,0,1,0,1,0
19064,55600,22,0,0,60,60,0,1,0,1,0
19065,62727,445,0,0,70,70,0,1,0,1,0
19066,62725,445,0,0,70,70,0,1,0,1,0
19067,62723,445,0,0,70,70,0,1,0,1,0
19068,57131,35776,0,0,145,145,0,1,0,1,0
19069,62717,445,0,0,70,70,0,1,0,1,0
19070,62716,445,0,0,70,70,0,1,0,1,0
19071,48176,50584,0,0,62,62,0,1,0,1,0
19072,3064,44847,0,0,62,62,0,1,0,1,0
19073,62902,445,0,0,66,66,0,1,0,1,0
19074,25296,51505,0,0,66,66,0,1,0,1,0
19075,6247,51221,0,0,78,78,0,1,0,1,0
19076,38475,11392,0,0,66,66,0,1,0,1,0
19077,51126,445,0,0,70,70,0,1,0,1,0
19078,27300,6881,0,0,66,66,0,1,0,1,0
19079,37429,25174,0,0,62,62,0,1,0,1,0
19080,42034,28189,0,0,62,62,0,1,0,1,0
19081,47424,25174,0,0,66,66,0,1,0,1,0
19082,45964,3111,0,0,60,60,0,1,0,1,0
19083,62900,445,0,0,66,66,0,1,0,1,0
19084,56897,11446,0,0,66,66,0,1,0,1,0
19085,26527,25174,0,0,66,66,0,1,0,1,0
19086,63023,51505,0,0,62,62,0,1,0,1,0
19087,53140,51221,0,0,74,74,0,1,0,1,0
19088,6356,26467,0,0,62,62,0,1,0,1,0
19089,52644,57209,0,0,62,62,0,1,0,1,0
19090,62705,445,0,0,70,70,0,1,0,1,0
19091,52143,37807,0,0,62,62,0,1,0,1,0
19092,36011,25174,0,0,66,66,0,1,0,1,0
19093,54526,44847,0,0,66,66,0,1,0,1,0
19094,62893,445,0,0,66,66,0,1,0,1,0
19095,62889,445,0,0,66,66,0,1,0,1,0
19096,43584,24748,0,0,156,156,0,1,0,1,0
19097,43584,24748,0,0,156,156,0,1,0,1,0
19098,43584,24748,0,0,156,156,0,1,0,1,0
19099,59803,22114,0,0,146,146,0,1,0,1,0
19100,62701,445,0,0,70,70,0,1,0,1,0
19101,27063,25174,0,0,62,62,0,1,0,1,0
19102,1646,23,0,0,60,60,0,1,0,1,0
19103,51118,445,0,0,70,70,0,1,0,1,0
19104,51116,445,0,0,70,70,0,1,0,1,0
19105,51114,445,0,0,70,70,0,1,0,1,0
19106,53495,37807,0,0,66,66,0,1,0,1,0
19107,16037,25174,0,0,62,62,0,1,0,1,0
19108,62690,445,0,0,70,70,0,1,0,1,0
19109,62872,445,0,0,66,66,0,1,0,1,0
19110,62691,445,0,0,70,70,0,1,0,1,0
19111,62876,445,0,0,66,66,0,1,0,1,0
19112,62875,445,0,0,66,66,0,1,0,1,0
19113,62692,445,0,0,70,70,0,1,0,1,0
19114,62870,445,0,0,66,66,0,1,0,1,0
19115,62877,445,0,0,66,66,0,1,0,1,0
19116,62871,445,0,0,66,66,0,1,0,1,0
19117,62869,445,0,0,66,66,0,1,0,1,0
19118,62874,445,0,0,66,66,0,1,0,1,0
19119,38518,1900,0,0,139,139,0,1,0,1,0
19120,52210,51505,0,0,62,62,0,1,0,1,0
19121,62687,445,0,0,70,70,0,1,0,1,0
19122,44127,30188,0,0,146,146,0,1,0,1,0
19123,56629,25174,0,0,66,66,0,1,0,1,0
19124,62684,445,0,0,70,70,0,1,0,1,0
19125,60342,36237,0,0,62,62,0,1,0,1,0
19126,17781,50265,0,0,62,62,0,1,0,1,0
19127,21542,57470,0,0,74,74,0,1,0,1,0
19128,18113,22114,0,0,62,62,0,1,0,1,0
19129,1027,64147,0,0,62,62,0,1,0,1,0
19130,50977,56205,0,0,66,66,0,1,0,1,0
19131,52744,25174,0,0,66,66,0,1,0,1,0
19132,48676,53399,0,0,60,60,0,1,0,1,0
19133,17415,25174,0,0,62,62,0,1,0,1,0
19134,51111,445,0,0,70,70,0,1,0,1,0
19135,51108,445,0,0,70,70,0,1,0,1,0
19136,51097,445,0,0,70,70,0,1,0,1,0
19137,51098,445,0,0,70,70,0,1,0,1,0
19138,15176,62413,0,0,66,66,0,1,0,1,0
19139,62679,445,0,0,70,70,0,1,0,1,0
19140,53822,25174,0,0,66,66,0,1,0,1,0
19141,62857,445,0,0,66,66,0,1,0,1,0
19142,62856,445,0,0,66,66,0,1,0,1,0
19143,62854,445,0,0,66,66,0,1,0,1,0
19144,55629,42873,0,0,74,74,0,1,0,1,0
19145,59668,50584,0,0,66,66,0,1,0,1,0
19146,63323,54369,0,0,78,78,0,1,0,1,0
19147,48019,22114,0,0,66,66,0,1,0,1,0
19148,10273,21247,0,0,66,66,0,1,0,1,0
19149,62671,445,0,0,70,70,0,1,0,1,0
19150,27144,25174,0,0,66,66,0,1,0,1,0
19151,51095,445,0,0,70,70,0,1,0,1,0
19152,55443,53,49327,53,188,96,92,2,30,1,1
19153,64721,53,36880,53,212,108,104,2,30,1,1
19154,49156,53,9695,53,190,97,93,2,30,1,1
19155,55551,53,29205,53,176,90,86,2,30,1,1
19156,55070,80,64489,80,246,120,126,5,16,3,2
19157,50983,443,64084,443,11897,6250,5647,27,81,14,13
19158,55812,53,55812,53,235,90,145,2,32,1,1
19159,52058,8329,19334,8329,70,70,0,2,9,2,0
19160,52450,443,52450,443,4750,1843,2907,19,26,11,8
19161,42478,80,42478,80,1913,1464,449,10,19,6,4
19162,59383,80,59383,80,1915,1466,449,10,19,6,4
19163,50985,443,12787,443,8007,3336,4671,19,78,11,8
19164,50982,443,30343,443,8227,3496,4731,20,82,11,9
19165,55782,53,37884,53,728,96,632,2,30,1,1
19166,49605,53,30084,53,756,95,661,2,30,1,1
19167,52240,443,52240,443,1615,941,674,15,21,7,8
19168,42607,443,22766,443,167,107,60,2,5,1,1
19169,56636,443,56636,443,4620,1713,2907,19,28,11,8
19170,46673,80,11851,80,1151,711,440,10,15,5,5
19171,55031,53,63225,53,756,95,661,2,31,1,1
19172,58907,443,50091,443,2976,1572,1404,17,17,9,8
19173,58077,36653,11744,36653,204,64,140,4,11,2,2
19174,51526,4545,51526,4545,156,156,0,3,8,3,0
19175,61099,443,1871,443,82,82,0,1,5,1,0
19176,58915,443,1330,443,6138,3860,2278,20,16,10,10
19177,8889,33873,8889,33873,124,60,64,2,30,1,1
19178,42384,443,16298,443,8561,2300,6261,37,316,18,19
19179,49203,53,20527,53,168,86,82,2,31,1,1
19180,54769,80,54769,80,23168,3380,19788,36,19,18,18
19181,41350,80,41350,80,1914,1465,449,10,19,6,4
19182,55690,53,56846,53,182,93,89,2,30,1,1
19183,47783,80,47783,80,1904,1455,449,10,19,6,4
19184,55946,53,3113,53,762,98,664,2,31,1,1
19185,58889,15000,32384,15000,138,78,60,2,6,1,1
19186,23150,53,23150,53,365,233,132,3,32,2,1
19187,45051,53,45051,53,404,259,145,3,32,2,1
19188,65187,53,4197,53,198,101,97,2,30,1,1
19189,61196,53,61196,53,213,79,134,2,32,1,1
19190,58906,443,27261,443,2896,1492,1404,17,17,9,8
19191,41629,15000,21496,15000,130,70,60,2,5,1,1
19192,58985,443,13213,443,9218,1776,7442,28,23,13,15
19193,36158,443,62102,443,7848,2137,5711,23,25,13,10
19194,52898,80,52898,80,1916,1467,449,10,19,6,4
19195,50678,80,40361,80,300,174,126,5,15,3,2
19196,59951,80,3769,80,1221,339,882,9,16,5,4
19197,50981,443,28253,443,8407,3736,4671,19,101,11,8
19198,49522,443,49522,443,7647,1693,5954,31,77,16,15
19199,49570,443,54043,443,1013,492,521,10,30,4,6
19200,50984,443,27569,443,8023,3352,4671,19,80,11,8
19201,60199,443,24633,443,5858,1511,4347,20,21,11,9
19202,47551,443,47551,443,4743,1836,2907,19,29,11,8
19203,33372,3389,33372,3389,4695,2520,2175,22,19,13,9
19204,50599,80,50599,80,4228,3295,933,17,19,9,8
19205,53861,53065,16335,53065,70,70,0,2,8,2,0
19206,50986,443,39025,443,18156,12850,5306,32,76,19,13
19207,3891,53,3891,53,235,90,145,2,32,1,1
19208,22751,53,22751,53,235,90,145,2,32,1,1
19209,64393,53,49935,53,182,93,89,2,31,1,1
19210,55134,53,14594,53,212,108,104,2,30,1,1
19211,48206,53,48206,53,253,99,154,2,30,1,1
19212,28885,53,28885,53,404,259,145,3,32,2,1
19213,50346,53,56767,53,760,97,663,2,30,1,1
19214,56756,53,42523,53,760,97,663,2,30,1,1
19215,58916,443,3751,443,6376,4098,2278,20,16,10,10
19216,56871,53,58198,53,745,93,652,2,30,1,1
19217,47391,443,14660,443,9921,3169,6752,31,20,17,14
19218,57196,53,22247,53,754,94,660,2,31,1,1
19219,56285,53,7225,53,751,95,656,2,31,1,1
19220,56266,53,14847,53,186,95,91,2,31,1,1
19221,35353,443,50088,443,1864,250,1614,8,120,4,4
19222,53342,443,18889,443,82909,70964,11945,139,283,71,68
19223,55481,53,35011,53,758,96,662,2,30,1,1
19224,56045,53,39272,53,731,91,640,2,30,1,1
19225,55335,53,8773,53,754,94,660,2,30,1,1
19226,49415,53,54397,53,188,96,92,2,31,1,1
19227,56062,53,2393,53,192,98,94,2,31,1,1
19228,56847,53,17178,53,761,100,661,2,31,1,1
19229,64554,53,25900,53,198,101,97,2,31,1,1
19230,49650,53,49396,53,776,102,674,2,31,1,1
19231,55887,53,42850,53,164,84,80,2,31,1,1
19232,61425,443,50113,443,9380,3315,6065,26,93,14,12
19233,61406,443,11878,443,12588,4915,7673,28,94,15,13
19234,55972,53,38960,53,756,95,661,2,31,1,1
19235,65291,53,61483,53,190,97,93,2,31,1,1
19236,38733,443,51557,443,7655,2018,5637,31,93,16,15
19237,56117,53,31292,53,172,88,84,2,31,1,1
19238,55818,53,21143,53,775,103,672,2,31,1,1
19239,64782,53,40065,53,758,93,665,2,31,1,1
19240,64140,53,60265,53,184,94,90,2,31,1,1
19241,48817,49301,48817,49301,490,149,341,2,1200,1,1
19242,59117,53,0,0,82,82,0,1,31,1,0
19243,55889,53,49760,53,198,101,97,2,31,1,1
19244,34351,53,57036,53,202,83,119,2,31,1,1
19245,62619,3389,62619,3389,3504,1790,1714,17,34,9,8
19246,56756,53,46487,53,166,85,81,2,31,1,1
19247,57023,53,64217,53,174,89,85,2,31,1,1
19248,56502,53,50256,53,726,85,641,2,31,1,1
19249,56127,53,8590,53,166,85,81,2,31,1,1
19250,56973,53,12553,53,186,95,91,2,31,1,1
19251,57382,53,8955,53,184,94,90,2,31,1,1
19252,56550,53,58694,53,84,84,0,1,31,1,0
19253,45374,443,48527,443,88469,3492,84977,104,396,35,69
19254,55541,53,53785,53,772,100,672,2,31,1,1
19255,63578,35440,0,0,62,62,0,1,0,1,0
19256,62670,445,0,0,70,70,0,1,0,1,0
19257,58228,53733,0,0,66,66,0,1,0,1,0
19258,51087,445,0,0,70,70,0,1,0,1,0
19259,51084,445,0,0,70,70,0,1,0,1,0
19260,51088,445,0,0,70,70,0,1,0,1,0
19261,64691,25320,0,0,66,66,0,1,0,1,0
19262,1646,23,0,0,60,60,0,1,0,1,0
19263,6712,123,0,0,90,90,0,1,0,1,0
19264,62664,445,0,0,70,70,0,1,0,1,0
19265,62663,445,0,0,70,70,0,1,0,1,0
19266,13684,25174,0,0,62,62,0,1,0,1,0
19267,10088,37807,0,0,66,66,0,1,0,1,0
19268,45783,22114,0,0,62,62,0,1,0,1,0
19269,8889,9794,0,0,60,60,0,1,0,1,0
19270,47357,50584,0,0,66,66,0,1,0,1,0
19271,56268,44847,0,0,66,66,0,1,0,1,0
19272,60721,22114,0,0,66,66,0,1,0,1,0
19273,49156,53,43723,53,195,102,93,2,32,1,1
19274,52061,35717,8703,35717,70,70,0,2,8,2,0
19275,57331,53,27996,53,164,86,78,2,30,1,1
19276,9698,53,9698,53,197,90,107,2,30,1,1
19277,443,62732,0,0,60,60,0,1,0,1,0
19278,62659,445,0,0,70,70,0,1,0,1,0
19279,44546,32468,0,0,62,62,0,1,0,1,0
19280,51077,445,0,0,70,70,0,1,0,1,0
19281,51075,445,0,0,70,70,0,1,0,1,0
19282,51072,445,0,0,70,70,0,1,0,1,0
19283,62658,445,0,0,70,70,0,1,0,1,0
19284,62796,37807,0,0,66,66,0,1,0,1,0
19285,51944,56205,0,0,62,62,0,1,0,1,0
19286,62845,445,0,0,66,66,0,1,0,1,0
19287,19361,23117,0,0,66,66,0,1,0,1,0
19288,51979,25174,0,0,66,66,0,1,0,1,0
19289,10050,31573,0,0,146,146,0,1,0,1,0
19290,33761,25174,0,0,62,62,0,1,0,1,0
19291,58844,51505,0,0,66,66,0,1,0,1,0
19292,42231,57470,0,0,78,78,0,1,0,1,0
19293,62651,445,0,0,70,70,0,1,0,1,0
19294,35011,37965,0,0,62,62,0,1,0,1,0
19295,51068,445,0,0,70,70,0,1,0,1,0
19296,51067,445,0,0,70,70,0,1,0,1,0
19297,55951,30188,0,0,66,66,0,1,0,1,0
19298,16057,56205,0,0,66,66,0,1,0,1,0
19299,58509,21247,0,0,66,66,0,1,0,1,0
19300,3047,50584,0,0,146,146,0,1,0,1,0
19301,15235,36237,0,0,62,62,0,1,0,1,0
19302,62830,445,0,0,66,66,0,1,0,1,0
19303,62829,445,0,0,66,66,0,1,0,1,0
19304,52557,44847,0,0,66,66,0,1,0,1,0
19305,57073,57470,0,0,62,62,0,1,0,1,0
19306,54721,22114,0,0,62,62,0,1,0,1,0
19307,28156,50584,0,0,62,62,0,1,0,1,0
19308,55424,38303,0,0,66,66,0,1,0,1,0
19309,52827,25174,0,0,146,146,0,1,0,1,0
19310,51058,445,0,0,70,70,0,1,0,1,0
19311,51055,445,0,0,70,70,0,1,0,1,0
19312,51054,445,0,0,70,70,0,1,0,1,0
19313,51048,445,0,0,70,70,0,1,0,1,0
19314,62638,445,0,0,70,70,0,1,0,1,0
19315,23331,25174,0,0,66,66,0,1,0,1,0
19316,54817,47993,0,0,66,66,0,1,0,1,0
19317,62821,445,0,0,66,66,0,1,0,1,0
19318,45144,25174,0,0,62,62,0,1,0,1,0
19319,56940,53,28824,53,200,102,98,2,30,1,1
19320,55690,53,37274,53,183,94,89,2,30,1,1
19321,56062,53,34305,53,196,102,94,2,30,1,1
19322,49284,53,21270,53,177,94,83,2,30,1,1
19323,64068,53,59683,53,168,86,82,2,30,1,1
19324,37606,443,47206,443,6277,1868,4409,22,45,13,9
19325,60864,443,60864,443,8578,2549,6029,22,16,13,9
19326,55922,53,5571,53,807,94,713,2,29,1,1
19327,50218,53,12883,53,165,86,79,2,29,1,1
19328,57651,80,10587,80,1151,711,440,10,15,5,5
19329,33410,80,44582,80,1570,754,816,10,15,6,4
19330,55443,53,14959,53,194,102,92,2,30,1,1
19331,58923,443,63838,443,5167,700,4467,16,14,7,9
19332,9248,80,12948,80,844,778,66,6,15,5,1
19333,56062,53,55511,53,196,102,94,2,30,1,1
19334,53722,443,10654,443,70,70,0,2,7,2,0
19335,65127,443,37615,443,146,64,82,3,9,2,1
19336,52095,443,5865,443,3023,2045,978,15,15,9,6
19337,64146,53,50563,53,308,99,209,4,39,2,2
19338,53821,443,16981,443,7980,1434,6546,24,19,13,11
19339,21189,53,21189,53,374,240,134,3,32,2,1
19340,55922,53,13122,53,184,94,90,2,29,1,1
19341,56349,53,42172,53,216,110,106,2,29,1,1
19342,64444,53,35858,53,183,94,89,2,29,1,1
19343,65187,53,35953,53,199,102,97,2,29,1,1
19344,65499,53,26043,53,167,86,81,2,29,1,1
19345,49823,53,8034,53,209,110,99,2,29,1,1
19346,56772,53,30219,53,185,102,83,2,29,1,1
19347,64051,53,30405,53,1114,468,646,12,67,6,6
19348,64679,53,2951,53,178,94,84,2,30,1,1
19349,55551,53,64054,53,180,94,86,2,29,1,1
19350,64858,53,43430,53,211,102,109,2,30,1,1
19351,49415,53,4512,53,194,102,92,2,30,1,1
19352,57374,53,58495,53,216,102,114,2,30,1,1
19353,56423,53,58524,53,168,86,82,2,30,1,1
19354,58917,80,56785,80,4107,3453,654,13,16,7,6
19355,59297,80,59297,80,107500,4003,103497,173,16,57,116
19356,57439,443,32851,443,5502,1543,3959,17,20,9,8
19357,28032,443,27743,443,6756,2587,4169,19,16,10,9
19358,58911,443,55607,443,5168,700,4468,16,16,7,9
19359,56732,443,23589,443,7855,1866,5989,20,15,11,9
19360,50601,80,50601,80,4206,3273,933,17,19,9,8
19361,61060,53,35678,53,311,94,217,2,30,1,1
19362,64721,53,18309,53,214,110,104,2,30,1,1
19363,49284,53,55787,53,185,102,83,2,30,1,1
19364,60870,53,30144,53,220,94,126,2,30,1,1
19365,61740,443,10410,443,9854,2716,7138,36,49,20,16
19366,56272,53,1689,53,167,86,81,2,30,1,1
19367,55735,53,9793,53,199,102,97,2,30,1,1
19368,49300,443,63188,443,6101,848,5253,17,21,9,8
19369,50045,53,13478,53,168,86,82,2,30,1,1
19370,64329,53,38742,53,479,111,368,4,50,2,2
19371,65089,53,28362,53,199,102,97,2,30,1,1
19372,56622,53,10987,53,214,110,104,2,30,1,1
19373,50377,53,41134,53,214,110,104,2,30,1,1
19374,55887,53,55834,53,166,86,80,2,30,1,1
19375,56323,53,21945,53,168,94,74,2,30,1,1
19376,65089,53,20611,53,199,102,97,2,30,1,1
19377,58914,443,39439,443,5168,700,4468,16,16,7,9
19378,56215,53,9049,53,165,86,79,2,30,1,1
19379,49609,53,44822,53,754,94,660,2,30,1,1
19380,56731,443,49373,443,7907,1918,5989,20,15,11,9
19381,55443,53,18885,53,194,102,92,2,30,1,1
19382,64721,53,29674,53,214,110,104,2,30,1,1
19383,56323,53,5698,53,152,78,74,2,30,1,1
19384,56622,53,31873,53,214,110,104,2,30,1,1
19385,49710,53,33849,53,183,102,81,2,30,1,1
19386,65387,53,9016,53,221,94,127,2,30,1,1
19387,49342,53,10156,53,443,182,261,6,30,3,3
19388,64506,53,14791,53,230,94,136,2,30,1,1
19389,49710,53,1886,53,183,102,81,2,30,1,1
19390,51081,443,32211,443,6653,3225,3428,18,135,9,9
19391,55690,53,57021,53,183,94,89,2,30,1,1
19392,59476,443,42006,443,4697,923,3774,13,120,6,7
19393,64792,53,60591,53,166,86,80,2,30,1,1
19394,56127,53,6171,53,167,86,81,2,30,1,1
19395,57319,53,4407,53,189,102,87,2,30,1,1
19396,52064,43273,5722,43273,70,70,0,2,7,2,0
19397,52514,80,52514,80,1916,1467,449,10,19,6,4
19398,59298,80,59298,80,85989,14398,71591,143,15,40,103
19399,63991,80,39490,80,314,192,122,6,15,4,2
19400,65119,53,47223,53,568,188,380,6,60,3,3
19401,64689,53,47457,53,763,102,661,2,30,1,1
19402,36013,53,23635,53,86,86,0,1,30,1,0
19403,49505,53,42199,53,225,110,115,2,30,1,1
19404,47894,443,29583,443,295475,14093,281382,413,469,162,251
19405,52063,7886,55344,7886,70,70,0,2,8,2,0
19406,49518,443,49518,443,103941,6635,97306,158,76,81,77
19407,65187,53,40747,53,345,101,244,4,53,2,2
19408,57331,53,30032,53,172,94,78,2,30,1,1
19409,64493,53,17644,53,280,97,183,4,60,2,2
19410,55132,53,34901,53,889,404,485,10,30,5,5
19411,49741,53,35577,53,766,102,664,2,30,1,1
19412,49795,53,15978,53,209,110,99,2,30,1,1
19413,60710,53,32625,53,211,78,133,2,30,1,1
19414,50026,53,4265,53,395,99,296,4,57,2,2
19415,64297,53,43105,53,364,94,270,4,49,2,2
19416,35814,443,57995,443,9126,3975,5151,21,15,11,10
19417,60602,5222,39358,5222,5564,2206,3358,50,310,20,30
19418,54106,80,38158,80,78,78,0,1,5,1,0
19419,56733,443,4067,443,7941,1952,5989,20,15,11,9
19420,47996,80,47996,80,1920,1471,449,10,19,6,4
19421,57664,80,57664,80,1917,1468,449,10,19,6,4
19422,46248,443,47277,443,979612,946319,33293,1091,25,690,401
19423,64512,53,2401,53,524,91,433,4,34,2,2
19424,56739,80,48782,80,1462,703,759,8,16,5,3
19425,49588,53,53938,53,733,94,639,2,29,1,1
19426,65134,53,52533,53,812,110,702,2,29,1,1
19427,64444,53,57791,53,183,94,89,2,29,1,1
19428,56752,53,3213,53,183,94,89,2,29,1,1
19429,64679,53,32723,53,328,88,240,4,32,2,2
19430,56047,443,45831,443,126,60,66,3,4,2,1
19431,52209,443,18180,443,502469,15202,487267,580,97,193,387
19432,50377,53,58981,53,214,110,104,2,30,1,1
19433,37569,443,45273,443,11226,3029,8197,36,55,18,18
19434,64309,53,55479,53,549,188,361,6,57,3,3
19435,58919,443,29317,443,5166,700,4466,16,15,7,9
19436,60620,80,60620,80,1916,1467,449,10,19,6,4
19437,49347,53,23678,53,342,91,251,4,54,2,2
19438,55636,80,55636,80,1916,1467,449,10,19,6,4
19439,55520,53,61502,53,194,102,92,2,30,1,1
19440,55520,53,61056,53,194,102,92,2,29,1,1
19441,61673,443,61673,443,76863,6096,70767,103,17,49,54
19442,56254,53,3663,53,498,204,294,6,30,3,3
19443,64721,53,12160,53,466,108,358,4,45,2,2
19444,64748,53,3750,53,168,94,74,2,29,1,1
19445,64128,53,22207,53,194,94,100,2,31,1,1
19446,53863,8999,11307,8999,70,70,0,2,7,2,0
19447,64961,27025,27939,27025,1334,462,872,4,30,2,2
19448,52059,47363,50172,47363,70,70,0,2,8,2,0
19449,54519,443,46768,443,70,70,0,1,5,1,0
19450,64748,53,7421,53,152,78,74,2,30,1,1
19451,57319,53,9103,53,189,102,87,2,30,1,1
19452,55624,53,2352,53,199,102,97,2,30,1,1
19453,38701,443,23957,443,1065134,19929,1045205,1009,16,288,721
19454,49527,53,33639,53,173,94,79,2,30,1,1
19455,50600,80,50600,80,4262,3329,933,17,19,9,8
19456,56622,53,54285,53,214,110,104,2,30,1,1
19457,49520,443,49520,443,88797,5446,83351,137,76,70,67
19458,57438,443,63629,443,7720,2815,4905,22,20,10,12
19459,58918,443,16774,443,5166,700,4466,16,16,7,9
19460,56134,53,5515,53,183,94,89,2,29,1,1
19461,64744,53,61506,53,770,102,668,2,29,1,1
19462,49614,53,25029,53,380,110,270,2,29,1,1
19463,56215,53,29779,53,165,86,79,2,30,1,1
19464,64657,53,3237,53,193,102,91,2,30,1,1
19465,55714,53,2036,53,165,86,79,2,30,1,1
19466,64060,53,33741,53,258,110,148,2,30,1,1
19467,56304,53,62384,53,443,182,261,6,31,3,3
19468,55999,443,22014,443,3640,606,3034,13,120,6,7
19469,61681,443,50543,443,10714,3531,7183,26,120,12,14
19470,48305,443,59833,443,572565,17274,555291,546,147,124,422
19471,6881,6881,26676,6881,238,118,120,2,1200,1,1
19472,50228,53,44907,53,173,94,79,2,30,1,1
19473,55463,53,8245,53,193,102,91,2,30,1,1
19474,65142,53,52457,53,167,86,81,2,30,1,1
19475,56266,53,65060,53,193,102,91,2,30,1,1
19476,64140,53,44344,53,184,94,90,2,31,1,1
19477,63885,443,2549,443,254829,10396,244433,255,194,64,191
19478,49415,53,62672,53,194,102,92,2,30,1,1
19479,59965,80,33685,80,1638,1324,314,10,15,5,5
19480,63966,443,14721,443,22930,2512,20418,37,75,17,20
19481,52062,60388,61139,60388,70,70,0,2,8,2,0
19482,52044,5824,26075,5824,70,70,0,1,5,1,0
19483,63139,53,20764,53,234,234,0,4,47,4,0
19484,49476,53,34696,53,764,102,662,2,30,1,1
19485,64052,53,55826,53,232,102,130,2,30,1,1
19486,56136,53,4435,53,733,94,639,2,30,1,1
19487,65056,53,56800,53,270,94,176,2,30,1,1
19488,49944,53,37550,53,196,102,94,2,30,1,1
19489,56388,53,30178,53,165,86,79,2,30,1,1
19490,64178,53,3511,53,276,94,182,2,30,1,1
19491,55735,53,16181,53,199,102,97,2,30,1,1
19492,64959,27038,6979,27038,996,462,534,4,30,2,2
19493,49527,53,30173,53,165,86,79,2,30,1,1
19494,56349,53,21926,53,216,110,106,2,30,1,1
19495,65006,53,44331,53,763,102,661,2,30,1,1
19496,55043,443,31088,443,11681,3607,8074,40,120,20,20
19497,51221,32329,23850,32329,870,330,540,12,1316,6,6
19498,33228,443,46001,443,2567,1173,1394,19,179,8,11
19499,61398,80,61398,80,1917,1468,449,10,19,6,4
19500,52060,29868,16909,29868,70,70,0,2,8,2,0
19501,56738,80,55725,80,1462,703,759,8,16,5,3
19502,65038,53,25509,53,165,86,79,2,30,1,1
19503,9021,53,9021,53,216,90,126,2,30,1,1
19504,49844,53,19437,53,734,102,632,2,30,1,1
19505,64627,53,26278,53,168,86,82,2,30,1,1
19506,56940,53,50066,53,200,102,98,2,30,1,1
19507,55979,53,24460,53,168,86,82,2,30,1,1
19508,56388,53,39602,53,173,94,79,2,30,1,1
19509,55551,53,65057,53,180,94,86,2,30,1,1
19510,53831,53,28587,53,260,86,174,2,30,1,1
19511,49636,53,12225,53,180,94,86,2,30,1,1
19512,39771,80,39771,80,17982,4308,13674,30,20,15,15
19513,54105,80,38446,80,78,78,0,1,5,1,0
19514,50377,53,60945,53,214,110,104,2,30,1,1
19515,55735,53,42351,53,199,102,97,2,30,1,1
19516,36125,443,36185,443,6620,1197,5423,22,129,12,10
19517,45571,443,60221,443,3974,2015,1959,21,345,10,11
19518,65220,53,61957,53,811,94,717,2,30,1,1
19519,65291,53,24701,53,195,102,93,2,30,1,1
19520,49203,53,46894,53,168,86,82,2,30,1,1
19521,64792,53,47254,53,166,86,80,2,30,1,1
19522,64554,53,41182,53,199,102,97,2,30,1,1
19523,56117,53,21155,53,178,94,84,2,30,1,1
19524,46851,53,12035,53,168,78,90,2,30,1,1
19525,39195,443,6951,443,8991,2438,6553,18,120,8,10
19526,55443,53,14783,53,194,102,92,2,30,1,1
19527,50228,53,36486,53,173,94,79,2,30,1,1
19528,64393,53,36156,53,183,94,89,2,30,1,1
19529,49388,53,27609,53,215,102,113,2,30,1,1
19530,41107,53,24186,53,168,78,90,2,30,1,1
19531,64376,53,46569,53,247,94,153,2,30,1,1
19532,64657,53,42843,53,816,102,714,2,30,1,1
19533,56423,53,27855,53,184,102,82,2,30,1,1
19534,50071,53,62204,53,458,188,270,6,30,3,3
19535,49415,53,16500,53,194,102,92,2,30,1,1
19536,55856,53,56508,53,265,94,171,2,30,1,1
19537,60709,53,36089,53,260,86,174,2,30,1,1
19538,49765,53,13036,53,194,102,92,2,31,1,1
19539,55877,42466,20270,42466,481,150,331,2,1200,1,1
19540,56379,53,59317,53,166,86,80,2,30,1,1
19541,49574,53,25202,53,816,102,714,2,30,1,1
19542,57334,53,42427,53,184,94,90,2,30,1,1
19543,55367,53,46146,53,195,102,93,2,31,1,1
19544,57053,53,53183,53,173,94,79,2,31,1,1
19545,57333,53,36710,53,167,86,81,2,31,1,1
19546,65417,53,49087,53,402,118,284,2,30,1,1
19547,55889,53,7647,53,199,102,97,2,30,1,1
19548,56379,53,29859,53,166,86,80,2,31,1,1
19549,57023,53,45929,53,179,94,85,2,31,1,1
19550,49966,53,36472,53,182,102,80,2,30,1,1
19551,56266,53,13342,53,193,102,91,2,31,1,1
19552,64393,53,13343,53,183,94,89,2,31,1,1
19553,57382,53,16095,53,184,94,90,2,31,1,1
19554,57323,53,24768,53,194,102,92,2,31,1,1
19555,56837,443,38721,443,2349,258,2091,10,120,4,6
19556,55141,53,56040,53,184,94,90,2,31,1,1
19557,51221,1950,25491,1950,870,330,540,12,1316,6,6
19558,58934,53,32905,53,205,86,119,2,30,1,1
19559,49966,53,59809,53,166,86,80,2,30,1,1
19560,64140,53,48538,53,184,94,90,2,30,1,1
19561,56195,53,54925,53,811,94,717,2,30,1,1
19562,65139,53,1458,53,216,110,106,2,30,1,1
19563,55714,53,64632,53,173,94,79,2,30,1,1
19564,52165,443,19255,443,289596,9131,280465,283,48,85,198
19565,64853,53,20952,53,199,102,97,2,31,1,1
19566,55887,53,33560,53,166,86,80,2,31,1,1
19567,57430,53,3513,53,200,102,98,2,31,1,1
19568,65139,53,19988,53,216,110,106,2,31,1,1
19569,55816,53,60578,53,214,110,104,2,31,1,1
19570,59477,443,7119,443,14489,12206,2283,25,120,15,10
19571,57334,53,60234,53,184,94,90,2,31,1,1
19572,63996,45759,44503,45759,70,70,0,1,5,1,0
19573,52041,48103,59658,48103,70,70,0,1,5,1,0
19574,64344,53,48570,53,286,102,184,4,46,2,2
19575,49823,53,25346,53,502,103,399,4,51,2,2
19576,55624,53,59892,53,308,101,207,4,53,2,2
19577,56975,53,16815,53,413,170,243,6,31,3,3
19578,49636,53,15924,53,180,94,86,2,31,1,1
19579,56819,53,17305,53,209,110,99,2,31,1,1
19580,55841,53,16397,53,458,188,270,6,31,3,3
19581,58908,443,8392,443,5166,700,4466,16,16,7,9
19582,38700,443,57335,443,90113,3417,86696,95,16,30,65
19583,29988,44847,0,0,66,66,0,1,0,1,0
19584,51564,50584,0,0,62,62,0,1,0,1,0
19585,50079,23,0,0,60,60,0,1,0,1,0
19586,62816,445,0,0,66,66,0,1,0,1,0
19587,62810,445,0,0,66,66,0,1,0,1,0
19588,62812,445,0,0,66,66,0,1,0,1,0
19589,62817,445,0,0,66,66,0,1,0,1,0
19590,62813,445,0,0,66,66,0,1,0,1,0
19591,62818,445,0,0,66,66,0,1,0,1,0
19592,62811,445,0,0,66,66,0,1,0,1,0
19593,37647,36237,0,0,66,66,0,1,0,1,0
19594,44147,64147,0,0,62,62,0,1,0,1,0
19595,51042,445,0,0,70,70,0,1,0,1,0
19596,54377,56205,0,0,62,62,0,1,0,1,0
19597,9528,44847,0,0,62,62,0,1,0,1,0
19598,31738,51505,0,0,62,62,0,1,0,1,0
19599,51039,445,0,0,70,70,0,1,0,1,0
19600,51035,445,0,0,70,70,0,1,0,1,0
19601,51038,445,0,0,70,70,0,1,0,1,0
19602,56328,36237,0,0,66,66,0,1,0,1,0
19603,19267,5555,0,0,60,60,0,1,0,1,0
19604,52781,57470,0,0,66,66,0,1,0,1,0
19605,49415,22114,0,0,66,66,0,1,0,1,0
19606,61591,22114,0,0,62,62,0,1,0,1,0
19607,62630,445,0,0,70,70,0,1,0,1,0
19608,62629,445,0,0,70,70,0,1,0,1,0
19609,7423,22114,0,0,62,62,0,1,0,1,0
19610,62627,445,0,0,70,70,0,1,0,1,0
19611,19455,25174,0,0,146,146,0,1,0,1,0
19612,25565,18855,0,0,60,60,0,1,0,1,0
19613,45682,37965,0,0,62,62,0,1,0,1,0
19614,7001,6881,0,0,62,62,0,1,0,1,0
19615,7067,22114,0,0,62,62,0,1,0,1,0
19616,51034,445,0,0,70,70,0,1,0,1,0
19617,51031,445,0,0,70,70,0,1,0,1,0
19618,51028,445,0,0,70,70,0,1,0,1,0
19619,57669,64147,0,0,62,62,0,1,0,1,0
19620,62802,445,0,0,66,66,0,1,0,1,0
19621,51026,445,0,0,70,70,0,1,0,1,0
19622,65015,22114,0,0,66,66,0,1,0,1,0
19623,62798,445,0,0,66,66,0,1,0,1,0
19624,33215,37965,0,0,62,62,0,1,0,1,0
19625,58880,443,32825,443,1413,876,537,12,11,6,6
19626,34166,22114,0,0,62,62,0,1,0,1,0
19627,58303,22114,0,0,62,62,0,1,0,1,0
19628,62795,445,0,0,66,66,0,1,0,1,0
19629,62794,445,0,0,66,66,0,1,0,1,0
19630,62620,445,0,0,70,70,0,1,0,1,0
19631,49797,25174,0,0,66,66,0,1,0,1,0
19632,62792,445,0,0,66,66,0,1,0,1,0
19633,27348,22114,0,0,66,66,0,1,0,1,0
19634,62911,36237,0,0,66,66,0,1,0,1,0
19635,62618,445,0,0,70,70,0,1,0,1,0
19636,47943,50584,0,0,74,74,0,1,0,1,0
19637,44815,36829,0,0,62,62,0,1,0,1,0
19638,30304,64147,0,0,66,66,0,1,0,1,0
19639,62617,445,0,0,70,70,0,1,0,1,0
19640,62616,445,0,0,70,70,0,1,0,1,0
19641,51021,445,0,0,70,70,0,1,0,1,0
19642,62615,445,0,0,70,70,0,1,0,1,0
19643,22733,26467,0,0,62,62,0,1,0,1,0
19644,55161,37807,0,0,66,66,0,1,0,1,0
19645,5476,23,0,0,60,60,0,1,0,1,0
19646,62609,445,0,0,70,70,0,1,0,1,0
19647,62610,445,0,0,70,70,0,1,0,1,0
19648,6247,51221,0,0,78,78,0,1,0,1,0
19649,51009,445,0,0,70,70,0,1,0,1,0
19650,51012,445,0,0,70,70,0,1,0,1,0
19651,30654,51221,0,0,72,72,0,1,0,1,0
19652,35666,22114,0,0,62,62,0,1,0,1,0
19653,62781,445,0,0,66,66,0,1,0,1,0
19654,57797,64147,0,0,62,62,0,1,0,1,0
19655,55144,30188,0,0,66,66,0,1,0,1,0
19656,61961,11392,0,0,66,66,0,1,0,1,0
19657,62597,445,0,0,70,70,0,1,0,1,0
19658,62595,445,0,0,70,70,0,1,0,1,0
19659,63400,57470,0,0,66,66,0,1,0,1,0
19660,62591,445,0,0,70,70,0,1,0,1,0
19661,59234,21247,0,0,62,62,0,1,0,1,0
19662,62587,445,0,0,70,70,0,1,0,1,0
19663,62586,445,0,0,70,70,0,1,0,1,0
19664,55130,25174,0,0,66,66,0,1,0,1,0
19665,55199,21247,0,0,66,66,0,1,0,1,0
19666,25031,25174,0,0,62,62,0,1,0,1,0
19667,54166,25174,0,0,66,66,0,1,0,1,0
19668,17781,44847,0,0,146,146,0,1,0,1,0
19669,62774,445,0,0,66,66,0,1,0,1,0
19670,51003,445,0,0,70,70,0,1,0,1,0
19671,45941,23386,0,0,60,60,0,1,0,1,0
19672,34713,22114,0,0,146,146,0,1,0,1,0
19673,17097,62413,0,0,62,62,0,1,0,1,0
19674,63832,25174,0,0,66,66,0,1,0,1,0
19675,52321,26467,0,0,62,62,0,1,0,1,0
19676,30707,30317,0,0,62,62,0,1,0,1,0
19677,18017,25773,0,0,143,143,0,1,0,1,0
19678,15189,25174,0,0,146,146,0,1,0,1,0
19679,62772,445,0,0,66,66,0,1,0,1,0
19680,62575,445,0,0,70,70,0,1,0,1,0
19681,27321,25174,0,0,146,146,0,1,0,1,0
19682,23306,25174,0,0,146,146,0,1,0,1,0
19683,62765,445,0,0,66,66,0,1,0,1,0
19684,51834,35440,0,0,66,66,0,1,0,1,0
19685,7000,23117,0,0,66,66,0,1,0,1,0
19686,13525,51505,0,0,146,146,0,1,0,1,0
19687,62760,445,0,0,66,66,0,1,0,1,0
19688,34636,23,0,0,60,60,0,1,0,1,0
19689,1536,50584,0,0,146,146,0,1,0,1,0
19690,51609,37807,0,0,66,66,0,1,0,1,0
19691,62571,445,0,0,70,70,0,1,0,1,0
19692,56770,26467,0,0,62,62,0,1,0,1,0
19693,62014,35440,0,0,66,66,0,1,0,1,0
19694,57337,64147,0,0,66,66,0,1,0,1,0
19695,33359,30188,0,0,66,66,0,1,0,1,0
19696,30574,64147,0,0,62,62,0,1,0,1,0
19697,54769,50584,0,0,62,62,0,1,0,1,0
19698,62560,445,0,0,70,70,0,1,0,1,0
19699,62562,445,0,0,70,70,0,1,0,1,0
19700,62559,445,0,0,70,70,0,1,0,1,0
19701,55562,50584,0,0,62,62,0,1,0,1,0
19702,49994,26467,0,0,62,62,0,1,0,1,0
19703,64509,9571,0,0,62,62,0,1,0,1,0
19704,62557,445,0,0,70,70,0,1,0,1,0
19705,50991,445,0,0,70,70,0,1,0,1,0
19706,50987,445,0,0,70,70,0,1,0,1,0
19707,50986,445,0,0,70,70,0,1,0,1,0
19708,63474,48817,0,0,66,66,0,1,0,1,0
19709,19875,30170,0,0,145,145,0,1,0,1,0
19710,6036,51505,0,0,66,66,0,1,0,1,0
19711,62554,445,0,0,70,70,0,1,0,1,0
19712,62743,445,0,0,66,66,0,1,0,1,0
19713,62748,445,0,0,66,66,0,1,0,1,0
19714,62747,445,0,0,66,66,0,1,0,1,0
19715,62746,445,0,0,66,66,0,1,0,1,0
19716,62744,445,0,0,66,66,0,1,0,1,0
19717,62745,445,0,0,66,66,0,1,0,1,0
19718,62742,445,0,0,66,66,0,1,0,1,0
19719,62741,445,0,0,66,66,0,1,0,1,0
19720,46509,36237,0,0,66,66,0,1,0,1,0
19721,61738,2767,0,0,66,66,0,1,0,1,0
19722,58250,35440,0,0,62,62,0,1,0,1,0
19723,8229,22114,0,0,66,66,0,1,0,1,0
19724,63323,54369,0,0,78,78,0,1,0,1,0
19725,7210,22114,0,0,66,66,0,1,0,1,0
19726,23021,25174,0,0,66,66,0,1,0,1,0
19727,56161,62413,0,0,62,62,0,1,0,1,0
19728,55019,443,64416,443,13326,1847,11479,27,31,14,13
19729,64493,53,24989,53,280,97,183,4,59,2,2
19730,48590,443,14073,443,3538,2083,1455,17,256,9,8
19731,5588,5588,0,0,3354,1792,1562,46,193,23,23
19732,5588,5588,0,0,3354,1792,1562,46,194,23,23
19733,55367,53,8311,53,190,97,93,2,31,1,1
19734,56790,53,40538,53,758,93,665,2,30,1,1
19735,31019,53,31019,53,194,87,107,2,30,1,1
19736,52621,443,59205,443,190,70,120,4,15,2,2
19737,57968,53,57968,53,371,237,134,3,32,2,1
19738,49407,53,35774,53,774,101,673,2,30,1,1
19739,56313,53,15835,53,196,100,96,2,30,1,1
19740,55816,53,28988,53,212,108,104,2,30,1,1
19741,24009,53,24009,53,825,99,726,2,30,1,1
19742,65274,53,19286,53,295,101,194,4,32,2,2
19743,57563,443,58695,443,10044,2134,7910,42,34,23,19
19744,58895,443,48917,443,13440,8354,5086,39,20,20,19
19745,60910,443,19521,443,3862,2679,1183,28,46,15,13
19746,64003,38926,55687,38926,66,66,0,1,5,1,0
19747,50309,443,46447,443,5955,1619,4336,23,15,13,10
19748,60909,443,5719,443,5150,3651,1499,34,46,18,16
19749,58902,443,55109,443,8119,5152,2967,29,18,14,15
19750,5588,5588,0,0,3562,1936,1626,48,194,24,24
19751,65180,53,33252,53,751,95,656,2,30,1,1
19752,57314,53,61726,53,190,97,93,2,31,1,1
19753,57334,53,10038,53,184,94,90,2,30,1,1
19754,65139,53,15314,53,216,110,106,2,30,1,1
19755,48833,443,62502,443,1348406,28891,1319515,1247,31,340,907
19756,34879,443,57316,443,167,107,60,2,5,1,1
19757,55147,53,40257,53,776,102,674,2,30,1,1
19758,49408,443,42776,443,4189,2286,1903,35,256,17,18
19759,57430,53,32678,53,200,102,98,2,30,1,1
19760,65420,443,40711,443,3213,2242,971,19,25,9,10
19761,49519,443,49519,443,15064,2611,12453,43,76,23,20
19762,28742,53,28742,53,365,233,132,3,32,2,1
19763,38664,443,19990,443,8195,1780,6415,23,60,12,11
19764,60906,443,59580,443,11543,5375,6168,45,47,24,21
19765,61356,53,61356,53,235,90,145,2,32,1,1
19766,55305,53,52264,53,1448,103,1345,4,54,2,2
19767,52159,80,40700,80,1278,731,547,10,15,6,4
19768,64002,2880,14112,2880,66,66,0,1,5,1,0
19769,65344,53,21017,53,90,90,0,1,30,1,0
19770,58900,443,22833,443,8547,5209,3338,30,19,15,15
19771,42974,53,0,0,82,82,0,1,30,1,0
19772,57323,53,18058,53,188,96,92,2,31,1,1
19773,56431,53,36582,53,778,103,675,2,31,1,1
19774,51038,443,30038,443,7263,1830,5433,27,16,15,12
19775,31680,53,31680,53,404,259,145,3,32,2,1
19776,49765,53,55763,53,188,96,92,2,31,1,1
19777,39858,443,36124,443,167,107,60,2,5,1,1
19778,64344,53,46040,53,286,102,184,4,45,2,2
19779,52712,443,61572,443,348281,20002,328279,401,350,153,248
19780,38334,22,38334,22,9022,3349,5673,57,43,26,31
19781,63987,58476,60558,58476,504,382,122,8,16,6,2
19782,63116,53,14772,53,578,286,292,9,15,5,4
19783,9233,443,25219,443,5955,728,5227,17,15,8,9
19784,58904,443,20613,443,4732,3142,1590,20,18,9,11
19785,55693,45341,14771,45341,70,70,0,2,8,2,0
19786,60911,443,41186,443,3862,2679,1183,28,46,15,13
19787,47281,443,8413,443,190,70,120,4,15,2,2
19788,48834,443,52235,443,655052,13866,641186,599,31,150,449
19789,56439,53,22467,53,751,95,656,2,30,1,1
19790,48847,443,57026,443,2478246,45190,2433056,2175,27,520,1655
19791,41432,53,63040,53,202,83,119,2,30,1,1
19792,65437,53,48894,53,1386,85,1301,4,53,2,2
19793,49253,53,20812,53,198,101,97,2,30,1,1
19794,54973,53,46622,53,178,91,87,2,31,1,1
19795,14205,53,14205,53,233,91,142,2,31,1,1
19796,55127,53,55127,53,220,100,120,2,31,1,1
19797,22394,53,22394,53,233,91,142,2,31,1,1
19798,13160,53,13160,53,198,89,109,2,31,1,1
19799,53404,443,26776,443,8437,4827,3610,50,180,25,25
19800,62009,443,59530,443,5017,1969,3048,14,136,7,7
19801,57470,16288,57203,16288,924,924,0,15,1200,15,0
19802,57340,53,3053,53,747,92,655,2,31,1,1
19803,55141,53,13525,53,184,94,90,2,31,1,1
19804,55268,53,37193,53,186,95,91,2,31,1,1
19805,56964,53,11967,53,774,101,673,2,31,1,1
19806,65204,53,50970,53,182,93,89,2,31,1,1
19807,57351,53,37431,53,184,94,90,2,31,1,1
19808,55056,53,12643,53,202,103,99,2,31,1,1
19809,55220,53,9691,53,186,95,91,2,31,1,1
19810,56711,53,31656,53,202,103,99,2,31,1,1
19811,56126,53,16372,53,774,101,673,2,31,1,1
19812,33133,443,21005,443,8138,2101,6037,17,121,9,8
19813,57416,53,37012,53,771,101,670,2,31,1,1
19814,56819,53,59960,53,202,103,99,2,31,1,1
19815,64020,53,44407,53,192,98,94,2,31,1,1
19816,64896,53,10637,53,716,95,621,2,31,1,1
19817,29076,53,29076,53,231,90,141,2,31,1,1
19818,49636,53,21781,53,176,90,86,2,31,1,1
19819,56857,53,63903,53,190,97,93,2,31,1,1
19820,59899,53,59899,53,194,87,107,2,31,1,1
19821,55415,53,34000,53,182,93,89,2,31,1,1
19822,65132,53,11821,53,166,85,81,2,31,1,1
19823,55123,53,64230,53,196,100,96,2,31,1,1
19824,55577,53,45509,53,198,101,97,2,31,1,1
19825,55688,53,29259,53,184,94,90,2,31,1,1
19826,65505,53,12322,53,164,84,80,2,31,1,1
19827,49628,53,48622,53,168,86,82,2,31,1,1
19828,50353,443,15424,443,1775,169,1606,7,121,3,4
19829,50357,443,38830,443,1786,172,1614,7,121,3,4
19830,11601,53,11601,53,233,91,142,2,31,1,1
19831,20336,53,20336,53,233,91,142,2,31,1,1
19832,55003,53,14075,53,192,98,94,2,31,1,1
19833,64816,53,1997,53,164,84,80,2,31,1,1
19834,23980,53,23980,53,220,100,120,2,31,1,1
19835,64853,53,19289,53,198,101,97,2,31,1,1
19836,27005,27015,65390,27015,891,126,765,2,31,1,1
19837,65495,53,9784,53,202,103,99,2,31,1,1
19838,53144,53,53144,53,231,90,141,2,31,1,1
19839,25434,53,25434,53,231,90,141,2,31,1,1
19840,55224,53,59301,53,180,92,88,2,31,1,1
19841,59919,53,59919,53,231,90,141,2,31,1,1
19842,57386,53,9687,53,186,95,91,2,31,1,1
19843,56532,53,51264,53,186,95,91,2,31,1,1
19844,56543,53,0,0,82,82,0,1,31,1,0
19845,57834,443,16694,443,6214,1733,4481,13,121,6,7
19846,49466,53,56538,53,202,103,99,2,31,1,1
19847,56912,53,37939,53,753,96,657,2,31,1,1
19848,54711,443,40588,443,3663,1136,2527,13,136,6,7
19849,52102,443,38740,443,6903,3076,3827,20,136,10,10
19850,30960,45759,38428,45759,330,330,0,6,3609,6,0
19851,48706,23393,0,0,60,60,0,1,0,1,0
19852,32976,37965,0,0,66,66,0,1,0,1,0
19853,59786,25174,0,0,66,66,0,1,0,1,0
19854,62548,445,0,0,70,70,0,1,0,1,0
19855,58511,50584,0,0,62,62,0,1,0,1,0
19856,50984,445,0,0,70,70,0,1,0,1,0
19857,50979,445,0,0,70,70,0,1,0,1,0
19858,50973,445,0,0,70,70,0,1,0,1,0
19859,50968,445,0,0,70,70,0,1,0,1,0
19860,57479,56205,0,0,66,66,0,1,0,1,0
19861,45205,25174,0,0,146,146,0,1,0,1,0
19862,62729,445,0,0,66,66,0,1,0,1,0
19863,62728,445,0,0,66,66,0,1,0,1,0
19864,62726,445,0,0,66,66,0,1,0,1,0
19865,59696,57470,0,0,62,62,0,1,0,1,0
19866,19944,22114,0,0,66,66,0,1,0,1,0
19867,33502,5529,0,0,143,143,0,1,0,1,0
19868,62541,445,0,0,70,70,0,1,0,1,0
19869,57323,53,27696,53,194,102,92,2,30,1,1
19870,62540,445,0,0,70,70,0,1,0,1,0
19871,57220,26467,0,0,66,66,0,1,0,1,0
19872,50967,445,0,0,70,70,0,1,0,1,0
19873,50965,445,0,0,70,70,0,1,0,1,0
19874,50964,445,0,0,70,70,0,1,0,1,0
19875,1024,37450,0,0,62,62,0,1,0,1,0
19876,50957,445,0,0,70,70,0,1,0,1,0
19877,2062,35440,0,0,66,66,0,1,0,1,0
19878,47727,25174,0,0,62,62,0,1,0,1,0
19879,62535,445,0,0,70,70,0,1,0,1,0
19880,52925,64147,0,0,62,62,0,1,0,1,0
19881,62533,445,0,0,70,70,0,1,0,1,0
19882,22530,25174,0,0,62,62,0,1,0,1,0
19883,40687,64147,0,0,62,62,0,1,0,1,0
19884,45964,2225,0,0,60,60,0,1,0,1,0
19885,26658,25174,0,0,62,62,0,1,0,1,0
19886,61550,5529,0,0,145,145,0,1,0,1,0
19887,55678,32468,0,0,66,66,0,1,0,1,0
19888,6881,6881,0,0,62,62,0,1,0,1,0
19889,55839,56535,0,0,62,62,0,1,0,1,0
19890,62529,445,0,0,70,70,0,1,0,1,0
19891,42231,57470,0,0,78,78,0,1,0,1,0
19892,62527,445,0,0,70,70,0,1,0,1,0
19893,50949,445,0,0,70,70,0,1,0,1,0
19894,50947,445,0,0,70,70,0,1,0,1,0
19895,50944,445,0,0,70,70,0,1,0,1,0
19896,62717,445,0,0,66,66,0,1,0,1,0
19897,36641,25174,0,0,66,66,0,1,0,1,0
19898,44612,25174,0,0,66,66,0,1,0,1,0
19899,64155,60043,0,0,62,62,0,1,0,1,0
19900,14397,37965,0,0,62,62,0,1,0,1,0
19901,62523,445,0,0,70,70,0,1,0,1,0
19902,11136,15503,0,0,62,62,0,1,0,1,0
19903,60403,22114,0,0,66,66,0,1,0,1,0
19904,50940,445,0,0,70,70,0,1,0,1,0
19905,50938,445,0,0,70,70,0,1,0,1,0
19906,39416,443,35535,443,32732,6260,26472,69,217,34,35
19907,52177,443,57914,443,7659,3234,4425,35,288,17,18
19908,64585,53,5921,53,198,102,96,2,30,1,1
19909,49448,53,48392,53,210,102,108,2,30,1,1
19910,64585,53,62482,53,821,102,719,2,30,1,1
19911,51644,53,17659,53,195,78,117,2,30,1,1
19912,49241,53,22091,53,785,110,675,2,30,1,1
19913,55180,53,29558,53,209,110,99,2,30,1,1
19914,44847,20101,53137,20101,150,150,0,1,1200,1,0
19915,65274,53,10401,53,295,101,194,4,32,2,2
19916,55979,53,16779,53,184,102,82,2,29,1,1
19917,57023,53,46258,53,179,94,85,2,29,1,1
19918,57430,53,55125,53,185,102,83,2,29,1,1
19919,56127,53,58620,53,167,86,81,2,29,1,1
19920,55520,53,58665,53,194,102,92,2,29,1,1
19921,49580,53,43364,53,782,110,672,2,30,1,1
19922,49723,53,26637,53,209,110,99,2,30,1,1
19923,49990,53,43468,53,198,102,96,2,30,1,1
19924,50646,443,35425,443,6789,1020,5769,20,101,11,9
19925,64344,53,51510,53,286,102,184,4,45,2,2
19926,53762,53,52593,53,168,78,90,2,30,1,1
19927,19924,53,19924,53,235,90,145,2,32,1,1
19928,46834,53,46834,53,235,90,145,2,32,1,1
19929,50679,80,31597,80,62,62,0,1,4,1,0
19930,63984,53,63454,53,264,110,154,2,30,1,1
19931,60270,443,24845,443,6155,1709,4446,29,1710,15,14
19932,50651,80,37006,80,1555,1103,452,9,21,5,4
19933,63999,10552,38263,10552,70,70,0,1,4,1,0
19934,63995,15396,40455,15396,70,70,0,1,4,1,0
19935,53269,443,51596,443,5766,1925,3841,22,17,14,8
19936,59473,80,31869,80,1052,612,440,10,15,5,5
19937,50623,443,64489,443,1350,773,577,15,107,8,7
19938,64344,53,14813,53,568,192,376,6,71,3,3
19939,53864,24874,8342,24874,320,140,180,6,6,3,3
19940,54969,53,12796,53,199,102,97,2,29,1,1
19941,64000,14441,58412,14441,70,70,0,1,4,1,0
19942,55816,53,14968,53,214,110,104,2,29,1,1
19943,49599,53,2987,53,732,86,646,2,29,1,1
19944,49291,53,35462,53,212,102,110,2,29,1,1
19945,57382,53,23125,53,184,94,90,2,29,1,1
19946,57053,53,14057,53,173,94,79,2,29,1,1
19947,55889,53,50897,53,199,102,97,2,29,1,1
19948,55690,53,21416,53,183,94,89,2,29,1,1
19949,49723,53,9926,53,209,110,99,2,30,1,1
19950,46948,443,43691,443,6374,2446,3928,26,217,13,13
19951,43733,443,15802,443,27525,2389,25136,47,27,22,25
19952,39050,443,47247,443,26692,5527,21165,54,31,28,26
19953,50295,443,29927,443,18401,4536,13865,48,27,24,24
19954,65477,53,50858,53,209,110,99,2,30,1,1
19955,55628,53,3702,53,198,102,96,2,30,1,1
19956,56313,53,27206,53,198,102,96,2,30,1,1
19957,49446,53,1735,53,403,142,261,2,30,1,1
19958,56247,53,6224,53,215,102,113,2,30,1,1
19959,64231,53,19664,53,196,94,102,2,30,1,1
19960,63920,443,64654,443,3192,633,2559,17,135,7,10
19961,43154,53,41451,53,168,78,90,2,30,1,1
19962,55141,53,55990,53,184,94,90,2,30,1,1
19963,64020,53,34722,53,196,102,94,2,30,1,1
19964,56756,53,38135,53,167,86,81,2,30,1,1
19965,39827,443,61705,443,6128,3746,2382,48,46,25,23
19966,52057,34664,13510,34664,70,70,0,2,8,2,0
19967,56632,443,17597,443,13148,2310,10838,29,80,16,13
19968,64307,53,12624,53,463,90,373,4,34,2,2
19969,57139,53,12753,53,816,102,714,2,30,1,1
19970,64853,53,20032,53,199,102,97,2,30,1,1
19971,38643,443,11641,443,1468,893,575,15,62,8,7
19972,65477,53,46159,53,209,110,99,2,30,1,1
19973,44791,443,29863,443,3181,1647,1534,18,31,10,8
19974,56436,80,34544,80,17067,1439,15628,23,25,8,15
19975,55855,53,27713,53,182,102,80,2,30,1,1
19976,57603,443,1218,443,2614,1689,925,18,23,10,8
19977,56756,53,60834,53,167,86,81,2,30,1,1
19978,58088,8765,45865,8765,336,150,186,6,89,3,3
19979,41269,443,34077,443,234,234,0,4,12,4,0
19980,57314,53,53459,53,195,102,93,2,30,1,1
19981,56973,53,50381,53,193,102,91,2,30,1,1
19982,35333,80,8364,80,1432,663,769,10,19,6,4
19983,55180,53,4513,53,209,110,99,2,30,1,1
19984,38432,53,33848,53,336,231,105,3,30,2,1
19985,65501,53,61730,53,774,102,672,2,30,1,1
19986,37645,443,51983,443,23266,18300,4966,56,27,33,23
19987,65228,53,28840,53,200,102,98,2,30,1,1
19988,49713,53,34138,53,198,94,104,2,30,1,1
19989,49693,53,65326,53,209,110,99,2,30,1,1
19990,56117,53,20260,53,178,94,84,2,30,1,1
19991,53739,53,43732,53,168,78,90,2,30,1,1
19992,54372,80,17871,80,3517,1612,1905,17,186,10,7
19993,65204,53,43316,53,183,94,89,2,30,1,1
19994,49213,53,0,0,333,102,231,2,30,1,1
19995,56226,53,33247,53,200,102,98,2,30,1,1
19996,64748,53,54501,53,183,94,89,2,30,1,1
19997,50933,443,10395,443,10546,2453,8093,28,15,16,12
19998,38621,443,27614,443,1593,946,647,15,64,8,7
19999,50293,443,61876,443,12677,3097,9580,37,26,19,18
20000,60948,53,22265,53,168,78,90,2,30,1,1
20001,45932,53,57917,53,199,94,105,2,30,1,1
20002,56313,53,23049,53,198,102,96,2,30,1,1
20003,59124,443,18887,443,9612,1720,7892,32,130,15,17
20004,15503,8624,29745,8624,491,150,341,2,1200,1,1
20005,56062,53,55161,53,537,98,439,4,40,2,2
20006,50292,443,41099,443,183024,16754,166270,247,28,114,133
20007,39053,443,36119,443,6699,4494,2205,27,29,14,13
20008,56756,53,14084,53,167,86,81,2,30,1,1
20009,50010,53,37943,53,205,86,119,2,30,1,1
20010,36936,53,30039,53,78,78,0,1,30,1,0
20011,60211,53,51487,53,205,86,119,2,30,1,1
20012,65316,53,39745,53,225,110,115,2,30,1,1
20013,54973,53,20292,53,181,94,87,2,30,1,1
20014,64748,53,6781,53,183,94,89,2,30,1,1
20015,65228,53,28438,53,200,102,98,2,30,1,1
20016,49765,53,11309,53,194,102,92,2,30,1,1
20017,56266,53,11208,53,193,102,91,2,30,1,1
20018,56468,53,49469,53,209,110,99,2,30,1,1
20019,55686,44049,11130,44049,504,318,186,8,15,5,3
20020,55525,443,64786,443,5200,2825,2375,18,155,9,9
20021,64004,48339,32132,48339,70,70,0,1,4,1,0
20022,63994,47013,15711,47013,70,70,0,1,4,1,0
20023,64493,53,56892,53,280,97,183,4,58,2,2
20024,49521,443,49521,443,25081,3001,22080,55,75,29,26
20025,49754,443,12620,443,17243,5482,11761,82,316,41,41
20026,49909,53,17902,53,1410,95,1315,4,57,2,2
20027,56163,53,14069,53,265,85,180,4,42,2,2
20028,65503,443,44158,443,429890,12640,417250,442,16,155,287
20029,37614,80,61486,80,1399,406,993,15,43,5,10
20030,64001,13051,4222,13051,70,70,0,1,4,1,0
20031,57440,443,35509,443,8200,2465,5735,30,18,14,16
20032,65274,53,29709,53,295,101,194,4,31,2,2
20033,38644,443,44476,443,8165,1664,6501,30,62,14,16
20034,53832,56005,63005,56005,70,70,0,1,4,1,0
20035,53286,80,26328,80,3096,1001,2095,12,150,7,5
20036,62593,7010,62593,7010,4231,2106,2125,15,15,8,7
20037,60022,80,60022,80,2959,1505,1454,10,15,6,4
20038,49452,443,53461,443,13184,2507,10677,27,64,14,13
20039,52347,443,62894,443,7847,2985,4862,30,337,16,14
20040,27076,80,27076,80,6337,947,5390,15,17,8,7
20041,57259,53,43490,53,167,86,81,2,29,1,1
20042,63989,20939,6044,20939,504,382,122,8,15,6,2
20043,5588,5588,0,0,3354,1792,1562,46,193,23,23
20044,53832,53,28034,53,211,78,133,2,29,1,1
20045,49476,53,24497,53,402,118,284,2,29,1,1
20046,65010,53,7971,53,758,102,656,2,29,1,1
20047,49574,53,41987,53,193,102,91,2,29,1,1
20048,54969,53,41747,53,199,102,97,2,29,1,1
20049,57430,53,65274,53,177,94,83,2,30,1,1
20050,43725,443,24670,443,82838,3838,79000,104,31,42,62
20051,57139,53,30822,53,193,102,91,2,30,1,1
20052,65291,53,57485,53,195,102,93,2,29,1,1
20053,57314,53,31776,53,195,102,93,2,30,1,1
20054,55463,53,39462,53,816,102,714,2,29,1,1
20055,32939,443,44702,443,3312,1936,1376,19,29,10,9
20056,57259,53,28924,53,167,86,81,2,29,1,1
20057,65142,53,52775,53,167,86,81,2,29,1,1
20058,57430,53,14392,53,200,102,98,2,29,1,1
20059,64554,53,13352,53,199,102,97,2,29,1,1
20060,55367,53,40346,53,195,102,93,2,30,1,1
20061,64097,53,23639,53,308,91,217,4,56,2,2
20062,55889,53,44791,53,199,102,97,2,30,1,1
20063,56973,53,45728,53,193,102,91,2,30,1,1
20064,64658,53,30936,53,785,110,675,2,30,1,1
20065,64661,53,48759,53,216,102,114,2,30,1,1
20066,64816,53,50725,53,166,86,80,2,30,1,1
20067,57023,53,56230,53,179,94,85,2,30,1,1
20068,55220,53,13554,53,193,102,91,2,30,1,1
20069,57314,53,2474,53,195,102,93,2,31,1,1
20070,54973,53,16224,53,181,94,87,2,31,1,1
20071,53092,443,35345,443,7676,1577,6099,28,395,9,19
20072,57835,443,21443,443,9125,3736,5389,19,120,10,9
20073,65132,53,27212,53,167,86,81,2,30,1,1
20074,64205,53,1901,53,178,94,84,2,30,1,1
20075,49324,53,24551,53,258,94,164,2,30,1,1
20076,56973,53,9162,53,193,102,91,2,30,1,1
20077,65495,53,16317,53,209,110,99,2,30,1,1
20078,53185,443,52524,443,4442408,142153,4300255,4731,235,1574,3157
20079,55056,53,39813,53,209,110,99,2,30,1,1
20080,65204,53,23706,53,183,94,89,2,30,1,1
20081,58753,443,18417,443,10379,2361,8018,27,20,16,11
20082,51963,443,38927,443,14602,6734,7868,46,56,26,20
20083,38660,443,61188,443,7031,1824,5207,23,60,12,11
20084,43361,443,8514,443,13275,10536,2739,50,101,27,23
20085,65504,443,39358,443,92275,4799,87476,107,16,43,64
20086,43732,443,8555,443,19123,2319,16804,39,28,21,18
20087,39058,443,63912,443,8028,5439,2589,32,27,16,16
20088,39051,443,15445,443,7082,4527,2555,31,31,16,15
20089,64493,53,34209,53,280,97,183,4,59,2,2
20090,49253,53,32297,53,593,188,405,6,59,3,3
20091,55628,53,5942,53,821,102,719,2,30,1,1
20092,49693,53,49502,53,209,110,99,2,30,1,1
20093,55268,53,2485,53,193,102,91,2,30,1,1
20094,55003,53,31448,53,196,102,94,2,30,1,1
20095,54371,80,58322,80,3623,1718,1905,17,186,10,7
20096,54731,443,46644,443,9498,2578,6920,28,19,16,12
20097,47531,8080,0,0,184,78,106,3,10,2,1
20098,50294,443,54513,443,9999,2316,7683,30,26,15,15
20099,48436,443,64004,443,9744,1958,7786,25,18,13,12
20100,43731,443,32992,443,10930,1759,9171,27,28,13,14
20101,39062,443,32900,443,11360,8326,3034,36,22,19,17
20102,32934,443,9755,443,7623,3362,4261,26,31,14,12
20103,64724,53,45753,53,336,110,226,2,30,1,1
20104,49253,53,44015,53,199,102,97,2,30,1,1
20105,55855,53,25503,53,182,102,80,2,30,1,1
20106,57351,53,34146,53,184,94,90,2,30,1,1
20107,64816,53,25047,53,166,86,80,2,30,1,1
20108,56127,53,41688,53,167,86,81,2,30,1,1
20109,64554,53,27674,53,199,102,97,2,30,1,1
20110,54973,53,14051,53,181,94,87,2,30,1,1
20111,55046,53,35740,53,198,102,96,2,30,1,1
20112,52189,443,16564,443,36007,4328,31679,65,217,33,32
20113,38642,443,33643,443,1468,893,575,15,62,8,7
20114,63988,43365,3645,43365,624,382,242,10,15,6,4
20115,58905,443,1469,443,6370,706,5664,19,16,7,12
20116,57333,53,60768,53,167,86,81,2,30,1,1
20117,64569,53,4728,53,413,170,243,6,30,3,3
20118,49253,53,58276,53,199,102,97,2,30,1,1
20119,49990,53,60528,53,198,102,96,2,30,1,1
20120,56819,53,1488,53,209,110,99,2,30,1,1
20121,56468,53,56108,53,209,110,99,2,30,1,1
20122,55245,53,36514,53,209,110,99,2,30,1,1
20123,55367,53,11900,53,195,102,93,2,30,1,1
20124,55688,53,25850,53,184,94,90,2,31,1,1
20125,55816,53,3790,53,214,110,104,2,31,1,1
20126,65132,53,40938,53,167,86,81,2,31,1,1
20127,55577,53,15503,53,199,102,97,2,31,1,1
20128,65020,53,14135,53,184,94,90,2,31,1,1
20129,50584,51414,36185,51414,475,150,325,2,1200,1,1
20130,55688,53,51379,53,184,94,90,2,30,1,1
20131,64810,53,57933,53,199,102,97,2,30,1,1
20132,55056,53,20306,53,209,110,99,2,30,1,1
20133,49206,53,3418,53,448,184,264,6,30,3,3
20134,49656,53,55066,53,193,102,91,2,30,1,1
20135,57244,53,57244,53,240,98,142,2,30,1,1
20136,30584,53,30584,53,241,98,143,2,30,1,1
20137,60346,53,60346,53,241,98,143,2,30,1,1
20138,57323,53,38814,53,194,102,92,2,31,1,1
20139,41931,443,53560,443,8579,2273,6306,17,136,8,9
20140,30188,33285,47903,33285,502,150,352,2,1200,1,1
20141,49628,53,6846,53,168,86,82,2,31,1,1
20142,55415,53,31153,53,183,94,89,2,31,1,1
20143,65241,53,22089,53,200,102,98,2,31,1,1
20144,55220,53,48038,53,193,102,91,2,31,1,1
20145,55003,53,40085,53,196,102,94,2,30,1,1
20146,65229,53,50750,53,193,102,91,2,31,1,1
20147,49656,53,53430,53,193,102,91,2,30,1,1
20148,55415,53,7035,53,183,94,89,2,30,1,1
20149,49374,53,42809,53,197,94,103,2,30,1,1
20150,57386,53,13419,53,193,102,91,2,31,1,1
20151,49765,53,24395,53,194,102,92,2,31,1,1
20152,56711,53,61949,53,209,110,99,2,31,1,1
20153,55123,53,57840,53,198,102,96,2,31,1,1
20154,65495,53,62386,53,209,110,99,2,31,1,1
20155,64205,53,47320,53,178,94,84,2,31,1,1
20156,27005,27016,42013,27016,893,126,767,2,31,1,1
20157,57470,20015,34460,20015,150,150,0,1,1199,1,0
20158,50358,443,36799,443,1786,172,1614,7,121,3,4
20159,56637,53,33997,53,199,102,97,2,31,1,1
20160,55159,53,6565,53,200,102,98,2,30,1,1
20161,56821,53,60054,53,199,102,97,2,30,1,1
20162,65505,53,15527,53,166,86,80,2,31,1,1
20163,63932,53,16188,53,179,94,85,2,31,1,1
20164,64520,53,30136,53,198,102,96,2,31,1,1
20165,63949,53,18113,53,195,102,93,2,31,1,1
20166,65291,53,60855,53,335,97,238,4,31,2,2
20167,2371,53,52292,53,164,86,78,2,31,1,1
20168,61419,443,21446,443,1664127,116770,1547357,2028,401,736,1292
20169,49247,53,4260,53,194,102,92,2,31,1,1
20170,65274,53,37017,53,295,101,194,4,31,2,2
20171,37965,1052,51562,1052,132,132,0,3,1199,3,0
20172,44314,443,36123,443,1268867,60489,1208378,1558,141,557,1001
20173,51221,51413,55208,51413,460,150,310,2,1201,1,1
20174,64053,53,8111,53,276,94,182,4,56,2,2
20175,56665,80,42041,80,234,234,0,4,12,4,0
20176,52040,2524,48292,2524,70,70,0,1,5,1,0
20177,37592,443,51917,443,9000,2566,6434,29,47,17,12
20178,52040,80,45485,80,4185,3462,723,14,16,7,7
20179,53152,27367,49089,27367,758,320,438,11,20,6,5
20180,44984,443,57604,443,4499,2807,1692,24,95,13,11
20181,51957,80,56020,80,486,300,186,9,27,6,3
20182,58858,443,41294,443,318,192,126,6,26,4,2
20183,60171,443,39238,443,1059,556,503,12,25,6,6
20184,51951,80,50498,80,366,240,126,7,28,5,2
20185,37582,443,5548,443,15901,7016,8885,37,49,22,15
20186,51933,80,40922,80,3676,2136,1540,15,40,10,5
20187,56561,53,57177,53,183,94,89,2,30,1,1
20188,65040,53,64754,53,749,94,655,2,30,1,1
20189,65241,53,55089,53,200,102,98,2,31,1,1
20190,63949,53,30252,53,195,102,93,2,31,1,1
20191,53722,443,52101,443,327838,13327,314511,355,127,121,234
20192,55836,443,59611,443,7519,2177,5342,16,136,8,8
20193,10151,49001,62928,49001,481,150,331,2,1201,1,1
20194,47096,443,23148,443,6211,1753,4458,43,215,15,28
20195,64998,27037,52668,27037,3573,2238,1335,16,34,8,8
20196,37594,443,15585,443,60339,4689,55650,79,47,35,44
20197,51952,443,19528,443,11367,3820,7547,28,28,16,12
20198,52183,443,15080,443,69339,4124,65215,96,22,45,51
20199,56226,53,49033,53,200,102,98,2,30,1,1
20200,55603,443,55603,443,4684,1777,2907,19,12,11,8
20201,1066,16464,0,0,60,60,0,1,0,1,0
20202,44611,23,0,0,60,60,0,1,0,1,0
20203,53640,25174,0,0,66,66,0,1,0,1,0
20204,40481,22114,0,0,66,66,0,1,0,1,0
20205,22924,25174,0,0,62,62,0,1,0,1,0
20206,62699,445,0,0,66,66,0,1,0,1,0
20207,62698,445,0,0,66,66,0,1,0,1,0
20208,52340,64147,0,0,66,66,0,1,0,1,0
20209,34932,38608,0,0,62,62,0,1,0,1,0
20210,51413,10387,0,0,139,139,0,1,0,1,0
20211,53554,1433,0,0,60,60,0,1,0,1,0
20212,62510,445,0,0,70,70,0,1,0,1,0
20213,16454,25174,0,0,66,66,0,1,0,1,0
20214,53160,25174,0,0,146,146,0,1,0,1,0
20215,50566,22114,0,0,62,62,0,1,0,1,0
20216,50928,445,0,0,70,70,0,1,0,1,0
20217,50927,445,0,0,70,70,0,1,0,1,0
20218,50925,445,0,0,70,70,0,1,0,1,0
20219,50919,445,0,0,70,70,0,1,0,1,0
20220,15345,36829,0,0,62,62,0,1,0,1,0
20221,62348,57470,0,0,109,109,0,1,0,1,0
20222,62507,445,0,0,70,70,0,1,0,1,0
20223,62694,445,0,0,66,66,0,1,0,1,0
20224,54601,26467,0,0,62,62,0,1,0,1,0
20225,32736,22114,0,0,66,66,0,1,0,1,0
20226,25150,25174,0,0,62,62,0,1,0,1,0
20227,50046,22114,0,0,66,66,0,1,0,1,0
20228,3937,36829,0,0,62,62,0,1,0,1,0
20229,54530,46776,0,0,66,66,0,1,0,1,0
20230,62690,445,0,0,66,66,0,1,0,1,0
20231,62684,445,0,0,66,66,0,1,0,1,0
20232,62687,445,0,0,66,66,0,1,0,1,0
20233,62681,445,0,0,66,66,0,1,0,1,0
20234,62683,445,0,0,66,66,0,1,0,1,0
20235,62682,445,0,0,66,66,0,1,0,1,0
20236,62688,445,0,0,66,66,0,1,0,1,0
20237,65404,36237,0,0,62,62,0,1,0,1,0
20238,50916,445,0,0,70,70,0,1,0,1,0
20239,51706,25174,0,0,66,66,0,1,0,1,0
20240,62502,445,0,0,70,70,0,1,0,1,0
20241,50911,445,0,0,70,70,0,1,0,1,0
20242,50910,445,0,0,70,70,0,1,0,1,0
20243,49730,443,47083,443,4484,1063,3421,15,10,7,8
20244,55012,25174,0,0,66,66,0,1,0,1,0
20245,50907,445,0,0,70,70,0,1,0,1,0
20246,1027,25174,0,0,62,62,0,1,0,1,0
20247,1027,25174,0,0,146,146,0,1,0,1,0
20248,62501,445,0,0,70,70,0,1,0,1,0
20249,63554,44847,0,0,62,62,0,1,0,1,0
20250,53323,35253,0,0,62,62,0,1,0,1,0
20251,24378,5169,24378,5169,507,507,0,1,0,1,0
20252,62489,23117,0,0,66,66,0,1,0,1,0
20253,62499,445,0,0,70,70,0,1,0,1,0
20254,51479,25174,0,0,66,66,0,1,0,1,0
20255,2849,30188,0,0,66,66,0,1,0,1,0
20256,55570,44847,0,0,66,66,0,1,0,1,0
20257,25878,25174,0,0,66,66,0,1,0,1,0
20258,27197,22114,0,0,146,146,0,1,0,1,0
20259,15227,26467,0,0,66,66,0,1,0,1,0
20260,33941,37807,0,0,62,62,0,1,0,1,0
20261,33941,37807,0,0,146,146,0,1,0,1,0
20262,50905,445,0,0,70,70,0,1,0,1,0
20263,50903,445,0,0,70,70,0,1,0,1,0
20264,50902,445,0,0,70,70,0,1,0,1,0
20265,62671,445,0,0,66,66,0,1,0,1,0
20266,6882,51505,0,0,66,66,0,1,0,1,0
20267,50898,445,0,0,70,70,0,1,0,1,0
20268,16358,50584,0,0,146,146,0,1,0,1,0
20269,62492,445,0,0,70,70,0,1,0,1,0
20270,62670,445,0,0,66,66,0,1,0,1,0
20271,38093,11392,0,0,62,62,0,1,0,1,0
20272,54121,25174,0,0,66,66,0,1,0,1,0
20273,62668,445,0,0,66,66,0,1,0,1,0
20274,62666,445,0,0,66,66,0,1,0,1,0
20275,62490,445,0,0,70,70,0,1,0,1,0
20276,56676,37965,0,0,66,66,0,1,0,1,0
20277,53140,51221,0,0,74,74,0,1,0,1,0
20278,62665,445,0,0,66,66,0,1,0,1,0
20279,58627,25174,0,0,62,62,0,1,0,1,0
20280,62489,445,0,0,70,70,0,1,0,1,0
20281,30149,23,0,0,60,60,0,1,0,1,0
20282,11136,15503,0,0,62,62,0,1,0,1,0
20283,62488,445,0,0,70,70,0,1,0,1,0
20284,62487,445,0,0,70,70,0,1,0,1,0
20285,60558,51221,0,0,62,62,0,1,0,1,0
20286,62485,445,0,0,70,70,0,1,0,1,0
20287,62483,445,0,0,70,70,0,1,0,1,0
20288,22168,25174,0,0,146,146,0,1,0,1,0
20289,40312,55442,0,0,62,62,0,1,0,1,0
20290,50893,445,0,0,70,70,0,1,0,1,0
20291,44388,63874,0,0,62,62,0,1,0,1,0
20292,41197,30188,0,0,62,62,0,1,0,1,0
20293,53841,37965,0,0,66,66,0,1,0,1,0
20294,50888,445,0,0,70,70,0,1,0,1,0
20295,50880,445,0,0,70,70,0,1,0,1,0
20296,2476,6881,0,0,62,62,0,1,0,1,0
20297,28636,25174,0,0,146,146,0,1,0,1,0
20298,0,0,0,0,98,98,0,1,0,1,0
20299,0,0,0,0,98,98,0,1,0,1,0
20300,0,0,0,0,98,98,0,1,0,1,0
20301,0,0,0,0,98,98,0,1,0,1,0
20302,0,0,0,0,98,98,0,1,0,1,0
20303,0,0,0,0,98,98,0,1,0,1,0
20304,0,0,0,0,98,98,0,1,0,1,0
20305,0,0,0,0,244,244,0,2,0,2,0
20306,0,0,0,0,98,98,0,1,0,1,0
20307,1025,50584,0,0,146,146,0,1,0,1,0
20308,56127,37965,0,0,66,66,0,1,0,1,0
20309,52038,50584,0,0,66,66,0,1,0,1,0
20310,23719,22114,0,0,146,146,0,1,0,1,0
20311,14692,25174,0,0,62,62,0,1,0,1,0
20312,62469,445,0,0,70,70,0,1,0,1,0
20313,62468,445,0,0,70,70,0,1,0,1,0
20314,62465,445,0,0,70,70,0,1,0,1,0
20315,24144,57470,0,0,62,62,0,1,0,1,0
20316,62458,445,0,0,70,70,0,1,0,1,0
20317,62459,445,0,0,70,70,0,1,0,1,0
20318,62653,445,0,0,66,66,0,1,0,1,0
20319,60058,25174,0,0,66,66,0,1,0,1,0
20320,7372,25773,0,0,139,139,0,1,0,1,0
20321,23131,25174,0,0,62,62,0,1,0,1,0
20322,1943,48817,0,0,66,66,0,1,0,1,0
20323,62646,445,0,0,66,66,0,1,0,1,0
20324,50870,445,0,0,70,70,0,1,0,1,0
20325,50734,37965,0,0,62,62,0,1,0,1,0
20326,34073,37965,0,0,62,62,0,1,0,1,0
20327,50327,1433,0,0,60,60,0,1,0,1,0
20328,42986,25174,0,0,66,66,0,1,0,1,0
20329,62447,445,0,0,70,70,0,1,0,1,0
20330,52988,53567,0,0,62,62,0,1,0,1,0
20331,60097,22114,0,0,66,66,0,1,0,1,0
20332,62643,445,0,0,66,66,0,1,0,1,0
20333,45118,39004,0,0,74,74,0,1,0,1,0
20334,3399,25174,0,0,66,66,0,1,0,1,0
20335,61190,21247,0,0,62,62,0,1,0,1,0
20336,36663,22114,0,0,62,62,0,1,0,1,0
20337,42285,57470,0,0,62,62,0,1,0,1,0
20338,55232,25174,0,0,146,146,0,1,0,1,0
20339,55629,42873,0,0,74,74,0,1,0,1,0
20340,26192,23,0,0,60,60,0,1,0,1,0
20341,62635,445,0,0,66,66,0,1,0,1,0
20342,36804,25174,0,0,66,66,0,1,0,1,0
20343,54299,28081,0,0,143,143,0,1,0,1,0
20344,15677,64147,0,0,145,145,0,1,0,1,0
20345,52238,26467,0,0,62,62,0,1,0,1,0
20346,64036,23718,0,0,66,66,0,1,0,1,0
20347,56289,25174,0,0,66,66,0,1,0,1,0
20348,55508,64147,0,0,62,62,0,1,0,1,0
20349,62630,445,0,0,66,66,0,1,0,1,0
20350,62443,445,0,0,70,70,0,1,0,1,0
20351,63595,51050,0,0,66,66,0,1,0,1,0
20352,22408,22114,0,0,66,66,0,1,0,1,0
20353,55167,48817,0,0,66,66,0,1,0,1,0
20354,25207,48817,0,0,62,62,0,1,0,1,0
20355,35894,17,0,0,60,60,0,1,0,1,0
20356,3615,53,3615,53,231,90,141,2,30,1,1
20357,54221,443,30270,443,8327,4890,3437,23,316,12,11
20358,55691,16410,1413,16410,70,70,0,1,5,1,0
20359,16012,53,16012,53,235,90,145,2,32,1,1
20360,62591,7000,62591,7000,3530,2027,1503,16,15,9,7
20361,51934,443,29764,443,550,310,240,10,35,6,4
20362,62590,7000,62590,7000,2163,676,1487,14,15,7,7
20363,55687,47613,14281,47613,164,70,94,2,5,1,1
20364,51390,53,51390,53,398,255,143,3,31,2,1
20365,37591,443,4877,443,62657,4444,58213,83,46,37,46
20366,5588,5588,0,0,3562,1936,1626,48,193,24,24
20367,65241,53,18449,53,200,102,98,2,31,1,1
20368,54968,53,43880,53,198,101,97,2,30,1,1
20369,51936,443,23888,443,4940,3363,1577,27,34,16,11
20370,5588,5588,0,0,3354,1792,1562,46,192,23,23
20371,5588,5588,0,0,3354,1792,1562,46,194,23,23
20372,63949,53,59282,53,190,97,93,2,31,1,1
20373,63932,53,54885,53,174,89,85,2,31,1,1
20374,55152,53,27991,53,176,90,86,2,30,1,1
20375,65472,53,63288,53,202,103,99,2,31,1,1
20376,63968,53,37221,53,200,102,98,2,30,1,1
20377,65133,53,56873,53,196,100,96,2,31,1,1
20378,64205,53,12061,53,172,88,84,2,30,1,1
20379,65229,53,55495,53,186,95,91,2,30,1,1
20380,64053,53,64602,53,276,94,182,4,55,2,2
20381,51935,443,8500,443,2780,1797,983,21,35,11,10
20382,48326,53,48326,53,398,255,143,3,33,2,1
20383,49526,53,35749,53,272,97,175,4,58,2,2
20384,35195,443,7133,443,153,93,60,2,5,1,1
20385,64959,53,64959,53,398,255,143,3,33,2,1
20386,52039,38541,32643,38541,66,66,0,1,5,1,0
20387,37851,443,37851,443,4691,1784,2907,19,27,11,8
20388,65363,53,30865,53,178,91,87,2,31,1,1
20389,49532,53,4849,53,190,97,93,2,31,1,1
20390,49521,53,26950,53,182,93,89,2,30,1,1
20391,51591,80,40282,80,12683,8567,4116,53,271,33,20
20392,61440,443,7179,443,7896,1207,6689,20,26,10,10
20393,52054,50513,38403,50513,70,70,0,2,9,2,0
20394,55689,37558,18058,37558,70,70,0,1,5,1,0
20395,56163,53,47516,53,265,85,180,4,41,2,2
20396,57035,53,11215,53,1414,95,1319,4,41,2,2
20397,46744,53,46744,53,404,259,145,3,32,2,1
20398,7198,53,7198,53,398,255,143,3,32,2,1
20399,19789,53,19789,53,371,237,134,3,33,2,1
20400,24692,53,24692,53,235,90,145,2,32,1,1
20401,56740,53,17032,53,716,95,621,2,30,1,1
20402,47357,443,6177,443,153,93,60,2,5,1,1
20403,52038,14487,65073,14487,66,66,0,1,5,1,0
20404,55159,53,29512,53,200,102,98,2,30,1,1
20405,33424,53,33424,53,233,91,142,2,30,1,1
20406,49533,53,65286,53,771,101,670,2,30,1,1
20407,50534,53,50534,53,216,88,128,2,30,1,1
20408,18238,53,18238,53,240,96,144,2,30,1,1
20409,14885,53,14885,53,220,100,120,2,30,1,1
20410,50263,53,61533,53,753,96,657,2,30,1,1
20411,64520,53,59126,53,196,100,96,2,30,1,1
20412,65020,53,8823,53,184,94,90,2,31,1,1
20413,55384,53,37937,53,188,96,92,2,31,1,1
20414,49862,53,25145,53,176,90,86,2,30,1,1
20415,56625,53,59531,53,186,95,91,2,31,1,1
20416,57212,53,19775,53,780,104,676,2,31,1,1
20417,64567,53,31447,53,186,95,91,2,31,1,1
20418,49556,443,19377,443,198375,6279,192096,205,153,69,136
20419,64780,53,55734,53,186,95,91,2,31,1,1
20420,16693,53,16693,53,217,87,130,2,31,1,1
20421,64833,53,14951,53,166,85,81,2,31,1,1
20422,35229,443,14508,443,9488,4114,5374,27,363,14,13
20423,65376,53,45808,53,184,94,90,2,31,1,1
20424,57792,53,57792,53,215,87,128,2,31,1,1
20425,63992,53,33581,53,198,101,97,2,31,1,1
20426,49290,53,14935,53,184,94,90,2,31,1,1
20427,57397,53,42252,53,735,88,647,2,31,1,1
20428,55547,53,9428,53,774,101,673,2,31,1,1
20429,56032,443,63053,443,1775,169,1606,7,120,3,4
20430,50355,443,1395,443,1786,172,1614,7,120,3,4
20431,63991,53,7704,53,186,95,91,2,31,1,1
20432,49752,50584,0,0,62,62,0,1,0,1,0
20433,62432,445,0,0,70,70,0,1,0,1,0
20434,62431,445,0,0,70,70,0,1,0,1,0
20435,62433,445,0,0,70,70,0,1,0,1,0
20436,62429,445,0,0,70,70,0,1,0,1,0
20437,62427,445,0,0,70,70,0,1,0,1,0
20438,13178,37965,0,0,62,62,0,1,0,1,0
20439,80,65095,0,0,66,66,0,1,0,1,0
20440,6881,6881,0,0,146,146,0,1,0,1,0
20441,56381,25174,0,0,62,62,0,1,0,1,0
20442,50862,445,0,0,70,70,0,1,0,1,0
20443,50858,445,0,0,70,70,0,1,0,1,0
20444,50859,445,0,0,70,70,0,1,0,1,0
20445,9836,22114,0,0,66,66,0,1,0,1,0
20446,62614,445,0,0,66,66,0,1,0,1,0
20447,62620,445,0,0,66,66,0,1,0,1,0
20448,62619,445,0,0,66,66,0,1,0,1,0
20449,62616,445,0,0,66,66,0,1,0,1,0
20450,62618,445,0,0,66,66,0,1,0,1,0
20451,62621,445,0,0,66,66,0,1,0,1,0
20452,62617,445,0,0,66,66,0,1,0,1,0
20453,62613,445,0,0,66,66,0,1,0,1,0
20454,47944,50584,0,0,62,62,0,1,0,1,0
20455,55435,25174,0,0,62,62,0,1,0,1,0
20456,49290,53,62128,53,184,94,90,2,30,1,1
20457,56163,53,45369,53,265,85,180,4,41,2,2
20458,64947,53,61833,53,275,96,179,4,41,2,2
20459,45547,53,15973,53,199,94,105,2,30,1,1
20460,55056,53,51122,53,209,110,99,2,30,1,1
20461,65277,53,40732,53,199,102,97,2,30,1,1
20462,57363,53,63578,53,193,102,91,2,30,1,1
20463,55123,53,56989,53,198,102,96,2,30,1,1
20464,40226,53,63320,53,258,78,180,4,30,2,2
20465,56637,53,46210,53,199,102,97,2,30,1,1
20466,65495,53,27520,53,209,110,99,2,30,1,1
20467,64816,53,50363,53,166,86,80,2,30,1,1
20468,64520,53,48129,53,198,102,96,2,30,1,1
20469,65363,53,10698,53,181,94,87,2,30,1,1
20470,49862,53,40662,53,180,94,86,2,30,1,1
20471,38269,80,33887,80,190,70,120,4,14,2,2
20472,37595,443,31654,443,34423,3999,30424,52,46,24,28
20473,57737,53,57737,53,374,240,134,3,32,2,1
20474,10283,53,10283,53,370,238,132,3,31,2,1
20475,56430,443,45343,443,10956,4863,6093,47,82,22,25
20476,57386,53,23091,53,193,102,91,2,29,1,1
20477,64284,53,55514,53,229,110,119,2,30,1,1
20478,56625,53,47756,53,193,102,91,2,30,1,1
20479,56161,53,4993,53,817,102,715,2,30,1,1
20480,49532,53,13697,53,195,102,93,2,30,1,1
20481,49247,53,61621,53,817,102,715,2,30,1,1
20482,51954,80,41489,80,18285,8756,9529,29,27,15,14
20483,51943,80,43908,80,306,120,186,6,27,3,3
20484,53852,14099,17770,14099,320,140,180,6,6,3,3
20485,51938,80,16530,80,4424,3281,1143,12,27,8,4
20486,51940,80,37296,80,366,240,126,7,27,5,2
20487,57061,53,39332,53,1780,674,1106,18,68,9,9
20488,60907,443,25513,443,7477,3022,4455,27,45,15,12
20489,64810,53,23866,53,199,102,97,2,29,1,1
20490,47652,443,53871,443,1058,571,487,10,24,6,4
20491,55046,53,11757,53,198,102,96,2,29,1,1
20492,55451,53,40344,53,816,102,714,2,29,1,1
20493,56550,53,53287,53,166,86,80,2,29,1,1
20494,17206,53,17206,53,240,98,142,2,29,1,1
20495,56271,53,27532,53,195,102,93,2,29,1,1
20496,57351,53,48672,53,184,94,90,2,29,1,1
20497,49276,53,39804,53,199,102,97,2,29,1,1
20498,56561,53,8736,53,183,94,89,2,29,1,1
20499,57430,53,16018,53,200,102,98,2,29,1,1
20500,64308,53,11059,53,258,102,156,2,29,1,1
20501,56819,53,44720,53,209,110,99,2,29,1,1
20502,55688,53,8374,53,184,94,90,2,30,1,1
20503,49532,53,40570,53,195,102,93,2,30,1,1
20504,56161,53,2092,53,194,102,92,2,30,1,1
20505,51036,80,2227,80,1514,480,1034,11,16,6,5
20506,55224,53,48169,53,182,94,88,2,30,1,1
20507,27005,27015,51372,27015,884,126,758,2,30,1,1
20508,65133,53,55111,53,198,102,96,2,30,1,1
20509,65472,53,43093,53,209,110,99,2,30,1,1
20510,45754,80,60037,80,1282,650,632,9,127,5,4
20511,65229,53,46914,53,193,102,91,2,30,1,1
20512,54968,53,59501,53,199,102,97,2,30,1,1
20513,9097,5228,6402,5228,6138,1256,4882,22,58,11,11
20514,64020,53,53035,53,196,102,94,2,30,1,1
20515,49244,80,49244,80,661753,15722,646031,683,17,235,448
20516,49591,80,27431,80,314,128,186,6,27,3,3
20517,60471,19776,35509,19776,70,70,0,2,8,2,0
20518,54805,80,8562,80,448,78,370,6,24,1,5
20519,57386,53,39494,53,193,102,91,2,30,1,1
20520,61438,443,9604,443,4933,771,4162,18,28,8,10
20521,63959,15922,28893,15922,2136,1536,600,18,22,12,6
20522,51606,443,26654,443,2895,2046,849,14,134,8,6
20523,46410,80,31458,80,1163,705,458,10,15,6,4
20524,57398,443,53104,443,1056,569,487,10,24,6,4
20525,55688,33958,16437,33958,70,70,0,1,5,1,0
20526,60377,443,19236,443,10101,2782,7319,22,78,10,12
20527,53468,443,36235,443,3153,2232,921,15,15,8,7
20528,37648,443,15216,443,9618,7387,2231,30,26,18,12
20529,21456,53,21456,53,240,98,142,2,30,1,1
20530,50970,80,61956,80,11340,3061,8279,31,115,12,19
20531,37651,443,4131,443,4162,3001,1161,20,25,12,8
20532,56857,53,15955,53,195,102,93,2,30,1,1
20533,49549,443,14886,443,19491,14463,5028,50,224,26,24
20534,55245,53,25152,53,193,102,91,2,30,1,1
20535,56532,53,25649,53,193,102,91,2,30,1,1
20536,49654,53,46255,53,775,102,673,2,30,1,1
20537,60684,53,9516,53,199,94,105,2,30,1,1
20538,56857,53,39377,53,195,102,93,2,30,1,1
20539,55729,53,3509,53,199,102,97,2,30,1,1
20540,55159,53,29350,53,200,102,98,2,30,1,1
20541,49521,53,40316,53,183,94,89,2,30,1,1
20542,55308,53,65535,53,194,94,100,2,30,1,1
20543,65277,53,48607,53,199,102,97,2,30,1,1
20544,65133,53,34896,53,198,102,96,2,30,1,1
20545,27005,27015,64415,27015,875,126,749,2,30,1,1
20546,49205,53,3818,53,720,94,626,2,30,1,1
20547,59859,443,59054,443,27510,4470,23040,67,122,34,33
20548,1956,53,1956,53,240,98,142,2,30,1,1
20549,60365,443,29839,443,13649,6567,7082,29,127,14,15
20550,51604,443,15214,443,2911,2062,849,14,134,8,6
20551,49792,53,55353,53,755,202,553,6,61,3,3
20552,10049,5222,44592,5222,6103,3081,3022,63,616,34,29
20553,49268,53,9594,53,200,94,106,2,30,1,1
20554,37683,53,37683,53,240,98,142,2,30,1,1
20555,56857,53,28297,53,195,102,93,2,30,1,1
20556,27005,27015,33669,27015,876,126,750,2,30,1,1
20557,57363,53,3624,53,193,102,91,2,30,1,1
20558,55003,53,61767,53,196,102,94,2,30,1,1
20559,55224,53,43043,53,182,94,88,2,30,1,1
20560,49505,443,22158,443,3182,1568,1614,8,120,4,4
20561,48625,443,33941,443,29988,20891,9097,170,598,95,75
20562,61435,443,45257,443,1401,940,461,11,29,7,4
20563,53724,443,35083,443,7759,1476,6283,24,19,14,10
20564,56728,443,11785,443,8652,2148,6504,20,15,11,9
20565,55224,53,2332,53,182,94,88,2,30,1,1
20566,58868,443,25875,443,1826093,48237,1777856,1873,71,599,1274
20567,55317,53,30681,53,216,102,114,2,30,1,1
20568,49466,53,24088,53,209,110,99,2,30,1,1
20569,55141,53,24444,53,184,94,90,2,30,1,1
20570,56625,53,55820,53,193,102,91,2,30,1,1
20571,65020,53,48553,53,184,94,90,2,30,1,1
20572,49776,53,42364,53,182,94,88,2,30,1,1
20573,49526,53,12720,53,272,97,175,4,58,2,2
20574,65136,53,56323,53,458,104,354,4,57,2,2
20575,57396,443,55887,443,1054,567,487,10,24,6,4
20576,61436,443,20457,443,1401,940,461,11,29,7,4
20577,51937,80,32427,80,37552,16143,21409,54,28,26,28
20578,47650,443,28162,443,1056,569,487,10,24,6,4
20579,51919,80,35345,80,16004,8270,7734,32,57,17,15
20580,39456,443,56286,443,6944,1650,5294,24,40,14,10
20581,51850,80,53740,80,2188,1421,767,11,61,7,4
20582,51947,80,31823,80,1582,866,716,11,27,7,4
20583,50402,8080,50402,8080,378,180,198,7,78,4,3
20584,50639,80,20616,80,318,192,126,6,25,4,2
20585,41538,443,31150,443,8090,2462,5628,22,21,12,10
20586,61404,443,64202,443,4526,2655,1871,24,98,14,10
20587,50608,80,12728,80,10029,8683,1346,20,36,11,9
20588,50309,53,29176,53,193,102,91,2,29,1,1
20589,51955,80,57774,80,366,240,126,7,27,5,2
20590,55159,53,20403,53,200,102,98,2,29,1,1
20591,60789,40010,35327,40010,316,136,180,6,6,3,3
20592,64020,53,31935,53,196,102,94,2,29,1,1
20593,57334,53,51470,53,184,94,90,2,29,1,1
20594,55123,53,29393,53,198,102,96,2,29,1,1
20595,55245,53,15511,53,193,102,91,2,30,1,1
20596,51605,443,22416,443,2013,1363,650,12,134,7,5
20597,53268,443,33392,443,13176,4779,8397,47,17,29,18
20598,51602,443,19598,443,2013,1363,650,12,134,7,5
20599,55268,53,12955,53,193,102,91,2,29,1,1
20600,50309,53,52592,53,816,102,714,2,29,1,1
20601,57061,53,28599,53,1780,674,1106,18,68,9,9
20602,65091,53,53299,53,212,102,110,2,29,1,1
20603,49276,53,23238,53,199,102,97,2,29,1,1
20604,55245,53,61157,53,209,110,99,2,29,1,1
20605,65139,53,18725,53,216,110,106,2,29,1,1
20606,55451,53,24181,53,193,102,91,2,29,1,1
20607,57382,53,10173,53,184,94,90,2,29,1,1
20608,27005,23010,48268,23010,881,126,755,2,30,1,1
20609,56821,53,37054,53,199,102,97,2,29,1,1
20610,54960,53,7818,53,448,184,264,6,30,3,3
20611,27005,27015,22346,27015,869,126,743,2,30,1,1
20612,56271,53,40470,53,195,102,93,2,30,1,1
20613,65204,53,50425,53,183,94,89,2,29,1,1
20614,27005,27015,56487,27015,892,126,766,2,30,1,1
20615,56313,53,7170,53,198,102,96,2,29,1,1
20616,55325,53,53505,53,199,102,97,2,30,1,1
20617,64985,53,53017,53,196,102,94,2,30,1,1
20618,65132,53,29079,53,167,86,81,2,30,1,1
20619,65023,53,44980,53,761,102,659,2,30,1,1
20620,64489,53,32733,53,215,102,113,2,30,1,1
20621,34814,53,64232,53,168,78,90,2,30,1,1
20622,65363,53,10206,53,181,94,87,2,30,1,1
20623,49636,53,23682,53,180,94,86,2,30,1,1
20624,55577,53,20988,53,199,102,97,2,30,1,1
20625,65376,53,60931,53,184,94,90,2,30,1,1
20626,55384,53,24803,53,194,102,92,2,30,1,1
20627,49628,53,54412,53,168,86,82,2,30,1,1
20628,64853,53,39005,53,199,102,97,2,30,1,1
20629,64695,53,7882,53,275,118,157,2,30,1,1
20630,49290,53,50836,53,184,94,90,2,30,1,1
20631,52850,443,36065,443,5743,1339,4404,18,180,8,10
20632,60840,53,50587,53,255,86,169,2,31,1,1
20633,55384,53,49003,53,194,102,92,2,31,1,1
20634,51973,12321,46700,12321,1260,636,624,9,30,5,4
20635,53277,80,34172,80,4374,1724,2650,16,150,9,7
20636,37538,443,35991,443,14826,7220,7606,53,94,29,24
20637,56729,443,23413,443,8652,2148,6504,20,15,11,9
20638,46270,7700,51894,7700,1440,956,484,15,35,8,7
20639,33830,443,20220,443,130,70,60,2,15,1,1
20640,51603,443,62273,443,2927,2062,865,14,134,8,6
20641,60875,443,41853,443,7251,2098,5153,27,25,15,12
20642,60369,443,30950,443,12859,2557,10302,25,80,10,15
20643,55729,53,33239,53,199,102,97,2,30,1,1
20644,56532,53,39559,53,193,102,91,2,30,1,1
20645,25209,53,25209,53,240,98,142,2,30,1,1
20646,17855,53,17855,53,240,98,142,2,30,1,1
20647,63968,53,26432,53,200,102,98,2,30,1,1
20648,49466,53,47860,53,209,110,99,2,30,1,1
20649,63932,53,27137,53,179,94,85,2,30,1,1
20650,63968,53,62729,53,200,102,98,2,30,1,1
20651,59133,443,44471,443,2863,1501,1362,20,315,10,10
20652,63984,15847,44273,15847,1344,819,525,14,15,8,6
20653,60469,60092,64603,60092,70,70,0,2,8,2,0
20654,37650,443,41900,443,6898,5202,1696,25,25,15,10
20655,64053,53,64715,53,276,94,182,4,55,2,2
20656,55577,53,26571,53,199,102,97,2,30,1,1
20657,54968,53,43253,53,199,102,97,2,30,1,1
20658,57351,53,35105,53,184,94,90,2,30,1,1
20659,56711,53,25495,53,209,110,99,2,30,1,1
20660,54968,53,59116,53,199,102,97,2,30,1,1
20661,55388,53,5023,53,720,94,626,2,30,1,1
20662,65472,53,51115,53,209,110,99,2,30,1,1
20663,32879,443,46058,443,8137,2110,6027,29,394,10,19
20664,50631,80,34721,80,14784,7048,7736,31,27,18,13
20665,61437,443,53093,443,4872,771,4101,17,28,8,9
20666,40140,53,40140,53,404,259,145,3,32,2,1
20667,60472,20273,1767,20273,70,70,0,2,8,2,0
20668,36368,80,58408,80,78,78,0,1,5,1,0
20669,49526,53,27945,53,272,97,175,4,57,2,2
20670,56711,53,8899,53,209,110,99,2,30,1,1
20671,57707,53,34372,53,70,70,0,1,30,1,0
20672,65505,53,13490,53,166,86,80,2,30,1,1
20673,55415,53,9661,53,183,94,89,2,30,1,1
20674,49521,53,3193,53,183,94,89,2,30,1,1
20675,49452,53,60984,53,244,110,134,2,30,1,1
20676,55220,53,22108,53,193,102,91,2,30,1,1
20677,65229,53,52095,53,193,102,91,2,30,1,1
20678,49521,53,30278,53,183,94,89,2,30,1,1
20679,49838,443,59419,443,6915,3106,3809,21,144,10,11
20680,65472,53,45041,53,209,110,99,2,30,1,1
20681,64833,53,41021,53,167,86,81,2,31,1,1
20682,63999,53,20780,53,193,102,91,2,31,1,1
20683,64985,53,7448,53,196,102,94,2,31,1,1
20684,64449,53,34818,53,255,102,153,2,31,1,1
20685,64780,53,40708,53,193,102,91,2,31,1,1
20686,27005,27015,28442,27015,881,126,755,2,31,1,1
20687,65026,53,29362,53,193,102,91,2,31,1,1
20688,63932,53,25694,53,179,94,85,2,31,1,1
20689,60478,443,17919,443,5045,2009,3036,14,120,7,7
20690,56523,443,55087,443,8130,2093,6037,17,120,9,8
20691,49971,443,5852,443,62,62,0,1,120,1,0
20692,57176,443,31036,443,12844,2619,10225,23,120,10,13
20693,6881,55981,51460,55981,228,118,110,2,1200,1,1
20694,26467,6969,47386,6969,192,192,0,4,1200,4,0
20695,58386,443,63968,443,15705,3421,12284,53,360,23,30
20696,65363,53,1138,53,181,94,87,2,31,1,1
20697,27005,27025,22813,27025,887,126,761,2,31,1,1
20698,63991,53,25716,53,193,102,91,2,31,1,1
20699,50354,443,29554,443,1786,172,1614,7,120,3,4
20700,50228,443,34666,443,1775,169,1606,7,120,3,4
20701,49696,443,49696,443,4871,1623,3248,18,137,8,10
20702,65020,53,24466,53,290,94,196,4,55,2,2
20703,49466,53,63958,53,324,103,221,4,46,2,2
20704,63949,53,2589,53,338,97,241,4,43,2,2
20705,65241,53,13968,53,484,102,382,4,36,2,2
20706,49526,53,6376,53,272,97,175,4,58,2,2
20707,64205,53,39534,53,327,88,239,4,52,2,2
20708,51813,443,18719,443,130,70,60,3,5,2,1
20709,32888,80,22913,80,1542,831,711,7,16,5,2
20710,9231,443,14526,443,4942,429,4513,12,15,6,6
20711,60226,443,32684,443,1907736,31488,1876248,1747,21,470,1277
20712,49265,53,25625,53,211,102,109,2,30,1,1
20713,64567,53,64760,53,193,102,91,2,30,1,1
20714,5227,50584,0,0,62,62,0,1,0,1,0
20715,49577,57470,0,0,66,66,0,1,0,1,0
20716,54578,26467,0,0,66,66,0,1,0,1,0
20717,54373,26467,0,0,62,62,0,1,0,1,0
20718,62421,445,0,0,70,70,0,1,0,1,0
20719,24236,26296,0,0,148,148,0,1,0,1,0
20720,3077,50584,0,0,146,146,0,1,0,1,0
20721,50853,445,0,0,70,70,0,1,0,1,0
20722,50852,445,0,0,70,70,0,1,0,1,0
20723,50850,445,0,0,70,70,0,1,0,1,0
20724,50842,445,0,0,70,70,0,1,0,1,0
20725,53376,22114,0,0,62,62,0,1,0,1,0
20726,62413,445,0,0,70,70,0,1,0,1,0
20727,62600,445,0,0,66,66,0,1,0,1,0
20728,62598,445,0,0,66,66,0,1,0,1,0
20729,62599,445,0,0,66,66,0,1,0,1,0
20730,42231,57470,0,0,78,78,0,1,0,1,0
20731,58120,25174,0,0,66,66,0,1,0,1,0
20732,63717,37965,0,0,66,66,0,1,0,1,0
20733,50839,445,0,0,70,70,0,1,0,1,0
20734,62991,51221,0,0,66,66,0,1,0,1,0
20735,62407,445,0,0,70,70,0,1,0,1,0
20736,57131,31061,0,0,145,145,0,1,0,1,0
20737,50830,445,0,0,70,70,0,1,0,1,0
20738,50828,445,0,0,70,70,0,1,0,1,0
20739,50826,445,0,0,70,70,0,1,0,1,0
20740,62405,445,0,0,70,70,0,1,0,1,0
20741,23519,25174,0,0,146,146,0,1,0,1,0
20742,45941,23386,0,0,60,60,0,1,0,1,0
20743,14000,14914,0,0,157,157,0,1,0,1,0
20744,63852,25174,0,0,62,62,0,1,0,1,0
20745,63385,25174,0,0,66,66,0,1,0,1,0
20746,50563,37965,0,0,66,66,0,1,0,1,0
20747,62401,445,0,0,70,70,0,1,0,1,0
20748,64306,64147,0,0,62,62,0,1,0,1,0
20749,11815,30188,0,0,146,146,0,1,0,1,0
20750,19747,37965,0,0,62,62,0,1,0,1,0
20751,18683,26467,0,0,62,62,0,1,0,1,0
20752,2837,25174,0,0,66,66,0,1,0,1,0
20753,54277,22114,0,0,146,146,0,1,0,1,0
20754,11136,19910,0,0,62,62,0,1,0,1,0
20755,3717,25174,0,0,62,62,0,1,0,1,0
20756,50549,43890,0,0,66,66,0,1,0,1,0
20757,40840,21247,0,0,62,62,0,1,0,1,0
20758,62400,445,0,0,70,70,0,1,0,1,0
20759,56249,55442,0,0,66,66,0,1,0,1,0
20760,36992,25174,0,0,146,146,0,1,0,1,0
20761,51310,64147,0,0,66,66,0,1,0,1,0
20762,50821,445,0,0,70,70,0,1,0,1,0
20763,50817,445,0,0,70,70,0,1,0,1,0
20764,50815,445,0,0,70,70,0,1,0,1,0
20765,65006,26467,0,0,66,66,0,1,0,1,0
20766,62586,445,0,0,66,66,0,1,0,1,0
20767,23349,30188,0,0,62,62,0,1,0,1,0
20768,34914,26467,0,0,62,62,0,1,0,1,0
20769,50857,26467,0,0,66,66,0,1,0,1,0
20770,62395,445,0,0,70,70,0,1,0,1,0
20771,51045,25174,0,0,66,66,0,1,0,1,0
20772,63982,25174,0,0,66,66,0,1,0,1,0
20773,22677,25174,0,0,66,66,0,1,0,1,0
20774,1827,64147,0,0,66,66,0,1,0,1,0
20775,14614,25174,0,0,66,66,0,1,0,1,0
20776,7356,25174,0,0,66,66,0,1,0,1,0
20777,55529,44847,0,0,66,66,0,1,0,1,0
20778,52232,53,0,0,71,71,0,1,0,1,0
20779,50812,445,0,0,70,70,0,1,0,1,0
20780,50810,445,0,0,70,70,0,1,0,1,0
20781,61840,25174,0,0,66,66,0,1,0,1,0
20782,63888,25174,0,0,66,66,0,1,0,1,0
20783,53546,46824,0,0,66,66,0,1,0,1,0
20784,52809,56205,0,0,146,146,0,1,0,1,0
20785,21604,50201,0,0,66,66,0,1,0,1,0
20786,55987,53,22591,53,733,85,648,2,0,1,1
20787,56816,11392,0,0,62,62,0,1,0,1,0
20788,35812,1,0,0,146,146,0,1,0,1,0
20789,56334,1433,0,0,60,60,0,1,0,1,0
20790,54418,22114,0,0,66,66,0,1,0,1,0
20791,62571,445,0,0,66,66,0,1,0,1,0
20792,29509,25174,0,0,62,62,0,1,0,1,0
20793,51602,22114,0,0,66,66,0,1,0,1,0
20794,62382,445,0,0,70,70,0,1,0,1,0
20795,51094,35440,0,0,62,62,0,1,0,1,0
20796,56590,25174,0,0,66,66,0,1,0,1,0
20797,11967,57470,0,0,62,62,0,1,0,1,0
20798,3766,25174,0,0,62,62,0,1,0,1,0
20799,3766,25174,0,0,146,146,0,1,0,1,0
20800,62379,445,0,0,70,70,0,1,0,1,0
20801,50803,445,0,0,70,70,0,1,0,1,0
20802,50799,445,0,0,70,70,0,1,0,1,0
20803,50798,445,0,0,70,70,0,1,0,1,0
20804,50791,445,0,0,70,70,0,1,0,1,0
20805,62566,445,0,0,66,66,0,1,0,1,0
20806,15442,22114,0,0,66,66,0,1,0,1,0
20807,25296,51505,0,0,66,66,0,1,0,1,0
20808,7810,25174,0,0,66,66,0,1,0,1,0
20809,62554,445,0,0,66,66,0,1,0,1,0
20810,62557,445,0,0,66,66,0,1,0,1,0
20811,62558,445,0,0,66,66,0,1,0,1,0
20812,62562,445,0,0,66,66,0,1,0,1,0
20813,62556,445,0,0,66,66,0,1,0,1,0
20814,62553,445,0,0,66,66,0,1,0,1,0
20815,62551,445,0,0,66,66,0,1,0,1,0
20816,27300,6881,0,0,66,66,0,1,0,1,0
20817,62374,445,0,0,70,70,0,1,0,1,0
20818,50786,445,0,0,70,70,0,1,0,1,0
20819,62373,445,0,0,70,70,0,1,0,1,0
20820,50782,445,0,0,70,70,0,1,0,1,0
20821,50783,445,0,0,70,70,0,1,0,1,0
20822,50779,445,0,0,70,70,0,1,0,1,0
20823,28221,37965,0,0,62,62,0,1,0,1,0
20824,62371,445,0,0,70,70,0,1,0,1,0
20825,53140,51221,0,0,74,74,0,1,0,1,0
20826,6666,2222,0,0,60,60,0,1,0,1,0
20827,56397,26467,0,0,66,66,0,1,0,1,0
20828,22547,23,0,0,60,60,0,1,0,1,0
20829,62769,25174,0,0,146,146,0,1,0,1,0
20830,53539,44847,0,0,62,62,0,1,0,1,0
20831,50777,445,0,0,70,70,0,1,0,1,0
20832,50773,445,0,0,70,70,0,1,0,1,0
20833,50772,445,0,0,70,70,0,1,0,1,0
20834,62364,445,0,0,70,70,0,1,0,1,0
20835,64955,53,11149,53,761,100,661,2,0,1,1
20836,0,0,0,0,320,320,0,5,0,5,0
20837,62544,445,0,0,66,66,0,1,0,1,0
20838,50770,445,0,0,70,70,0,1,0,1,0
20839,62362,445,0,0,70,70,0,1,0,1,0
20840,53577,35894,0,0,66,66,0,1,0,1,0
20841,62541,445,0,0,66,66,0,1,0,1,0
20842,6652,25174,0,0,62,62,0,1,0,1,0
20843,62539,445,0,0,66,66,0,1,0,1,0
20844,62538,445,0,0,66,66,0,1,0,1,0
20845,53495,37807,0,0,66,66,0,1,0,1,0
20846,62361,445,0,0,70,70,0,1,0,1,0
20847,62536,445,0,0,66,66,0,1,0,1,0
20848,62360,445,0,0,70,70,0,1,0,1,0
20849,16037,25174,0,0,62,62,0,1,0,1,0
20850,62359,445,0,0,70,70,0,1,0,1,0
20851,16037,25174,0,0,146,146,0,1,0,1,0
20852,62356,445,0,0,70,70,0,1,0,1,0
20853,62353,445,0,0,70,70,0,1,0,1,0
20854,53199,30188,0,0,66,66,0,1,0,1,0
20855,56629,25174,0,0,66,66,0,1,0,1,0
20856,25961,55783,0,0,60,60,0,1,0,1,0
20857,49893,25174,0,0,66,66,0,1,0,1,0
20858,48826,25174,0,0,66,66,0,1,0,1,0
20859,55826,42771,0,0,66,66,0,1,0,1,0
20860,55825,52700,0,0,66,66,0,1,0,1,0
20861,53022,25174,0,0,66,66,0,1,0,1,0
20862,50764,445,0,0,70,70,0,1,0,1,0
20863,1024,25174,0,0,62,62,0,1,0,1,0
20864,11488,22114,0,0,66,66,0,1,0,1,0
20865,50755,445,0,0,70,70,0,1,0,1,0
20866,50751,445,0,0,70,70,0,1,0,1,0
20867,62341,445,0,0,70,70,0,1,0,1,0
20868,62340,445,0,0,70,70,0,1,0,1,0
20869,40400,22114,0,0,62,62,0,1,0,1,0
20870,62337,445,0,0,70,70,0,1,0,1,0
20871,62331,445,0,0,70,70,0,1,0,1,0
20872,62330,445,0,0,70,70,0,1,0,1,0
20873,30598,37965,0,0,62,62,0,1,0,1,0
20874,62525,445,0,0,66,66,0,1,0,1,0
20875,50927,44847,0,0,146,146,0,1,0,1,0
20876,48019,22114,0,0,66,66,0,1,0,1,0
20877,61017,64147,0,0,66,66,0,1,0,1,0
20878,1733,65448,0,0,66,66,0,1,0,1,0
20879,42238,25174,0,0,66,66,0,1,0,1,0
20880,55629,42873,0,0,74,74,0,1,0,1,0
20881,42034,28189,0,0,62,62,0,1,0,1,0
20882,47513,23,0,0,60,60,0,1,0,1,0
20883,62792,53,0,0,88,88,0,1,0,1,0
20884,10273,21247,0,0,66,66,0,1,0,1,0
20885,62518,445,0,0,66,66,0,1,0,1,0
20886,27144,25174,0,0,66,66,0,1,0,1,0
20887,50742,445,0,0,70,70,0,1,0,1,0
20888,62319,445,0,0,70,70,0,1,0,1,0
20889,55045,443,26442,443,5541,2778,2763,24,15,14,10
20890,14597,53,14597,53,404,259,145,3,32,2,1
20891,39704,53,39704,53,398,255,143,3,33,2,1
20892,45844,443,26065,443,44232,11223,33009,97,460,50,47
20893,63999,53,43877,53,186,95,91,2,30,1,1
20894,64985,53,36411,53,192,98,94,2,30,1,1
20895,53917,80,62681,80,1829,755,1074,10,15,6,4
20896,48908,53,48908,53,398,255,143,3,32,2,1
20897,42488,53,42488,53,235,90,145,2,32,1,1
20898,46025,80,38311,80,5037,1911,3126,18,86,10,8
20899,49705,22,49705,22,1108,66,1042,3,15,2,1
20900,26842,443,13375,443,7219,2522,4697,21,20,10,11
20901,51964,443,11131,443,5363,2713,2650,26,53,14,12
20902,58703,443,1950,443,15202,6356,8846,40,119,22,18
20903,55325,53,48577,53,198,101,97,2,30,1,1
20904,49182,53,44027,53,198,101,97,2,30,1,1
20905,49595,53,17154,53,176,90,86,2,30,1,1
20906,57705,443,65472,443,7915,1994,5921,31,270,15,16
20907,55262,443,33483,443,28633618,753499,27880119,30116,102,8846,21270
20908,50381,443,49531,443,316,136,180,6,6,3,3
20909,60463,6890,27604,6890,70,70,0,1,5,1,0
20910,49317,53,41699,53,168,78,90,2,30,1,1
20911,65026,53,32654,53,186,95,91,2,30,1,1
20912,49171,443,58850,443,13649,6228,7421,28,30,15,13
20913,64444,53,59792,53,93,93,0,1,30,1,0
20914,58971,443,47268,443,2702,1593,1109,21,23,11,10
20915,64947,53,18048,53,275,96,179,4,41,2,2
20916,48020,53,48020,53,404,259,145,3,33,2,1
20917,29047,80,29047,80,10148,1458,8690,23,25,11,12
20918,62964,53,62964,53,404,259,145,3,33,2,1
20919,59420,443,36806,443,7913,5787,2126,28,316,14,14
20920,46028,80,31228,80,1176793,65077,1111716,1528,85,788,740
20921,49165,53,64334,53,780,104,676,2,30,1,1
20922,45116,80,45116,80,24787,1571,23216,40,21,20,20
20923,64790,53,58871,53,88,88,0,1,30,1,0
20924,58878,443,22672,443,25575,16682,8893,57,21,31,26
20925,46029,80,61068,80,111564,6775,104789,160,85,86,74
20926,50370,443,23415,443,316,136,180,6,6,3,3
20927,18686,53,18686,53,235,90,145,2,32,1,1
20928,39861,80,23505,80,1056,682,374,10,15,6,4
20929,19116,53,19116,53,398,255,143,3,33,2,1
20930,51638,80,49602,80,19232,1830,17402,35,49,19,16
20931,2402,7000,2402,7000,1236,676,560,13,22,7,6
20932,57089,443,54231,443,5574,999,4575,21,256,11,10
20933,55044,443,54771,443,5549,2777,2772,24,16,14,10
20934,56423,443,49453,443,6294,1494,4800,22,17,11,11
20935,54958,443,14997,443,6578,1571,5007,24,17,13,11
20936,56410,53,65347,53,757,98,659,2,30,1,1
20937,49776,53,56083,53,180,92,88,2,30,1,1
20938,32346,53,32346,53,200,90,110,2,30,1,1
20939,30834,53,30834,53,194,87,107,2,30,1,1
20940,49558,53,30601,53,184,94,90,2,30,1,1
20941,56433,53,16233,53,204,104,100,2,30,1,1
20942,18194,53,18194,53,225,87,138,2,31,1,1
20943,30960,45756,31120,45756,396,396,0,7,3616,7,0
20944,56604,443,22617,443,2904,662,2242,13,135,6,7
20945,40204,40007,54780,40007,140,78,62,2,31,1,1
20946,65487,53,62751,53,204,104,100,2,31,1,1
20947,56327,53,49632,53,172,88,84,2,31,1,1
20948,64034,53,21913,53,188,96,92,2,31,1,1
20949,27005,27015,63024,27015,897,126,771,2,31,1,1
20950,49380,53,50592,53,377,110,267,2,31,1,1
20951,5588,5588,0,0,3354,1792,1562,46,195,23,23
20952,14721,53,14721,53,217,87,130,2,31,1,1
20953,27005,27016,61455,27016,881,126,755,2,31,1,1
20954,27233,53,27233,53,213,87,126,2,31,1,1
20955,56927,53,19352,53,182,93,89,2,31,1,1
20956,49916,53,52400,53,395,111,284,2,31,1,1
20957,55693,53,60577,53,748,95,653,2,31,1,1
20958,27005,27018,40028,27018,891,126,765,2,31,1,1
20959,49969,53,49918,53,198,101,97,2,31,1,1
20960,64290,53,55058,53,192,98,94,2,31,1,1
20961,53822,25174,0,0,66,66,0,1,0,1,0
20962,63888,57470,0,0,62,62,0,1,0,1,0
20963,58228,53733,0,0,66,66,0,1,0,1,0
20964,55732,5900,0,0,60,60,0,1,0,1,0
20965,62516,445,0,0,66,66,0,1,0,1,0
20966,20706,37965,0,0,62,62,0,1,0,1,0
20967,6666,16010,0,0,60,60,0,1,0,1,0
20968,20576,37965,0,0,62,62,0,1,0,1,0
20969,7222,57470,0,0,62,62,0,1,0,1,0
20970,62580,25174,0,0,62,62,0,1,0,1,0
20971,27063,25174,0,0,62,62,0,1,0,1,0
20972,51298,57470,0,0,66,66,0,1,0,1,0
20973,31404,46232,0,0,100,100,0,1,0,1,0
20974,47357,50584,0,0,66,66,0,1,0,1,0
20975,10072,25174,0,0,62,62,0,1,0,1,0
20976,60721,22114,0,0,66,66,0,1,0,1,0
20977,62315,445,0,0,70,70,0,1,0,1,0
20978,62509,445,0,0,66,66,0,1,0,1,0
20979,51600,443,3011,443,12552,2564,9988,29,16,17,12
20980,62716,2323,0,0,60,60,0,1,0,1,0
20981,1882,43890,0,0,62,62,0,1,0,1,0
20982,62506,445,0,0,66,66,0,1,0,1,0
20983,57655,56205,0,0,66,66,0,1,0,1,0
20984,62424,37965,0,0,62,62,0,1,0,1,0
20985,31404,52955,0,0,100,100,0,1,0,1,0
20986,50956,25174,0,0,146,146,0,1,0,1,0
20987,62306,445,0,0,70,70,0,1,0,1,0
20988,62303,445,0,0,70,70,0,1,0,1,0
20989,62305,445,0,0,70,70,0,1,0,1,0
20990,31404,12082,0,0,100,100,0,1,0,1,0
20991,31404,36778,0,0,100,100,0,1,0,1,0
20992,31404,59961,0,0,100,100,0,1,0,1,0
20993,31404,36841,0,0,100,100,0,1,0,1,0
20994,62301,445,0,0,70,70,0,1,0,1,0
20995,49417,38558,0,0,66,66,0,1,0,1,0
20996,62299,445,0,0,70,70,0,1,0,1,0
20997,50126,23117,0,0,66,66,0,1,0,1,0
20998,62796,37807,0,0,66,66,0,1,0,1,0
20999,49931,25174,0,0,66,66,0,1,0,1,0
21000,50211,51050,0,0,62,62,0,1,0,1,0
21001,59192,25174,0,0,66,66,0,1,0,1,0
21002,45908,33330,0,0,60,60,0,1,0,1,0
21003,64035,25174,0,0,62,62,0,1,0,1,0
21004,2090,50265,0,0,145,145,0,1,0,1,0
21005,50735,445,0,0,70,70,0,1,0,1,0
21006,50732,445,0,0,70,70,0,1,0,1,0
21007,50730,445,0,0,70,70,0,1,0,1,0
21008,62488,445,0,0,66,66,0,1,0,1,0
21009,55008,21247,0,0,62,62,0,1,0,1,0
21010,54280,3398,0,0,60,60,0,1,0,1,0
21011,62492,445,0,0,66,66,0,1,0,1,0
21012,62493,445,0,0,66,66,0,1,0,1,0
21013,62491,445,0,0,66,66,0,1,0,1,0
21014,62486,445,0,0,66,66,0,1,0,1,0
21015,62489,445,0,0,66,66,0,1,0,1,0
21016,62487,445,0,0,66,66,0,1,0,1,0
21017,62485,445,0,0,66,66,0,1,0,1,0
21018,10949,22114,0,0,146,146,0,1,0,1,0
21019,60075,41705,0,0,66,66,0,1,0,1,0
21020,33761,25174,0,0,62,62,0,1,0,1,0
21021,62292,445,0,0,70,70,0,1,0,1,0
21022,44903,80,37166,80,918,461,457,9,16,6,3
21023,32975,443,44703,443,4648,1885,2763,20,95,10,10
21024,55384,53,51117,53,194,102,92,2,30,1,1
21025,57252,53,26443,53,229,102,127,2,30,1,1
21026,57558,443,4202,443,42986,7555,35431,69,125,29,40
21027,51295,80,40456,80,6702,5879,823,19,135,10,9
21028,44911,80,9577,80,1492,1050,442,7,15,5,2
21029,49590,80,22848,80,314,128,186,6,26,3,3
21030,43016,53,43016,53,235,90,145,2,32,1,1
21031,64672,53,41499,53,576,195,381,6,51,3,3
21032,65220,53,7032,53,371,97,274,4,53,2,2
21033,49182,53,41433,53,199,102,97,2,29,1,1
21034,49776,53,43757,53,182,94,88,2,29,1,1
21035,49558,53,61450,53,184,94,90,2,29,1,1
21036,64053,53,32861,53,276,94,182,4,54,2,2
21037,49947,53,36871,53,264,102,162,2,30,1,1
21038,49166,443,48248,443,9022,1416,7606,25,31,11,14
21039,47873,443,44942,443,12813,5036,7777,40,383,20,20
21040,47191,443,13970,443,8756,2298,6458,39,314,18,21
21041,52053,34411,20997,34411,70,70,0,2,7,2,0
21042,50362,80,15549,80,3907,880,3027,11,15,5,6
21043,36628,80,36628,80,5529,713,4816,15,15,8,7
21044,53465,443,55749,443,3166,2245,921,15,15,8,7
21045,43683,443,23640,443,6941,1551,5390,25,200,12,13
21046,58068,443,17873,443,543,303,240,8,5,4,4
21047,49320,53,42245,53,331,90,241,4,38,2,2
21048,55325,53,47399,53,199,102,97,2,29,1,1
21049,56625,53,48390,53,193,102,91,2,29,1,1
21050,55152,53,21399,53,180,94,86,2,29,1,1
21051,65505,53,17210,53,166,86,80,2,29,1,1
21052,49233,53,56407,53,196,102,94,2,29,1,1
21053,64520,53,16253,53,198,102,96,2,29,1,1
21054,64790,53,41901,53,178,94,84,2,29,1,1
21055,55236,53,27697,53,196,102,94,2,29,1,1
21056,65026,53,34108,53,193,102,91,2,29,1,1
21057,64011,53,28636,53,288,94,194,2,29,1,1
21058,65376,53,47204,53,184,94,90,2,29,1,1
21059,64567,53,8117,53,193,102,91,2,29,1,1
21060,65167,53,26450,53,212,102,110,2,29,1,1
21061,50535,53,14934,53,210,110,100,2,29,1,1
21062,55236,53,12241,53,819,102,717,2,29,1,1
21063,65376,53,8405,53,184,94,90,2,30,1,1
21064,60874,443,9716,443,4479,788,3691,17,25,9,8
21065,61491,443,56385,443,5628,1716,3912,26,109,16,10
21066,53253,443,36100,443,8662,1469,7193,28,66,15,13
21067,64833,53,62978,53,167,86,81,2,30,1,1
21068,27005,27018,61540,27018,881,126,755,2,30,1,1
21069,49595,53,9542,53,180,94,86,2,30,1,1
21070,63992,53,39861,53,199,102,97,2,30,1,1
21071,49489,53,23234,53,241,118,123,2,30,1,1
21072,57536,443,25705,443,232,172,60,3,5,2,1
21073,55682,32765,50295,32765,3529,1769,1760,11,15,6,5
21074,59999,443,10266,443,1571,660,911,13,18,7,6
21075,53263,443,23949,443,11175,1078,10097,25,41,11,14
21076,55054,80,54288,80,67750,4451,63299,78,60,32,46
21077,49182,53,13161,53,199,102,97,2,30,1,1
21078,55684,80,48603,80,70,70,0,1,5,1,0
21079,27005,27016,10139,27016,887,126,761,2,30,1,1
21080,49534,53,17481,53,315,84,231,4,40,2,2
21081,64312,53,41455,53,225,110,115,2,30,1,1
21082,59996,443,60855,443,1641,730,911,14,18,8,6
21083,52094,443,44037,443,2983,1667,1316,25,153,12,13
21084,49903,53,41942,53,194,94,100,2,30,1,1
21085,44380,443,20721,443,5624,2556,3068,29,80,15,14
21086,65507,53,44287,53,199,102,97,2,30,1,1
21087,36575,443,29496,443,412,140,272,7,25,3,4
21088,53252,443,20191,443,6053,974,5079,20,66,10,10
21089,61490,443,7323,443,4561,1129,3432,22,109,13,9
21090,65216,53,8359,53,775,102,673,2,30,1,1
21091,49248,53,1565,53,301,90,211,4,46,2,2
21092,56433,53,47561,53,210,110,100,2,30,1,1
21093,35350,443,47252,443,13168,2505,10663,21,121,9,12
21094,42792,443,30288,443,7102,1857,5245,28,95,15,13
21095,56453,53,58094,53,243,94,149,2,30,1,1
21096,19473,61397,60276,61397,323,150,173,2,1200,1,1
21097,17860,53,17860,53,216,90,126,2,30,1,1
21098,51221,41939,7547,41939,3917,1584,2333,50,3325,25,25
21099,51388,443,13575,443,6703,3312,3391,31,145,14,17
21100,42568,443,34410,443,8049,2043,6006,23,360,11,12
21101,65121,443,49060,443,11416,4745,6671,45,256,22,23
21102,53035,80,53035,80,373926,8227,365699,379,143,130,249
21103,49835,443,51050,443,8754,2616,6138,34,96,19,15
21104,56288,53,63412,53,210,110,100,2,30,1,1
21105,63992,53,62838,53,199,102,97,2,30,1,1
21106,27005,27015,24846,27015,878,126,752,2,30,1,1
21107,57514,53,51498,53,168,78,90,2,30,1,1
21108,50359,80,14465,80,1770,961,809,10,15,5,5
21109,60000,443,63999,443,1641,730,911,14,18,8,6
21110,50857,3389,50857,3389,3613,1594,2019,19,18,10,9
21111,63988,53,50282,53,559,193,366,6,67,3,3
21112,56288,53,18039,53,210,110,100,2,30,1,1
21113,64833,53,29927,53,167,86,81,2,30,1,1
21114,27005,27016,36126,27016,883,126,757,2,30,1,1
21115,44119,53,25337,53,168,78,90,2,30,1,1
21116,65507,53,53628,53,199,102,97,2,30,1,1
21117,49595,53,47380,53,180,94,86,2,30,1,1
21118,65133,53,1707,53,339,100,239,4,51,2,2
21119,37663,80,36231,80,974,481,493,8,15,5,3
21120,57904,80,60274,80,6453,1210,5243,14,23,8,6
21121,53153,17639,25846,17639,698,320,378,10,18,6,4
21122,48440,443,28168,443,6945,1551,5394,25,200,12,13
21123,44907,80,29624,80,1514,962,552,7,16,5,2
21124,50391,80,25680,80,2837,582,2255,12,17,7,5
21125,51950,80,61236,80,3648,1775,1873,13,26,7,6
21126,49589,80,33481,80,314,128,186,6,26,3,3
21127,46773,443,61841,443,10812,3429,7383,39,315,20,19
21128,53851,23650,26484,23650,320,140,180,6,5,3,3
21129,64947,53,23514,53,275,96,179,4,41,2,2
21130,57695,443,41532,443,9493,2266,7227,24,14,13,11
21131,52036,52608,31210,52608,70,70,0,1,4,1,0
21132,6666,2222,6666,2222,130,66,64,2,5,1,1
21133,56163,53,10376,53,624,188,436,6,60,3,3
21134,43807,80,36292,80,138,78,60,2,4,1,1
21135,64947,53,11296,53,275,96,179,4,41,2,2
21136,59997,443,42772,443,1571,660,911,13,18,7,6
21137,50357,80,43010,80,764,698,66,6,15,5,1
21138,45775,443,19122,443,8706,1430,7276,23,316,9,14
21139,58903,443,20018,443,6033,770,5263,18,15,8,10
21140,50594,80,50594,80,9937,4191,5746,27,17,13,14
21141,10014,443,17937,443,3876,2012,1864,21,315,10,11
21142,49558,53,47394,53,184,94,90,2,30,1,1
21143,63999,53,37511,53,193,102,91,2,29,1,1
21144,49233,53,6991,53,819,102,717,2,29,1,1
21145,41812,443,33083,443,6617,1705,4912,24,331,11,13
21146,64780,53,50803,53,193,102,91,2,29,1,1
21147,27005,27015,62179,27015,889,126,763,2,30,1,1
21148,49277,53,5788,53,199,86,113,2,29,1,1
21149,27005,27017,42100,27017,891,126,765,2,30,1,1
21150,49570,53,16357,53,196,94,102,2,29,1,1
21151,64497,53,35440,53,232,110,122,2,29,1,1
21152,63991,53,55633,53,193,102,91,2,29,1,1
21153,49182,53,3761,53,199,102,97,2,29,1,1
21154,55325,53,5383,53,199,102,97,2,30,1,1
21155,50535,53,65134,53,210,110,100,2,29,1,1
21156,53261,443,44593,443,5025,973,4052,19,53,10,9
21157,51939,53,4042,53,222,94,128,2,30,1,1
21158,65403,53,26978,53,178,94,84,2,30,1,1
21159,53258,443,7093,443,5124,979,4145,19,54,10,9
21160,53249,443,44486,443,11150,2012,9138,29,67,14,15
21161,65026,53,30024,53,193,102,91,2,30,1,1
21162,59868,443,9732,443,6869,3351,3518,22,135,11,11
21163,49942,53,17734,53,741,94,647,2,30,1,1
21164,64271,53,22789,53,198,94,104,2,30,1,1
21165,49290,53,29478,53,184,94,90,2,30,1,1
21166,49160,6889,59737,6889,834,150,684,4,1200,2,2
21167,60462,47821,9617,47821,70,70,0,1,5,1,0
21168,57537,443,24448,443,130,70,60,3,5,2,1
21169,27005,27017,7414,27017,882,126,756,2,30,1,1
21170,63069,443,57757,443,2523249,58976,2464273,2483,33,820,1663
21171,53264,443,4162,443,41321,1491,39830,52,41,15,37
21172,53262,443,44480,443,7608,1340,6268,27,53,13,14
21173,49762,443,52270,443,7479,2226,5253,29,151,15,14
21174,49939,53,35576,53,229,102,127,2,30,1,1
21175,64444,53,10743,53,183,94,89,2,30,1,1
21176,55058,80,17892,80,48751,3044,45707,57,60,23,34
21177,50723,80,33475,80,1546,1109,437,7,15,5,2
21178,53036,80,53036,80,2954,720,2234,13,143,6,7
21179,50912,443,13273,443,5159,1080,4079,20,255,10,10
21180,60420,443,16410,443,7330,1565,5765,20,134,10,10
21181,45885,80,47215,80,23259,2769,20490,36,143,19,17
21182,56937,7150,12270,7150,126,126,0,1,30,1,0
21183,27005,27015,1536,27015,883,126,757,2,30,1,1
21184,53242,443,3574,443,5993,974,5019,19,70,10,9
21185,56433,53,24075,53,210,110,100,2,30,1,1
21186,63991,53,7605,53,193,102,91,2,30,1,1
21187,65403,53,51244,53,178,94,84,2,30,1,1
21188,40428,53,46586,53,168,78,90,2,30,1,1
21189,56462,53,3765,53,168,78,90,2,30,1,1
21190,56327,53,4067,53,178,94,84,2,30,1,1
21191,61387,443,3059,443,12231,6846,5385,38,160,19,19
21192,51738,7000,51738,7000,3550,1983,1567,15,16,8,7
21193,63992,53,19496,53,199,102,97,2,30,1,1
21194,55273,53,2212,53,168,78,90,2,30,1,1
21195,64567,53,13390,53,193,102,91,2,30,1,1
21196,53259,443,63565,443,27501,3878,23623,57,54,24,33
21197,53243,443,50839,443,242426,7999,234427,277,70,100,177
21198,48694,123,37842,123,184,94,90,2,30,1,1
21199,49595,53,24473,53,180,94,86,2,30,1,1
21200,64396,53,16886,53,231,102,129,2,30,1,1
21201,55387,53,41194,53,164,86,78,2,30,1,1
21202,64290,53,18678,53,196,102,94,2,31,1,1
21203,58781,443,55654,443,6133,1655,4478,12,120,5,7
21204,50038,53,4648,53,281,78,203,2,31,1,1
21205,51653,443,13431,443,6660,1542,5118,21,305,11,10
21206,57291,53,29680,53,178,94,84,2,30,1,1
21207,65293,53,30071,53,349,110,239,2,30,1,1
21208,40204,40012,25675,40012,148,86,62,2,30,1,1
21209,40204,40026,38971,40026,148,86,62,2,30,1,1
21210,56938,53,56411,53,199,102,97,2,31,1,1
21211,49776,53,15280,53,289,92,197,4,31,2,2
21212,64034,53,39969,53,194,102,92,2,31,1,1
21213,55569,443,40443,443,8867,3511,5356,20,120,9,11
21214,34478,443,59065,443,9107,2253,6854,22,185,11,11
21215,63789,443,32462,443,4407024,140001,4267023,4628,124,1546,3082
21216,52055,20019,40122,20019,316,136,180,6,7,3,3
21217,53826,10168,43672,10168,70,70,0,1,5,1,0
21218,63985,43081,52828,43081,70,70,0,1,5,1,0
21219,52048,44059,61296,44059,258,70,188,4,8,2,2
21220,52050,31648,17402,31648,70,70,0,2,8,2,0
21221,45720,443,24721,443,1625,1038,587,14,26,8,6
21222,44885,443,54078,443,1849,1130,719,17,38,9,8
21223,34431,443,7506,443,1701,1048,653,15,39,8,7
21224,48008,443,47118,443,10665,3059,7606,28,17,16,12
21225,53250,443,16467,443,70319,5815,64504,146,67,52,94
21226,52049,52557,35035,52557,70,70,0,2,8,2,0
21227,52051,29868,56419,29868,70,70,0,2,8,2,0
21228,36403,443,54491,443,1149,709,440,13,39,8,5
21229,51667,443,62904,443,1203,703,500,14,42,8,6
21230,54188,443,5906,443,2895,1646,1249,17,16,8,9
21231,57291,53,9525,53,178,94,84,2,30,1,1
21232,58509,21247,0,0,66,66,0,1,0,1,0
21233,63565,22114,0,0,146,146,0,1,0,1,0
21234,16387,51369,0,0,60,60,0,1,0,1,0
21235,39132,44847,0,0,62,62,0,1,0,1,0
21236,42231,57470,0,0,78,78,0,1,0,1,0
21237,50265,23,0,0,60,60,0,1,0,1,0
21238,30280,37965,0,0,66,66,0,1,0,1,0
21239,50729,445,0,0,70,70,0,1,0,1,0
21240,50725,445,0,0,70,70,0,1,0,1,0
21241,50712,445,0,0,70,70,0,1,0,1,0
21242,50714,445,0,0,70,70,0,1,0,1,0
21243,62285,445,0,0,70,70,0,1,0,1,0
21244,53257,37450,0,0,66,66,0,1,0,1,0
21245,38134,8497,0,0,143,143,0,1,0,1,0
21246,11599,25174,0,0,146,146,0,1,0,1,0
21247,55136,11392,0,0,62,62,0,1,0,1,0
21248,62282,445,0,0,70,70,0,1,0,1,0
21249,62471,445,0,0,66,66,0,1,0,1,0
21250,62473,445,0,0,66,66,0,1,0,1,0
21251,62470,445,0,0,66,66,0,1,0,1,0
21252,58791,25174,0,0,62,62,0,1,0,1,0
21253,59451,50584,0,0,62,62,0,1,0,1,0
21254,64755,31573,0,0,66,66,0,1,0,1,0
21255,62278,445,0,0,70,70,0,1,0,1,0
21256,63813,26467,0,0,66,66,0,1,0,1,0
21257,62277,445,0,0,70,70,0,1,0,1,0
21258,50711,445,0,0,70,70,0,1,0,1,0
21259,50707,445,0,0,70,70,0,1,0,1,0
21260,50706,445,0,0,70,70,0,1,0,1,0
21261,50700,445,0,0,70,70,0,1,0,1,0
21262,50197,64147,0,0,62,62,0,1,0,1,0
21263,42796,22114,0,0,146,146,0,1,0,1,0
21264,39086,53733,0,0,146,146,0,1,0,1,0
21265,62273,445,0,0,70,70,0,1,0,1,0
21266,9528,44847,0,0,62,62,0,1,0,1,0
21267,43891,8497,0,0,148,148,0,1,0,1,0
21268,56328,36237,0,0,66,66,0,1,0,1,0
21269,2422,62507,0,0,66,66,0,1,0,1,0
21270,52781,57470,0,0,66,66,0,1,0,1,0
21271,50851,25864,0,0,74,74,0,1,0,1,0
21272,31281,57470,0,0,145,145,0,1,0,1,0
21273,80,57411,0,0,1514,1514,0,1,0,1,0
21274,16387,45121,0,0,60,60,0,1,0,1,0
21275,62272,445,0,0,70,70,0,1,0,1,0
21276,54048,25174,0,0,66,66,0,1,0,1,0
21277,16387,41860,0,0,60,60,0,1,0,1,0
21278,65015,22114,0,0,66,66,0,1,0,1,0
21279,31738,51505,0,0,62,62,0,1,0,1,0
21280,41908,1433,0,0,60,60,0,1,0,1,0
21281,53567,64147,0,0,66,66,0,1,0,1,0
21282,7423,22114,0,0,62,62,0,1,0,1,0
21283,80,36466,0,0,1514,1514,0,1,0,1,0
21284,50442,25174,0,0,66,66,0,1,0,1,0
21285,24040,22114,0,0,62,62,0,1,0,1,0
21286,7482,57470,0,0,66,66,0,1,0,1,0
21287,50692,445,0,0,70,70,0,1,0,1,0
21288,50690,445,0,0,70,70,0,1,0,1,0
21289,50687,445,0,0,70,70,0,1,0,1,0
21290,25469,81,0,0,60,60,0,1,0,1,0
21291,46774,51050,0,0,62,62,0,1,0,1,0
21292,62267,445,0,0,70,70,0,1,0,1,0
21293,62459,445,0,0,66,66,0,1,0,1,0
21294,34166,22114,0,0,62,62,0,1,0,1,0
21295,61961,11392,0,0,66,66,0,1,0,1,0
21296,13684,25174,0,0,62,62,0,1,0,1,0
21297,27348,22114,0,0,66,66,0,1,0,1,0
21298,56052,53,55355,53,1392,85,1307,4,12,2,2
21299,49797,25174,0,0,66,66,0,1,0,1,0
21300,26435,39004,0,0,62,62,0,1,0,1,0
21301,14692,25174,0,0,62,62,0,1,0,1,0
21302,22240,22114,0,0,62,62,0,1,0,1,0
21303,62911,36237,0,0,66,66,0,1,0,1,0
21304,30304,64147,0,0,66,66,0,1,0,1,0
21305,35011,37965,0,0,62,62,0,1,0,1,0
21306,50683,445,0,0,70,70,0,1,0,1,0
21307,50682,445,0,0,70,70,0,1,0,1,0
21308,7067,22114,0,0,62,62,0,1,0,1,0
21309,44546,32468,0,0,62,62,0,1,0,1,0
21310,63708,25174,0,0,66,66,0,1,0,1,0
21311,26752,64147,0,0,62,62,0,1,0,1,0
21312,55161,37807,0,0,66,66,0,1,0,1,0
21313,62254,445,0,0,70,70,0,1,0,1,0
21314,5,47993,0,0,62,62,0,1,0,1,0
21315,62446,445,0,0,66,66,0,1,0,1,0
21316,62442,445,0,0,66,66,0,1,0,1,0
21317,63460,55160,0,0,62,62,0,1,0,1,0
21318,62251,445,0,0,70,70,0,1,0,1,0
21319,21108,25174,0,0,62,62,0,1,0,1,0
21320,50673,445,0,0,70,70,0,1,0,1,0
21321,50674,445,0,0,70,70,0,1,0,1,0
21322,50672,445,0,0,70,70,0,1,0,1,0
21323,50663,445,0,0,70,70,0,1,0,1,0
21324,56131,37807,0,0,62,62,0,1,0,1,0
21325,55130,25174,0,0,66,66,0,1,0,1,0
21326,30861,46783,0,0,62,62,0,1,0,1,0
21327,62440,445,0,0,66,66,0,1,0,1,0
21328,49540,50584,0,0,66,66,0,1,0,1,0
21329,54166,25174,0,0,66,66,0,1,0,1,0
21330,59745,25174,0,0,146,146,0,1,0,1,0
21331,62247,445,0,0,70,70,0,1,0,1,0
21332,52471,22114,0,0,62,62,0,1,0,1,0
21333,62245,445,0,0,70,70,0,1,0,1,0
21334,62433,445,0,0,66,66,0,1,0,1,0
21335,62423,445,0,0,66,66,0,1,0,1,0
21336,62434,445,0,0,66,66,0,1,0,1,0
21337,62431,445,0,0,66,66,0,1,0,1,0
21338,62425,445,0,0,66,66,0,1,0,1,0
21339,62424,445,0,0,66,66,0,1,0,1,0
21340,44285,25174,0,0,62,62,0,1,0,1,0
21341,62243,445,0,0,70,70,0,1,0,1,0
21342,50659,445,0,0,70,70,0,1,0,1,0
21343,50655,445,0,0,70,70,0,1,0,1,0
21344,50652,445,0,0,70,70,0,1,0,1,0
21345,50651,445,0,0,70,70,0,1,0,1,0
21346,59949,44847,0,0,66,66,0,1,0,1,0
21347,63840,36829,0,0,62,62,0,1,0,1,0
21348,19330,25174,0,0,62,62,0,1,0,1,0
21349,52024,25174,0,0,66,66,0,1,0,1,0
21350,51155,56205,0,0,62,62,0,1,0,1,0
21351,7877,22114,0,0,66,66,0,1,0,1,0
21352,63347,25174,0,0,66,66,0,1,0,1,0
21353,8903,23,0,0,60,60,0,1,0,1,0
21354,18061,25174,0,0,62,62,0,1,0,1,0
21355,6881,37965,0,0,146,146,0,1,0,1,0
21356,51834,35440,0,0,66,66,0,1,0,1,0
21357,6666,138,0,0,60,60,0,1,0,1,0
21358,45144,25174,0,0,62,62,0,1,0,1,0
21359,17676,23,0,0,60,60,0,1,0,1,0
21360,62236,445,0,0,70,70,0,1,0,1,0
21361,51609,37807,0,0,66,66,0,1,0,1,0
21362,3800,5223,0,0,146,146,0,1,0,1,0
21363,62234,445,0,0,70,70,0,1,0,1,0
21364,50648,445,0,0,70,70,0,1,0,1,0
21365,50647,445,0,0,70,70,0,1,0,1,0
21366,50645,445,0,0,70,70,0,1,0,1,0
21367,21542,57470,0,0,74,74,0,1,0,1,0
21368,62418,445,0,0,66,66,0,1,0,1,0
21369,50642,445,0,0,70,70,0,1,0,1,0
21370,62413,445,0,0,66,66,0,1,0,1,0
21371,62233,445,0,0,70,70,0,1,0,1,0
21372,6666,990,0,0,60,60,0,1,0,1,0
21373,62232,445,0,0,70,70,0,1,0,1,0
21374,62411,445,0,0,66,66,0,1,0,1,0
21375,62410,445,0,0,66,66,0,1,0,1,0
21376,62231,445,0,0,70,70,0,1,0,1,0
21377,61400,64147,0,0,66,66,0,1,0,1,0
21378,6036,51505,0,0,66,66,0,1,0,1,0
21379,62225,445,0,0,70,70,0,1,0,1,0
21380,62229,445,0,0,70,70,0,1,0,1,0
21381,62885,62413,0,0,66,66,0,1,0,1,0
21382,63474,48817,0,0,66,66,0,1,0,1,0
21383,62409,445,0,0,66,66,0,1,0,1,0
21384,59988,64147,0,0,66,66,0,1,0,1,0
21385,32704,25174,0,0,62,62,0,1,0,1,0
21386,45964,3111,0,0,60,60,0,1,0,1,0
21387,62408,50584,0,0,62,62,0,1,0,1,0
21388,62637,42873,0,0,66,66,0,1,0,1,0
21389,51396,56205,0,0,66,66,0,1,0,1,0
21390,61738,2767,0,0,66,66,0,1,0,1,0
21391,7811,44847,0,0,62,62,0,1,0,1,0
21392,8229,22114,0,0,66,66,0,1,0,1,0
21393,23021,25174,0,0,66,66,0,1,0,1,0
21394,62213,445,0,0,70,70,0,1,0,1,0
21395,62212,445,0,0,70,70,0,1,0,1,0
21396,50637,445,0,0,70,70,0,1,0,1,0
21397,62210,445,0,0,70,70,0,1,0,1,0
21398,51999,37965,0,0,62,62,0,1,0,1,0
21399,39195,25174,0,0,62,62,0,1,0,1,0
21400,62202,445,0,0,70,70,0,1,0,1,0
21401,62203,445,0,0,70,70,0,1,0,1,0
21402,54828,53,54828,53,404,259,145,3,33,2,1
21403,37460,443,43570,443,5674,3900,1774,29,80,15,14
21404,55040,443,30969,443,15722,5108,10614,39,16,22,17
21405,49337,443,20876,443,3185,2263,922,18,26,9,9
21406,39966,53,39966,53,235,90,145,2,32,1,1
21407,61817,80,50485,80,3373,591,2782,11,45,6,5
21408,55692,18319,26451,18319,320,140,180,6,7,3,3
21409,57125,53,40271,53,745,93,652,2,30,1,1
21410,27005,27017,4986,27017,881,126,755,2,30,1,1
21411,27005,27015,43445,27015,882,126,756,2,30,1,1
21412,27721,53,27721,53,404,259,145,3,32,2,1
21413,58849,443,61655,443,36920,24591,12329,80,24,47,33
21414,58993,443,47340,443,6414,1614,4800,24,17,13,11
21415,52190,80,11921,80,3223,843,2380,12,30,7,5
21416,49511,443,49511,443,150713,27113,123600,199,82,104,95
21417,53246,443,31450,443,6066,1046,5020,20,69,11,9
21418,53247,443,42679,443,7461,1789,5672,25,69,14,11
21419,54828,443,24747,443,6296,1556,4740,22,16,12,10
21420,46423,443,25968,443,1340,760,580,14,39,8,6
21421,45627,443,27902,443,6410,1610,4800,24,17,13,11
21422,52034,48856,38527,48856,66,66,0,1,5,1,0
21423,61818,80,36349,80,4454,591,3863,12,45,6,6
21424,49377,443,6065,443,6350,1550,4800,23,19,12,11
21425,32782,80,6482,80,1495,779,716,10,30,6,4
21426,54306,443,48186,443,6376,1576,4800,24,19,13,11
21427,53241,443,12408,443,6058,1038,5020,20,69,11,9
21428,56708,443,9469,443,6155,919,5236,18,55,10,8
21429,53240,443,55808,443,14932,1671,13261,31,69,15,16
21430,46424,443,29456,443,1340,760,580,14,39,8,6
21431,58899,443,33038,443,3690,2585,1105,17,16,9,8
21432,27345,53,27345,53,398,255,143,3,33,2,1
21433,41858,443,41858,443,4350,1443,2907,19,26,11,8
21434,53155,28206,56023,28206,70,70,0,1,5,1,0
21435,46780,443,9186,443,9801,3049,6752,29,20,15,14
21436,61816,80,7127,80,2058,589,1469,10,45,6,4
21437,61815,80,10742,80,4268,653,3615,13,45,7,6
21438,49320,443,28886,443,2371,1839,532,14,45,8,6
21439,49846,443,49846,443,4693,1786,2907,19,27,11,8
21440,56938,53,41054,53,198,101,97,2,30,1,1
21441,51539,443,4046,443,6359,1559,4800,24,19,13,11
21442,49636,443,58848,443,9790,1841,7949,24,136,12,12
21443,64798,53,2925,53,172,88,84,2,30,1,1
21444,51594,53,0,0,206,95,111,2,31,1,1
21445,54306,443,20116,443,13053,5216,7837,25,135,11,14
21446,60985,443,19268,443,20423,4091,16332,33,122,15,18
21447,37736,443,59185,443,16925,11562,5363,36,363,19,17
21448,44361,443,44674,443,424,210,214,7,132,4,3
21449,50792,443,51398,443,144115,19017,125098,229,400,112,117
21450,6881,6889,31599,6889,221,111,110,2,1200,1,1
21451,21133,8535,17822,8535,490,149,341,2,1200,1,1
21452,50633,445,0,0,70,70,0,1,0,1,0
21453,50625,445,0,0,70,70,0,1,0,1,0
21454,50251,35440,0,0,66,66,0,1,0,1,0
21455,27677,22114,0,0,62,62,0,1,0,1,0
21456,7210,22114,0,0,66,66,0,1,0,1,0
21457,62397,445,0,0,66,66,0,1,0,1,0
21458,58303,22114,0,0,62,62,0,1,0,1,0
21459,60786,25174,0,0,66,66,0,1,0,1,0
21460,60806,51050,0,0,62,62,0,1,0,1,0
21461,56067,25174,0,0,146,146,0,1,0,1,0
21462,34932,38608,0,0,62,62,0,1,0,1,0
21463,25600,23684,0,0,159,159,0,1,0,1,0
21464,59147,25174,0,0,62,62,0,1,0,1,0
21465,54438,62413,0,0,66,66,0,1,0,1,0
21466,46492,50584,0,0,62,62,0,1,0,1,0
21467,62191,445,0,0,70,70,0,1,0,1,0
21468,62390,445,0,0,66,66,0,1,0,1,0
21469,50615,445,0,0,70,70,0,1,0,1,0
21470,59324,17,0,0,60,60,0,1,0,1,0
21471,1537,22114,0,0,146,146,0,1,0,1,0
21472,62388,445,0,0,66,66,0,1,0,1,0
21473,47727,25174,0,0,62,62,0,1,0,1,0
21474,62187,445,0,0,70,70,0,1,0,1,0
21475,46162,25174,0,0,146,146,0,1,0,1,0
21476,54021,25174,0,0,146,146,0,1,0,1,0
21477,62381,445,0,0,66,66,0,1,0,1,0
21478,41541,25174,0,0,66,66,0,1,0,1,0
21479,22530,25174,0,0,62,62,0,1,0,1,0
21480,19944,22114,0,0,66,66,0,1,0,1,0
21481,62373,445,0,0,66,66,0,1,0,1,0
21482,62175,445,0,0,70,70,0,1,0,1,0
21483,62177,445,0,0,70,70,0,1,0,1,0
21484,62178,445,0,0,70,70,0,1,0,1,0
21485,6461,25174,0,0,66,66,0,1,0,1,0
21486,62173,445,0,0,70,70,0,1,0,1,0
21487,34674,41864,0,0,145,145,0,1,0,1,0
21488,56720,443,60130,443,4989,1014,3975,16,53,9,7
21489,58901,443,21819,443,5168,700,4468,16,15,7,9
21490,63969,57635,11400,57635,504,382,122,8,17,6,2
21491,27005,27015,53679,27015,894,126,768,2,30,1,1
21492,64137,53,46613,53,276,126,150,2,30,1,1
21493,54492,80,36549,80,1384,937,447,9,360,5,4
21494,53245,443,58724,443,4595,1038,3557,19,69,11,8
21495,51535,443,24359,443,322,262,60,2,4,1,1
21496,53825,58968,36842,58968,70,70,0,1,4,1,0
21497,55159,53,49513,53,199,102,97,2,29,1,1
21498,40204,40010,8959,40010,148,86,62,2,29,1,1
21499,56927,53,35589,53,183,94,89,2,30,1,1
21500,56936,53,1448,53,244,94,150,2,30,1,1
21501,53248,443,8243,443,5995,974,5021,19,66,10,9
21502,53256,443,33969,443,6181,1040,5141,22,65,11,11
21503,53239,443,57625,443,84664,6099,78565,140,70,56,84
21504,53254,443,6395,443,310549,9420,301129,339,65,122,217
21505,53251,443,19794,443,5025,973,4052,19,66,10,9
21506,53257,443,20854,443,7422,1563,5859,32,53,15,17
21507,47950,443,47950,443,9159,1627,7532,19,150,11,8
21508,53255,443,13217,443,6244,1104,5140,23,65,12,11
21509,63062,443,18661,443,26697,7168,19529,74,213,39,35
21510,45386,5222,47309,5222,4579,2357,2222,46,114,26,20
21511,36405,443,39201,443,1149,709,440,13,38,8,5
21512,41832,5222,27749,5222,3823,1878,1945,39,309,22,17
21513,34429,443,39079,443,1701,1048,653,15,38,8,7
21514,48936,443,24863,443,494,280,214,8,49,5,3
21515,45721,443,58682,443,1925,1120,805,16,25,9,7
21516,51671,443,38152,443,1143,703,440,13,38,8,5
21517,42804,80,7713,80,1115,534,581,12,15,7,5
21518,40102,443,45271,443,29714,2090,27624,43,97,17,26
21519,56664,80,50394,80,234,234,0,4,11,4,0
21520,33827,443,18177,443,696,152,544,11,48,3,8
21521,53827,5889,39241,5889,70,70,0,1,4,1,0
21522,60627,443,41376,443,5663,1711,3952,22,17,13,9
21523,56433,53,33860,53,210,110,100,2,29,1,1
21524,64034,53,38664,53,194,102,92,2,29,1,1
21525,65487,53,2041,53,210,110,100,2,29,1,1
21526,64238,53,7198,53,211,102,109,2,29,1,1
21527,55159,53,25315,53,199,102,97,2,29,1,1
21528,56327,53,21642,53,178,94,84,2,29,1,1
21529,56240,53,1263,53,226,94,132,2,29,1,1
21530,55387,53,44046,53,172,94,78,2,29,1,1
21531,65487,53,41710,53,210,110,100,2,29,1,1
21532,56534,53,33541,53,276,94,182,2,30,1,1
21533,56938,53,31467,53,452,101,351,4,36,2,2
21534,54772,443,51519,443,3388,894,2494,19,154,8,11
21535,49834,443,52390,443,8332,3418,4914,31,95,17,14
21536,27005,27016,5470,27016,879,126,753,2,30,1,1
21537,50647,443,3164,443,3201,1812,1389,15,19,9,6
21538,12573,53,12573,53,235,90,145,2,32,1,1
21539,37998,49152,32246,49152,156,156,0,3,8,3,0
21540,37567,443,51638,443,13774,4989,8785,35,51,20,15
21541,39133,5223,14877,5223,4113,1213,2900,22,713,12,10
21542,59911,80,3482,80,2025658,45348,1980310,1992,44,640,1352
21543,48844,443,50866,443,36383,29447,6936,103,163,51,52
21544,53812,45694,7999,45694,3156,1011,2145,16,16,8,8
21545,57442,66,49848,66,70,70,0,2,8,2,0
21546,49620,443,22598,443,4565,3479,1086,13,138,8,5
21547,50642,80,53491,80,27013,3578,23435,36,21,15,21
21548,27005,27015,27381,27015,887,126,761,2,30,1,1
21549,50351,80,28696,80,1083,653,430,8,15,5,3
21550,64331,53,13624,53,226,110,116,2,30,1,1
21551,64874,53,59017,53,323,110,213,2,30,1,1
21552,49541,53,16544,53,745,215,530,6,51,3,3
21553,37575,443,11902,443,11095,3227,7868,30,47,17,13
21554,49969,53,31598,53,199,102,97,2,30,1,1
21555,36843,443,62939,443,1988,1348,640,16,30,9,7
21556,59928,80,12349,80,5755,3943,1812,24,31,13,11
21557,64404,53,27516,53,250,102,148,2,30,1,1
21558,55543,53,20770,53,402,118,284,2,30,1,1
21559,56327,53,13541,53,178,94,84,2,30,1,1
21560,27005,27018,44540,27018,882,126,756,2,30,1,1
21561,59595,53,23581,53,164,78,86,2,30,1,1
21562,54461,443,55522,443,7548,2583,4965,26,362,12,14
21563,62336,443,4923,443,8217,2075,6142,31,76,15,16
21564,65344,53,52002,53,190,90,100,3,60,2,1
21565,55875,53,25979,53,296,110,186,2,30,1,1
21566,27005,27015,38295,27015,874,126,748,2,30,1,1
21567,60399,443,57774,443,8061,1926,6135,24,361,11,13
21568,59948,80,1436,80,1756,414,1342,12,15,6,6
21569,56725,443,7873,443,6481,972,5509,17,52,10,7
21570,55374,25,55374,25,130,66,64,2,5,1,1
21571,50653,80,52730,80,1658,1247,411,8,15,5,3
21572,34953,443,6409,443,9415,3482,5933,57,16,29,28
21573,53460,443,30062,443,30688,2660,28028,51,31,23,28
21574,65487,53,56832,53,210,110,100,2,30,1,1
21575,64798,53,7114,53,178,94,84,2,30,1,1
21576,64078,443,31734,443,4458,1569,2889,24,138,10,14
21577,53136,443,65509,443,3028365,2245986,782379,11999,627,7647,4352
21578,53260,443,48140,443,4885,983,3902,21,53,10,11
21579,51670,443,38480,443,1203,703,500,14,38,8,6
21580,33147,443,60062,443,7639,948,6691,25,395,9,16
21581,36406,443,50079,443,1149,709,440,13,38,8,5
21582,54354,443,10906,443,18848,10436,8412,42,33,20,22
21583,60575,443,23365,443,5994,1594,4400,23,42,12,11
21584,36407,443,52772,443,1149,709,440,13,38,8,5
21585,53244,443,63773,443,57649,2489,55160,66,69,23,43
21586,5588,5588,0,0,3354,1792,1562,46,194,23,23
21587,34430,443,8333,443,1701,1048,653,15,38,8,7
21588,10013,443,27326,443,10336,4760,5576,37,315,18,19
21589,43726,443,52371,443,1201,707,494,12,35,7,5
21590,53828,51354,58095,51354,70,70,0,1,4,1,0
21591,54017,443,16478,443,33220,3819,29401,77,255,39,38
21592,53824,41482,6861,41482,70,70,0,1,4,1,0
21593,49624,443,29597,443,2899,1813,1086,12,136,7,5
21594,63140,30685,24929,30685,70,70,0,1,5,1,0
21595,53158,17234,26675,17234,70,70,0,2,8,2,0
21596,63999,53,50492,53,193,102,91,2,29,1,1
21597,50990,53,51984,53,232,94,138,2,29,1,1
21598,56938,53,8399,53,199,102,97,2,29,1,1
21599,62339,443,17791,443,9125,2616,6509,30,76,14,16
21600,50717,80,28545,80,1649,963,686,7,15,5,2
21601,59926,80,37542,80,2615,830,1785,10,32,6,4
21602,53458,443,17930,443,144165,6110,138055,170,31,67,103
21603,50949,80,11302,80,942,527,415,11,342,6,5
21604,49498,443,65049,443,5394,2785,2609,14,134,7,7
21605,39639,80,40156,80,1143,401,742,9,360,5,4
21606,60329,443,10695,443,2859,1499,1360,20,315,10,10
21607,51472,80,52276,80,1410,797,613,10,302,6,4
21608,55532,80,33980,80,12971,971,12000,22,15,12,10
21609,62322,80,60035,80,384,384,0,7,34,7,0
21610,56256,80,30485,80,25043,1750,23293,44,30,23,21
21611,64290,53,4027,53,302,98,204,4,47,2,2
21612,56927,53,57127,53,183,94,89,2,30,1,1
21613,64798,53,14494,53,178,94,84,2,30,1,1
21614,56732,443,47503,443,6205,986,5219,16,48,10,6
21615,64584,443,62186,443,24682,1935,22747,36,19,17,19
21616,64034,53,27312,53,194,102,92,2,30,1,1
21617,49969,53,27742,53,199,102,97,2,30,1,1
21618,33148,443,29475,443,7639,948,6691,25,395,9,16
21619,6881,6881,37501,6881,259,150,109,2,1200,1,1
21620,61542,443,4330,443,6049,1986,4063,23,19,12,11
21621,37997,49152,15013,49152,156,156,0,3,8,3,0
21622,49700,443,48800,443,64,64,0,2,5,2,0
21623,59931,80,27664,80,1272,786,486,8,31,5,3
21624,53811,8999,57709,8999,1322,799,523,13,16,8,5
21625,60868,80,60868,80,5973,779,5194,17,16,9,8
21626,50950,80,33535,80,942,527,415,11,342,6,5
21627,64290,53,4374,53,196,102,94,2,30,1,1
21628,65065,53,58024,53,209,110,99,2,30,1,1
21629,63241,443,59120,443,5248,2550,2698,21,178,10,11
21630,36821,443,62805,443,6164,3172,2992,28,141,12,16
21631,36674,443,40100,443,11882,3450,8432,39,120,19,20
21632,57470,6969,5895,6969,132,132,0,3,1199,3,0
21633,46031,443,52828,443,12395,2182,10213,21,122,10,11
21634,61546,443,4493,443,208,60,148,4,13,2,2
21635,53225,443,9099,443,6597,1798,4799,28,80,12,16
21636,50348,80,25254,80,4929,2773,2156,17,42,9,8
21637,53841,8999,55229,8999,70,70,0,2,8,2,0
21638,52867,443,11328,443,15730,2196,13534,32,436,17,15
21639,62311,443,64602,443,598,598,0,8,41,8,0
21640,52056,50328,8366,50328,70,70,0,1,5,1,0
21641,50344,80,51584,80,3132,730,2402,13,42,7,6
21642,50216,443,23002,443,6796,1796,5000,26,257,14,12
21643,49690,53,46468,53,198,94,104,2,30,1,1
21644,1030,64147,0,0,62,62,0,1,0,1,0
21645,62170,445,0,0,70,70,0,1,0,1,0
21646,60104,30188,0,0,66,66,0,1,0,1,0
21647,51560,46783,0,0,66,66,0,1,0,1,0
21648,26658,25174,0,0,62,62,0,1,0,1,0
21649,42231,57470,0,0,78,78,0,1,0,1,0
21650,59696,57470,0,0,62,62,0,1,0,1,0
21651,50606,445,0,0,70,70,0,1,0,1,0
21652,50605,445,0,0,70,70,0,1,0,1,0
21653,50603,445,0,0,70,70,0,1,0,1,0
21654,47256,37807,0,0,62,62,0,1,0,1,0
21655,62365,445,0,0,66,66,0,1,0,1,0
21656,62363,445,0,0,66,66,0,1,0,1,0
21657,62361,445,0,0,66,66,0,1,0,1,0
21658,62362,445,0,0,66,66,0,1,0,1,0
21659,62360,445,0,0,66,66,0,1,0,1,0
21660,62364,445,0,0,66,66,0,1,0,1,0
21661,62359,445,0,0,66,66,0,1,0,1,0
21662,62358,445,0,0,66,66,0,1,0,1,0
21663,62164,445,0,0,70,70,0,1,0,1,0
21664,41490,25174,0,0,62,62,0,1,0,1,0
21665,51705,22114,0,0,62,62,0,1,0,1,0
21666,60403,22114,0,0,66,66,0,1,0,1,0
21667,36641,25174,0,0,66,66,0,1,0,1,0
21668,64214,25174,0,0,66,66,0,1,0,1,0
21669,23763,23,0,0,60,60,0,1,0,1,0
21670,62157,445,0,0,70,70,0,1,0,1,0
21671,53197,25174,0,0,66,66,0,1,0,1,0
21672,62156,445,0,0,70,70,0,1,0,1,0
21673,54769,50584,0,0,62,62,0,1,0,1,0
21674,52925,64147,0,0,62,62,0,1,0,1,0
21675,52340,64147,0,0,66,66,0,1,0,1,0
21676,50596,445,0,0,70,70,0,1,0,1,0
21677,50597,445,0,0,70,70,0,1,0,1,0
21678,50589,445,0,0,70,70,0,1,0,1,0
21679,50584,445,0,0,70,70,0,1,0,1,0
21680,53470,22114,0,0,66,66,0,1,0,1,0
21681,16454,25174,0,0,66,66,0,1,0,1,0
21682,62345,445,0,0,66,66,0,1,0,1,0
21683,62344,445,0,0,66,66,0,1,0,1,0
21684,62342,445,0,0,66,66,0,1,0,1,0
21685,22924,25174,0,0,62,62,0,1,0,1,0
21686,62150,445,0,0,70,70,0,1,0,1,0
21687,50822,50584,0,0,66,66,0,1,0,1,0
21688,62149,445,0,0,70,70,0,1,0,1,0
21689,62813,25174,0,0,62,62,0,1,0,1,0
21690,50046,22114,0,0,66,66,0,1,0,1,0
21691,58914,37965,0,0,66,66,0,1,0,1,0
21692,50582,445,0,0,70,70,0,1,0,1,0
21693,63878,22114,0,0,62,62,0,1,0,1,0
21694,26717,25174,0,0,62,62,0,1,0,1,0
21695,50574,445,0,0,70,70,0,1,0,1,0
21696,50573,445,0,0,70,70,0,1,0,1,0
21697,50572,445,0,0,70,70,0,1,0,1,0
21698,52459,3399,0,0,60,60,0,1,0,1,0
21699,62145,445,0,0,70,70,0,1,0,1,0
21700,32736,22114,0,0,66,66,0,1,0,1,0
21701,58511,50584,0,0,62,62,0,1,0,1,0
21702,62144,445,0,0,70,70,0,1,0,1,0
21703,2849,30188,0,0,66,66,0,1,0,1,0
21704,32997,50584,0,0,62,62,0,1,0,1,0
21705,27000,23117,0,0,62,62,0,1,0,1,0
21706,25878,25174,0,0,66,66,0,1,0,1,0
21707,20962,22114,0,0,62,62,0,1,0,1,0
21708,54518,25174,0,0,146,146,0,1,0,1,0
21709,62139,445,0,0,70,70,0,1,0,1,0
21710,443,18177,0,0,66,66,0,1,0,1,0
21711,50563,445,0,0,70,70,0,1,0,1,0
21712,50561,445,0,0,70,70,0,1,0,1,0
21713,50559,445,0,0,70,70,0,1,0,1,0
21714,60260,22114,0,0,66,66,0,1,0,1,0
21715,62331,445,0,0,66,66,0,1,0,1,0
21716,6882,51505,0,0,66,66,0,1,0,1,0
21717,55711,26467,0,0,66,66,0,1,0,1,0
21718,51746,25174,0,0,66,66,0,1,0,1,0
21719,58131,29072,0,0,146,146,0,1,0,1,0
21720,43828,44847,0,0,66,66,0,1,0,1,0
21721,50459,62413,0,0,66,66,0,1,0,1,0
21722,50557,445,0,0,70,70,0,1,0,1,0
21723,50556,445,0,0,70,70,0,1,0,1,0
21724,62126,445,0,0,70,70,0,1,0,1,0
21725,28286,22114,0,0,62,62,0,1,0,1,0
21726,14397,37965,0,0,62,62,0,1,0,1,0
21727,13285,29892,0,0,145,145,0,1,0,1,0
21728,41197,30188,0,0,62,62,0,1,0,1,0
21729,443,64347,0,0,131,131,0,1,0,1,0
21730,3399,25174,0,0,66,66,0,1,0,1,0
21731,15605,50265,0,0,62,62,0,1,0,1,0
21732,62316,445,0,0,66,66,0,1,0,1,0
21733,62315,445,0,0,66,66,0,1,0,1,0
21734,62123,445,0,0,70,70,0,1,0,1,0
21735,56127,37965,0,0,66,66,0,1,0,1,0
21736,52038,50584,0,0,66,66,0,1,0,1,0
21737,40312,55442,0,0,62,62,0,1,0,1,0
21738,58627,25174,0,0,62,62,0,1,0,1,0
21739,64190,2767,0,0,66,66,0,1,0,1,0
21740,12700,57470,0,0,145,145,0,1,0,1,0
21741,23131,25174,0,0,62,62,0,1,0,1,0
21742,50547,445,0,0,70,70,0,1,0,1,0
21743,50544,445,0,0,70,70,0,1,0,1,0
21744,50543,445,0,0,70,70,0,1,0,1,0
21745,50535,445,0,0,70,70,0,1,0,1,0
21746,23131,25174,0,0,146,146,0,1,0,1,0
21747,57284,22114,0,0,66,66,0,1,0,1,0
21748,21119,31573,0,0,146,146,0,1,0,1,0
21749,60823,25174,0,0,66,66,0,1,0,1,0
21750,1943,48817,0,0,66,66,0,1,0,1,0
21751,62309,445,0,0,66,66,0,1,0,1,0
21752,62117,445,0,0,70,70,0,1,0,1,0
21753,35450,23,0,0,60,60,0,1,0,1,0
21754,62064,22114,0,0,66,66,0,1,0,1,0
21755,64392,25174,0,0,66,66,0,1,0,1,0
21756,29139,64147,0,0,62,62,0,1,0,1,0
21757,62115,445,0,0,70,70,0,1,0,1,0
21758,61523,37807,0,0,66,66,0,1,0,1,0
21759,62306,445,0,0,66,66,0,1,0,1,0
21760,62304,445,0,0,66,66,0,1,0,1,0
21761,62303,445,0,0,66,66,0,1,0,1,0
21762,62298,445,0,0,66,66,0,1,0,1,0
21763,62295,445,0,0,66,66,0,1,0,1,0
21764,62297,445,0,0,66,66,0,1,0,1,0
21765,62296,445,0,0,66,66,0,1,0,1,0
21766,28306,25604,0,0,62,62,0,1,0,1,0
21767,60097,22114,0,0,66,66,0,1,0,1,0
21768,45313,64147,0,0,62,62,0,1,0,1,0
21769,42986,25174,0,0,66,66,0,1,0,1,0
21770,50530,445,0,0,70,70,0,1,0,1,0
21771,50527,445,0,0,70,70,0,1,0,1,0
21772,50525,445,0,0,70,70,0,1,0,1,0
21773,50523,445,0,0,70,70,0,1,0,1,0
21774,45118,39004,0,0,74,74,0,1,0,1,0
21775,36663,22114,0,0,62,62,0,1,0,1,0
21776,48706,23393,0,0,60,60,0,1,0,1,0
21777,57090,51505,0,0,62,62,0,1,0,1,0
21778,59051,27520,0,0,62,62,0,1,0,1,0
21779,19875,30170,0,0,145,145,0,1,0,1,0
21780,62273,50584,0,0,62,62,0,1,0,1,0
21781,50757,64147,0,0,62,62,0,1,0,1,0
21782,34073,37965,0,0,62,62,0,1,0,1,0
21783,36804,25174,0,0,66,66,0,1,0,1,0
21784,62108,445,0,0,70,70,0,1,0,1,0
21785,56289,25174,0,0,66,66,0,1,0,1,0
21786,62106,445,0,0,70,70,0,1,0,1,0
21787,17573,44847,0,0,146,146,0,1,0,1,0
21788,59938,443,27868,443,1820,1303,517,13,26,7,6
21789,47664,3389,47664,3389,4575,2400,2175,20,19,11,9
21790,45551,443,26442,443,7764,1734,6030,23,20,13,10
21791,55039,443,45987,443,7993,677,7316,16,16,8,8
21792,62919,993,20862,993,134,60,74,3,11,2,1
21793,49306,443,46343,443,83411,4586,78825,94,47,30,64
21794,56425,53,0,0,82,82,0,1,30,1,0
21795,58992,53,0,0,273,86,187,2,30,1,1
21796,58129,80,58129,80,23462,3780,19682,49,47,24,25
21797,49308,443,39770,443,4256,2975,1281,23,47,12,11
21798,49309,443,31644,443,4250,2969,1281,23,47,12,11
21799,54815,3389,54815,3389,3428,1714,1714,16,32,8,8
21800,59945,80,11723,80,1197,419,778,9,16,5,4
21801,49633,443,51430,443,4348,911,3437,14,135,8,6
21802,27005,27019,44528,27019,880,126,754,2,30,1,1
21803,65379,53,64746,53,376,126,250,2,30,1,1
21804,55437,443,56917,443,24415,1491,22924,34,131,14,20
21805,55085,443,57915,443,5803,4960,843,19,124,11,8
21806,44739,443,37697,443,6220,1790,4430,19,120,10,9
21807,57470,41071,64833,41071,1716,1716,0,27,1598,27,0
21808,58643,443,8549,443,4801,2506,2295,12,121,6,6
21809,36889,80,51153,80,1584,1130,454,15,39,10,5
21810,58891,443,55777,443,7641,5165,2476,25,18,13,12
21811,13095,80,13095,80,32613,1160,31453,38,16,13,25
21812,52045,16853,65490,16853,70,70,0,2,8,2,0
21813,44358,443,57886,443,502,288,214,8,131,5,3
21814,53816,42459,30480,42459,552,306,246,9,16,5,4
21815,64728,443,31234,443,25423484,377367,25046117,21027,1082,2865,18162
21816,46862,15000,28105,15000,130,70,60,2,5,1,1
21817,58970,443,57205,443,3715,1958,1757,23,21,12,11
21818,50583,80,50583,80,17375,11554,5821,52,27,32,20
21819,51594,53,0,0,206,95,111,2,30,1,1
21820,50340,80,53882,80,8924,872,8052,19,41,9,10
21821,61281,443,15563,443,3169,979,2190,14,135,7,7
21822,50341,80,19405,80,306,180,126,6,41,4,2
21823,43177,443,43177,443,4493,1586,2907,19,26,11,8
21824,52031,20301,50759,20301,66,66,0,1,5,1,0
21825,49647,53,49647,53,404,259,145,3,32,2,1
21826,57602,443,32129,443,7527,1788,5739,23,20,13,10
21827,35466,443,44428,443,7409,1702,5707,23,20,13,10
21828,58889,443,6054,443,7871,5455,2416,24,18,13,11
21829,27005,27016,63308,27016,887,126,761,2,30,1,1
21830,50116,22,0,0,60,60,0,1,90,1,0
21831,40410,443,37656,443,2975,719,2256,14,136,7,7
21832,30960,45754,34064,45754,396,396,0,7,3615,7,0
21833,50521,445,0,0,70,70,0,1,0,1,0
21834,50517,445,0,0,70,70,0,1,0,1,0
21835,50516,445,0,0,70,70,0,1,0,1,0
21836,6889,65473,0,0,143,143,0,1,0,1,0
21837,62105,445,0,0,70,70,0,1,0,1,0
21838,62288,445,0,0,66,66,0,1,0,1,0
21839,55554,22114,0,0,62,62,0,1,0,1,0
21840,50514,445,0,0,70,70,0,1,0,1,0
21841,62104,445,0,0,70,70,0,1,0,1,0
21842,62103,445,0,0,70,70,0,1,0,1,0
21843,62101,445,0,0,70,70,0,1,0,1,0
21844,62099,445,0,0,70,70,0,1,0,1,0
21845,62286,445,0,0,66,66,0,1,0,1,0
21846,62283,445,0,0,66,66,0,1,0,1,0
21847,62282,445,0,0,66,66,0,1,0,1,0
21848,62281,445,0,0,66,66,0,1,0,1,0
21849,47944,50584,0,0,62,62,0,1,0,1,0
21850,61299,25174,0,0,146,146,0,1,0,1,0
21851,57338,443,31270,443,222159,52803,169356,361,26,173,188
21852,61550,5529,0,0,145,145,0,1,0,1,0
21853,49164,25174,0,0,62,62,0,1,0,1,0
21854,42285,57470,0,0,62,62,0,1,0,1,0
21855,62085,445,0,0,70,70,0,1,0,1,0
21856,62084,445,0,0,70,70,0,1,0,1,0
21857,62082,445,0,0,70,70,0,1,0,1,0
21858,26425,22114,0,0,62,62,0,1,0,1,0
21859,62075,445,0,0,70,70,0,1,0,1,0
21860,62074,445,0,0,70,70,0,1,0,1,0
21861,44383,30188,0,0,66,66,0,1,0,1,0
21862,49577,57470,0,0,66,66,0,1,0,1,0
21863,50511,445,0,0,70,70,0,1,0,1,0
21864,61140,27520,0,0,62,62,0,1,0,1,0
21865,24144,57470,0,0,62,62,0,1,0,1,0
21866,50500,445,0,0,70,70,0,1,0,1,0
21867,50497,445,0,0,70,70,0,1,0,1,0
21868,52230,50265,0,0,66,66,0,1,0,1,0
21869,62269,445,0,0,66,66,0,1,0,1,0
21870,27005,27015,25452,27015,887,126,761,2,30,1,1
21871,34937,443,49817,443,10059,2039,8020,23,186,12,11
21872,50265,43178,20188,43178,481,150,331,2,1200,1,1
21873,63974,80,35530,80,314,192,122,6,15,4,2
21874,50587,80,50587,80,1711,1011,700,11,21,6,5
21875,62158,443,35160,443,4975,2828,2147,14,135,7,7
21876,52052,27427,24815,27427,316,136,180,6,6,3,3
21877,8917,443,55362,443,7308,864,6444,26,394,9,17
21878,60461,10138,64431,10138,70,70,0,1,5,1,0
21879,53365,80,32049,80,405,285,120,5,15,3,2
21880,50346,80,22819,80,502,250,252,9,41,5,4
21881,52047,42805,9664,42805,164,70,94,3,7,2,1
21882,64798,53,32594,53,303,88,215,4,40,2,2
21883,56927,53,28530,53,183,94,89,2,29,1,1
21884,49578,53,60840,53,212,102,110,2,29,1,1
21885,57103,53,61295,53,193,102,91,2,29,1,1
21886,27005,27018,14110,27018,881,126,755,2,30,1,1
21887,49508,53,61449,53,370,102,268,2,30,1,1
21888,58856,80,5930,80,1614,1300,314,10,15,5,5
21889,60026,443,10175,443,8382,2454,5928,44,86,26,18
21890,60967,443,57765,443,11529,8753,2776,41,120,22,19
21891,57089,53,62761,53,226,110,116,2,30,1,1
21892,46831,53,55820,53,391,102,289,2,30,1,1
21893,27005,27017,41161,27017,883,126,757,2,30,1,1
21894,38698,443,50432,443,90261,3545,86716,96,16,32,64
21895,60466,64337,52523,64337,70,70,0,2,8,2,0
21896,36000,443,6421,443,68705,5084,63621,93,172,36,57
21897,57341,443,25399,443,7551,2807,4744,42,26,22,20
21898,36003,443,8954,443,70007,4677,65330,92,172,36,56
21899,48742,443,35072,443,5378,1423,3955,19,49,11,8
21900,53222,53,43522,53,165,78,87,2,30,1,1
21901,53223,53,33950,53,165,78,87,2,30,1,1
21902,27005,27015,43819,27015,868,126,742,2,30,1,1
21903,53455,443,54035,443,240325,8131,232194,262,31,100,162
21904,53457,443,28376,443,26693,2059,24634,42,30,18,24
21905,64698,53,59784,53,430,106,324,4,58,2,2
21906,49444,53,22362,53,212,102,110,2,30,1,1
21907,55739,443,5145,443,47102,3841,43261,59,121,25,34
21908,43112,443,57880,443,7192,1772,5420,25,305,13,12
21909,63139,12311,39911,12311,70,70,0,1,5,1,0
21910,52089,443,56891,443,4408,801,3607,16,34,8,8
21911,57339,443,47908,443,1495,768,727,16,26,9,7
21912,57345,443,32367,443,55537,4477,51060,81,22,38,43
21913,52884,443,37471,443,4466,1914,2552,32,116,18,14
21914,27005,27017,10039,27017,891,126,765,2,30,1,1
21915,54324,27016,3441,27016,924,924,0,3,30,3,0
21916,49429,443,33645,443,8861,3484,5377,19,120,9,10
21917,37572,443,26829,443,30365,21942,8423,58,50,32,26
21918,50343,80,37536,80,1192,658,534,11,41,6,5
21919,50339,80,14820,80,306,180,126,6,41,4,2
21920,53140,80,7687,80,2560,2083,477,13,15,7,6
21921,49220,2710,39360,2710,70,70,0,2,8,2,0
21922,58898,443,10940,443,5108,700,4408,15,15,7,8
21923,52046,59791,37077,59791,70,70,0,2,7,2,0
21924,62061,445,0,0,70,70,0,1,0,1,0
21925,36548,25174,0,0,62,62,0,1,0,1,0
21926,63895,44847,0,0,62,62,0,1,0,1,0
21927,38093,11392,0,0,62,62,0,1,0,1,0
21928,60419,61248,0,0,145,145,0,1,0,1,0
21929,55338,11744,0,0,145,145,0,1,0,1,0
21930,51023,443,24793,443,26189,8238,17951,72,18,39,33
21931,50338,80,24125,80,2475,723,1752,12,41,6,6
21932,58718,80,58718,80,106571,3881,102690,128,16,56,72
21933,43169,443,5370,443,8615,2156,6459,37,315,16,21
21934,6259,25,6259,25,130,66,64,2,5,1,1
21935,37710,443,47259,443,13986,9199,4787,59,94,24,35
21936,50759,443,24454,443,19782,3596,16186,38,256,21,17
21937,53456,443,13197,443,25555,2220,23335,44,30,20,24
21938,49219,51237,3510,51237,624,318,306,10,15,5,5
21939,65384,443,21164,443,8613,1465,7148,22,15,13,9
21940,57346,443,34868,443,1547,960,587,14,22,8,6
21941,57599,80,28045,80,808,485,323,8,75,5,3
21942,56512,443,45161,443,155750,151462,4288,169,215,112,57
21943,49470,443,50216,443,2772,1777,995,16,124,9,7
21944,57103,53,56809,53,193,102,91,2,30,1,1
21945,43089,443,26098,443,9737,6695,3042,45,81,24,21
21946,50586,80,50586,80,5320,3428,1892,22,21,12,10
21947,27005,27015,24724,27015,878,126,752,2,30,1,1
21948,50588,80,50588,80,2765,1835,930,14,21,8,6
21949,53537,53,1672,53,391,102,289,2,29,1,1
21950,56903,53,50850,53,232,94,138,2,30,1,1
21951,49515,53,21422,53,226,110,116,2,29,1,1
21952,54325,27016,47516,27016,924,924,0,3,30,3,0
21953,54323,27016,29153,27016,924,924,0,3,30,3,0
21954,54326,27054,42842,27054,924,924,0,3,30,3,0
21955,58614,443,16756,443,12164,4840,7324,29,198,16,13
21956,17750,60780,57502,60780,481,150,331,2,1200,1,1
21957,49626,443,3697,443,35474,2800,32674,56,135,27,29
21958,50589,80,50589,80,1714,1014,700,11,21,6,5
21959,48735,443,54377,443,77050,5353,71697,113,95,46,67
21960,27005,27015,60875,27015,881,126,755,2,30,1,1
21961,55901,53,32764,53,226,110,116,2,30,1,1
21962,63310,443,15095,443,1481,701,780,20,120,10,10
21963,57288,443,16066,443,7427,2084,5343,24,361,12,12
21964,1100,27540,45452,27540,132,70,62,2,31,1,1
21965,53202,443,56977,443,23323,1589,21734,27,85,10,17
21966,40492,1488,40492,1488,156,156,0,3,8,3,0
21967,39771,443,64614,443,6903,1273,5630,25,255,13,12
21968,7634,80,7634,80,1845,523,1322,10,15,6,4
21969,35989,443,62539,443,2840032,64781,2775251,2709,292,769,1940
21970,33894,80,31956,80,1376,788,588,10,35,6,4
21971,37680,443,40317,443,16742,3383,13359,57,309,28,29
21972,57344,53,44764,53,228,110,118,2,30,1,1
21973,27005,27015,45199,27015,892,126,766,2,30,1,1
21974,57398,53,47898,53,232,110,122,2,30,1,1
21975,57344,443,31123,443,30232,22633,7599,77,23,46,31
21976,60457,16881,27690,16881,1948,891,1057,16,18,8,8
21977,53151,34935,46356,34935,698,320,378,10,17,6,4
21978,49598,80,65095,80,400,70,330,6,24,1,5
21979,38699,443,63342,443,759586,14873,744713,719,16,209,510
21980,52094,443,12498,443,2960,1982,978,15,16,9,6
21981,62481,80,55007,80,890,440,450,10,33,6,4
21982,42732,53,10027,53,86,86,0,1,30,1,0
21983,62187,443,25960,443,36473,7710,28763,63,124,27,36
21984,6881,6881,34169,6881,502,150,352,2,1200,1,1
21985,27005,27035,11763,27035,891,126,765,2,31,1,1
21986,52029,52093,64487,52093,70,70,0,1,5,1,0
21987,53819,9472,3134,9472,70,70,0,1,5,1,0
21988,57427,443,63478,443,5337,1085,4252,14,76,8,6
21989,65048,53,24505,53,396,84,312,4,54,2,2
21990,63965,53,50907,53,306,94,212,2,30,1,1
21991,27005,52013,10619,52013,901,126,775,2,31,1,1
21992,65353,53,55498,53,351,105,246,4,57,2,2
21993,63975,24874,47562,24874,70,70,0,1,5,1,0
21994,45764,443,11581,443,57543,2347,55196,68,16,26,42
21995,44864,25,44864,25,130,66,64,2,5,1,1
21996,55012,64147,0,0,62,62,0,1,0,1,0
21997,50734,37965,0,0,62,62,0,1,0,1,0
21998,62769,25174,0,0,62,62,0,1,0,1,0
21999,51414,22,0,0,60,60,0,1,0,1,0
22000,62262,445,0,0,66,66,0,1,0,1,0
22001,50487,445,0,0,70,70,0,1,0,1,0
22002,63717,37965,0,0,66,66,0,1,0,1,0
22003,3717,25174,0,0,62,62,0,1,0,1,0
22004,62260,445,0,0,66,66,0,1,0,1,0
22005,62057,445,0,0,70,70,0,1,0,1,0
22006,42951,22114,0,0,66,66,0,1,0,1,0
22007,22530,23718,0,0,66,66,0,1,0,1,0
22008,62045,445,0,0,70,70,0,1,0,1,0
22009,62048,445,0,0,70,70,0,1,0,1,0
22010,64673,6881,0,0,66,66,0,1,0,1,0
22011,62253,445,0,0,66,66,0,1,0,1,0
22012,62044,445,0,0,70,70,0,1,0,1,0
22013,62654,35440,0,0,62,62,0,1,0,1,0
22014,62041,445,0,0,70,70,0,1,0,1,0
22015,62245,445,0,0,66,66,0,1,0,1,0
22016,51310,64147,0,0,66,66,0,1,0,1,0
22017,52238,26467,0,0,62,62,0,1,0,1,0
22018,65006,26467,0,0,66,66,0,1,0,1,0
22019,50316,25604,0,0,66,66,0,1,0,1,0
22020,23349,30188,0,0,62,62,0,1,0,1,0
22021,63083,25174,0,0,66,66,0,1,0,1,0
22022,7356,25174,0,0,66,66,0,1,0,1,0
22023,51045,25174,0,0,66,66,0,1,0,1,0
22024,50478,445,0,0,70,70,0,1,0,1,0
22025,50474,445,0,0,70,70,0,1,0,1,0
22026,50475,445,0,0,70,70,0,1,0,1,0
22027,23710,41615,0,0,145,145,0,1,0,1,0
22028,62035,445,0,0,70,70,0,1,0,1,0
22029,62237,445,0,0,66,66,0,1,0,1,0
22030,62230,445,0,0,66,66,0,1,0,1,0
22031,62234,445,0,0,66,66,0,1,0,1,0
22032,62233,445,0,0,66,66,0,1,0,1,0
22033,62235,445,0,0,66,66,0,1,0,1,0
22034,62236,445,0,0,66,66,0,1,0,1,0
22035,62229,445,0,0,66,66,0,1,0,1,0
22036,62231,445,0,0,66,66,0,1,0,1,0
22037,14614,25174,0,0,66,66,0,1,0,1,0
22038,51109,11392,0,0,66,66,0,1,0,1,0
22039,52973,57470,0,0,74,74,0,1,0,1,0
22040,35570,22114,0,0,62,62,0,1,0,1,0
22041,61840,25174,0,0,66,66,0,1,0,1,0
22042,16618,52952,0,0,146,146,0,1,0,1,0
22043,24560,25174,0,0,62,62,0,1,0,1,0
22044,21604,50201,0,0,66,66,0,1,0,1,0
22045,62027,445,0,0,70,70,0,1,0,1,0
22046,63878,22114,0,0,146,146,0,1,0,1,0
22047,56249,55442,0,0,66,66,0,1,0,1,0
22048,62558,20170,0,0,145,145,0,1,0,1,0
22049,51769,51505,0,0,62,62,0,1,0,1,0
22050,62025,445,0,0,70,70,0,1,0,1,0
22051,32395,30188,0,0,146,146,0,1,0,1,0
22052,54418,22114,0,0,66,66,0,1,0,1,0
22053,63982,25174,0,0,66,66,0,1,0,1,0
22054,29509,25174,0,0,62,62,0,1,0,1,0
22055,50465,445,0,0,70,70,0,1,0,1,0
22056,50464,445,0,0,70,70,0,1,0,1,0
22057,50458,445,0,0,70,70,0,1,0,1,0
22058,50456,445,0,0,70,70,0,1,0,1,0
22059,37011,25174,0,0,146,146,0,1,0,1,0
22060,62020,445,0,0,70,70,0,1,0,1,0
22061,31683,35440,0,0,146,146,0,1,0,1,0
22062,62019,445,0,0,70,70,0,1,0,1,0
22063,62217,445,0,0,66,66,0,1,0,1,0
22064,62215,445,0,0,66,66,0,1,0,1,0
22065,62214,445,0,0,66,66,0,1,0,1,0
22066,5841,22114,0,0,62,62,0,1,0,1,0
22067,15442,22114,0,0,66,66,0,1,0,1,0
22068,62015,445,0,0,70,70,0,1,0,1,0
22069,64002,15503,0,0,146,146,0,1,0,1,0
22070,50455,445,0,0,70,70,0,1,0,1,0
22071,7810,25174,0,0,66,66,0,1,0,1,0
22072,50446,445,0,0,70,70,0,1,0,1,0
22073,50445,445,0,0,70,70,0,1,0,1,0
22074,50444,445,0,0,70,70,0,1,0,1,0
22075,62512,25174,0,0,146,146,0,1,0,1,0
22076,62014,445,0,0,70,70,0,1,0,1,0
22077,27309,6881,0,0,62,62,0,1,0,1,0
22078,63023,51505,0,0,66,66,0,1,0,1,0
22079,10540,25174,0,0,146,146,0,1,0,1,0
22080,52644,57209,0,0,66,66,0,1,0,1,0
22081,16092,50265,0,0,62,62,0,1,0,1,0
22082,52143,37807,0,0,66,66,0,1,0,1,0
22083,56397,26467,0,0,66,66,0,1,0,1,0
22084,63569,62413,0,0,62,62,0,1,0,1,0
22085,11842,23,0,0,60,60,0,1,0,1,0
22086,62009,445,0,0,70,70,0,1,0,1,0
22087,11136,19910,0,0,62,62,0,1,0,1,0
22088,14740,26467,0,0,62,62,0,1,0,1,0
22089,63116,22114,0,0,62,62,0,1,0,1,0
22090,33556,25174,0,0,146,146,0,1,0,1,0
22091,50432,445,0,0,70,70,0,1,0,1,0
22092,50434,445,0,0,70,70,0,1,0,1,0
22093,50431,445,0,0,70,70,0,1,0,1,0
22094,59424,50265,0,0,74,74,0,1,0,1,0
22095,63467,37807,0,0,62,62,0,1,0,1,0
22096,31627,64147,0,0,62,62,0,1,0,1,0
22097,62203,445,0,0,66,66,0,1,0,1,0
22098,0,0,0,0,74,74,0,1,0,1,0
22099,53577,35894,0,0,66,66,0,1,0,1,0
22100,6652,25174,0,0,62,62,0,1,0,1,0
22101,63852,25174,0,0,62,62,0,1,0,1,0
22102,5223,14446,0,0,220,220,0,1,0,1,0
22103,43578,15503,0,0,74,74,0,1,0,1,0
22104,5223,22981,0,0,60,60,0,1,0,1,0
22105,45908,33330,0,0,60,60,0,1,0,1,0
22106,8889,30434,0,0,60,60,0,1,0,1,0
22107,2731,25174,0,0,146,146,0,1,0,1,0
22108,61996,445,0,0,70,70,0,1,0,1,0
22109,53199,30188,0,0,66,66,0,1,0,1,0
22110,52210,51505,0,0,66,66,0,1,0,1,0
22111,11488,22114,0,0,66,66,0,1,0,1,0
22112,49893,25174,0,0,66,66,0,1,0,1,0
22113,60342,36237,0,0,66,66,0,1,0,1,0
22114,15499,22114,0,0,62,62,0,1,0,1,0
22115,50427,445,0,0,70,70,0,1,0,1,0
22116,50428,445,0,0,70,70,0,1,0,1,0
22117,53022,25174,0,0,66,66,0,1,0,1,0
22118,55826,42771,0,0,66,66,0,1,0,1,0
22119,55825,52700,0,0,66,66,0,1,0,1,0
22120,48826,25174,0,0,66,66,0,1,0,1,0
22121,63242,50584,0,0,62,62,0,1,0,1,0
22122,21542,57470,0,0,74,74,0,1,0,1,0
22123,61993,445,0,0,70,70,0,1,0,1,0
22124,50977,56205,0,0,66,66,0,1,0,1,0
22125,2278,25174,0,0,62,62,0,1,0,1,0
22126,62186,445,0,0,66,66,0,1,0,1,0
22127,12143,56205,0,0,62,62,0,1,0,1,0
22128,42238,25174,0,0,66,66,0,1,0,1,0
22129,61017,64147,0,0,66,66,0,1,0,1,0
22130,1733,65448,0,0,66,66,0,1,0,1,0
22131,50415,445,0,0,70,70,0,1,0,1,0
22132,10462,25174,0,0,62,62,0,1,0,1,0
22133,50413,445,0,0,70,70,0,1,0,1,0
22134,50412,445,0,0,70,70,0,1,0,1,0
22135,50408,445,0,0,70,70,0,1,0,1,0
22136,61989,445,0,0,70,70,0,1,0,1,0
22137,11716,37965,0,0,62,62,0,1,0,1,0
22138,61987,445,0,0,70,70,0,1,0,1,0
22139,62184,445,0,0,66,66,0,1,0,1,0
22140,61985,445,0,0,70,70,0,1,0,1,0
22141,33886,52255,0,0,162,162,0,1,0,1,0
22142,50573,22114,0,0,62,62,0,1,0,1,0
22143,62172,445,0,0,66,66,0,1,0,1,0
22144,62176,445,0,0,66,66,0,1,0,1,0
22145,62177,445,0,0,66,66,0,1,0,1,0
22146,62178,445,0,0,66,66,0,1,0,1,0
22147,62173,445,0,0,66,66,0,1,0,1,0
22148,62171,445,0,0,66,66,0,1,0,1,0
22149,62167,445,0,0,66,66,0,1,0,1,0
22150,63578,35440,0,0,66,66,0,1,0,1,0
22151,52235,443,52235,443,4892,844,4048,19,21,9,10
22152,58968,443,55462,443,4934,1351,3583,21,21,11,10
22153,13171,53,13171,53,404,259,145,3,32,2,1
22154,59944,80,51806,80,1186,390,796,9,16,5,4
22155,55056,80,55056,80,2959,1505,1454,10,16,6,4
22156,47322,80,21803,80,75931,3459,72472,97,43,38,59
22157,52237,443,52237,443,7718,2030,5688,23,20,11,12
22158,18166,53,18166,53,825,99,726,2,30,1,1
22159,40800,443,27923,443,19403,4043,15360,36,48,19,17
22160,49319,443,42333,443,3191,2313,878,17,44,10,7
22161,53589,53,45469,53,578,286,292,9,15,5,4
22162,58876,443,42159,443,19357,12948,6409,47,18,26,21
22163,58610,443,32629,443,6345,1545,4800,23,18,12,11
22164,49217,52769,38751,52769,2189,1143,1046,10,16,6,4
22165,53843,17556,3555,17556,320,140,180,6,7,3,3
22166,53821,7788,40501,7788,70,70,0,1,5,1,0
22167,37665,443,54006,443,8134,2717,5417,24,16,15,9
22168,61432,443,52750,443,2959,1819,1140,19,86,10,9
22169,49656,443,50043,443,11810,2769,9041,29,47,15,14
22170,63118,7000,63118,7000,3310,1535,1775,15,15,8,7
22171,34256,443,33618,443,67835,6280,61555,96,108,45,51
22172,27005,27020,4875,27020,898,126,772,2,30,1,1
22173,34097,443,35195,443,5241,860,4381,17,15,9,8
22174,43324,22,43324,22,8157,3445,4712,59,43,28,31
22175,59517,443,5605,443,6285,1545,4740,22,17,12,10
22176,57428,443,23700,443,6277,1727,4550,16,75,9,7
22177,54902,80,36045,80,1107,630,477,10,16,6,4
22178,52030,43068,29971,43068,66,66,0,1,5,1,0
22179,63976,25725,20832,25725,66,66,0,1,5,1,0
22180,46439,443,34571,443,8246,1739,6507,21,17,11,10
22181,63977,54486,15705,54486,66,66,0,1,5,1,0
22182,40998,80,36819,80,103213,8726,94487,178,38,109,69
22183,60055,53,0,0,82,82,0,1,30,1,0
22184,58969,443,56637,443,2768,1593,1175,22,21,11,11
22185,27005,27018,6738,27018,888,126,762,2,30,1,1
22186,60805,443,29197,443,7983,4398,3585,17,121,8,9
22187,45602,443,17240,443,4417,3084,1333,17,361,9,8
22188,27005,27016,8684,27016,898,126,772,2,31,1,1
22189,61666,443,28189,443,1786,172,1614,7,120,3,4
22190,45141,443,63115,443,4497,2208,2289,15,137,7,8
22191,48389,443,33224,443,6616,3644,2972,18,122,9,9
22192,51426,443,3125,443,15947,5526,10421,38,622,16,22
22193,56381,25174,0,0,62,62,0,1,0,1,0
22194,52811,44847,0,0,66,66,0,1,0,1,0
22195,13414,23,0,0,60,60,0,1,0,1,0
22196,50404,445,0,0,70,70,0,1,0,1,0
22197,50399,445,0,0,70,70,0,1,0,1,0
22198,50398,445,0,0,70,70,0,1,0,1,0
22199,50395,445,0,0,70,70,0,1,0,1,0
22200,62580,25174,0,0,62,62,0,1,0,1,0
22201,55464,22114,0,0,146,146,0,1,0,1,0
22202,10088,37807,0,0,66,66,0,1,0,1,0
22203,61978,445,0,0,70,70,0,1,0,1,0
22204,10072,25174,0,0,62,62,0,1,0,1,0
22205,50358,443,18545,443,5133,2154,2979,26,81,13,13
22206,61923,80,14146,80,4295,719,3576,16,125,8,8
22207,61976,445,0,0,70,70,0,1,0,1,0
22208,56268,44847,0,0,66,66,0,1,0,1,0
22209,57655,56205,0,0,66,66,0,1,0,1,0
22210,61975,445,0,0,70,70,0,1,0,1,0
22211,1027,64147,0,0,62,62,0,1,0,1,0
22212,61974,445,0,0,70,70,0,1,0,1,0
22213,61973,445,0,0,70,70,0,1,0,1,0
22214,50392,445,0,0,70,70,0,1,0,1,0
22215,50391,445,0,0,70,70,0,1,0,1,0
22216,50389,445,0,0,70,70,0,1,0,1,0
22217,61968,445,0,0,70,70,0,1,0,1,0
22218,61967,445,0,0,70,70,0,1,0,1,0
22219,62160,445,0,0,66,66,0,1,0,1,0
22220,49417,38558,0,0,66,66,0,1,0,1,0
22221,49931,25174,0,0,66,66,0,1,0,1,0
22222,50386,445,0,0,70,70,0,1,0,1,0
22223,7099,51505,0,0,62,62,0,1,0,1,0
22224,51944,56205,0,0,66,66,0,1,0,1,0
22225,62157,445,0,0,66,66,0,1,0,1,0
22226,48335,25174,0,0,146,146,0,1,0,1,0
22227,64035,25174,0,0,62,62,0,1,0,1,0
22228,59192,25174,0,0,66,66,0,1,0,1,0
22229,62155,445,0,0,66,66,0,1,0,1,0
22230,62156,445,0,0,66,66,0,1,0,1,0
22231,62153,445,0,0,66,66,0,1,0,1,0
22232,61955,445,0,0,70,70,0,1,0,1,0
22233,61954,445,0,0,70,70,0,1,0,1,0
22234,61950,445,0,0,70,70,0,1,0,1,0
22235,60075,41705,0,0,66,66,0,1,0,1,0
22236,61945,445,0,0,70,70,0,1,0,1,0
22237,61944,445,0,0,70,70,0,1,0,1,0
22238,58844,51505,0,0,66,66,0,1,0,1,0
22239,1024,25174,0,0,146,146,0,1,0,1,0
22240,50381,445,0,0,70,70,0,1,0,1,0
22241,30280,37965,0,0,66,66,0,1,0,1,0
22242,50376,445,0,0,70,70,0,1,0,1,0
22243,50370,445,0,0,70,70,0,1,0,1,0
22244,30598,37965,0,0,62,62,0,1,0,1,0
22245,18203,23,0,0,60,60,0,1,0,1,0
22246,13021,25174,0,0,62,62,0,1,0,1,0
22247,47461,50584,0,0,62,62,0,1,0,1,0
22248,62141,445,0,0,66,66,0,1,0,1,0
22249,61933,445,0,0,70,70,0,1,0,1,0
22250,15235,36237,0,0,62,62,0,1,0,1,0
22251,63346,53,0,0,75,75,0,1,0,1,0
22252,54721,22114,0,0,66,66,0,1,0,1,0
22253,46640,55443,0,0,60,60,0,1,0,1,0
22254,57982,25174,0,0,62,62,0,1,0,1,0
22255,57073,57470,0,0,62,62,0,1,0,1,0
22256,64755,31573,0,0,66,66,0,1,0,1,0
22257,58791,25174,0,0,62,62,0,1,0,1,0
22258,11136,57587,0,0,62,62,0,1,0,1,0
22259,58791,25174,0,0,146,146,0,1,0,1,0
22260,1538,50584,0,0,146,146,0,1,0,1,0
22261,56704,80,26438,80,1146417,29701,1116716,1218,54,422,796
22262,63978,63776,58166,63776,70,70,0,1,4,1,0
22263,63980,4804,25300,4804,70,70,0,1,4,1,0
22264,53800,59950,39242,59950,1973,1021,952,10,15,6,4
22265,53624,53,53624,53,832,106,726,2,29,1,1
22266,54365,443,56544,443,3970,1726,2244,13,134,6,7
22267,43405,443,52895,443,5977,1326,4651,18,30,11,7
22268,49902,443,36938,443,109400,8787,100613,159,81,78,81
22269,52025,42442,45647,42442,70,70,0,1,4,1,0
22270,52027,49743,23707,49743,70,70,0,1,4,1,0
22271,40784,443,40784,443,4378,1471,2907,19,25,11,8
22272,57437,443,10192,443,9539,3344,6195,36,17,17,19
22273,60788,40010,33720,40010,316,136,180,6,5,3,3
22274,50267,80,27570,80,12364,548,11816,17,46,6,11
22275,58897,443,22242,443,5167,700,4467,16,14,7,9
22276,52028,35097,53575,35097,206,136,70,4,13,3,1
22277,50211,1688,3994,1688,70,70,0,1,4,1,0
22278,27005,27016,21347,27016,902,126,776,2,30,1,1
22279,58018,443,65091,443,8828,2193,6635,38,99,17,21
22280,61924,80,25773,80,2170,472,1698,10,125,6,4
22281,27005,27017,42794,27017,880,126,754,2,30,1,1
22282,56445,53,19322,53,374,94,280,2,30,1,1
22283,49282,53,18906,53,197,94,103,2,30,1,1
22284,52003,443,46194,443,18400,6207,12193,60,212,32,28
22285,58893,443,9531,443,5107,700,4407,15,15,7,8
22286,61416,443,34403,443,6437,1994,4443,22,87,12,10
22287,52042,38074,53103,38074,70,70,0,2,8,2,0
22288,46640,443,38435,443,10768,1726,9042,35,199,17,18
22289,58896,443,22104,443,5168,700,4468,16,15,7,9
22290,65501,443,33887,443,416348,12360,403988,429,16,151,278
22291,14199,443,14199,443,416,198,218,7,27,4,3
22292,42430,443,21880,443,3927,1425,2502,18,121,8,10
22293,50584,6881,18955,6881,502,150,352,2,1200,1,1
22294,63971,42759,55186,42759,504,382,122,8,15,6,2
22295,53683,443,41886,443,9880,1687,8193,23,15,12,11
22296,46966,5222,45433,5222,12521,2892,9629,64,356,27,37
22297,49846,80,38683,80,3215,2272,943,15,38,9,6
22298,64088,53,9032,53,434,108,326,4,51,2,2
22299,55722,53,10365,53,229,110,119,2,30,1,1
22300,56809,53,8718,53,232,94,138,2,30,1,1
22301,56663,80,6268,80,234,234,0,4,12,4,0
22302,65502,443,12498,443,92573,4519,88054,105,16,39,66
22303,64157,53,10043,53,323,90,233,4,48,2,2
22304,27005,27015,3156,27015,878,126,752,2,30,1,1
22305,49210,80,26357,80,2965,715,2250,9,75,5,4
22306,63117,7000,63117,7000,4067,1750,2317,16,15,9,7
22307,28000,443,52315,443,5746,1271,4475,25,105,12,13
22308,52041,48103,36252,48103,70,70,0,2,8,2,0
22309,49907,443,10260,443,3787,2434,1353,29,72,16,13
22310,53820,7488,54828,7488,70,70,0,1,4,1,0
22311,60467,51095,40128,51095,320,140,180,6,7,3,3
22312,58171,80,42934,80,1651,550,1101,13,15,7,6
22313,52134,443,44449,443,473832,22822,451010,464,109,139,325
22314,52044,5824,18446,5824,70,70,0,2,8,2,0
22315,52026,12523,4758,12523,70,70,0,1,4,1,0
22316,63981,34250,52912,34250,70,70,0,1,4,1,0
22317,53822,18716,19485,18716,70,70,0,1,4,1,0
22318,63138,51452,7117,51452,70,70,0,1,5,1,0
22319,50700,80,27825,80,142,142,0,1,5,1,0
22320,48111,443,2939,443,214,140,74,4,15,3,1
22321,60265,53,3375,53,215,86,129,2,30,1,1
22322,58890,80,3070,80,1883,1448,435,11,16,6,5
22323,64941,53,51178,53,216,94,122,2,30,1,1
22324,65191,53,55910,53,294,102,192,2,30,1,1
22325,27005,27015,15191,27015,889,126,763,2,30,1,1
22326,27005,27017,27810,27017,890,126,764,2,30,1,1
22327,40940,443,19885,443,9856,1973,7883,32,140,17,15
22328,37965,34591,32228,34591,820,152,668,4,1199,2,2
22329,37912,443,38909,443,2738,1475,1263,19,275,10,9
22330,57470,51413,34007,51413,460,150,310,2,1199,1,1
22331,6882,25021,51756,25021,509,150,359,2,1200,1,1
22332,33227,443,20860,443,8888,1757,7131,26,174,15,11
22333,54184,443,12378,443,2786,1537,1249,17,16,8,9
22334,46592,53,27919,53,168,78,90,2,30,1,1
22335,47876,443,34439,443,996037,37114,958923,1187,271,459,728
22336,59676,53,12870,53,195,94,101,2,30,1,1
22337,50638,80,16658,80,21873,2252,19621,27,21,10,17
22338,50116,22,50116,22,152,66,86,2,9,1,1
22339,61925,80,57280,80,2418,495,1923,11,125,6,5
22340,58894,443,36068,443,5168,700,4468,16,15,7,9
22341,49356,53,31614,53,209,102,107,2,30,1,1
22342,58914,53,2441,53,244,86,158,2,30,1,1
22343,40071,443,38223,443,7855,1850,6005,24,187,14,10
22344,59518,80,10090,80,14862,1091,13771,26,135,14,12
22345,47668,443,3195,443,69732,65832,3900,104,316,55,49
22346,53453,443,41566,443,6824,2097,4727,19,15,11,8
22347,5588,5588,0,0,3354,1792,1562,46,194,23,23
22348,64812,53,57206,53,347,91,256,4,56,2,2
22349,50688,53,22980,53,78,78,0,1,30,1,0
22350,27005,27016,64097,27016,880,126,754,2,30,1,1
22351,53610,443,29299,443,3096,962,2134,13,135,6,7
22352,56713,53,30137,53,226,110,116,2,30,1,1
22353,65265,53,48964,53,207,86,121,2,30,1,1
22354,50345,53,44210,53,193,102,91,2,30,1,1
22355,39098,443,35056,443,5519,1493,4026,20,121,9,11
22356,47127,443,18899,443,7166,2377,4789,16,122,7,9
22357,59661,443,56024,443,9055,2404,6651,24,126,13,11
22358,30188,31063,61312,31063,502,150,352,2,1200,1,1
22359,64463,53,25750,53,183,94,89,2,31,1,1
22360,27005,27018,28436,27018,895,126,769,2,31,1,1
22361,53832,56005,15467,56005,70,70,0,2,8,2,0
22362,59105,443,52375,443,8742,3785,4957,21,16,12,9
22363,54271,80,5783,80,6006,861,5145,18,19,10,8
22364,44097,80,3259,80,36152,2792,33360,55,19,29,26
22365,47894,443,25578,443,52038,3333,48705,74,157,30,44
22366,63994,47013,54250,47013,66,66,0,2,8,2,0
22367,63996,45759,55251,45759,66,66,0,2,8,2,0
22368,59580,443,31817,443,10200,2180,8020,26,19,15,11
22369,37858,443,14705,443,10281,2251,8030,25,17,14,11
22370,56574,443,10843,443,6974,1513,5461,21,81,11,10
22371,63999,10552,13138,10552,66,66,0,2,8,2,0
22372,50679,80,21512,80,132,132,0,2,8,2,0
22373,35821,80,40158,80,34712,2489,32223,52,19,27,25
22374,64617,53,10590,53,301,102,199,2,30,1,1
22375,62134,445,0,0,66,66,0,1,0,1,0
22376,28085,36237,0,0,66,66,0,1,0,1,0
22377,29988,44847,0,0,66,66,0,1,0,1,0
22378,50358,445,0,0,70,70,0,1,0,1,0
22379,5223,7851,0,0,66,66,0,1,0,1,0
22380,51564,50584,0,0,66,66,0,1,0,1,0
22381,1024,25174,0,0,62,62,0,1,0,1,0
22382,61929,445,0,0,70,70,0,1,0,1,0
22383,40400,22114,0,0,62,62,0,1,0,1,0
22384,40086,22114,0,0,62,62,0,1,0,1,0
22385,62132,445,0,0,66,66,0,1,0,1,0
22386,54377,56205,0,0,66,66,0,1,0,1,0
22387,55920,25174,0,0,62,62,0,1,0,1,0
22388,61917,445,0,0,70,70,0,1,0,1,0
22389,61919,445,0,0,70,70,0,1,0,1,0
22390,61920,445,0,0,70,70,0,1,0,1,0
22391,2422,62507,0,0,66,66,0,1,0,1,0
22392,61915,445,0,0,70,70,0,1,0,1,0
22393,61913,445,0,0,70,70,0,1,0,1,0
22394,7482,57470,0,0,66,66,0,1,0,1,0
22395,54048,25174,0,0,66,66,0,1,0,1,0
22396,62125,445,0,0,66,66,0,1,0,1,0
22397,22924,25174,0,0,146,146,0,1,0,1,0
22398,2886,35440,0,0,66,66,0,1,0,1,0
22399,7222,57470,0,0,62,62,0,1,0,1,0
22400,20576,37965,0,0,62,62,0,1,0,1,0
22401,53567,64147,0,0,66,66,0,1,0,1,0
22402,62122,445,0,0,66,66,0,1,0,1,0
22403,30800,25174,0,0,62,62,0,1,0,1,0
22404,10688,25174,0,0,62,62,0,1,0,1,0
22405,37617,443,47875,443,499,425,74,4,0,3,1
22406,31609,25174,0,0,146,146,0,1,0,1,0
22407,24560,25174,0,0,146,146,0,1,0,1,0
22408,24040,22114,0,0,62,62,0,1,0,1,0
22409,46774,51050,0,0,62,62,0,1,0,1,0
22410,49482,22,0,0,60,60,0,1,0,1,0
22411,57669,64147,0,0,66,66,0,1,0,1,0
22412,61906,445,0,0,70,70,0,1,0,1,0
22413,50350,445,0,0,70,70,0,1,0,1,0
22414,50346,445,0,0,70,70,0,1,0,1,0
22415,50347,445,0,0,70,70,0,1,0,1,0
22416,50442,25174,0,0,66,66,0,1,0,1,0
22417,62109,445,0,0,66,66,0,1,0,1,0
22418,62102,445,0,0,66,66,0,1,0,1,0
22419,62105,445,0,0,66,66,0,1,0,1,0
22420,62107,445,0,0,66,66,0,1,0,1,0
22421,62101,445,0,0,66,66,0,1,0,1,0
22422,62103,445,0,0,66,66,0,1,0,1,0
22423,62108,445,0,0,66,66,0,1,0,1,0
22424,62106,445,0,0,66,66,0,1,0,1,0
22425,33215,37965,0,0,62,62,0,1,0,1,0
22426,22240,22114,0,0,62,62,0,1,0,1,0
22427,33183,23,0,0,60,60,0,1,0,1,0
22428,61899,445,0,0,70,70,0,1,0,1,0
22429,26435,39004,0,0,62,62,0,1,0,1,0
22430,61898,445,0,0,70,70,0,1,0,1,0
22431,63708,25174,0,0,66,66,0,1,0,1,0
22432,44147,64147,0,0,62,62,0,1,0,1,0
22433,61892,445,0,0,70,70,0,1,0,1,0
22434,50344,445,0,0,70,70,0,1,0,1,0
22435,50339,445,0,0,70,70,0,1,0,1,0
22436,50330,445,0,0,70,70,0,1,0,1,0
22437,50328,445,0,0,70,70,0,1,0,1,0
22438,61891,445,0,0,70,70,0,1,0,1,0
22439,67,68,0,0,346,346,0,1,0,1,0
22440,57797,64147,0,0,66,66,0,1,0,1,0
22441,62088,445,0,0,66,66,0,1,0,1,0
22442,62089,445,0,0,66,66,0,1,0,1,0
22443,62086,445,0,0,66,66,0,1,0,1,0
22444,63400,57470,0,0,66,66,0,1,0,1,0
22445,45908,33330,0,0,60,60,0,1,0,1,0
22446,61887,445,0,0,70,70,0,1,0,1,0
22447,7877,22114,0,0,66,66,0,1,0,1,0
22448,50327,445,0,0,70,70,0,1,0,1,0
22449,61886,445,0,0,70,70,0,1,0,1,0
22450,50318,445,0,0,70,70,0,1,0,1,0
22451,50322,445,0,0,70,70,0,1,0,1,0
22452,50317,445,0,0,70,70,0,1,0,1,0
22453,13285,29892,0,0,145,145,0,1,0,1,0
22454,0,0,0,0,480,244,236,4,0,2,2
22455,54876,25174,0,0,62,62,0,1,0,1,0
22456,59949,44847,0,0,66,66,0,1,0,1,0
22457,52024,25174,0,0,66,66,0,1,0,1,0
22458,19330,25174,0,0,62,62,0,1,0,1,0
22459,61881,445,0,0,70,70,0,1,0,1,0
22460,63347,25174,0,0,66,66,0,1,0,1,0
22461,18061,25174,0,0,62,62,0,1,0,1,0
22462,63084,64147,0,0,62,62,0,1,0,1,0
22463,50309,445,0,0,70,70,0,1,0,1,0
22464,50308,445,0,0,70,70,0,1,0,1,0
22465,50304,445,0,0,70,70,0,1,0,1,0
22466,56770,26467,0,0,66,66,0,1,0,1,0
22467,52321,26467,0,0,62,62,0,1,0,1,0
22468,62077,445,0,0,66,66,0,1,0,1,0
22469,62014,35440,0,0,66,66,0,1,0,1,0
22470,49001,40108,0,0,161,161,0,1,0,1,0
22471,49686,44847,0,0,62,62,0,1,0,1,0
22472,49001,40108,0,0,161,161,0,1,0,1,0
22473,53756,50584,0,0,62,62,0,1,0,1,0
22474,53257,37450,0,0,66,66,0,1,0,1,0
22475,61400,64147,0,0,66,66,0,1,0,1,0
22476,55562,50584,0,0,66,66,0,1,0,1,0
22477,49994,26467,0,0,66,66,0,1,0,1,0
22478,47771,25174,0,0,62,62,0,1,0,1,0
22479,61868,445,0,0,70,70,0,1,0,1,0
22480,62637,42873,0,0,66,66,0,1,0,1,0
22481,32704,25174,0,0,62,62,0,1,0,1,0
22482,51396,56205,0,0,66,66,0,1,0,1,0
22483,46864,25174,0,0,146,146,0,1,0,1,0
22484,22733,26467,0,0,62,62,0,1,0,1,0
22485,59988,64147,0,0,66,66,0,1,0,1,0
22486,26752,64147,0,0,62,62,0,1,0,1,0
22487,3584,25174,0,0,62,62,0,1,0,1,0
22488,57604,32480,0,0,62,62,0,1,0,1,0
22489,14489,25174,0,0,62,62,0,1,0,1,0
22490,58250,35440,0,0,66,66,0,1,0,1,0
22491,46367,36237,0,0,66,66,0,1,0,1,0
22492,61865,445,0,0,70,70,0,1,0,1,0
22493,50298,445,0,0,70,70,0,1,0,1,0
22494,50293,445,0,0,70,70,0,1,0,1,0
22495,62792,53,0,0,88,88,0,1,0,1,0
22496,56161,62413,0,0,66,66,0,1,0,1,0
22497,49514,52255,0,0,162,162,0,1,0,1,0
22498,12632,25174,0,0,62,62,0,1,0,1,0
22499,29016,25174,0,0,62,62,0,1,0,1,0
22500,32976,37965,0,0,66,66,0,1,0,1,0
22501,49086,443,34505,443,8535,2139,6396,25,394,9,16
22502,38223,443,38223,443,4782,1875,2907,19,29,11,8
22503,55254,443,18308,443,8431,2584,5847,25,46,14,11
22504,54278,53,0,0,82,82,0,1,30,1,0
22505,26867,443,1450,443,11115,3034,8081,35,19,18,17
22506,39192,80,42667,80,62592,60966,1626,63,16,47,16
22507,53817,59216,40309,59216,164,70,94,2,5,1,1
22508,63970,28423,20673,28423,564,382,182,9,15,6,3
22509,61505,443,24914,443,4820,863,3957,18,31,10,8
22510,61506,443,7741,443,15255,2304,12951,30,31,13,17
22511,64002,2880,57977,2880,66,66,0,2,8,2,0
22512,60456,58675,9788,58675,1307,786,521,15,16,8,7
22513,60901,443,60901,443,24367,4634,19733,52,49,26,26
22514,63968,37264,37420,37264,504,382,122,8,15,6,2
22515,49994,443,12654,443,378,82,296,5,17,1,4
22516,56449,443,10507,443,3182,1568,1614,8,120,4,4
22517,63062,53,6744,53,303,85,218,2,30,1,1
22518,55835,443,26347,443,10087,3968,6119,32,271,17,15
22519,63063,443,23701,443,303,85,218,2,30,1,1
22520,57334,443,4953,443,11347,2434,8913,28,62,15,13
22521,40030,443,25382,443,2651,1331,1320,18,17,10,8
22522,40803,443,57775,443,1093,662,431,10,46,6,4
22523,53149,47383,18287,47383,694,320,374,10,18,6,4
22524,52907,443,48453,443,9303,3133,6170,26,22,13,13
22525,60454,18359,20909,18359,1842,1017,825,19,16,9,10
22526,60413,80,20847,80,958,543,415,11,315,6,5
22527,60412,80,59747,80,958,543,415,11,315,6,5
22528,49812,443,22276,443,6128,1356,4772,20,978,10,10
22529,58870,443,34912,443,21207,14062,7145,50,19,28,22
22530,64003,38926,33075,38926,66,66,0,2,8,2,0
22531,41339,443,20728,443,7450,1203,6247,22,16,12,10
22532,53232,80,53232,80,6385,778,5607,17,16,9,8
22533,54054,443,22271,443,12268,7082,5186,26,85,15,11
22534,58967,443,57759,443,9225,1878,7347,28,21,14,14
22535,10808,443,10808,443,4902,861,4041,15,16,7,8
22536,53018,443,37160,443,6352,1552,4800,23,17,12,11
22537,54031,443,8430,443,350,210,140,6,25,4,2
22538,63961,53,35480,53,184,86,98,2,30,1,1
22539,48817,6889,48817,6889,480,149,331,2,1200,1,1
22540,36420,443,54908,443,7018,1381,5637,24,17,14,10
22541,64115,80,27951,80,2575,635,1940,12,36,7,5
22542,5588,5588,0,0,3354,1792,1562,46,196,23,23
22543,5588,5588,0,0,3354,1792,1562,46,194,23,23
22544,27005,27016,57447,27016,885,126,759,2,30,1,1
22545,60903,443,60903,443,13557,3307,10250,43,47,25,18
22546,64827,53,64827,53,288,83,205,2,30,1,1
22547,63071,443,65203,443,569,164,405,2,30,1,1
22548,5588,5588,0,0,3354,1792,1562,46,193,23,23
22549,63070,53,63583,53,446,164,282,2,30,1,1
22550,52062,443,2872,443,61141,52577,8564,102,363,50,52
22551,27005,27017,35476,27017,882,126,756,2,31,1,1
22552,27005,27017,28274,27017,880,126,754,2,31,1,1
22553,55647,443,60557,443,90956,83597,7359,106,127,70,36
22554,62061,445,0,0,66,66,0,1,0,1,0
22555,62057,445,0,0,66,66,0,1,0,1,0
22556,12183,22114,0,0,62,62,0,1,0,1,0
22557,62885,62413,0,0,66,66,0,1,0,1,0
22558,27677,22114,0,0,62,62,0,1,0,1,0
22559,50251,35440,0,0,66,66,0,1,0,1,0
22560,18608,11392,0,0,62,62,0,1,0,1,0
22561,61861,445,0,0,70,70,0,1,0,1,0
22562,54438,62413,0,0,66,66,0,1,0,1,0
22563,36456,25174,0,0,62,62,0,1,0,1,0
22564,57479,56205,0,0,66,66,0,1,0,1,0
22565,61859,445,0,0,70,70,0,1,0,1,0
22566,51210,50584,0,0,146,146,0,1,0,1,0
22567,60786,25174,0,0,66,66,0,1,0,1,0
22568,59147,25174,0,0,62,62,0,1,0,1,0
22569,63910,44847,0,0,62,62,0,1,0,1,0
22570,50285,445,0,0,70,70,0,1,0,1,0
22571,50289,445,0,0,70,70,0,1,0,1,0
22572,50283,445,0,0,70,70,0,1,0,1,0
22573,50282,445,0,0,70,70,0,1,0,1,0
22574,30782,36237,0,0,146,146,0,1,0,1,0
22575,58251,36237,0,0,62,62,0,1,0,1,0
22576,61857,445,0,0,70,70,0,1,0,1,0
22577,62053,445,0,0,66,66,0,1,0,1,0
22578,49591,53,54188,53,408,86,322,4,31,2,2
22579,63056,443,24879,443,304,86,218,2,30,1,1
22580,63068,443,50738,443,571,166,405,2,30,1,1
22581,50632,80,1606,80,1559,1107,452,9,22,5,4
22582,60438,53,27899,53,154,154,0,3,46,3,0
22583,63242,443,5586,443,9042,4612,4430,31,175,17,14
22584,61691,53,19669,53,256,94,162,2,30,1,1
22585,59625,443,5961,443,6703,1307,5396,28,18,14,14
22586,56569,443,12304,443,340595,9013,331582,345,80,119,226
22587,53818,15337,26034,15337,164,70,94,2,4,1,1
22588,50995,53,51013,53,168,78,90,2,30,1,1
22589,38100,53,30457,53,168,78,90,2,30,1,1
22590,53764,443,39809,443,8115,1962,6153,24,18,14,10
22591,52618,80,60049,80,1141,529,612,10,18,6,4
22592,55026,443,39326,443,3591,1906,1685,22,80,11,11
22593,37235,443,30384,443,8877,1380,7497,30,18,15,15
22594,53424,443,24039,443,9953,1605,8348,35,18,19,16
22595,53814,6725,20985,6725,70,70,0,1,4,1,0
22596,64000,14441,35024,14441,66,66,0,2,7,2,0
22597,53815,17290,25400,17290,70,70,0,1,4,1,0
22598,53808,56215,4312,56215,70,70,0,1,4,1,0
22599,50635,80,60349,80,3722,1504,2218,13,20,7,6
22600,51553,443,28429,443,6662,522,6140,15,16,5,10
22601,54136,443,42387,443,1053,566,487,10,16,6,4
22602,50374,53,63648,53,755,102,653,2,29,1,1
22603,63075,53,54531,53,571,166,405,2,29,1,1
22604,63074,443,53301,443,384,166,218,2,29,1,1
22605,58726,53,60102,53,247,102,145,2,30,1,1
22606,50345,53,41743,53,193,102,91,2,30,1,1
22607,63059,53,39205,53,304,86,218,2,30,1,1
22608,54657,6881,47052,6881,1682,716,966,12,15,6,6
22609,56566,443,19189,443,343737,9198,334539,348,80,121,227
22610,64406,53,46788,53,204,204,0,3,46,3,0
22611,64124,53,32205,53,236,86,150,2,30,1,1
22612,63069,53,35959,53,384,166,218,2,30,1,1
22613,63058,443,54083,443,304,86,218,2,30,1,1
22614,60458,61473,34807,61473,1587,935,652,14,16,8,6
22615,60946,443,58938,443,1373,712,661,14,18,8,6
22616,56570,443,57405,443,4722,1330,3392,18,80,9,9
22617,56565,443,50266,443,52157,3066,49091,65,80,26,39
22618,49634,53,43147,53,344,126,218,2,30,1,1
22619,40603,80,57176,80,1104,475,629,10,15,6,4
22620,20954,53,64122,53,223,78,145,2,30,1,1
22621,65064,53,44516,53,338,110,228,2,30,1,1
22622,39607,443,22667,443,559339,545011,14328,595,316,388,207
22623,60949,443,41744,443,1598,794,804,16,18,9,7
22624,27005,27016,52333,27016,892,126,766,2,30,1,1
22625,33936,443,61935,443,9880,2011,7869,38,256,17,21
22626,49732,443,11249,443,592433,191668,400765,1555,1157,608,947
22627,56450,443,16622,443,1786,172,1614,7,120,3,4
22628,56654,53,7518,53,306,306,0,4,47,4,0
22629,59813,53,1465,53,355,118,237,2,30,1,1
22630,65016,443,10524,443,5957,2481,3476,14,120,8,6
22631,1399,53,11703,53,256,94,162,2,30,1,1
22632,54699,53,18510,53,236,86,150,2,30,1,1
22633,60448,443,25494,443,17060,10614,6446,52,132,25,27
22634,44136,53,62801,53,220,78,142,2,30,1,1
22635,50265,12656,39117,12656,402,132,270,6,1209,3,3
22636,58892,443,12440,443,5167,700,4467,16,15,7,9
22637,55008,443,6262,443,7679,2605,5074,26,45,15,11
22638,35879,443,58250,443,6108,3916,2192,51,1143,31,20
22639,61637,53,50085,53,246,246,0,4,47,4,0
22640,27005,27016,17194,27016,878,126,752,2,30,1,1
22641,50265,40448,36258,40448,2118,858,1260,28,1274,14,14
22642,48144,443,29490,443,16198,9822,6376,54,35,28,26
22643,60956,443,57163,443,13342,9687,3655,53,17,28,25
22644,60944,443,6650,443,59999,8737,51262,95,18,43,52
22645,42319,443,8708,443,6664,1570,5094,23,18,13,10
22646,59779,443,38576,443,142,142,0,1,5,1,0
22647,45511,443,41466,443,130,70,60,2,15,1,1
22648,55445,53,39762,53,192,192,0,3,46,3,0
22649,53434,53,32877,53,261,261,0,4,47,4,0
22650,60473,8765,34134,8765,199,75,124,4,59,2,2
22651,27005,27018,49128,27018,879,126,753,2,30,1,1
22652,63067,53,20594,53,384,166,218,2,30,1,1
22653,8893,123,39834,123,94,94,0,1,30,1,0
22654,63060,53,7236,53,304,86,218,2,30,1,1
22655,35506,80,16634,80,120,60,60,3,3600,2,1
22656,55305,53,27046,53,176,176,0,3,46,3,0
22657,60945,443,60187,443,1373,712,661,14,18,8,6
22658,54056,443,63986,443,8340,3417,4923,20,75,11,9
22659,40656,443,51290,443,10293,1331,8962,22,255,12,10
22660,56576,443,12093,443,6971,1510,5461,21,80,11,10
22661,64001,13051,20049,13051,66,66,0,2,7,2,0
22662,46683,443,6885,443,234,234,0,4,12,4,0
22663,64004,48339,7779,48339,66,66,0,2,7,2,0
22664,60953,443,32015,443,103580,4856,98724,133,17,56,77
22665,42574,443,64198,443,130,70,60,3,5,2,1
22666,64828,53,47016,53,881,243,638,6,39,3,3
22667,59942,80,31955,80,2241,1549,692,9,15,5,4
22668,53753,443,14141,443,6973,2166,4807,20,15,11,9
22669,42137,443,46635,443,9173,2080,7093,22,18,13,9
22670,60950,443,63675,443,7431,2753,4678,40,18,21,19
22671,62995,53,20908,53,202,202,0,3,46,3,0
22672,37663,443,39550,443,8493,2314,6179,33,15,18,15
22673,2089,7000,2089,7000,2227,676,1551,15,14,7,8
22674,63995,15396,7460,15396,66,66,0,2,7,2,0
22675,55348,53,14185,53,332,94,238,2,29,1,1
22676,51923,443,5090,443,8964,6357,2607,44,163,23,21
22677,63073,53,51318,53,304,86,218,2,30,1,1
22678,54553,53,62342,53,202,202,0,3,46,3,0
22679,27005,27018,51393,27018,881,126,755,2,30,1,1
22680,65501,53,1213,53,226,94,132,2,29,1,1
22681,63072,443,30970,443,304,86,218,2,30,1,1
22682,63066,443,9445,443,448,166,282,2,30,1,1
22683,46676,443,54715,443,16425,3923,12502,37,156,19,18
22684,60580,53,24695,53,229,94,135,2,30,1,1
22685,63064,443,8160,443,448,166,282,2,30,1,1
22686,49897,53,22937,53,384,94,290,2,30,1,1
22687,63057,53,17577,53,304,86,218,2,30,1,1
22688,45387,443,38103,443,3999,2255,1744,37,1122,19,18
22689,60955,443,4042,443,40105,2847,37258,61,17,28,33
22690,27005,27016,52967,27016,879,126,753,2,30,1,1
22691,46404,53,18296,53,240,86,154,2,30,1,1
22692,63061,443,64217,443,304,86,218,2,30,1,1
22693,60958,443,2953,443,1547,960,587,14,17,8,6
22694,60947,443,46012,443,1373,712,661,14,18,8,6
22695,60460,54233,13899,54233,70,70,0,1,5,1,0
22696,45510,443,22832,443,130,70,60,2,15,1,1
22697,41000,443,2288,443,6237,1811,4426,22,22,12,10
22698,61071,1053,14234,1053,1139,878,261,2,30,1,1
22699,27005,27015,13591,27015,880,126,754,2,30,1,1
22700,27005,27025,23287,27025,895,126,769,2,30,1,1
22701,52989,53,36046,53,406,94,312,2,30,1,1
22702,40204,40016,4435,40016,148,86,62,2,30,1,1
22703,60952,443,35261,443,391561,17125,374436,478,17,213,265
22704,60948,443,3715,443,1373,712,661,14,18,8,6
22705,54181,443,63427,443,9283,2154,7129,22,15,12,10
22706,50116,22,50116,22,66,66,0,1,5,1,0
22707,62074,443,56208,443,350,210,140,6,15,4,2
22708,53791,53,58724,53,204,204,0,3,46,3,0
22709,61072,53,60652,53,1139,878,261,2,30,1,1
22710,63065,53,14429,53,448,166,282,2,30,1,1
22711,54672,443,56107,443,2285,1130,1155,25,120,12,13
22712,59984,443,65136,443,2419,330,2089,12,135,5,7
22713,56485,443,48158,443,5711,1208,4503,21,121,11,10
22714,57470,50321,52574,50321,1584,1584,0,25,1537,25,0
22715,37526,443,48276,443,10637,4761,5876,30,145,17,13
22716,55877,56148,26245,56148,481,150,331,2,1200,1,1
22717,42207,443,33313,443,7870,2945,4925,19,136,9,10
22718,60455,65054,62710,65054,624,318,306,10,16,5,5
22719,58731,443,5711,443,2383,1460,923,18,201,10,8
22720,64463,53,17671,53,183,94,89,2,30,1,1
22721,55427,53,42725,53,442,110,332,4,44,2,2
22722,55078,80,14305,80,265275,25834,239441,366,101,182,184
22723,65071,53,49896,53,93,93,0,2,60,2,0
22724,52178,443,8092,443,414,140,274,7,26,3,4
22725,59489,53,5531,53,168,78,90,2,30,1,1
22726,62709,57470,0,0,62,62,0,1,0,1,0
22727,62048,445,0,0,66,66,0,1,0,1,0
22728,62047,445,0,0,66,66,0,1,0,1,0
22729,62042,445,0,0,66,66,0,1,0,1,0
22730,62050,445,0,0,66,66,0,1,0,1,0
22731,62049,445,0,0,66,66,0,1,0,1,0
22732,62044,445,0,0,66,66,0,1,0,1,0
22733,62038,445,0,0,66,66,0,1,0,1,0
22734,55435,25174,0,0,146,146,0,1,0,1,0
22735,7977,25174,0,0,146,146,0,1,0,1,0
22736,7977,25174,0,0,62,62,0,1,0,1,0
22737,50274,445,0,0,70,70,0,1,0,1,0
22738,10632,25174,0,0,146,146,0,1,0,1,0
22739,50271,445,0,0,70,70,0,1,0,1,0
22740,50270,445,0,0,70,70,0,1,0,1,0
22741,50267,445,0,0,70,70,0,1,0,1,0
22742,55839,56535,0,0,62,62,0,1,0,1,0
22743,61850,445,0,0,70,70,0,1,0,1,0
22744,21108,25174,0,0,62,62,0,1,0,1,0
22745,61848,445,0,0,70,70,0,1,0,1,0
22746,44285,25174,0,0,62,62,0,1,0,1,0
22747,15400,47807,0,0,159,159,0,1,0,1,0
22748,37633,44847,0,0,62,62,0,1,0,1,0
22749,2717,31573,0,0,62,62,0,1,0,1,0
22750,47727,25174,0,0,146,146,0,1,0,1,0
22751,41541,25174,0,0,66,66,0,1,0,1,0
22752,61847,445,0,0,70,70,0,1,0,1,0
22753,61846,445,0,0,70,70,0,1,0,1,0
22754,15249,22114,0,0,62,62,0,1,0,1,0
22755,61845,445,0,0,70,70,0,1,0,1,0
22756,61843,445,0,0,70,70,0,1,0,1,0
22757,61841,445,0,0,70,70,0,1,0,1,0
22758,59213,25174,0,0,66,66,0,1,0,1,0
22759,60104,30188,0,0,66,66,0,1,0,1,0
22760,50264,445,0,0,70,70,0,1,0,1,0
22761,50263,445,0,0,70,70,0,1,0,1,0
22762,50261,445,0,0,70,70,0,1,0,1,0
22763,30861,46783,0,0,62,62,0,1,0,1,0
22764,51560,46783,0,0,66,66,0,1,0,1,0
22765,62033,445,0,0,66,66,0,1,0,1,0
22766,39873,23,0,0,60,60,0,1,0,1,0
22767,50258,445,0,0,70,70,0,1,0,1,0
22768,35828,8970,0,0,146,146,0,1,0,1,0
22769,54876,25174,0,0,146,146,0,1,0,1,0
22770,62029,445,0,0,66,66,0,1,0,1,0
22771,60558,51221,0,0,62,62,0,1,0,1,0
22772,64155,60043,0,0,66,66,0,1,0,1,0
22773,5926,25174,0,0,62,62,0,1,0,1,0
22774,61827,445,0,0,70,70,0,1,0,1,0
22775,6881,35894,0,0,62,62,0,1,0,1,0
22776,61826,445,0,0,70,70,0,1,0,1,0
22777,61820,445,0,0,70,70,0,1,0,1,0
22778,62027,445,0,0,66,66,0,1,0,1,0
22779,62026,445,0,0,66,66,0,1,0,1,0
22780,18091,32480,0,0,62,62,0,1,0,1,0
22781,61816,445,0,0,70,70,0,1,0,1,0
22782,61817,445,0,0,70,70,0,1,0,1,0
22783,62025,445,0,0,66,66,0,1,0,1,0
22784,47256,37807,0,0,62,62,0,1,0,1,0
22785,11136,15503,0,0,62,62,0,1,0,1,0
22786,41490,25174,0,0,62,62,0,1,0,1,0
22787,57994,30188,0,0,62,62,0,1,0,1,0
22788,60941,25174,0,0,62,62,0,1,0,1,0
22789,33074,5900,0,0,60,60,0,1,0,1,0
22790,50255,445,0,0,70,70,0,1,0,1,0
22791,64214,25174,0,0,66,66,0,1,0,1,0
22792,50240,445,0,0,70,70,0,1,0,1,0
22793,50242,445,0,0,70,70,0,1,0,1,0
22794,40687,64147,0,0,62,62,0,1,0,1,0
22795,53197,25174,0,0,66,66,0,1,0,1,0
22796,56309,22114,0,0,62,62,0,1,0,1,0
22797,50822,50584,0,0,66,66,0,1,0,1,0
22798,61805,445,0,0,70,70,0,1,0,1,0
22799,57131,31061,0,0,145,145,0,1,0,1,0
22800,62013,445,0,0,66,66,0,1,0,1,0
22801,3937,36829,0,0,62,62,0,1,0,1,0
22802,53470,22114,0,0,66,66,0,1,0,1,0
22803,2946,25174,0,0,62,62,0,1,0,1,0
22804,46808,25174,0,0,146,146,0,1,0,1,0
22805,6881,8305,0,0,143,143,0,1,0,1,0
22806,51948,17372,0,0,62,62,0,1,0,1,0
22807,15345,36829,0,0,66,66,0,1,0,1,0
22808,56922,29434,0,0,107,107,0,1,0,1,0
22809,53906,17372,0,0,145,145,0,1,0,1,0
22810,54601,26467,0,0,66,66,0,1,0,1,0
22811,62006,445,0,0,66,66,0,1,0,1,0
22812,61801,445,0,0,70,70,0,1,0,1,0
22813,39195,25174,0,0,62,62,0,1,0,1,0
22814,50233,445,0,0,70,70,0,1,0,1,0
22815,62813,25174,0,0,62,62,0,1,0,1,0
22816,19455,25174,0,0,62,62,0,1,0,1,0
22817,63878,22114,0,0,62,62,0,1,0,1,0
22818,1266,57470,0,0,146,146,0,1,0,1,0
22819,49163,22114,0,0,62,62,0,1,0,1,0
22820,65400,36237,0,0,66,66,0,1,0,1,0
22821,61792,445,0,0,70,70,0,1,0,1,0
22822,33804,443,22331,443,5815,1128,4687,19,0,9,10
22823,61791,445,0,0,70,70,0,1,0,1,0
22824,61790,445,0,0,70,70,0,1,0,1,0
22825,62003,445,0,0,66,66,0,1,0,1,0
22826,61788,445,0,0,70,70,0,1,0,1,0
22827,61784,445,0,0,70,70,0,1,0,1,0
22828,54280,3398,0,0,60,60,0,1,0,1,0
22829,27000,23117,0,0,62,62,0,1,0,1,0
22830,63554,44847,0,0,66,66,0,1,0,1,0
22831,61997,445,0,0,66,66,0,1,0,1,0
22832,26469,26348,0,0,62,62,0,1,0,1,0
22833,32997,50584,0,0,62,62,0,1,0,1,0
22834,61993,445,0,0,66,66,0,1,0,1,0
22835,25756,22114,0,0,146,146,0,1,0,1,0
22836,20962,22114,0,0,62,62,0,1,0,1,0
22837,60438,17372,0,0,66,66,0,1,0,1,0
22838,53323,35253,0,0,66,66,0,1,0,1,0
22839,61779,445,0,0,70,70,0,1,0,1,0
22840,17270,44847,0,0,146,146,0,1,0,1,0
22841,24504,37965,0,0,62,62,0,1,0,1,0
22842,43332,81,0,0,60,60,0,1,0,1,0
22843,50254,2323,0,0,60,60,0,1,0,1,0
22844,55711,26467,0,0,66,66,0,1,0,1,0
22845,51746,25174,0,0,66,66,0,1,0,1,0
22846,23274,50584,0,0,146,146,0,1,0,1,0
22847,52459,5555,0,0,60,60,0,1,0,1,0
22848,48335,25174,0,0,62,62,0,1,0,1,0
22849,4500,4500,0,0,862,862,0,1,0,1,0
22850,43828,44847,0,0,66,66,0,1,0,1,0
22851,50222,445,0,0,70,70,0,1,0,1,0
22852,50218,445,0,0,70,70,0,1,0,1,0
22853,50219,445,0,0,70,70,0,1,0,1,0
22854,15513,25174,0,0,62,62,0,1,0,1,0
22855,61979,445,0,0,66,66,0,1,0,1,0
22856,61981,445,0,0,66,66,0,1,0,1,0
22857,61977,445,0,0,66,66,0,1,0,1,0
22858,61976,445,0,0,66,66,0,1,0,1,0
22859,61978,445,0,0,66,66,0,1,0,1,0
22860,61975,445,0,0,66,66,0,1,0,1,0
22861,61974,445,0,0,66,66,0,1,0,1,0
22862,61973,445,0,0,66,66,0,1,0,1,0
22863,5222,46866,0,0,66,66,0,1,0,1,0
22864,61771,445,0,0,70,70,0,1,0,1,0
22865,53841,37965,0,0,66,66,0,1,0,1,0
22866,61770,445,0,0,70,70,0,1,0,1,0
22867,50459,62413,0,0,66,66,0,1,0,1,0
22868,60260,22114,0,0,66,66,0,1,0,1,0
22869,52630,1433,0,0,60,60,0,1,0,1,0
22870,6355,25174,0,0,62,62,0,1,0,1,0
22871,39661,53733,0,0,146,146,0,1,0,1,0
22872,12965,37965,0,0,66,66,0,1,0,1,0
22873,9588,37965,0,0,62,62,0,1,0,1,0
22874,44388,63874,0,0,66,66,0,1,0,1,0
22875,61764,445,0,0,70,70,0,1,0,1,0
22876,61763,445,0,0,70,70,0,1,0,1,0
22877,53513,56205,0,0,146,146,0,1,0,1,0
22878,50211,445,0,0,70,70,0,1,0,1,0
22879,50209,445,0,0,70,70,0,1,0,1,0
22880,50201,445,0,0,70,70,0,1,0,1,0
22881,50199,445,0,0,70,70,0,1,0,1,0
22882,37455,50584,0,0,62,62,0,1,0,1,0
22883,64190,2767,0,0,66,66,0,1,0,1,0
22884,2394,55108,0,0,159,159,0,1,0,1,0
22885,61959,445,0,0,66,66,0,1,0,1,0
22886,61960,445,0,0,66,66,0,1,0,1,0
22887,61961,445,0,0,66,66,0,1,0,1,0
22888,61759,445,0,0,70,70,0,1,0,1,0
22889,2475,6881,0,0,66,66,0,1,0,1,0
22890,57284,22114,0,0,66,66,0,1,0,1,0
22891,25961,55783,0,0,62,62,0,1,0,1,0
22892,61758,445,0,0,70,70,0,1,0,1,0
22893,60823,25174,0,0,66,66,0,1,0,1,0
22894,38549,22114,0,0,146,146,0,1,0,1,0
22895,6712,44818,0,0,66,66,0,1,0,1,0
22896,50197,445,0,0,70,70,0,1,0,1,0
22897,64392,25174,0,0,66,66,0,1,0,1,0
22898,62064,22114,0,0,66,66,0,1,0,1,0
22899,61523,37807,0,0,66,66,0,1,0,1,0
22900,50192,445,0,0,70,70,0,1,0,1,0
22901,50191,445,0,0,70,70,0,1,0,1,0
22902,50187,445,0,0,70,70,0,1,0,1,0
22903,48513,44847,0,0,146,146,0,1,0,1,0
22904,52988,53567,0,0,66,66,0,1,0,1,0
22905,61753,445,0,0,70,70,0,1,0,1,0
22906,61190,21247,0,0,66,66,0,1,0,1,0
22907,37834,45129,0,0,145,145,0,1,0,1,0
22908,13840,37965,0,0,146,146,0,1,0,1,0
22909,50180,445,0,0,70,70,0,1,0,1,0
22910,50178,445,0,0,70,70,0,1,0,1,0
22911,50176,445,0,0,70,70,0,1,0,1,0
22912,26717,25174,0,0,62,62,0,1,0,1,0
22913,1262,23,0,0,60,60,0,1,0,1,0
22914,27195,21247,0,0,146,146,0,1,0,1,0
22915,55554,22114,0,0,62,62,0,1,0,1,0
22916,61948,445,0,0,66,66,0,1,0,1,0
22917,61740,445,0,0,70,70,0,1,0,1,0
22918,57333,443,55597,443,12837,1681,11156,30,62,16,14
22919,36754,443,36754,443,4699,1792,2907,19,30,11,8
22920,52043,43578,45799,43578,316,136,180,6,6,3,3
22921,27005,27015,49738,27015,893,126,767,2,30,1,1
22922,27005,27018,4129,27018,881,126,755,2,30,1,1
22923,35555,53,35555,53,194,87,107,2,30,1,1
22924,52022,53657,53149,53657,66,66,0,1,5,1,0
22925,52037,45647,32087,45647,316,136,180,6,7,3,3
22926,63965,11785,30846,11785,66,66,0,1,5,1,0
22927,35955,5228,64424,5228,6776,1542,5234,21,3600,12,9
22928,51149,443,26017,443,5092,2574,2518,14,135,7,7
22929,42749,53,42749,53,847,110,737,2,30,1,1
22930,26229,80,26229,80,7372,954,6418,17,18,9,8
22931,55691,16410,58376,16410,70,70,0,2,8,2,0
22932,53803,17637,39254,17637,70,70,0,1,5,1,0
22933,58874,443,12303,443,10630,6981,3649,31,17,17,14
22934,64612,53,64612,53,213,87,126,2,30,1,1
22935,27005,27015,45876,27015,886,126,760,2,30,1,1
22936,15503,51413,47539,51413,459,149,310,2,1200,1,1
22937,51463,53,0,0,82,82,0,1,30,1,0
22938,48013,53,0,0,82,82,0,1,30,1,0
22939,47892,443,19816,443,6454,1447,5007,22,17,11,11
22940,52038,14487,18653,14487,70,70,0,2,7,2,0
22941,57228,8525,57228,8525,138,78,60,2,5,1,1
22942,52039,38541,31838,38541,70,70,0,2,7,2,0
22943,52035,36498,46508,36498,70,70,0,2,9,2,0
22944,55687,47613,13232,47613,258,70,188,4,8,2,2
22945,52021,32202,28754,32202,66,66,0,1,5,1,0
22946,41395,443,34255,443,6292,1492,4800,22,17,11,11
22947,54666,443,61385,443,3648,1080,2568,18,135,8,10
22948,56222,5228,31508,5228,2531,1513,1018,17,3601,8,9
22949,58886,443,39424,443,3989,2585,1404,17,15,9,8
22950,52649,443,45569,443,6292,1492,4800,22,17,11,11
22951,50649,80,63151,80,1366,865,501,8,15,5,3
22952,59940,80,29186,80,1169137,23501,1145636,1104,22,344,760
22953,53614,443,48622,443,6352,1552,4800,23,17,12,11
22954,61099,443,33626,443,492,492,0,7,15,7,0
22955,55689,37558,21710,37558,70,70,0,2,8,2,0
22956,63961,51641,64148,51641,504,382,122,8,16,6,2
22957,49199,8106,41963,8106,370,190,180,6,15,3,3
22958,49566,80,12827,80,1268,703,565,11,23,6,5
22959,27005,27014,42282,27014,882,126,756,2,30,1,1
22960,33063,443,10345,443,6411,1611,4800,24,17,13,11
22961,27005,27016,41906,27016,882,126,756,2,30,1,1
22962,22263,53,22263,53,288,83,205,2,30,1,1
22963,53502,443,33693,443,10893,6516,4377,36,131,16,20
22964,57470,58695,5572,58695,726,726,0,12,1200,12,0
22965,26651,25174,0,0,146,146,0,1,0,1,0
22966,13159,37965,0,0,66,66,0,1,0,1,0
22967,52227,64147,0,0,66,66,0,1,0,1,0
22968,29139,64147,0,0,62,62,0,1,0,1,0
22969,40797,25174,0,0,62,62,0,1,0,1,0
22970,27860,23,0,0,60,60,0,1,0,1,0
22971,49521,80,17385,80,1653,831,822,13,93,7,6
22972,45630,443,4110,443,2996,1629,1367,17,21,9,8
22973,53799,6881,10719,6881,70,70,0,1,4,1,0
22974,52024,47600,3124,47600,70,70,0,1,4,1,0
22975,64891,53,61433,53,320,97,223,4,34,2,2
22976,57470,64738,24802,64738,1577,594,983,20,1582,10,10
22977,34297,443,14287,443,65853,31390,34463,203,694,105,98
22978,38675,443,37452,443,13929,2854,11075,43,128,22,21
22979,57587,443,15184,443,7150,1958,5192,28,144,14,14
22980,52179,443,47721,443,414,140,274,7,25,3,4
22981,42164,80,6790,80,1658,1344,314,10,15,5,5
22982,49440,443,59866,443,5141,896,4245,17,69,8,9
22983,51053,80,62409,80,1638,1324,314,10,14,5,5
22984,8291,23,8291,23,66,66,0,1,4,1,0
22985,53798,62166,25360,62166,164,70,94,2,4,1,1
22986,53807,28630,23692,28630,70,70,0,1,4,1,0
22987,53804,24067,28773,24067,70,70,0,1,4,1,0
22988,53805,34155,22730,34155,70,70,0,1,4,1,0
22989,63966,42532,2551,42532,70,70,0,1,4,1,0
22990,45768,80,41776,80,2784,1804,980,17,20,9,8
22991,49214,58485,20411,58485,70,70,0,1,5,1,0
22992,65245,53,10432,53,479,98,381,4,57,2,2
22993,39197,443,22296,443,65158,3519,61639,89,200,41,48
22994,50619,443,52531,443,10483,1021,9462,30,100,11,19
22995,64063,53,31532,53,339,110,229,2,29,1,1
22996,19328,53,26253,53,236,86,150,2,29,1,1
22997,49997,53,41448,53,284,94,190,2,29,1,1
22998,49581,80,58944,80,2339,1107,1232,11,21,6,5
22999,38957,443,58777,443,7457,1333,6124,18,200,10,8
23000,57082,80,34844,80,2944,1074,1870,12,75,7,5
23001,55012,443,47170,443,3388,2236,1152,28,904,16,12
23002,60787,40010,15005,40010,316,136,180,6,6,3,3
23003,65469,53,60792,53,327,110,217,2,30,1,1
23004,49216,63752,26927,63752,70,70,0,1,5,1,0
23005,52023,41791,57379,41791,70,70,0,1,5,1,0
23006,49443,80,19440,80,3642,1460,2182,23,143,12,11
23007,50710,443,41434,443,6141,1268,4873,22,18,12,10
23008,49558,80,45042,80,39679,7315,32364,45,24,17,28
23009,49212,38306,22542,38306,70,70,0,1,5,1,0
23010,36803,53,44440,53,243,86,157,2,30,1,1
23011,58046,443,58046,443,4682,1775,2907,19,29,11,8
23012,54677,443,15752,443,3704,1428,2276,14,135,7,7
23013,54819,443,51937,443,9035,1873,7162,28,124,14,14
23014,52609,443,37495,443,24091,7349,16742,75,162,36,39
23015,52036,52608,61881,52608,70,70,0,2,8,2,0
23016,50648,80,9788,80,1717,1247,470,9,15,5,4
23017,54548,7000,54548,7000,4487,2090,2397,15,15,8,7
23018,37573,443,7707,443,13637,6347,7290,34,46,20,14
23019,49319,53,53546,53,260,102,158,2,30,1,1
23020,48717,443,44246,443,232,172,60,3,5,2,1
23021,50169,53,35420,53,223,78,145,2,30,1,1
23022,49160,6889,25152,6889,834,150,684,4,1200,2,2
23023,53270,443,30676,443,6894,1556,5338,23,3601,13,10
23024,60993,443,45715,443,7201,2107,5094,23,61,13,10
23025,58887,443,25823,443,5167,700,4467,16,15,7,9
23026,45767,80,42626,80,2768,1722,1046,17,20,8,9
23027,55360,443,39812,443,6379,1762,4617,27,27,14,13
23028,49196,443,53527,443,789207,20847,768360,812,23,294,518
23029,58813,80,56191,80,2393,551,1842,10,21,6,4
23030,50181,443,54274,443,8113,2063,6050,23,255,11,12
23031,59758,443,17824,443,4114,2557,1557,22,418,9,13
23032,58888,443,9606,443,5166,700,4466,16,14,7,9
23033,52040,2524,8539,2524,70,70,0,2,7,2,0
23034,37672,5223,41244,5223,220,220,0,3,6,3,0
23035,53806,37267,20623,37267,70,70,0,1,4,1,0
23036,64214,53,1437,53,337,106,231,4,43,2,2
23037,46405,80,41634,80,1213,755,458,10,15,6,4
23038,37833,80,26930,80,2087,729,1358,10,15,5,5
23039,33642,443,1036,443,8533,4446,4087,65,160,32,33
23040,55310,53,40255,53,168,78,90,2,29,1,1
23041,65134,53,41256,53,273,102,171,2,30,1,1
23042,39442,123,6602,123,184,94,90,2,30,1,1
23043,20254,53,7951,53,223,78,145,2,29,1,1
23044,64463,53,2430,53,183,94,89,2,29,1,1
23045,27005,27015,6059,27015,881,126,755,2,30,1,1
23046,27988,40021,42591,40021,245,182,63,2,30,1,1
23047,49380,53,7490,53,110,110,0,1,30,1,0
23048,38886,53,39118,53,223,78,145,2,30,1,1
23049,64494,53,62617,53,402,118,284,2,30,1,1
23050,51487,443,12254,443,828,390,438,11,60,4,7
23051,49215,52611,6615,52611,70,70,0,1,5,1,0
23052,58885,443,57111,443,5167,700,4467,16,15,7,9
23053,41231,443,41940,443,65667,5371,60296,89,85,36,53
23054,48063,80,21248,80,1638,1324,314,10,15,5,5
23055,61100,80,15206,80,1516,481,1035,11,15,6,5
23056,60222,443,18964,443,4308,1658,2650,14,16,7,7
23057,27005,27015,5411,27015,887,126,761,2,30,1,1
23058,27005,27017,58319,27017,883,126,757,2,30,1,1
23059,55688,33958,47150,33958,70,70,0,2,8,2,0
23060,56662,80,65360,80,234,234,0,4,12,4,0
23061,49986,53,37815,53,312,93,219,4,37,2,2
23062,47282,443,1990,443,130,70,60,2,15,1,1
23063,61737,445,0,0,70,70,0,1,0,1,0
23064,49164,25174,0,0,62,62,0,1,0,1,0
23065,50172,445,0,0,70,70,0,1,0,1,0
23066,50170,445,0,0,70,70,0,1,0,1,0
23067,26425,22114,0,0,62,62,0,1,0,1,0
23068,16270,56205,0,0,62,62,0,1,0,1,0
23069,49916,53,53241,53,118,118,0,1,30,1,0
23070,46694,443,30947,443,3680,1777,1903,18,34,8,10
23071,64711,53,30437,53,179,86,93,2,30,1,1
23072,64906,53,18657,53,209,110,99,2,30,1,1
23073,64921,53,46383,53,238,102,136,2,31,1,1
23074,49211,15576,30482,15576,70,70,0,1,5,1,0
23075,40561,443,22594,443,3167,2456,711,15,16,10,5
23076,65149,443,54688,443,2963,1304,1659,28,120,14,14
23077,53796,48019,63153,48019,70,70,0,1,5,1,0
23078,58933,80,48784,80,2055,1651,404,8,76,5,3
23079,35595,80,11916,80,1566,684,882,10,15,5,5
23080,37802,80,16566,80,1702,1388,314,10,16,5,5
23081,39297,443,18589,443,21690,2882,18808,59,197,30,29
23082,51245,443,54725,443,9847,4746,5101,43,16,24,19
23083,55056,443,52975,443,8309,1561,6748,26,204,14,12
23084,38076,80,55546,80,15538,1307,14231,27,45,15,12
23085,38956,443,38557,443,9096,4245,4851,29,121,14,15
23086,27005,30000,27515,30000,913,126,787,2,31,1,1
23087,44182,443,55726,443,8241,1810,6431,25,20,14,11
23088,58879,443,4460,443,5168,700,4468,16,15,7,9
23089,49546,443,43053,443,1346,918,428,10,23,6,4
23090,49547,443,35951,443,1346,918,428,10,23,6,4
23091,54374,443,53616,443,7402,1350,6052,24,16,13,11
23092,41228,443,9093,443,9161,2210,6951,23,187,11,12
23093,10552,25174,0,0,62,62,0,1,0,1,0
23094,60163,26467,0,0,66,66,0,1,0,1,0
23095,40742,2967,0,0,62,62,0,1,0,1,0
23096,63577,30188,0,0,66,66,0,1,0,1,0
23097,55653,23,0,0,60,60,0,1,0,1,0
23098,61933,445,0,0,66,66,0,1,0,1,0
23099,61931,445,0,0,66,66,0,1,0,1,0
23100,49324,64147,0,0,66,66,0,1,0,1,0
23101,61733,445,0,0,70,70,0,1,0,1,0
23102,61731,445,0,0,70,70,0,1,0,1,0
23103,63895,44847,0,0,62,62,0,1,0,1,0
23104,15605,50265,0,0,62,62,0,1,0,1,0
23105,52230,50265,0,0,66,66,0,1,0,1,0
23106,61729,445,0,0,70,70,0,1,0,1,0
23107,50159,445,0,0,70,70,0,1,0,1,0
23108,50160,445,0,0,70,70,0,1,0,1,0
23109,50154,445,0,0,70,70,0,1,0,1,0
23110,50152,445,0,0,70,70,0,1,0,1,0
23111,13508,15503,0,0,66,66,0,1,0,1,0
23112,61927,445,0,0,66,66,0,1,0,1,0
23113,61918,445,0,0,66,66,0,1,0,1,0
23114,61911,445,0,0,66,66,0,1,0,1,0
23115,61917,445,0,0,66,66,0,1,0,1,0
23116,61916,445,0,0,66,66,0,1,0,1,0
23117,61912,445,0,0,66,66,0,1,0,1,0
23118,61910,445,0,0,66,66,0,1,0,1,0
23119,62991,51221,0,0,66,66,0,1,0,1,0
23120,22461,34021,0,0,62,62,0,1,0,1,0
23121,61722,445,0,0,70,70,0,1,0,1,0
23122,50145,445,0,0,70,70,0,1,0,1,0
23123,40840,21247,0,0,62,62,0,1,0,1,0
23124,22530,23718,0,0,66,66,0,1,0,1,0
23125,42951,22114,0,0,66,66,0,1,0,1,0
23126,33380,48817,0,0,146,146,0,1,0,1,0
23127,50142,445,0,0,70,70,0,1,0,1,0
23128,50140,445,0,0,70,70,0,1,0,1,0
23129,53883,443,37691,443,495,421,74,4,0,3,1
23130,53879,443,22578,443,499,425,74,4,1,3,1
23131,53874,443,50535,443,499,425,74,4,1,3,1
23132,53877,443,42282,443,499,425,74,4,1,3,1
23133,53875,443,27415,443,499,425,74,4,1,3,1
23134,53872,443,24185,443,499,425,74,4,1,3,1
23135,50138,445,0,0,70,70,0,1,0,1,0
23136,61720,445,0,0,70,70,0,1,0,1,0
23137,49001,40108,0,0,161,161,0,1,0,1,0
23138,61719,445,0,0,70,70,0,1,0,1,0
23139,64306,64147,0,0,66,66,0,1,0,1,0
23140,13518,25174,0,0,62,62,0,1,0,1,0
23141,61718,445,0,0,70,70,0,1,0,1,0
23142,21817,22114,0,0,62,62,0,1,0,1,0
23143,54206,25174,0,0,62,62,0,1,0,1,0
23144,61717,445,0,0,70,70,0,1,0,1,0
23145,64673,6881,0,0,66,66,0,1,0,1,0
23146,61714,445,0,0,70,70,0,1,0,1,0
23147,61711,445,0,0,70,70,0,1,0,1,0
23148,49001,40108,0,0,161,161,0,1,0,1,0
23149,12164,22114,0,0,62,62,0,1,0,1,0
23150,17262,25174,0,0,146,146,0,1,0,1,0
23151,25961,55783,0,0,60,60,0,1,0,1,0
23152,62654,35440,0,0,62,62,0,1,0,1,0
23153,28306,25604,0,0,62,62,0,1,0,1,0
23154,50137,445,0,0,70,70,0,1,0,1,0
23155,50133,445,0,0,70,70,0,1,0,1,0
23156,50132,445,0,0,70,70,0,1,0,1,0
23157,50316,25604,0,0,66,66,0,1,0,1,0
23158,61903,445,0,0,66,66,0,1,0,1,0
23159,61699,445,0,0,70,70,0,1,0,1,0
23160,61698,445,0,0,70,70,0,1,0,1,0
23161,21322,25174,0,0,146,146,0,1,0,1,0
23162,50129,445,0,0,70,70,0,1,0,1,0
23163,61692,445,0,0,70,70,0,1,0,1,0
23164,8239,37965,0,0,146,146,0,1,0,1,0
23165,61902,445,0,0,66,66,0,1,0,1,0
23166,61689,445,0,0,70,70,0,1,0,1,0
23167,61688,445,0,0,70,70,0,1,0,1,0
23168,49001,40108,0,0,161,161,0,1,0,1,0
23169,61899,445,0,0,66,66,0,1,0,1,0
23170,61898,445,0,0,66,66,0,1,0,1,0
23171,2946,25174,0,0,146,146,0,1,0,1,0
23172,63083,25174,0,0,66,66,0,1,0,1,0
23173,61897,445,0,0,66,66,0,1,0,1,0
23174,59366,35440,0,0,62,62,0,1,0,1,0
23175,37431,25174,0,0,146,146,0,1,0,1,0
23176,51109,11392,0,0,66,66,0,1,0,1,0
23177,53873,443,46663,443,499,425,74,4,1,3,1
23178,53878,443,30400,443,499,425,74,4,1,3,1
23179,53876,443,64698,443,499,425,74,4,1,3,1
23180,53868,443,61364,443,499,425,74,4,1,3,1
23181,53871,443,16922,443,499,425,74,4,1,3,1
23182,53863,443,62778,443,499,425,74,4,1,3,1
23183,53869,443,21669,443,499,425,74,4,1,3,1
23184,53865,443,28083,443,499,425,74,4,1,3,1
23185,53862,443,35996,443,499,425,74,4,1,3,1
23186,53870,443,3316,443,499,425,74,4,1,3,1
23187,53864,443,39351,443,499,425,74,4,1,3,1
23188,53861,443,51732,443,499,425,74,4,1,3,1
23189,53867,443,58511,443,499,425,74,4,1,3,1
23190,53860,443,61776,443,499,425,74,4,1,3,1
23191,53858,443,59816,443,499,425,74,4,1,3,1
23192,53866,443,56444,443,499,425,74,4,1,3,1
23193,53857,443,11803,443,499,425,74,4,1,3,1
23194,53859,443,52772,443,499,425,74,4,1,3,1
23195,53906,17372,0,0,62,62,0,1,0,1,0
23196,50123,445,0,0,70,70,0,1,0,1,0
23197,24560,25174,0,0,62,62,0,1,0,1,0
23198,56816,11392,0,0,66,66,0,1,0,1,0
23199,61677,445,0,0,70,70,0,1,0,1,0
23200,51490,1,0,0,100,100,0,1,0,1,0
23201,59424,50265,0,0,74,74,0,1,0,1,0
23202,50118,445,0,0,70,70,0,1,0,1,0
23203,55529,44847,0,0,66,66,0,1,0,1,0
23204,50112,445,0,0,70,70,0,1,0,1,0
23205,2238,22114,0,0,146,146,0,1,0,1,0
23206,16092,50265,0,0,62,62,0,1,0,1,0
23207,58357,62413,0,0,62,62,0,1,0,1,0
23208,51094,35440,0,0,66,66,0,1,0,1,0
23209,61885,445,0,0,66,66,0,1,0,1,0
23210,54280,3385,0,0,60,60,0,1,0,1,0
23211,16376,35440,0,0,62,62,0,1,0,1,0
23212,6881,6881,0,0,62,62,0,1,0,1,0
23213,8108,55108,0,0,157,157,0,1,0,1,0
23214,1025,25174,0,0,62,62,0,1,0,1,0
23215,61673,445,0,0,70,70,0,1,0,1,0
23216,58488,37965,0,0,62,62,0,1,0,1,0
23217,61878,445,0,0,66,66,0,1,0,1,0
23218,50106,445,0,0,70,70,0,1,0,1,0
23219,5841,22114,0,0,62,62,0,1,0,1,0
23220,26698,57470,0,0,62,62,0,1,0,1,0
23221,61661,445,0,0,70,70,0,1,0,1,0
23222,61664,445,0,0,70,70,0,1,0,1,0
23223,61662,445,0,0,70,70,0,1,0,1,0
23224,61659,445,0,0,70,70,0,1,0,1,0
23225,54752,31573,0,0,62,62,0,1,0,1,0
23226,61657,445,0,0,70,70,0,1,0,1,0
23227,52644,57209,0,0,66,66,0,1,0,1,0
23228,61875,445,0,0,66,66,0,1,0,1,0
23229,63116,22114,0,0,62,62,0,1,0,1,0
23230,63023,51505,0,0,66,66,0,1,0,1,0
23231,52143,37807,0,0,66,66,0,1,0,1,0
23232,61869,445,0,0,66,66,0,1,0,1,0
23233,36548,25174,0,0,62,62,0,1,0,1,0
23234,57762,25174,0,0,62,62,0,1,0,1,0
23235,47910,7461,0,0,60,60,0,1,0,1,0
23236,61865,445,0,0,66,66,0,1,0,1,0
23237,62769,25174,0,0,62,62,0,1,0,1,0
23238,61650,445,0,0,70,70,0,1,0,1,0
23239,42252,33303,0,0,60,60,0,1,0,1,0
23240,53539,44847,0,0,66,66,0,1,0,1,0
23241,59745,25174,0,0,62,62,0,1,0,1,0
23242,13285,29892,0,0,145,145,0,1,0,1,0
23243,0,0,0,0,320,320,0,5,0,5,0
23244,0,0,0,0,70,70,0,1,0,1,0
23245,22150,6881,0,0,146,146,0,1,0,1,0
23246,12184,56205,0,0,146,146,0,1,0,1,0
23247,61643,445,0,0,70,70,0,1,0,1,0
23248,50093,445,0,0,70,70,0,1,0,1,0
23249,50090,445,0,0,70,70,0,1,0,1,0
23250,50089,445,0,0,70,70,0,1,0,1,0
23251,61642,445,0,0,70,70,0,1,0,1,0
23252,61848,445,0,0,66,66,0,1,0,1,0
23253,61852,445,0,0,66,66,0,1,0,1,0
23254,61851,445,0,0,66,66,0,1,0,1,0
23255,61850,445,0,0,66,66,0,1,0,1,0
23256,61853,445,0,0,66,66,0,1,0,1,0
23257,61849,445,0,0,66,66,0,1,0,1,0
23258,61846,445,0,0,66,66,0,1,0,1,0
23259,65018,7302,0,0,146,146,0,1,0,1,0
23260,40977,21247,0,0,62,62,0,1,0,1,0
23261,17251,10387,0,0,159,159,0,1,0,1,0
23262,52210,51505,0,0,66,66,0,1,0,1,0
23263,57459,51505,0,0,62,62,0,1,0,1,0
23264,60342,36237,0,0,66,66,0,1,0,1,0
23265,15499,22114,0,0,62,62,0,1,0,1,0
23266,49160,59033,0,0,146,146,0,1,0,1,0
23267,25187,31573,0,0,62,62,0,1,0,1,0
23268,61635,445,0,0,70,70,0,1,0,1,0
23269,46856,25174,0,0,62,62,0,1,0,1,0
23270,23475,25174,0,0,146,146,0,1,0,1,0
23271,50977,56205,0,0,66,66,0,1,0,1,0
23272,80,37649,0,0,60,60,0,1,0,1,0
23273,15451,25174,0,0,146,146,0,1,0,1,0
23274,50651,25174,0,0,62,62,0,1,0,1,0
23275,14023,37965,0,0,62,62,0,1,0,1,0
23276,50082,445,0,0,70,70,0,1,0,1,0
23277,50080,445,0,0,70,70,0,1,0,1,0
23278,50073,445,0,0,70,70,0,1,0,1,0
23279,50071,445,0,0,70,70,0,1,0,1,0
23280,35291,44847,0,0,62,62,0,1,0,1,0
23281,61631,445,0,0,70,70,0,1,0,1,0
23282,48706,23393,0,0,60,60,0,1,0,1,0
23283,19875,30170,0,0,145,145,0,1,0,1,0
23284,10462,25174,0,0,62,62,0,1,0,1,0
23285,61833,445,0,0,66,66,0,1,0,1,0
23286,61832,445,0,0,66,66,0,1,0,1,0
23287,61831,445,0,0,66,66,0,1,0,1,0
23288,2278,25174,0,0,62,62,0,1,0,1,0
23289,14740,26467,0,0,62,62,0,1,0,1,0
23290,52318,22114,0,0,62,62,0,1,0,1,0
23291,61630,445,0,0,70,70,0,1,0,1,0
23292,31017,50584,0,0,62,62,0,1,0,1,0
23293,31627,64147,0,0,62,62,0,1,0,1,0
23294,35570,22114,0,0,62,62,0,1,0,1,0
23295,62792,53,0,0,88,88,0,1,0,1,0
23296,50069,445,0,0,70,70,0,1,0,1,0
23297,50573,22114,0,0,62,62,0,1,0,1,0
23298,50068,445,0,0,70,70,0,1,0,1,0
23299,50064,445,0,0,70,70,0,1,0,1,0
23300,50059,445,0,0,70,70,0,1,0,1,0
23301,63578,35440,0,0,66,66,0,1,0,1,0
23302,59813,53,59813,53,228,97,131,2,30,1,1
23303,21184,53,21184,53,194,87,107,2,30,1,1
23304,37382,80,11429,80,1221,781,440,11,16,6,5
23305,52016,80,9292,80,124703,6134,118569,147,125,64,83
23306,56539,443,14998,443,52465,2787,49678,66,80,26,40
23307,60463,6890,23297,6890,164,70,94,3,8,2,1
23308,41173,443,28924,443,11771,2624,9147,50,19,25,25
23309,50593,443,49390,443,6292,1492,4800,22,16,11,11
23310,27005,27016,3846,27016,889,126,763,2,30,1,1
23311,34616,443,64459,443,9265,4429,4836,23,18,14,9
23312,40147,443,40147,443,1092,575,517,10,145,5,5
23313,11350,3389,11350,3389,3850,1745,2105,19,18,11,8
23314,64771,53,46292,53,793,101,692,2,30,1,1
23315,57367,443,57367,443,4381,1474,2907,19,29,11,8
23316,53795,22719,46314,22719,164,70,94,2,6,1,1
23317,49680,80,4197,80,1548,847,701,10,16,5,5
23318,32959,443,7767,443,9262,2792,6470,53,616,28,25
23319,55511,443,12800,443,10499,2421,8078,28,15,14,14
23320,56415,53,16835,53,740,93,647,2,30,1,1
23321,49532,443,49532,443,20488,16649,3839,30,24,18,12
23322,56525,443,51595,443,14108,2487,11621,32,81,18,14
23323,52017,26175,30441,26175,66,66,0,1,5,1,0
23324,49201,17852,10581,17852,66,66,0,1,5,1,0
23325,52034,48856,21980,48856,70,70,0,2,9,2,0
23326,49209,52030,14863,52030,66,66,0,1,5,1,0
23327,37244,53,37244,53,172,76,96,2,30,1,1
23328,4738,53,4738,53,213,87,126,2,30,1,1
23329,11786,53,11786,53,194,87,107,2,30,1,1
23330,60341,443,14614,443,54103,3190,50913,68,362,27,41
23331,61289,53,61289,53,197,76,121,2,30,1,1
23332,49681,80,35209,80,4584,3642,942,15,15,8,7
23333,57119,80,41470,80,5774,783,4991,17,75,10,7
23334,40620,443,2727,443,7049,1412,5637,24,16,14,10
23335,58818,443,11066,443,1413,876,537,12,25,6,6
23336,56538,443,45521,443,7760,1599,6161,23,80,13,10
23337,65484,443,65484,443,4640,1733,2907,19,27,11,8
23338,58817,443,7616,443,1413,876,537,12,25,6,6
23339,2954,443,2954,443,6915,882,6033,16,149,9,7
23340,58483,443,25541,443,3024,709,2315,13,120,6,7
23341,58877,443,18145,443,2577,1550,1027,15,15,7,8
23342,47368,443,14689,443,7057,2186,4871,25,316,13,12
23343,46716,443,30978,443,7298,2661,4637,21,17,11,10
23344,49208,6881,5366,6881,66,66,0,1,5,1,0
23345,49533,443,49533,443,20402,16563,3839,29,24,17,12
23346,49901,53,49901,53,194,87,107,2,30,1,1
23347,54989,443,11421,443,34038,16039,17999,79,63,43,36
23348,16814,53,16814,53,217,87,130,2,30,1,1
23349,60166,443,38227,443,8198,2252,5946,29,318,14,15
23350,31011,53,31011,53,197,76,121,2,30,1,1
23351,27005,27015,44783,27015,939,126,813,2,30,1,1
23352,6881,38554,27434,38554,221,111,110,2,1200,1,1
23353,59319,53,47365,53,285,106,179,2,31,1,1
23354,59247,53,59247,53,825,99,726,2,31,1,1
23355,60505,53,0,0,340,90,250,2,31,1,1
23356,50820,443,59076,443,6133,1655,4478,12,121,5,7
23357,52332,443,60314,443,15746,4302,11444,17,122,5,12
23358,60505,53,0,0,340,90,250,2,31,1,1
23359,55269,53,20584,53,186,95,91,2,31,1,1
23360,58279,53,58279,53,847,110,737,2,31,1,1
23361,11859,64147,0,0,62,62,0,1,0,1,0
23362,41499,23,0,0,60,60,0,1,0,1,0
23363,61625,445,0,0,70,70,0,1,0,1,0
23364,2598,23718,0,0,62,62,0,1,0,1,0
23365,63888,57470,0,0,62,62,0,1,0,1,0
23366,55484,25174,0,0,62,62,0,1,0,1,0
23367,1882,43890,0,0,62,62,0,1,0,1,0
23368,55689,37965,0,0,66,66,0,1,0,1,0
23369,10701,11392,0,0,146,146,0,1,0,1,0
23370,20706,37965,0,0,62,62,0,1,0,1,0
23371,10088,37807,0,0,66,66,0,1,0,1,0
23372,51298,57470,0,0,66,66,0,1,0,1,0
23373,51800,80,7944,80,2169,472,1697,10,77,6,4
23374,54355,443,13555,443,15334,4707,10627,28,24,14,14
23375,54538,80,35235,80,4162,3455,707,14,15,8,6
23376,38077,80,35599,80,1484,601,883,9,44,6,3
23377,60132,443,39833,443,350,210,140,6,25,4,2
23378,33459,80,37833,80,1658,1344,314,10,14,5,5
23379,53132,443,53588,443,7271,2540,4731,32,20,18,14
23380,64327,53,59589,53,214,102,112,2,29,1,1
23381,64782,53,60235,53,212,102,110,2,29,1,1
23382,27005,27016,28994,27016,880,126,754,2,30,1,1
23383,27005,31000,15120,31000,898,126,772,2,30,1,1
23384,64160,53,55275,53,258,110,148,2,30,1,1
23385,56941,443,33358,443,4581,2831,1750,29,96,15,14
23386,42661,80,47037,80,78310,9243,69067,109,93,57,52
23387,63997,59512,17767,59512,312,132,180,6,5,3,3
23388,58926,80,29286,80,1291,887,404,8,89,5,3
23389,42663,80,49274,80,5562,1204,4358,11,91,7,4
23390,42665,80,22230,80,7651,2046,5605,16,91,10,6
23391,52019,40689,33926,40689,70,70,0,1,5,1,0
23392,64451,53,26294,53,363,92,271,4,31,2,2
23393,5385,22,5385,22,66,66,0,1,4,1,0
23394,9204,443,60040,443,5399,368,5031,18,31,5,13
23395,27005,27020,19187,27020,890,126,764,2,30,1,1
23396,27005,27016,54195,27016,876,126,750,2,30,1,1
23397,37635,443,24027,443,9406,2044,7362,27,21,16,11
23398,5588,5588,0,0,3354,1792,1562,46,192,23,23
23399,54808,443,25043,443,9657,1944,7713,31,82,15,16
23400,41593,53,64892,53,243,86,157,2,29,1,1
23401,35047,53,53594,53,70657,70002,655,845,88,839,6
23402,64581,443,64560,443,9221,2109,7112,28,32,15,13
23403,52020,28704,61808,28704,70,70,0,1,5,1,0
23404,52033,37905,61391,37905,70,70,0,2,8,2,0
23405,64394,53,6864,53,226,102,124,2,30,1,1
23406,52002,53,64717,53,289,86,203,2,30,1,1
23407,49206,12242,47287,12242,70,70,0,1,5,1,0
23408,53268,443,58840,443,4241,706,3535,14,25,8,6
23409,49202,31719,26471,31719,70,70,0,1,5,1,0
23410,49200,38001,12165,38001,70,70,0,1,5,1,0
23411,56059,80,49532,80,1151,711,440,10,15,5,5
23412,58875,443,10382,443,5168,700,4468,16,15,7,9
23413,60394,11136,28099,11136,7512,2276,5236,39,94,21,18
23414,60462,47821,34484,47821,70,70,0,2,8,2,0
23415,64515,53,64413,53,231,86,145,2,30,1,1
23416,33060,443,63569,443,25617,6531,19086,87,220,46,41
23417,49198,64509,55959,64509,70,70,0,1,5,1,0
23418,55269,53,18249,53,102,102,0,1,30,1,0
23419,54348,443,11963,443,8863,3511,5352,20,120,9,11
23420,57354,443,9548,443,28807,2716,26091,54,466,21,33
23421,56695,53,7335,53,183,94,89,2,30,1,1
23422,42454,443,47292,443,3513,795,2718,11,120,5,6
23423,60136,443,22877,443,3647,1221,2426,13,135,6,7
23424,65379,443,37475,443,76625,63648,12977,139,83,79,60
23425,60431,443,1098,443,3260,1646,1614,9,120,5,4
23426,65224,443,29038,443,18887,8273,10614,42,62,22,20
23427,48542,80,42394,80,811,671,140,6,32,4,2
23428,57903,80,16780,80,6457,1210,5247,14,17,8,6
23429,48550,80,64861,80,811,671,140,6,22,4,2
23430,37097,80,49884,80,1114,534,580,12,15,7,5
23431,39840,443,35916,443,6097,1540,4557,25,191,13,12
23432,51393,443,1567,443,4721,2724,1997,35,130,19,16
23433,42664,80,62788,80,63654,7979,55675,90,91,49,41
23434,50353,443,5439,443,130,70,60,3,4,2,1
23435,49548,443,37968,443,1346,918,428,10,22,6,4
23436,65127,443,61568,443,648,648,0,7,15,7,0
23437,49725,53,18742,53,211,102,109,2,29,1,1
23438,64359,53,13819,53,230,102,128,2,30,1,1
23439,51244,443,19950,443,8024,2572,5452,39,15,23,16
23440,50590,53,53774,53,889,404,485,10,30,5,5
23441,52065,443,43327,443,7851,2487,5364,35,383,16,19
23442,65281,53,27234,53,216,94,122,2,30,1,1
23443,49642,53,3732,53,302,110,192,2,30,1,1
23444,27005,27015,27369,27015,889,126,763,2,30,1,1
23445,57157,53,58237,53,458,188,270,6,30,3,3
23446,56695,53,47655,53,183,94,89,2,30,1,1
23447,64683,53,6623,53,168,78,90,2,30,1,1
23448,65129,53,16453,53,324,110,214,2,30,1,1
23449,55684,80,6722,80,70,70,0,2,8,2,0
23450,52018,2425,48269,2425,70,70,0,1,5,1,0
23451,45454,80,45454,80,42171,1901,40270,57,16,26,31
23452,62885,443,65198,443,8097,2684,5413,22,248,12,10
23453,38805,443,57310,443,6686,1197,5489,23,16,12,11
23454,37643,443,56932,443,10517,2926,7591,29,20,16,13
23455,49207,58751,38431,58751,70,70,0,1,5,1,0
23456,64152,53,18184,53,232,110,122,2,30,1,1
23457,56607,443,26886,443,133596,5859,127737,148,120,51,97
23458,55269,53,51344,53,193,102,91,2,30,1,1
23459,65080,53,46581,53,741,94,647,2,30,1,1
23460,33994,443,56656,443,19547,2951,16596,42,82,21,21
23461,52032,55505,56842,55505,70,70,0,2,8,2,0
23462,49210,33757,6282,33757,70,70,0,1,5,1,0
23463,8108,80,8108,80,7972,840,7132,16,50,6,10
23464,49416,80,5310,80,318,192,126,6,28,4,2
23465,35047,53,40543,53,214830,214584,246,2594,88,2591,3
23466,54033,443,12852,443,5260,2704,2556,13,121,7,6
23467,50821,443,29846,443,7619,3064,4555,14,121,6,8
23468,53545,443,54715,443,7330,2295,5035,19,135,9,10
23469,36983,80,48738,80,1143,401,742,9,360,5,4
23470,49366,443,29757,443,5777400,184445,5592955,6224,332,2268,3956
23471,40238,443,22315,443,7283,2384,4899,25,361,12,13
23472,10151,6881,1638,6881,460,150,310,2,1200,1,1
23473,27005,27015,1344,27015,880,126,754,3,31,2,1
23474,27005,27017,49884,27017,877,126,751,2,31,1,1
23475,27005,27015,55780,27015,873,126,747,3,31,2,1
23476,55245,443,43023,443,7725129,126824,7598305,6259,607,740,5519
23477,33555,443,31836,443,10856,3151,7705,34,361,16,18
23478,6881,6882,46322,6882,324,150,174,2,1200,1,1
23479,51221,51413,15223,51413,460,150,310,2,1200,1,1
23480,40326,443,22959,443,7937,3883,4054,65,4602,25,40
23481,5588,5588,0,0,3354,1792,1562,46,195,23,23
23482,60743,443,59766,443,7028,2639,4389,23,16,12,11
23483,27005,49000,16886,49000,887,126,761,2,31,1,1
23484,53824,41482,38792,41482,70,70,0,2,8,2,0
23485,53790,21011,8352,21011,70,70,0,1,5,1,0
23486,8243,443,8243,443,1024,539,485,10,58,5,5
23487,50619,80,32397,80,499,192,307,6,26,4,2
23488,49073,443,9351,443,7032,2643,4389,23,16,12,11
23489,57117,53,8258,53,209,102,107,2,31,1,1
23490,43788,80,23555,80,2597,699,1898,11,181,6,5
23491,53828,51354,7216,51354,70,70,0,2,8,2,0
23492,10012,40009,21244,40009,253,190,63,2,30,1,1
23493,56268,44847,0,0,66,66,0,1,0,1,0
23494,31991,23,0,0,60,60,0,1,0,1,0
23495,50051,445,0,0,70,70,0,1,0,1,0
23496,50050,445,0,0,70,70,0,1,0,1,0
23497,50049,445,0,0,70,70,0,1,0,1,0
23498,62424,37965,0,0,66,66,0,1,0,1,0
23499,49036,44847,0,0,146,146,0,1,0,1,0
23500,61612,445,0,0,70,70,0,1,0,1,0
23501,61550,5529,0,0,145,145,0,1,0,1,0
23502,61819,445,0,0,66,66,0,1,0,1,0
23503,50280,38558,0,0,62,62,0,1,0,1,0
23504,42898,25174,0,0,62,62,0,1,0,1,0
23505,50211,51050,0,0,66,66,0,1,0,1,0
23506,61609,445,0,0,70,70,0,1,0,1,0
23507,55008,21247,0,0,66,66,0,1,0,1,0
23508,51944,56205,0,0,66,66,0,1,0,1,0
23509,59592,37965,0,0,62,62,0,1,0,1,0
23510,58844,51505,0,0,66,66,0,1,0,1,0
23511,50044,445,0,0,70,70,0,1,0,1,0
23512,50036,445,0,0,70,70,0,1,0,1,0
23513,22530,25174,0,0,146,146,0,1,0,1,0
23514,3212,22114,0,0,62,62,0,1,0,1,0
23515,59451,50584,0,0,66,66,0,1,0,1,0
23516,26553,57470,0,0,62,62,0,1,0,1,0
23517,3341,23117,0,0,62,62,0,1,0,1,0
23518,61605,445,0,0,70,70,0,1,0,1,0
23519,61589,21247,0,0,62,62,0,1,0,1,0
23520,61603,445,0,0,70,70,0,1,0,1,0
23521,13021,25174,0,0,62,62,0,1,0,1,0
23522,26658,25174,0,0,146,146,0,1,0,1,0
23523,61806,445,0,0,66,66,0,1,0,1,0
23524,61803,445,0,0,66,66,0,1,0,1,0
23525,25565,13556,0,0,60,60,0,1,0,1,0
23526,39132,44847,0,0,66,66,0,1,0,1,0
23527,61601,445,0,0,70,70,0,1,0,1,0
23528,47461,50584,0,0,62,62,0,1,0,1,0
23529,55136,11392,0,0,66,66,0,1,0,1,0
23530,54721,22114,0,0,66,66,0,1,0,1,0
23531,50026,445,0,0,70,70,0,1,0,1,0
23532,50024,445,0,0,70,70,0,1,0,1,0
23533,50021,445,0,0,70,70,0,1,0,1,0
23534,50020,445,0,0,70,70,0,1,0,1,0
23535,56711,25174,0,0,146,146,0,1,0,1,0
23536,3875,25174,0,0,146,146,0,1,0,1,0
23537,10333,22114,0,0,62,62,0,1,0,1,0
23538,54614,37807,0,0,62,62,0,1,0,1,0
23539,11136,17500,0,0,62,62,0,1,0,1,0
23540,45941,23386,0,0,60,60,0,1,0,1,0
23541,61800,445,0,0,66,66,0,1,0,1,0
23542,15113,25174,0,0,62,62,0,1,0,1,0
23543,55713,25174,0,0,62,62,0,1,0,1,0
23544,8108,47807,0,0,157,157,0,1,0,1,0
23545,29988,44847,0,0,66,66,0,1,0,1,0
23546,61594,445,0,0,70,70,0,1,0,1,0
23547,61790,445,0,0,66,66,0,1,0,1,0
23548,61784,445,0,0,66,66,0,1,0,1,0
23549,61793,445,0,0,66,66,0,1,0,1,0
23550,61788,445,0,0,66,66,0,1,0,1,0
23551,61791,445,0,0,66,66,0,1,0,1,0
23552,61786,445,0,0,66,66,0,1,0,1,0
23553,61782,445,0,0,66,66,0,1,0,1,0
23554,63984,25174,0,0,62,62,0,1,0,1,0
23555,57131,8055,0,0,145,145,0,1,0,1,0
23556,14618,6881,0,0,62,62,0,1,0,1,0
23557,61592,445,0,0,70,70,0,1,0,1,0
23558,30179,23,0,0,60,60,0,1,0,1,0
23559,50017,445,0,0,70,70,0,1,0,1,0
23560,50197,64147,0,0,66,66,0,1,0,1,0
23561,54377,56205,0,0,66,66,0,1,0,1,0
23562,50013,445,0,0,70,70,0,1,0,1,0
23563,50010,445,0,0,70,70,0,1,0,1,0
23564,50009,445,0,0,70,70,0,1,0,1,0
23565,51564,50584,0,0,66,66,0,1,0,1,0
23566,40086,22114,0,0,62,62,0,1,0,1,0
23567,61591,445,0,0,70,70,0,1,0,1,0
23568,61590,445,0,0,70,70,0,1,0,1,0
23569,61589,445,0,0,70,70,0,1,0,1,0
23570,61583,445,0,0,70,70,0,1,0,1,0
23571,61586,445,0,0,70,70,0,1,0,1,0
23572,50478,51505,0,0,62,62,0,1,0,1,0
23573,65249,25864,0,0,72,72,0,1,0,1,0
23574,30800,25174,0,0,62,62,0,1,0,1,0
23575,18029,50584,0,0,66,66,0,1,0,1,0
23576,10688,25174,0,0,62,62,0,1,0,1,0
23577,52973,57470,0,0,74,74,0,1,0,1,0
23578,61571,445,0,0,70,70,0,1,0,1,0
23579,61570,445,0,0,70,70,0,1,0,1,0
23580,61566,445,0,0,70,70,0,1,0,1,0
23581,56874,67,0,0,60,60,0,1,0,1,0
23582,50007,445,0,0,70,70,0,1,0,1,0
23583,50006,445,0,0,70,70,0,1,0,1,0
23584,50004,445,0,0,70,70,0,1,0,1,0
23585,61561,445,0,0,70,70,0,1,0,1,0
23586,61560,445,0,0,70,70,0,1,0,1,0
23587,42252,33306,0,0,60,60,0,1,0,1,0
23588,51903,26467,0,0,62,62,0,1,0,1,0
23589,61777,445,0,0,66,66,0,1,0,1,0
23590,50000,445,0,0,70,70,0,1,0,1,0
23591,1027,64147,0,0,62,62,0,1,0,1,0
23592,57669,64147,0,0,66,66,0,1,0,1,0
23593,61773,445,0,0,66,66,0,1,0,1,0
23594,61772,445,0,0,66,66,0,1,0,1,0
23595,61770,445,0,0,66,66,0,1,0,1,0
23596,30575,11119,0,0,148,148,0,1,0,1,0
23597,54365,64147,0,0,62,62,0,1,0,1,0
23598,61768,445,0,0,66,66,0,1,0,1,0
23599,12465,11392,0,0,146,146,0,1,0,1,0
23600,38971,25174,0,0,146,146,0,1,0,1,0
23601,51414,22,0,0,60,60,0,1,0,1,0
23602,29697,51221,0,0,62,62,0,1,0,1,0
23603,61549,445,0,0,70,70,0,1,0,1,0
23604,59422,51221,0,0,62,62,0,1,0,1,0
23605,49993,445,0,0,70,70,0,1,0,1,0
23606,27343,55839,0,0,137,137,0,1,0,1,0
23607,60155,23718,0,0,66,66,0,1,0,1,0
23608,49988,445,0,0,70,70,0,1,0,1,0
23609,49987,445,0,0,70,70,0,1,0,1,0
23610,40095,23,0,0,60,60,0,1,0,1,0
23611,63460,55160,0,0,66,66,0,1,0,1,0
23612,7099,51505,0,0,62,62,0,1,0,1,0
23613,29016,25174,0,0,62,62,0,1,0,1,0
23614,56943,44847,0,0,62,62,0,1,0,1,0
23615,80,53945,0,0,60,60,0,1,0,1,0
23616,61757,445,0,0,66,66,0,1,0,1,0
23617,443,9986,0,0,669,669,0,1,0,1,0
23618,61545,445,0,0,70,70,0,1,0,1,0
23619,44147,64147,0,0,62,62,0,1,0,1,0
23620,67,68,0,0,346,346,0,1,0,1,0
23621,57797,64147,0,0,66,66,0,1,0,1,0
23622,57917,44847,0,0,62,62,0,1,0,1,0
23623,57073,57470,0,0,62,62,0,1,0,1,0
23624,63400,57470,0,0,66,66,0,1,0,1,0
23625,56131,37807,0,0,66,66,0,1,0,1,0
23626,443,62732,0,0,332,332,0,1,0,1,0
23627,61534,445,0,0,70,70,0,1,0,1,0
23628,61533,445,0,0,70,70,0,1,0,1,0
23629,61536,445,0,0,70,70,0,1,0,1,0
23630,49540,50584,0,0,66,66,0,1,0,1,0
23631,61750,445,0,0,66,66,0,1,0,1,0
23632,61530,445,0,0,70,70,0,1,0,1,0
23633,49974,445,0,0,70,70,0,1,0,1,0
23634,61528,445,0,0,70,70,0,1,0,1,0
23635,52471,22114,0,0,66,66,0,1,0,1,0
23636,60818,37965,0,0,62,62,0,1,0,1,0
23637,0,0,0,0,156,156,0,2,0,2,0
23638,0,0,0,0,156,156,0,2,0,2,0
23639,0,0,0,0,156,156,0,2,0,2,0
23640,0,0,0,0,156,156,0,2,0,2,0
23641,61747,445,0,0,66,66,0,1,0,1,0
23642,6703,21247,0,0,62,62,0,1,0,1,0
23643,19882,22114,0,0,62,62,0,1,0,1,0
23644,39996,23,0,0,60,60,0,1,0,1,0
23645,11688,23718,0,0,62,62,0,1,0,1,0
23646,62799,25174,0,0,146,146,0,1,0,1,0
23647,57982,25174,0,0,62,62,0,1,0,1,0
23648,63840,36829,0,0,66,66,0,1,0,1,0
23649,51155,56205,0,0,66,66,0,1,0,1,0
23650,50052,65008,0,0,60,60,0,1,0,1,0
23651,61739,445,0,0,66,66,0,1,0,1,0
23652,61522,445,0,0,70,70,0,1,0,1,0
23653,61735,445,0,0,66,66,0,1,0,1,0
23654,63084,64147,0,0,62,62,0,1,0,1,0
23655,62341,26467,0,0,62,62,0,1,0,1,0
23656,56770,26467,0,0,66,66,0,1,0,1,0
23657,61515,445,0,0,70,70,0,1,0,1,0
23658,55920,25174,0,0,62,62,0,1,0,1,0
23659,61512,445,0,0,70,70,0,1,0,1,0
23660,41848,23,0,0,60,60,0,1,0,1,0
23661,62014,35440,0,0,66,66,0,1,0,1,0
23662,55920,25174,0,0,146,146,0,1,0,1,0
23663,49964,445,0,0,70,70,0,1,0,1,0
23664,49961,445,0,0,70,70,0,1,0,1,0
23665,49960,445,0,0,70,70,0,1,0,1,0
23666,64124,25174,0,0,62,62,0,1,0,1,0
23667,17205,41864,0,0,143,143,0,1,0,1,0
23668,55562,50584,0,0,66,66,0,1,0,1,0
23669,61725,445,0,0,66,66,0,1,0,1,0
23670,61723,445,0,0,66,66,0,1,0,1,0
23671,61721,445,0,0,66,66,0,1,0,1,0
23672,61719,445,0,0,66,66,0,1,0,1,0
23673,61720,445,0,0,66,66,0,1,0,1,0
23674,61718,445,0,0,66,66,0,1,0,1,0
23675,61717,445,0,0,66,66,0,1,0,1,0
23676,49994,26467,0,0,66,66,0,1,0,1,0
23677,52321,26467,0,0,62,62,0,1,0,1,0
23678,61508,445,0,0,70,70,0,1,0,1,0
23679,62408,50584,0,0,66,66,0,1,0,1,0
23680,58250,35440,0,0,66,66,0,1,0,1,0
23681,61507,445,0,0,70,70,0,1,0,1,0
23682,443,60040,0,0,60,60,0,1,0,1,0
23683,7720,44847,0,0,66,66,0,1,0,1,0
23684,46367,36237,0,0,66,66,0,1,0,1,0
23685,26531,25174,0,0,146,146,0,1,0,1,0
23686,62792,53,0,0,88,88,0,1,0,1,0
23687,56161,62413,0,0,66,66,0,1,0,1,0
23688,2681,48817,0,0,146,146,0,1,0,1,0
23689,47040,25174,0,0,146,146,0,1,0,1,0
23690,62792,53,0,0,88,88,0,1,0,1,0
23691,64790,443,36803,443,53280,3270,50010,78,142,31,47
23692,55406,53,15179,53,768,99,669,2,30,1,1
23693,51959,443,18601,443,20648,4726,15922,40,48,19,21
23694,53789,47191,38332,47191,70,70,0,1,5,1,0
23695,56931,443,32343,443,34750,2997,31753,61,95,29,32
23696,64636,3389,64636,3389,3424,1710,1714,16,32,8,8
23697,52030,443,52030,443,4400,1493,2907,19,30,11,8
23698,40219,443,6179,443,2387,979,1408,15,36,6,9
23699,63962,10115,25745,10115,66,66,0,1,5,1,0
23700,58865,443,15727,443,10775,7126,3649,31,17,17,14
23701,1831,53,1831,53,194,87,107,2,30,1,1
23702,46216,443,47226,443,13769,11153,2616,30,361,16,14
23703,40472,443,17256,443,317215,285998,31217,436,982,244,192
23704,52016,58318,42027,58318,66,66,0,1,5,1,0
23705,52031,20301,11089,20301,70,70,0,2,8,2,0
23706,58281,53,0,0,82,82,0,2,40,2,0
23707,35437,443,7147,443,53756,46525,7231,82,275,51,31
23708,58869,443,7982,443,4052,2588,1464,18,16,9,9
23709,50607,443,39884,443,25263,2606,22657,41,90,19,22
23710,52830,443,59305,443,12577,3687,8890,63,415,30,33
23711,50981,443,20620,443,5553,1179,4374,24,80,13,11
23712,53155,28206,42266,28206,70,70,0,2,8,2,0
23713,53794,39607,26801,39607,70,70,0,1,5,1,0
23714,2547,53,2547,53,194,87,107,2,30,1,1
23715,27005,27013,23327,27013,869,126,743,2,30,1,1
23716,51961,443,54912,443,2600,1396,1204,18,48,10,8
23717,26978,443,38800,443,7547,2728,4819,26,20,13,13
23718,50982,443,1681,443,5552,1179,4373,24,80,13,11
23719,62854,443,62854,443,4579,1672,2907,19,29,11,8
23720,54063,80,60737,80,2545,515,2030,12,17,6,6
23721,53793,20468,19761,20468,70,70,0,1,5,1,0
23722,53156,57780,14557,57780,320,140,180,6,7,3,3
23723,56968,53,34326,53,762,97,665,2,30,1,1
23724,50116,22,50116,22,60,60,0,1,5,1,0
23725,50560,53,62139,53,755,94,661,2,30,1,1
23726,50859,53,0,0,286,79,207,2,30,1,1
23727,52189,53,52189,53,825,99,726,2,30,1,1
23728,50235,53,32276,53,768,99,669,2,30,1,1
23729,54630,53,54630,53,825,99,726,2,30,1,1
23730,19473,41049,5316,41049,149,149,0,1,1200,1,0
23731,50269,443,37644,443,8272,2455,5817,29,391,10,19
23732,53788,1,42504,1,70,70,0,1,5,1,0
23733,58845,443,51619,443,22402,14820,7582,52,20,29,23
23734,33809,80,12746,80,1052,612,440,10,15,5,5
23735,64547,53,37211,53,762,97,665,2,30,1,1
23736,10307,53,10307,53,213,87,126,2,30,1,1
23737,53791,16881,2744,16881,70,70,0,1,5,1,0
23738,24270,53,24270,53,825,99,726,2,30,1,1
23739,52013,35185,29346,35185,66,66,0,1,5,1,0
23740,58344,53,58344,53,847,110,737,2,30,1,1
23741,27005,27015,60571,27015,902,126,776,2,30,1,1
23742,56571,53,30480,53,749,94,655,2,31,1,1
23743,62121,443,9258,443,1864,250,1614,8,120,4,4
23744,27005,27017,40940,27017,600,126,474,2,31,1,1
23745,56941,443,11257,443,8304,2968,5336,24,362,13,11
23746,61503,445,0,0,70,70,0,1,0,1,0
23747,33215,37965,0,0,62,62,0,1,0,1,0
23748,32976,37965,0,0,66,66,0,1,0,1,0
23749,51655,26467,0,0,62,62,0,1,0,1,0
23750,49958,445,0,0,70,70,0,1,0,1,0
23751,49946,445,0,0,70,70,0,1,0,1,0
23752,49942,445,0,0,70,70,0,1,0,1,0
23753,36456,25174,0,0,62,62,0,1,0,1,0
23754,12632,25174,0,0,62,62,0,1,0,1,0
23755,51999,37965,0,0,62,62,0,1,0,1,0
23756,61501,445,0,0,70,70,0,1,0,1,0
23757,51756,64147,0,0,62,62,0,1,0,1,0
23758,45964,3111,0,0,60,60,0,1,0,1,0
23759,57479,56205,0,0,66,66,0,1,0,1,0
23760,2990,64147,0,0,62,62,0,1,0,1,0
23761,61702,445,0,0,66,66,0,1,0,1,0
23762,61704,445,0,0,66,66,0,1,0,1,0
23763,61703,445,0,0,66,66,0,1,0,1,0
23764,60806,51050,0,0,66,66,0,1,0,1,0
23765,6666,16010,0,0,60,60,0,1,0,1,0
23766,59663,37965,0,0,62,62,0,1,0,1,0
23767,59147,25174,0,0,146,146,0,1,0,1,0
23768,34932,38608,0,0,62,62,0,1,0,1,0
23769,33193,50584,0,0,146,146,0,1,0,1,0
23770,49676,53,32954,53,197,102,95,2,30,1,1
23771,49656,53,53745,53,309,118,191,2,30,1,1
23772,27005,27016,18981,27016,884,126,758,2,30,1,1
23773,48840,443,52863,443,3297,2327,970,22,51,11,11
23774,55839,56535,0,0,62,62,0,1,0,1,0
23775,49941,445,0,0,70,70,0,1,0,1,0
23776,61497,445,0,0,70,70,0,1,0,1,0
23777,49938,445,0,0,70,70,0,1,0,1,0
23778,49934,445,0,0,70,70,0,1,0,1,0
23779,49933,445,0,0,70,70,0,1,0,1,0
23780,7977,25174,0,0,62,62,0,1,0,1,0
23781,25510,48817,0,0,140,140,0,1,0,1,0
23782,46491,50584,0,0,66,66,0,1,0,1,0
23783,38592,57209,0,0,62,62,0,1,0,1,0
23784,12550,37807,0,0,62,62,0,1,0,1,0
23785,49923,445,0,0,70,70,0,1,0,1,0
23786,64463,53,5557,53,182,93,89,2,0,1,1
23787,60951,443,8364,443,11464,5499,5965,54,15,29,25
23788,55685,48407,34505,48407,320,140,180,6,6,3,3
23789,50939,443,29204,443,134,60,74,3,5,2,1
23790,49531,443,49531,443,95223,30803,64420,107,23,50,57
23791,49676,53,40519,53,197,102,95,2,30,1,1
23792,50585,80,50585,80,9588,4478,5110,28,21,16,12
23793,53785,33324,8660,33324,70,70,0,1,4,1,0
23794,62724,53,2730,53,195,78,117,2,29,1,1
23795,57033,443,35994,443,1092898,42451,1050447,1213,155,423,790
23796,63985,43081,42263,43081,66,66,0,2,7,2,0
23797,53826,10168,29575,10168,70,70,0,2,7,2,0
23798,53784,16671,31656,16671,70,70,0,1,4,1,0
23799,51607,53,46424,53,322,102,220,2,29,1,1
23800,64005,53,33305,53,226,102,124,2,30,1,1
23801,46072,443,46479,443,16656,3094,13562,29,271,14,15
23802,64907,53,3413,53,168,86,82,2,30,1,1
23803,65244,53,58540,53,378,99,279,4,45,2,2
23804,60451,17432,27417,17432,504,318,186,8,17,5,3
23805,51226,7275,28428,7275,416,210,206,7,16,4,3
23806,62884,5223,41292,5223,11427,6608,4819,37,248,21,16
23807,50544,53,44871,53,969,86,883,2,30,1,1
23808,55680,23711,32600,23711,70,70,0,1,5,1,0
23809,52014,20524,7082,20524,70,70,0,1,5,1,0
23810,51844,443,37014,443,6752,1387,5365,21,115,10,11
23811,55269,53,35707,53,193,102,91,2,31,1,1
23812,55956,443,61641,443,6058,1749,4309,22,200,13,9
23813,16689,53,15770,53,199,94,105,2,30,1,1
23814,64572,53,23687,53,561,104,457,4,57,2,2
23815,53782,42855,3816,42855,70,70,0,1,5,1,0
23816,44173,53,9700,53,168,78,90,2,30,1,1
23817,55681,31948,14765,31948,70,70,0,1,5,1,0
23818,49351,53,18900,53,212,102,110,2,30,1,1
23819,56864,15646,57596,15646,70,70,0,1,5,1,0
23820,55853,53,55965,53,197,102,95,2,30,1,1
23821,58873,443,46096,443,5166,700,4466,16,15,7,9
23822,51174,443,12417,443,786014,23908,762106,803,47,276,527
23823,55509,53,37936,53,215,102,113,2,30,1,1
23824,27005,27015,9880,27015,937,126,811,2,30,1,1
23825,49194,443,50497,443,159850,5338,154512,179,200,64,115
23826,50632,443,61474,443,10084,2145,7939,36,120,18,18
23827,56432,53,38041,53,195,102,93,2,30,1,1
23828,60199,443,60774,443,8958,1697,7261,18,15,9,9
23829,65121,53,39585,53,440,94,346,4,37,2,2
23830,38696,443,18796,443,1069542,21337,1048205,1028,16,310,718
23831,51212,443,57861,443,18745,11713,7032,67,77,37,30
23832,53605,443,11722,443,8738,2628,6110,23,154,11,12
23833,48098,80,19717,80,1638,1324,314,10,15,5,5
23834,37176,80,24453,80,941,526,415,11,315,6,5
23835,59377,53,59377,53,216,98,118,2,30,1,1
23836,55570,53,55501,53,341,134,207,2,30,1,1
23837,27005,27016,17329,27016,883,126,757,2,30,1,1
23838,37058,80,51116,80,1056,682,374,10,15,6,4
23839,9223,443,33719,443,4081,443,3638,12,15,6,6
23840,34768,443,44621,443,21905,3249,18656,38,271,18,20
23841,52093,443,48994,443,3687037,41923,3645114,3002,34,534,2468
23842,55690,54233,5574,54233,320,140,180,6,6,3,3
23843,63140,30685,55473,30685,70,70,0,2,8,2,0
23844,51099,443,34189,443,11482,3696,7786,28,62,15,13
23845,53827,5889,21032,5889,70,70,0,2,7,2,0
23846,53792,1,64543,1,70,70,0,1,4,1,0
23847,34341,28678,47024,28678,1806,1806,0,22,224,22,0
23848,42522,80,42522,80,29727,1571,28156,44,16,21,23
23849,49369,443,63066,443,6277395,184853,6092542,6543,317,2262,4281
23850,48068,443,12098,443,10418,1427,8991,27,16,12,15
23851,63996,443,19057,443,122293139,3727246,118565893,125460,331,39649,85811
23852,63957,80,57502,80,314,192,122,6,15,4,2
23853,49424,443,6642,443,77408,4295,73113,106,271,52,54
23854,57405,443,36790,443,5734,1543,4191,24,26,13,11
23855,49203,53,34232,53,195,102,93,2,30,1,1
23856,33990,443,59264,443,11404,1948,9456,30,81,15,15
23857,37075,80,46978,80,1678,1364,314,10,15,5,5
23858,43356,443,48473,443,79561,11513,68048,183,94,95,88
23859,53825,58968,28988,58968,70,70,0,2,7,2,0
23860,49421,53,13940,53,215,94,121,2,29,1,1
23861,16768,53,24708,53,199,94,105,2,30,1,1
23862,65379,53,2143,53,126,126,0,1,29,1,0
23863,64905,53,22894,53,458,188,270,6,29,3,3
23864,55323,443,19578,443,229587,8510,221077,245,121,82,163
23865,49393,443,42342,443,62,62,0,1,5,1,0
23866,52015,25487,39642,25487,70,70,0,1,5,1,0
23867,49203,53,1575,53,195,102,93,2,30,1,1
23868,64711,53,31035,53,273,118,155,2,30,1,1
23869,56661,80,6258,80,234,234,0,4,12,4,0
23870,65524,53,9019,53,386,122,264,4,52,2,2
23871,64683,53,44457,53,370,126,244,2,30,1,1
23872,10011,40005,27073,40005,148,86,62,2,30,1,1
23873,27005,27015,13852,27015,881,126,755,2,30,1,1
23874,56199,53,59192,53,227,110,117,2,30,1,1
23875,55679,1024,62004,1024,70,70,0,1,5,1,0
23876,49247,53,64384,53,776,283,493,8,82,4,4
23877,33062,53,30187,53,86,86,0,1,30,1,0
23878,44815,443,9189,443,7570,1955,5615,24,1179,12,12
23879,38420,80,16840,80,4535,1637,2898,23,2899,14,9
23880,50542,443,2915,443,6787,1846,4941,24,361,11,13
23881,6881,6881,44839,6881,238,118,120,2,1200,1,1
23882,27005,27017,47675,27017,878,126,752,2,31,1,1
23883,49380,443,11402,443,2382775,72482,2310293,2485,252,843,1642
23884,49340,443,62697,443,7492336,235716,7256620,8119,428,3022,5097
23885,51195,443,30169,443,291595,261981,29614,587,206,339,248
23886,34788,443,32056,443,8230,2275,5955,18,135,8,10
23887,44704,443,31142,443,7228,3478,3750,37,164,17,20
23888,33149,5228,22043,5228,15651,3559,12092,63,6557,28,35
23889,51547,443,55970,443,642,582,60,2,5,1,1
23890,60194,443,58489,443,8894,1633,7261,18,16,9,9
23891,58872,443,35466,443,5166,700,4466,16,15,7,9
23892,50641,80,49164,80,1658,1247,411,8,15,5,3
23893,51098,443,32791,443,7250,2813,4437,21,62,12,9
23894,56432,53,16819,53,195,102,93,2,30,1,1
23895,10003,40811,32278,40811,292,158,134,2,30,1,1
23896,21133,24035,37028,24035,481,150,331,2,1200,1,1
23897,38662,443,42991,443,6525,1695,4830,19,51,8,11
23898,57038,53,18190,53,240,86,154,2,30,1,1
23899,34150,443,7922,443,12564,9272,3292,66,107,31,35
23900,46434,443,35412,443,14879,4981,9898,43,121,21,22
23901,49922,445,0,0,70,70,0,1,0,1,0
23902,49919,445,0,0,70,70,0,1,0,1,0
23903,61482,445,0,0,70,70,0,1,0,1,0
23904,19455,25174,0,0,62,62,0,1,0,1,0
23905,61690,445,0,0,66,66,0,1,0,1,0
23906,37249,25174,0,0,146,146,0,1,0,1,0
23907,61479,445,0,0,70,70,0,1,0,1,0
23908,54876,25174,0,0,62,62,0,1,0,1,0
23909,12545,25174,0,0,146,146,0,1,0,1,0
23910,64155,60043,0,0,66,66,0,1,0,1,0
23911,42615,25174,0,0,146,146,0,1,0,1,0
23912,49913,445,0,0,70,70,0,1,0,1,0
23913,49907,445,0,0,70,70,0,1,0,1,0
23914,61474,445,0,0,70,70,0,1,0,1,0
23915,51705,22114,0,0,66,66,0,1,0,1,0
23916,60941,25174,0,0,62,62,0,1,0,1,0
23917,61473,445,0,0,70,70,0,1,0,1,0
23918,45981,51505,0,0,62,62,0,1,0,1,0
23919,33710,22114,0,0,146,146,0,1,0,1,0
23920,53469,36237,0,0,62,62,0,1,0,1,0
23921,6881,35894,0,0,62,62,0,1,0,1,0
23922,61471,445,0,0,70,70,0,1,0,1,0
23923,36903,56205,0,0,62,62,0,1,0,1,0
23924,61677,445,0,0,66,66,0,1,0,1,0
23925,61676,445,0,0,66,66,0,1,0,1,0
23926,57894,44847,0,0,62,62,0,1,0,1,0
23927,27507,25174,0,0,146,146,0,1,0,1,0
23928,2946,25174,0,0,62,62,0,1,0,1,0
23929,15249,22114,0,0,62,62,0,1,0,1,0
23930,47771,25174,0,0,62,62,0,1,0,1,0
23931,3928,64147,0,0,62,62,0,1,0,1,0
23932,49905,445,0,0,70,70,0,1,0,1,0
23933,49904,445,0,0,70,70,0,1,0,1,0
23934,49903,445,0,0,70,70,0,1,0,1,0
23935,49895,445,0,0,70,70,0,1,0,1,0
23936,3937,36829,0,0,62,62,0,1,0,1,0
23937,14489,25174,0,0,62,62,0,1,0,1,0
23938,15345,36829,0,0,66,66,0,1,0,1,0
23939,3584,25174,0,0,62,62,0,1,0,1,0
23940,61671,445,0,0,66,66,0,1,0,1,0
23941,3584,25174,0,0,146,146,0,1,0,1,0
23942,61464,445,0,0,70,70,0,1,0,1,0
23943,49629,26467,0,0,62,62,0,1,0,1,0
23944,47910,7454,0,0,60,60,0,1,0,1,0
23945,47910,7454,0,0,60,60,0,1,0,1,0
23946,1030,64147,0,0,62,62,0,1,0,1,0
23947,61462,445,0,0,70,70,0,1,0,1,0
23948,54601,26467,0,0,66,66,0,1,0,1,0
23949,50383,443,21192,443,452,386,66,4,1,3,1
23950,58914,37965,0,0,66,66,0,1,0,1,0
23951,64649,81,0,0,60,60,0,1,0,1,0
23952,61666,445,0,0,66,66,0,1,0,1,0
23953,61665,445,0,0,66,66,0,1,0,1,0
23954,61664,445,0,0,66,66,0,1,0,1,0
23955,61661,445,0,0,66,66,0,1,0,1,0
23956,61658,445,0,0,66,66,0,1,0,1,0
23957,61655,445,0,0,66,66,0,1,0,1,0
23958,61656,445,0,0,66,66,0,1,0,1,0
23959,53012,51050,0,0,62,62,0,1,0,1,0
23960,43461,35440,0,0,62,62,0,1,0,1,0
23961,61461,445,0,0,70,70,0,1,0,1,0
23962,49888,445,0,0,70,70,0,1,0,1,0
23963,12183,22114,0,0,62,62,0,1,0,1,0
23964,61460,445,0,0,70,70,0,1,0,1,0
23965,65400,36237,0,0,66,66,0,1,0,1,0
23966,61459,445,0,0,70,70,0,1,0,1,0
23967,49885,445,0,0,70,70,0,1,0,1,0
23968,49884,445,0,0,70,70,0,1,0,1,0
23969,49881,445,0,0,70,70,0,1,0,1,0
23970,61457,445,0,0,70,70,0,1,0,1,0
23971,61455,445,0,0,70,70,0,1,0,1,0
23972,15105,25174,0,0,146,146,0,1,0,1,0
23973,63554,44847,0,0,66,66,0,1,0,1,0
23974,32551,51221,0,0,62,62,0,1,0,1,0
23975,40687,64147,0,0,62,62,0,1,0,1,0
23976,62415,57470,0,0,66,66,0,1,0,1,0
23977,61441,445,0,0,70,70,0,1,0,1,0
23978,61440,445,0,0,70,70,0,1,0,1,0
23979,13166,57470,0,0,62,62,0,1,0,1,0
23980,59599,62413,0,0,62,62,0,1,0,1,0
23981,61437,445,0,0,70,70,0,1,0,1,0
23982,2622,25174,0,0,146,146,0,1,0,1,0
23983,61431,445,0,0,70,70,0,1,0,1,0
23984,61430,445,0,0,70,70,0,1,0,1,0
23985,50570,57470,0,0,66,66,0,1,0,1,0
23986,3585,64147,0,0,62,62,0,1,0,1,0
23987,49879,445,0,0,70,70,0,1,0,1,0
23988,53323,35253,0,0,66,66,0,1,0,1,0
23989,49875,445,0,0,70,70,0,1,0,1,0
23990,49874,445,0,0,70,70,0,1,0,1,0
23991,61647,445,0,0,66,66,0,1,0,1,0
23992,1024,26296,0,0,159,159,0,1,0,1,0
23993,49872,445,0,0,70,70,0,1,0,1,0
23994,61645,445,0,0,66,66,0,1,0,1,0
23995,61644,445,0,0,66,66,0,1,0,1,0
23996,61642,445,0,0,66,66,0,1,0,1,0
23997,19286,25174,0,0,146,146,0,1,0,1,0
23998,61640,445,0,0,66,66,0,1,0,1,0
23999,15513,25174,0,0,62,62,0,1,0,1,0
24000,61419,445,0,0,70,70,0,1,0,1,0
24001,24066,25174,0,0,146,146,0,1,0,1,0
24002,11136,15503,0,0,62,62,0,1,0,1,0
24003,61230,22114,0,0,62,62,0,1,0,1,0
24004,49867,445,0,0,70,70,0,1,0,1,0
24005,49861,445,0,0,70,70,0,1,0,1,0
24006,49860,445,0,0,70,70,0,1,0,1,0
24007,44388,63874,0,0,66,66,0,1,0,1,0
24008,53841,37965,0,0,66,66,0,1,0,1,0
24009,52146,1433,0,0,60,60,0,1,0,1,0
24010,0,0,0,0,82,82,0,1,0,1,0
24011,0,0,0,0,124,64,60,2,0,1,1
24012,61415,445,0,0,70,70,0,1,0,1,0
24013,56278,52752,0,0,62,62,0,1,0,1,0
24014,61630,445,0,0,66,66,0,1,0,1,0
24015,47788,12250,0,0,146,146,0,1,0,1,0
24016,42429,22114,0,0,62,62,0,1,0,1,0
24017,61405,445,0,0,70,70,0,1,0,1,0
24018,61406,445,0,0,70,70,0,1,0,1,0
24019,61404,445,0,0,70,70,0,1,0,1,0
24020,33582,44847,0,0,62,62,0,1,0,1,0
24021,61402,445,0,0,70,70,0,1,0,1,0
24022,2475,6881,0,0,66,66,0,1,0,1,0
24023,57994,30188,0,0,62,62,0,1,0,1,0
24024,12240,48817,0,0,146,146,0,1,0,1,0
24025,61399,445,0,0,70,70,0,1,0,1,0
24026,56309,22114,0,0,62,62,0,1,0,1,0
24027,61622,445,0,0,66,66,0,1,0,1,0
24028,49847,445,0,0,70,70,0,1,0,1,0
24029,25497,44847,0,0,62,62,0,1,0,1,0
24030,45941,23386,0,0,60,60,0,1,0,1,0
24031,40116,23,0,0,60,60,0,1,0,1,0
24032,5926,25174,0,0,62,62,0,1,0,1,0
24033,45313,64147,0,0,62,62,0,1,0,1,0
24034,61619,445,0,0,66,66,0,1,0,1,0
24035,55496,64097,0,0,62,62,0,1,0,1,0
24036,27773,56205,0,0,62,62,0,1,0,1,0
24037,52988,53567,0,0,66,66,0,1,0,1,0
24038,61190,21247,0,0,66,66,0,1,0,1,0
24039,61392,445,0,0,70,70,0,1,0,1,0
24040,57090,51505,0,0,66,66,0,1,0,1,0
24041,56718,50584,0,0,62,62,0,1,0,1,0
24042,62273,50584,0,0,66,66,0,1,0,1,0
24043,61613,445,0,0,66,66,0,1,0,1,0
24044,50757,64147,0,0,66,66,0,1,0,1,0
24045,56015,56205,0,0,62,62,0,1,0,1,0
24046,61608,445,0,0,66,66,0,1,0,1,0
24047,39460,23117,0,0,62,62,0,1,0,1,0
24048,60112,23,0,0,60,60,0,1,0,1,0
24049,50052,65008,0,0,60,60,0,1,0,1,0
24050,61385,445,0,0,70,70,0,1,0,1,0
24051,21993,25174,0,0,146,146,0,1,0,1,0
24052,61383,445,0,0,70,70,0,1,0,1,0
24053,50516,53,53120,53,168,86,82,2,30,1,1
24054,57622,7000,57622,7000,2343,856,1487,17,16,10,7
24055,50579,80,50579,80,32612,18106,14506,83,24,47,36
24056,40671,443,5840,443,190,70,120,4,15,2,2
24057,49317,443,8477,443,1486172,26246,1459926,1245,40,266,979
24058,43131,53,0,0,82,82,0,1,30,1,0
24059,41101,443,39031,443,7067,2430,4637,18,17,8,10
24060,55765,53,10201,53,770,101,669,2,30,1,1
24061,58842,443,44558,443,16260,10863,5397,39,19,21,18
24062,55842,80,22065,80,1151,711,440,10,15,5,5
24063,56817,53,9899,53,772,103,669,2,30,1,1
24064,54730,443,29479,443,20465,3839,16626,43,229,22,21
24065,44695,443,65027,443,4419,3179,1240,17,17,10,7
24066,55510,53,10819,53,578,286,292,9,15,5,4
24067,28743,53,28743,53,197,76,121,2,30,1,1
24068,64907,53,25739,53,168,86,82,2,30,1,1
24069,42386,443,40078,443,10424,3393,7031,31,274,16,15
24070,57106,33000,6001,33000,223,223,0,1,30,1,0
24071,55704,53,41065,53,752,93,659,2,30,1,1
24072,57044,53,19964,53,194,99,95,2,31,1,1
24073,55176,53,63516,53,190,97,93,2,31,1,1
24074,50046,443,28953,443,12134,6888,5246,27,37,15,12
24075,37568,443,13649,443,1702,861,841,19,110,10,9
24076,13088,80,11600,80,4079,3203,876,12,97,8,4
24077,56078,80,65466,80,2458,531,1927,11,75,6,5
24078,64843,53,27388,53,772,103,669,2,30,1,1
24079,65419,443,11559,443,2494,1643,851,17,24,9,8
24080,63548,443,63548,443,4742,1835,2907,19,29,11,8
24081,58863,443,23250,443,3873,2469,1404,17,16,9,8
24082,49839,443,44506,443,7021,1767,5254,26,224,13,13
24083,49573,53,33204,53,738,86,652,2,30,1,1
24084,38961,443,19720,443,67063,17409,49654,94,274,48,46
24085,38300,443,24962,443,200383,4673,195710,196,30,58,138
24086,50193,53,18428,53,770,101,669,2,30,1,1
24087,65342,53,53223,53,760,97,663,2,30,1,1
24088,49934,53,41301,53,752,93,659,2,30,1,1
24089,27005,27015,61503,27015,868,126,742,3,31,2,1
24090,55382,53,44759,53,738,86,652,2,31,1,1
24091,58868,443,40093,443,3867,2403,1464,17,15,8,9
24092,37874,19000,47411,19000,602,174,428,2,31,1,1
24093,49771,80,10429,80,254,128,126,5,16,3,2
24094,50582,80,50582,80,6647,4891,1756,23,21,13,10
24095,49312,443,38998,443,3171,2293,878,17,40,10,7
24096,58850,443,33361,443,9035,5883,3152,26,17,14,12
24097,55992,80,41926,80,57401,3150,54251,84,109,43,41
24098,56077,80,49245,80,2481,529,1952,11,75,6,5
24099,62074,443,62074,443,151233,12592,138641,190,19,88,102
24100,61295,443,61295,443,5014,1722,3292,17,18,10,7
24101,50912,53,50912,53,213,81,132,2,30,1,1
24102,52968,53,0,0,82,82,0,1,30,1,0
24103,27005,27015,5725,27015,876,126,750,2,30,1,1
24104,49964,53,9082,53,760,97,663,2,30,1,1
24105,65071,53,11229,53,93,93,0,2,60,2,0
24106,46215,443,63410,443,4182,2874,1308,17,361,9,8
24107,49522,443,58242,443,2731084,2639957,91127,2979,151,1945,1034
24108,55123,53,62052,53,762,97,665,2,31,1,1
24109,37965,11102,8568,11102,132,132,0,3,1200,3,0
24110,46211,443,8239,443,9805,1642,8163,24,362,12,12
24111,27005,27015,40148,27015,886,126,760,2,31,1,1
24112,46212,443,60547,443,9753,1572,8181,22,362,11,11
24113,40967,1433,0,0,60,60,0,1,0,1,0
24114,8999,57470,0,0,146,146,0,1,0,1,0
24115,63944,30188,0,0,62,62,0,1,0,1,0
24116,13159,37965,0,0,66,66,0,1,0,1,0
24117,55123,64097,0,0,66,66,0,1,0,1,0
24118,49835,445,0,0,70,70,0,1,0,1,0
24119,49834,445,0,0,70,70,0,1,0,1,0
24120,49832,445,0,0,70,70,0,1,0,1,0
24121,61379,445,0,0,70,70,0,1,0,1,0
24122,61597,445,0,0,66,66,0,1,0,1,0
24123,61596,445,0,0,66,66,0,1,0,1,0
24124,61595,445,0,0,66,66,0,1,0,1,0
24125,61593,445,0,0,66,66,0,1,0,1,0
24126,61594,445,0,0,66,66,0,1,0,1,0
24127,61592,445,0,0,66,66,0,1,0,1,0
24128,61591,445,0,0,66,66,0,1,0,1,0
24129,61589,445,0,0,66,66,0,1,0,1,0
24130,33912,25174,0,0,146,146,0,1,0,1,0
24131,59051,27520,0,0,62,62,0,1,0,1,0
24132,61377,445,0,0,70,70,0,1,0,1,0
24133,43725,57470,0,0,109,109,0,1,0,1,0
24134,16270,56205,0,0,62,62,0,1,0,1,0
24135,1046,25174,0,0,146,146,0,1,0,1,0
24136,61373,445,0,0,70,70,0,1,0,1,0
24137,36688,443,58971,443,178,118,60,2,15,1,1
24138,50298,53,22376,53,172,94,78,2,30,1,1
24139,34209,80,4661,80,1280,586,694,10,14,5,5
24140,10006,40025,40345,40025,284,190,94,2,29,1,1
24141,10552,25174,0,0,62,62,0,1,0,1,0
24142,10627,36829,0,0,146,146,0,1,0,1,0
24143,61372,445,0,0,70,70,0,1,0,1,0
24144,12986,64147,0,0,62,62,0,1,0,1,0
24145,49825,445,0,0,70,70,0,1,0,1,0
24146,49822,445,0,0,70,70,0,1,0,1,0
24147,49817,445,0,0,70,70,0,1,0,1,0
24148,49814,445,0,0,70,70,0,1,0,1,0
24149,40356,9192,0,0,145,145,0,1,0,1,0
24150,61140,27520,0,0,66,66,0,1,0,1,0
24151,48335,25174,0,0,62,62,0,1,0,1,0
24152,61576,445,0,0,66,66,0,1,0,1,0
24153,61575,445,0,0,66,66,0,1,0,1,0
24154,61574,445,0,0,66,66,0,1,0,1,0
24155,2636,7302,0,0,66,66,0,1,0,1,0
24156,13062,52752,0,0,66,66,0,1,0,1,0
24157,61367,445,0,0,70,70,0,1,0,1,0
24158,55012,64147,0,0,66,66,0,1,0,1,0
24159,40204,40031,4239,40031,140,78,62,2,29,1,1
24160,15241,53,62094,53,215,86,129,2,30,1,1
24161,53464,3389,53464,3389,4245,2461,1784,18,31,9,9
24162,49922,443,6981,443,11466,1320,10146,22,135,10,12
24163,50616,443,60964,443,8643,1918,6725,21,26,11,10
24164,10128,443,36900,443,22677,11756,10921,45,315,26,19
24165,65405,53,50341,53,560,104,456,4,43,2,2
24166,38697,443,5230,443,90001,3161,86840,91,15,26,65
24167,39803,443,33160,443,1701571,69958,1631613,1930,170,782,1148
24168,54993,53,49299,53,410,109,301,4,32,2,2
24169,63961,53,2242,53,373,171,202,5,40,3,2
24170,38873,443,28510,443,10209,2574,7635,39,917,18,21
24171,57044,53,35114,53,197,102,95,2,30,1,1
24172,55176,53,23619,53,195,102,93,2,30,1,1
24173,52489,53,54304,53,302,78,224,2,29,1,1
24174,64907,53,65054,53,168,86,82,2,29,1,1
24175,55853,53,20879,53,197,102,95,2,29,1,1
24176,65404,53,11597,53,182,94,88,2,30,1,1
24177,10978,8443,10978,8443,66,66,0,1,5,1,0
24178,50432,5222,28391,5222,28281,9813,18468,196,608,100,96
24179,64926,53,45252,53,257,102,155,2,30,1,1
24180,40290,22,40290,22,66,66,0,1,5,1,0
24181,35869,80,16584,80,2604,1690,914,20,610,11,9
24182,50673,443,61982,443,14723,2606,12117,54,19,22,32
24183,55836,443,63316,443,320,140,180,6,15,3,3
24184,56522,443,50354,443,5212,1037,4175,20,115,10,10
24185,55239,53,38143,53,272,94,178,2,30,1,1
24186,54287,443,13671,443,122,62,60,2,15,1,1
24187,60453,24369,18318,24369,70,70,0,1,5,1,0
24188,65024,53,6765,53,199,102,97,2,30,1,1
24189,42443,443,56747,443,5378,1512,3866,20,16,11,9
24190,58867,443,59291,443,5167,700,4467,16,15,7,9
24191,27005,27111,30399,27111,893,126,767,2,30,1,1
24192,27005,27015,38392,27015,878,126,752,2,30,1,1
24193,63139,12311,7837,12311,70,70,0,2,8,2,0
24194,55834,443,1790,443,190,70,120,4,15,2,2
24195,49742,53,64876,53,223,102,121,2,30,1,1
24196,57326,53,9216,53,180,94,86,2,35,1,1
24197,27005,27015,2437,27015,878,126,752,2,30,1,1
24198,64684,53,7467,53,757,102,655,2,30,1,1
24199,56523,443,42102,443,5212,1037,4175,20,115,10,10
24200,51641,443,16546,443,7419,2682,4737,26,66,13,13
24201,65499,443,30170,443,410116,12150,397966,421,16,148,273
24202,46082,443,8016,443,137024,6442,130582,171,109,61,110
24203,46085,443,28925,443,13018,2021,10997,34,95,14,20
24204,64555,53,23004,53,297,102,195,4,48,2,2
24205,64649,53,32892,53,807,94,713,2,30,1,1
24206,27005,27222,26856,27222,890,126,764,2,30,1,1
24207,52824,443,36459,443,7118,2239,4879,22,15,12,10
24208,46279,443,60019,443,172,172,0,2,5,2,0
24209,50578,80,50578,80,35580,13335,22245,69,23,38,31
24210,50584,80,50584,80,6706,4950,1756,23,20,13,10
24211,61461,443,61461,443,19070,4830,14240,33,18,18,15
24212,56524,443,12291,443,5212,1037,4175,20,115,10,10
24213,54449,443,31656,443,128477,6347,122130,155,276,56,99
24214,27005,27333,40989,27333,890,126,764,2,30,1,1
24215,55865,53,34168,53,807,94,713,2,30,1,1
24216,50516,53,58230,53,168,86,82,2,30,1,1
24217,49614,53,6383,53,183,94,89,2,30,1,1
24218,55821,443,39900,443,128791,11254,117537,141,132,48,93
24219,49894,80,26822,80,1409,735,674,12,17,5,7
24220,48574,443,45361,443,9336,1153,8183,27,34,14,13
24221,58871,443,24134,443,5106,700,4406,15,15,7,8
24222,51967,443,38807,443,10684,3167,7517,43,34,24,19
24223,46315,443,19188,443,5571,2240,3331,28,87,14,14
24224,53425,51689,2819,51689,546,306,240,9,142,5,4
24225,56388,443,41257,443,15485,8351,7134,71,130,40,31
24226,39180,443,51621,443,3221,2218,1003,16,15,8,8
24227,60195,443,54821,443,8894,1633,7261,18,15,9,9
24228,60782,20010,25511,20010,70,70,0,1,5,1,0
24229,49296,443,32357,443,50454,5259,45195,52,105,17,35
24230,10010,40029,17242,40029,148,86,62,2,29,1,1
24231,65460,53,50952,53,215,102,113,2,29,1,1
24232,49921,443,56889,443,11831,1466,10365,24,135,11,13
24233,55012,53,50167,53,275,110,165,2,30,1,1
24234,65440,53,38806,53,240,86,154,2,29,1,1
24235,27005,27019,53599,27019,881,126,755,2,30,1,1
24236,55865,53,22117,53,184,94,90,2,30,1,1
24237,50298,53,38554,53,164,86,78,2,30,1,1
24238,63560,443,29520,443,2773,1570,1203,22,275,11,11
24239,65024,53,19328,53,199,102,97,2,30,1,1
24240,26815,80,16585,80,2894,1095,1799,15,131,8,7
24241,63076,443,41788,443,7975,423,7552,15,119,6,9
24242,65286,53,17051,53,756,94,662,2,30,1,1
24243,49420,53,26234,53,364,102,262,2,30,1,1
24244,20222,53,8890,53,223,78,145,2,30,1,1
24245,59792,443,33674,443,12836,2016,10820,48,361,20,28
24246,35785,80,12900,80,1594,1280,314,10,15,5,5
24247,65500,443,21161,443,91813,4379,87434,101,16,37,64
24248,59044,53,47816,53,78,78,0,1,30,1,0
24249,65404,53,9178,53,198,110,88,2,30,1,1
24250,32927,443,31722,443,867883,29498,838385,922,58,328,594
24251,60036,161,64579,161,2800,2800,0,28,111,28,0
24252,49157,443,64620,443,2529,1230,1299,17,16,9,8
24253,34574,443,39427,443,130,70,60,2,15,1,1
24254,55057,443,7517,443,1364,940,424,12,16,7,5
24255,65101,53,44970,53,749,94,655,2,30,1,1
24256,64649,53,56977,53,184,94,90,2,30,1,1
24257,49867,53,28958,53,232,110,122,2,30,1,1
24258,55176,53,57165,53,195,102,93,2,30,1,1
24259,56724,53,27864,53,182,94,88,2,30,1,1
24260,49534,53,11716,53,193,102,91,2,31,1,1
24261,52092,443,50536,443,4642,3496,1146,18,16,10,8
24262,60461,10138,55813,10138,70,70,0,2,8,2,0
24263,60452,62582,62916,62582,70,70,0,1,5,1,0
24264,56435,80,7640,80,17248,1619,15629,26,25,11,15
24265,65432,53,2736,53,254,94,160,2,30,1,1
24266,57044,53,24810,53,197,102,95,2,30,1,1
24267,44847,43154,42931,43154,150,150,0,1,1200,1,0
24268,15503,52798,43633,52798,28448,16525,11923,253,3696,148,105
24269,30188,27772,64348,27772,502,150,352,2,1200,1,1
24270,37965,1,53190,1,330,330,0,6,1199,6,0
24271,51148,443,35605,443,4332,1907,2425,18,136,8,10
24272,6882,50239,19851,50239,296,150,146,2,1200,1,1
24273,55683,19215,63970,19215,320,140,180,6,7,3,3
24274,63978,63776,45573,63776,66,66,0,2,8,2,0
24275,63981,34250,53768,34250,66,66,0,2,8,2,0
24276,53822,18716,3913,18716,70,70,0,2,8,2,0
24277,64102,53,54377,53,619,102,517,4,43,2,2
24278,50077,53,56181,53,261,97,164,4,44,2,2
24279,47040,443,54181,443,10326,4295,6031,29,62,16,13
24280,50669,443,37355,443,12463,2350,10113,46,20,19,27
24281,49920,443,51438,443,10526,811,9715,20,135,8,12
24282,50077,53,51701,53,261,97,164,4,44,2,2
24283,9059,443,42849,443,19816,13030,6786,80,159,40,40
24284,63980,4804,28040,4804,66,66,0,2,8,2,0
24285,58866,443,35097,443,5166,700,4466,16,15,7,9
24286,55993,53,52586,53,199,102,97,2,30,1,1
24287,50596,53,57766,53,168,86,82,2,30,1,1
24288,57136,53,36933,53,209,110,99,2,31,1,1
24289,56055,53,2822,53,168,86,82,2,31,1,1
24290,54488,443,26044,443,4967,2482,2485,26,271,13,13
24291,60786,40010,58556,40010,316,136,180,6,7,3,3
24292,51462,3027,51462,3027,156,156,0,3,8,3,0
24293,53820,7488,11201,7488,70,70,0,2,8,2,0
24294,52008,49383,19063,49383,70,70,0,1,5,1,0
24295,58856,443,29128,443,2881,1766,1115,17,16,9,8
24296,64769,53,55242,53,418,150,268,2,30,1,1
24297,49812,445,0,0,70,70,0,1,0,1,0
24298,49806,445,0,0,70,70,0,1,0,1,0
24299,49807,445,0,0,70,70,0,1,0,1,0
24300,49805,445,0,0,70,70,0,1,0,1,0
24301,60558,51221,0,0,62,62,0,1,0,1,0
24302,62991,51221,0,0,66,66,0,1,0,1,0
24303,52578,34021,0,0,62,62,0,1,0,1,0
24304,12794,25174,0,0,146,146,0,1,0,1,0
24305,6889,8497,0,0,143,143,0,1,0,1,0
24306,57825,13014,0,0,74,74,0,1,0,1,0
24307,40840,21247,0,0,62,62,0,1,0,1,0
24308,62079,30188,0,0,62,62,0,1,0,1,0
24309,50160,57470,0,0,146,146,0,1,0,1,0
24310,13518,25174,0,0,62,62,0,1,0,1,0
24311,64306,64147,0,0,66,66,0,1,0,1,0
24312,58276,43890,0,0,62,62,0,1,0,1,0
24313,61354,445,0,0,70,70,0,1,0,1,0
24314,37014,23,0,0,60,60,0,1,0,1,0
24315,2890,443,2890,443,6915,882,6033,16,134,9,7
24316,12164,22114,0,0,62,62,0,1,0,1,0
24317,49795,445,0,0,70,70,0,1,0,1,0
24318,49792,445,0,0,70,70,0,1,0,1,0
24319,49789,445,0,0,70,70,0,1,0,1,0
24320,3478,61463,0,0,233,233,0,1,0,1,0
24321,3478,61463,0,0,1262,1262,0,1,0,1,0
24322,61351,445,0,0,70,70,0,1,0,1,0
24323,48706,23393,0,0,60,60,0,1,0,1,0
24324,61563,445,0,0,66,66,0,1,0,1,0
24325,60311,56205,0,0,62,62,0,1,0,1,0
24326,55766,36237,0,0,62,62,0,1,0,1,0
24327,3478,61463,0,0,301,301,0,1,0,1,0
24328,3478,61463,0,0,1248,1248,0,1,0,1,0
24329,61346,445,0,0,70,70,0,1,0,1,0
24330,27539,25174,0,0,146,146,0,1,0,1,0
24331,61345,445,0,0,70,70,0,1,0,1,0
24332,6355,25174,0,0,62,62,0,1,0,1,0
24333,49787,445,0,0,70,70,0,1,0,1,0
24334,49779,445,0,0,70,70,0,1,0,1,0
24335,13120,25174,0,0,146,146,0,1,0,1,0
24336,61343,445,0,0,70,70,0,1,0,1,0
24337,14103,35440,0,0,62,62,0,1,0,1,0
24338,14175,10387,0,0,159,159,0,1,0,1,0
24339,52973,57470,0,0,74,74,0,1,0,1,0
24340,50371,443,40015,443,456,390,66,4,0,3,1
24341,50372,443,12434,443,456,390,66,4,0,3,1
24342,29895,23,0,0,60,60,0,1,0,1,0
24343,51769,51505,0,0,66,66,0,1,0,1,0
24344,53546,46824,0,0,66,66,0,1,0,1,0
24345,56816,11392,0,0,66,66,0,1,0,1,0
24346,3478,61463,0,0,921,921,0,1,0,1,0
24347,61549,445,0,0,66,66,0,1,0,1,0
24348,61546,445,0,0,66,66,0,1,0,1,0
24349,48125,7548,0,0,60,60,0,1,0,1,0
24350,443,61686,0,0,1484,1484,0,1,0,1,0
24351,58195,38303,0,0,66,66,0,1,0,1,0
24352,5223,14446,0,0,220,220,0,1,0,1,0
24353,52459,5555,0,0,60,60,0,1,0,1,0
24354,58357,62413,0,0,62,62,0,1,0,1,0
24355,51094,35440,0,0,66,66,0,1,0,1,0
24356,59934,35440,0,0,62,62,0,1,0,1,0
24357,14350,56205,0,0,62,62,0,1,0,1,0
24358,49773,445,0,0,70,70,0,1,0,1,0
24359,49769,445,0,0,70,70,0,1,0,1,0
24360,49767,445,0,0,70,70,0,1,0,1,0
24361,49766,445,0,0,70,70,0,1,0,1,0
24362,61336,445,0,0,70,70,0,1,0,1,0
24363,3478,61463,0,0,164,164,0,1,0,1,0
24364,3478,61463,0,0,1262,1262,0,1,0,1,0
24365,45964,2225,0,0,60,60,0,1,0,1,0
24366,48327,57470,0,0,145,145,0,1,0,1,0
24367,61334,445,0,0,70,70,0,1,0,1,0
24368,61544,445,0,0,66,66,0,1,0,1,0
24369,1025,25174,0,0,62,62,0,1,0,1,0
24370,55524,46232,0,0,62,62,0,1,0,1,0
24371,24127,56205,0,0,66,66,0,1,0,1,0
24372,61333,445,0,0,70,70,0,1,0,1,0
24373,61536,445,0,0,66,66,0,1,0,1,0
24374,61532,445,0,0,66,66,0,1,0,1,0
24375,61537,445,0,0,66,66,0,1,0,1,0
24376,61530,445,0,0,66,66,0,1,0,1,0
24377,61538,445,0,0,66,66,0,1,0,1,0
24378,61535,445,0,0,66,66,0,1,0,1,0
24379,61528,445,0,0,66,66,0,1,0,1,0
24380,40797,25174,0,0,62,62,0,1,0,1,0
24381,61332,445,0,0,70,70,0,1,0,1,0
24382,45941,23386,0,0,60,60,0,1,0,1,0
24383,3478,61463,0,0,1188,1188,0,1,0,1,0
24384,61331,445,0,0,70,70,0,1,0,1,0
24385,14693,64147,0,0,62,62,0,1,0,1,0
24386,61329,445,0,0,70,70,0,1,0,1,0
24387,61326,445,0,0,70,70,0,1,0,1,0
24388,3478,61463,0,0,455,455,0,1,0,1,0
24389,3478,61463,0,0,1275,1275,0,1,0,1,0
24390,49761,445,0,0,70,70,0,1,0,1,0
24391,50063,35776,0,0,148,148,0,1,0,1,0
24392,49757,445,0,0,70,70,0,1,0,1,0
24393,49756,445,0,0,70,70,0,1,0,1,0
24394,49753,445,0,0,70,70,0,1,0,1,0
24395,54868,1433,0,0,60,60,0,1,0,1,0
24396,61313,445,0,0,70,70,0,1,0,1,0
24397,61312,445,0,0,70,70,0,1,0,1,0
24398,61306,445,0,0,70,70,0,1,0,1,0
24399,51453,64147,0,0,62,62,0,1,0,1,0
24400,61302,445,0,0,70,70,0,1,0,1,0
24401,61303,445,0,0,70,70,0,1,0,1,0
24402,3478,61463,0,0,928,928,0,1,0,1,0
24403,57762,25174,0,0,62,62,0,1,0,1,0
24404,63569,62413,0,0,66,66,0,1,0,1,0
24405,50160,57470,0,0,146,146,0,1,0,1,0
24406,23936,41615,0,0,146,146,0,1,0,1,0
24407,23936,41615,0,0,146,146,0,1,0,1,0
24408,58022,1471,0,0,60,60,0,1,0,1,0
24409,50160,57470,0,0,146,146,0,1,0,1,0
24410,53539,44847,0,0,66,66,0,1,0,1,0
24411,59745,25174,0,0,62,62,0,1,0,1,0
24412,49750,445,0,0,70,70,0,1,0,1,0
24413,49749,445,0,0,70,70,0,1,0,1,0
24414,49747,445,0,0,70,70,0,1,0,1,0
24415,3478,61463,0,0,665,665,0,1,0,1,0
24416,61522,445,0,0,66,66,0,1,0,1,0
24417,63467,37807,0,0,62,62,0,1,0,1,0
24418,49744,445,0,0,70,70,0,1,0,1,0
24419,62043,25174,0,0,146,146,0,1,0,1,0
24420,0,0,0,0,156,156,0,2,0,2,0
24421,0,0,0,0,2000,1020,980,20,0,10,10
24422,0,0,0,0,244,244,0,2,0,2,0
24423,61518,445,0,0,66,66,0,1,0,1,0
24424,1024,41055,0,0,157,157,0,1,0,1,0
24425,3478,61463,0,0,1097,1097,0,1,0,1,0
24426,61516,445,0,0,66,66,0,1,0,1,0
24427,61515,445,0,0,66,66,0,1,0,1,0
24428,61291,445,0,0,70,70,0,1,0,1,0
24429,61513,445,0,0,66,66,0,1,0,1,0
24430,31950,22114,0,0,62,62,0,1,0,1,0
24431,54206,25174,0,0,62,62,0,1,0,1,0
24432,46856,25174,0,0,62,62,0,1,0,1,0
24433,46330,56205,0,0,146,146,0,1,0,1,0
24434,45767,50584,0,0,146,146,0,1,0,1,0
24435,49736,445,0,0,70,70,0,1,0,1,0
24436,25187,31573,0,0,62,62,0,1,0,1,0
24437,25233,23,0,0,60,60,0,1,0,1,0
24438,49730,445,0,0,70,70,0,1,0,1,0
24439,49726,445,0,0,70,70,0,1,0,1,0
24440,63242,50584,0,0,66,66,0,1,0,1,0
24441,61287,445,0,0,70,70,0,1,0,1,0
24442,3478,61463,0,0,1049,1049,0,1,0,1,0
24443,61461,50584,0,0,62,62,0,1,0,1,0
24444,61502,445,0,0,66,66,0,1,0,1,0
24445,19790,35440,0,0,146,146,0,1,0,1,0
24446,61278,445,0,0,70,70,0,1,0,1,0
24447,61275,445,0,0,70,70,0,1,0,1,0
24448,61277,445,0,0,70,70,0,1,0,1,0
24449,63855,25174,0,0,146,146,0,1,0,1,0
24450,12143,56205,0,0,66,66,0,1,0,1,0
24451,61273,445,0,0,70,70,0,1,0,1,0
24452,52318,22114,0,0,62,62,0,1,0,1,0
24453,3375,35253,0,0,62,62,0,1,0,1,0
24454,61270,445,0,0,70,70,0,1,0,1,0
24455,31017,50584,0,0,62,62,0,1,0,1,0
24456,61494,445,0,0,66,66,0,1,0,1,0
24457,3478,61463,0,0,822,822,0,1,0,1,0
24458,49719,445,0,0,70,70,0,1,0,1,0
24459,26717,25174,0,0,146,146,0,1,0,1,0
24460,33886,65504,0,0,162,162,0,1,0,1,0
24461,29363,36237,0,0,146,146,0,1,0,1,0
24462,1882,43890,0,0,62,62,0,1,0,1,0
24463,25901,50265,0,0,62,62,0,1,0,1,0
24464,62067,80,14393,80,1862,616,1246,11,15,6,5
24465,58854,443,18047,443,5202,3361,1841,19,16,10,9
24466,38380,80,38380,80,5397,713,4684,14,16,8,6
24467,56715,443,19932,443,1207531,28695,1178836,1184,46,400,784
24468,54870,443,54870,443,313399,38167,275232,411,23,205,206
24469,57331,53,13149,53,1420,95,1325,4,32,2,2
24470,65184,53,54868,53,164,84,80,2,31,1,1
24471,54587,53,0,0,82,82,0,1,30,1,0
24472,56500,53,18802,53,775,103,672,2,31,1,1
24473,57136,53,51914,53,202,103,99,2,31,1,1
24474,56055,53,24959,53,168,86,82,2,30,1,1
24475,55830,53,60660,53,182,93,89,2,31,1,1
24476,58020,80,7358,80,2482,516,1966,11,75,6,5
24477,50042,80,50042,80,2986,1514,1472,10,15,6,4
24478,53821,7788,19069,7788,70,70,0,2,8,2,0
24479,48983,15000,51295,15000,130,70,60,2,6,1,1
24480,52030,43068,39879,43068,70,70,0,2,8,2,0
24481,53060,1433,53060,1433,60,60,0,1,5,1,0
24482,56505,443,54192,443,78426,3219,75207,98,96,37,61
24483,58846,443,58496,443,7680,4905,2775,24,17,12,12
24484,60587,443,60587,443,4572,1665,2907,19,27,11,8
24485,56590,53,27360,53,760,97,663,2,30,1,1
24486,56360,53,50871,53,814,110,704,2,30,1,1
24487,50542,53,19780,53,762,98,664,2,30,1,1
24488,61018,443,61018,443,4400,1493,2907,19,29,11,8
24489,51230,80,14122,80,579418,15579,563839,599,76,219,380
24490,63977,54486,31444,54486,66,66,0,2,8,2,0
24491,54833,443,54833,443,306802,26705,280097,395,21,190,205
24492,36858,443,39662,443,3789,2373,1416,24,26,14,10
24493,63976,25725,46114,25725,66,66,0,2,8,2,0
24494,62068,80,36797,80,2806,626,2180,12,15,6,6
24495,33661,53,33661,53,643,88,555,2,30,1,1
24496,53781,36366,2063,36366,70,70,0,1,5,1,0
24497,55076,53,44619,53,760,97,663,2,30,1,1
24498,27005,27017,29678,27017,917,126,791,2,30,1,1
24499,58113,3389,58113,3389,4245,2461,1784,18,33,9,9
24500,27005,27015,49152,27015,919,126,793,2,30,1,1
24501,54291,443,41478,443,8056,3762,4294,55,517,28,27
24502,44482,443,20797,443,7464,1869,5595,29,409,11,18
24503,50467,53,38713,53,758,93,665,2,31,1,1
24504,49898,53,38099,53,184,94,90,2,31,1,1
24505,53687,19010,53687,19010,64,64,0,1,31,1,0
24506,59003,443,53579,443,10196,6897,3299,39,121,20,19
24507,50584,53,23534,53,744,89,655,2,31,1,1
24508,55261,53,40486,53,716,95,621,2,31,1,1
24509,49534,53,33345,53,186,95,91,2,31,1,1
24510,55200,53,19804,53,202,103,99,2,31,1,1
24511,56697,53,31729,53,196,100,96,2,31,1,1
24512,55362,53,13886,53,190,97,93,2,31,1,1
24513,27005,27017,53289,27017,900,126,774,2,31,1,1
24514,50265,42805,33244,42805,480,149,331,2,1200,1,1
24515,55831,53,12169,53,182,93,89,2,31,1,1
24516,50219,53,44100,53,751,95,656,2,31,1,1
24517,57470,17984,29715,17984,870,330,540,12,1496,6,6
24518,64614,443,5122,443,5505,3166,2339,22,136,11,11
24519,52811,44847,0,0,66,66,0,1,0,1,0
24520,61491,445,0,0,66,66,0,1,0,1,0
24521,61265,445,0,0,70,70,0,1,0,1,0
24522,3478,61463,0,0,1063,1063,0,1,0,1,0
24523,3478,61463,0,0,1012,1012,0,1,0,1,0
24524,16376,35440,0,0,62,62,0,1,0,1,0
24525,61485,445,0,0,66,66,0,1,0,1,0
24526,61475,445,0,0,66,66,0,1,0,1,0
24527,3478,61463,0,0,164,164,0,1,0,1,0
24528,61257,445,0,0,70,70,0,1,0,1,0
24529,3478,61463,0,0,942,942,0,1,0,1,0
24530,51298,57470,0,0,66,66,0,1,0,1,0
24531,49296,80,39063,80,1515,481,1034,11,15,6,5
24532,54826,443,54826,443,158092,23051,135041,216,21,110,106
24533,52025,42442,23036,42442,70,70,0,2,7,2,0
24534,52011,10722,14551,10722,70,70,0,1,4,1,0
24535,56724,53,33113,53,182,94,88,2,29,1,1
24536,49677,53,61420,53,373,126,247,2,29,1,1
24537,8998,53,50504,53,225,78,147,2,29,1,1
24538,50378,53,9266,53,199,102,97,2,29,1,1
24539,55993,53,8187,53,199,102,97,2,29,1,1
24540,58862,443,26650,443,5167,700,4467,16,15,7,9
24541,63975,24874,26677,24874,66,66,0,2,7,2,0
24542,52026,12523,2339,12523,70,70,0,2,7,2,0
24543,63139,53,8265,53,78,78,0,2,31,2,0
24544,52007,37732,20807,37732,70,70,0,1,4,1,0
24545,49197,2710,30685,2710,70,70,0,1,4,1,0
24546,49537,80,13843,80,5514,3156,2358,21,66,15,6
24547,50596,53,52895,53,168,86,82,2,29,1,1
24548,58860,443,58775,443,5594,3484,2110,16,15,8,8
24549,45852,53,16051,53,774,76,698,4,29,2,2
24550,37093,53,37093,53,645,90,555,2,29,1,1
24551,25463,53,62402,53,827,91,736,4,29,2,2
24552,26079,53,52153,53,226,78,148,2,29,1,1
24553,50378,53,11083,53,199,102,97,2,29,1,1
24554,50378,53,26291,53,199,102,97,2,29,1,1
24555,65504,53,13937,53,216,94,122,2,30,1,1
24556,55176,53,60647,53,195,102,93,2,30,1,1
24557,56961,53,64914,53,757,102,655,2,30,1,1
24558,51453,80,39611,80,214,140,74,4,15,3,1
24559,49749,443,9817,443,438048,86860,351188,491,420,213,278
24560,49895,443,62049,443,493316,12157,481159,470,94,122,348
24561,50100,53,44319,53,216,110,106,2,30,1,1
24562,50386,53,42277,53,782,110,672,2,30,1,1
24563,64548,53,58347,53,209,110,99,2,30,1,1
24564,49317,53,61782,53,194,102,92,2,30,1,1
24565,54998,53,51168,53,195,102,93,2,30,1,1
24566,64827,53,50756,53,291,86,205,2,30,1,1
24567,49842,443,3993,443,6212,1823,4389,16,75,9,7
24568,38799,53,0,0,86,86,0,1,30,1,0
24569,38101,443,38674,443,190,70,120,4,15,2,2
24570,55107,53,60503,53,816,102,714,2,30,1,1
24571,53638,443,51723,443,24895,2856,22039,46,270,22,24
24572,55223,443,2473,443,1118883,33814,1085069,1206,48,451,755
24573,62480,443,56428,443,1326,876,450,11,26,6,5
24574,64126,53,37940,53,216,102,114,2,30,1,1
24575,53770,58120,33681,58120,684,432,252,10,19,6,4
24576,56456,53,45669,53,199,102,97,2,30,1,1
24577,55380,53,60904,53,289,97,192,4,45,2,2
24578,56456,53,39368,53,199,102,97,2,30,1,1
24579,39839,443,5588,443,5829,1408,4421,21,188,11,10
24580,63138,51452,48571,51452,70,70,0,2,8,2,0
24581,55830,53,64690,53,183,94,89,2,30,1,1
24582,55715,53,57381,53,168,86,82,2,30,1,1
24583,7318,443,16542,443,6458,2658,3800,34,255,16,18
24584,50028,53,64249,53,256,102,154,2,30,1,1
24585,57435,53,43686,53,184,102,82,2,30,1,1
24586,56799,80,63768,80,1514,481,1033,11,15,6,5
24587,49199,53,25125,53,193,102,91,2,30,1,1
24588,49199,53,34176,53,816,102,714,2,30,1,1
24589,54476,443,29193,443,48303,3997,44306,69,271,30,39
24590,49678,80,44529,80,1977,921,1056,9,15,5,4
24591,41714,443,33432,443,4590,3026,1564,28,80,15,13
24592,64387,53,16161,53,359,99,260,4,54,2,2
24593,49503,443,38675,443,1363701,35511,1328190,1382,271,476,906
24594,57340,53,29949,53,216,110,106,2,30,1,1
24595,27005,27015,8670,27015,877,126,751,2,30,1,1
24596,65300,53,36602,53,758,102,656,2,30,1,1
24597,51263,443,3091,443,8247,2116,6131,23,360,11,12
24598,55392,443,3923,443,7347,2127,5220,18,135,8,10
24599,55042,443,48187,443,5409,1471,3938,21,17,12,9
24600,57340,53,7589,53,216,110,106,2,30,1,1
24601,58864,443,14029,443,5167,700,4467,16,15,7,9
24602,33971,443,52032,443,244193,7090,237103,260,136,87,173
24603,52027,49743,54736,49743,70,70,0,2,7,2,0
24604,50126,443,34426,443,15032,5689,9343,51,35,27,24
24605,50211,1688,29763,1688,70,70,0,2,7,2,0
24606,57893,80,44001,80,318,192,126,6,26,4,2
24607,49772,80,38817,80,70,70,0,1,5,1,0
24608,59734,443,48585,443,1312,651,661,13,184,7,6
24609,33845,443,64577,443,6495,1547,4948,19,318,10,9
24610,55285,53,16025,53,268,95,173,4,47,2,2
24611,58872,443,3820,443,1178,820,358,9,15,6,3
24612,57034,443,8240,443,30645,2719,27926,60,153,25,35
24613,56660,80,51147,80,234,234,0,4,12,4,0
24614,64794,80,22092,80,22646,1660,20986,29,135,10,19
24615,55285,53,18984,53,268,95,173,4,46,2,2
24616,53819,9472,27834,9472,70,70,0,2,7,2,0
24617,52029,52093,47612,52093,70,70,0,2,7,2,0
24618,64589,53,62557,53,814,110,704,2,29,1,1
24619,27724,53,46943,53,322,84,238,4,29,2,2
24620,64882,53,62094,53,343,134,209,2,30,1,1
24621,56357,53,8894,53,168,86,82,2,30,1,1
24622,39422,80,48610,80,1057,683,374,10,15,6,4
24623,64774,53,37147,53,214,102,112,2,29,1,1
24624,49614,53,48973,53,183,94,89,2,29,1,1
24625,56372,53,7936,53,172,94,78,2,30,1,1
24626,56456,53,58146,53,199,102,97,2,30,1,1
24627,65234,53,55204,53,248,110,138,2,29,1,1
24628,62749,53,25858,53,184,86,98,2,30,1,1
24629,56372,53,63368,53,172,94,78,2,29,1,1
24630,49283,53,8368,53,251,102,149,2,30,1,1
24631,39869,53,19258,53,394,80,314,4,29,2,2
24632,50100,53,47683,53,216,110,106,2,30,1,1
24633,56357,53,62096,53,168,86,82,2,30,1,1
24634,27005,27015,51947,27015,879,126,753,2,30,1,1
24635,55651,53,17505,53,199,102,97,2,30,1,1
24636,27005,27013,41883,27013,879,126,753,2,30,1,1
24637,65431,53,63045,53,210,102,108,2,30,1,1
24638,57044,53,35705,53,197,102,95,2,30,1,1
24639,64991,53,4692,53,779,86,693,2,30,1,1
24640,50450,53,9173,53,209,110,99,2,30,1,1
24641,51795,443,38241,443,4209,2221,1988,25,157,12,13
24642,60582,53,13685,53,180,86,94,2,30,1,1
24643,49572,443,38388,443,11583,4967,6616,31,47,17,14
24644,38086,53,54095,53,199,94,105,2,30,1,1
24645,49568,53,32071,53,168,86,82,2,31,1,1
24646,59964,443,21876,443,1346200,44765,1301435,1428,128,479,949
24647,15503,61284,64885,61284,16553,6930,9623,212,6269,106,106
24648,57340,53,2776,53,216,110,106,2,30,1,1
24649,50450,53,51972,53,209,110,99,2,30,1,1
24650,51867,53,1821,53,179,86,93,2,30,1,1
24651,65184,53,13116,53,166,86,80,2,30,1,1
24652,56738,53,38791,53,821,102,719,2,30,1,1
24653,49543,53,52836,53,200,102,98,2,30,1,1
24654,56738,53,58828,53,198,102,96,2,30,1,1
24655,65152,53,32824,53,167,86,81,2,31,1,1
24656,50308,443,46748,443,44311,4535,39776,55,121,21,34
24657,37965,31483,54456,31483,4530,2856,1674,62,2421,35,27
24658,52845,443,44053,443,2082,1322,760,14,41,8,6
24659,28474,3389,28474,3389,3850,1745,2105,19,18,11,8
24660,48676,53395,48676,53395,124,60,64,3,5,2,1
24661,64957,53,41435,53,506,131,375,4,41,2,2
24662,51110,80,32972,80,23850,1662,22188,36,15,19,17
24663,50672,443,34507,443,6202,1828,4374,25,18,12,13
24664,52148,443,33858,443,375357,11451,363906,356,61,100,256
24665,41398,443,9003,443,3135,1968,1167,22,72,12,10
24666,65309,53,6020,53,227,110,117,2,30,1,1
24667,57435,53,39763,53,184,102,82,2,30,1,1
24668,50011,53,7545,53,766,102,664,2,30,1,1
24669,27005,27018,3011,27018,882,126,756,2,30,1,1
24670,50137,53,54059,53,183,94,89,2,31,1,1
24671,49677,80,37951,80,1977,921,1056,9,16,5,4
24672,57136,53,22982,53,209,110,99,2,30,1,1
24673,56626,53,17271,53,224,102,122,2,30,1,1
24674,57054,53,38199,53,164,78,86,2,30,1,1
24675,27005,27015,34659,27015,899,126,773,2,30,1,1
24676,55107,53,32486,53,193,102,91,2,30,1,1
24677,39888,53,65133,53,168,78,90,2,30,1,1
24678,50630,53,64139,53,209,110,99,2,30,1,1
24679,65515,53,15950,53,652,209,443,6,50,3,3
24680,50100,53,23176,53,216,110,106,2,30,1,1
24681,65193,53,19280,53,436,94,342,2,30,1,1
24682,27005,27444,51395,27444,893,126,767,2,30,1,1
24683,49898,53,31342,53,184,94,90,2,30,1,1
24684,56365,53,8027,53,199,102,97,2,30,1,1
24685,55830,53,46828,53,183,94,89,2,30,1,1
24686,56365,53,14208,53,199,102,97,2,30,1,1
24687,49898,53,13665,53,184,94,90,2,30,1,1
24688,17750,51965,19962,51965,150,150,0,1,1200,1,0
24689,46479,443,13902,443,5241,2026,3215,50,6660,18,32
24690,55849,53,18869,53,195,102,93,2,31,1,1
24691,65112,53,1739,53,209,110,99,2,31,1,1
24692,40040,5223,48273,5223,5386,1100,4286,27,686,10,17
24693,64655,443,35493,443,8903,2857,6046,22,135,10,12
24694,57707,443,36174,443,3150,1709,1441,26,276,13,13
24695,37965,46008,3180,46008,132,132,0,3,1200,3,0
24696,56934,53,48178,53,216,110,106,2,31,1,1
24697,37965,15357,58016,15357,481,150,331,2,1200,1,1
24698,53818,15337,22779,15337,258,70,188,4,8,2,2
24699,37612,443,3287,443,2141,1270,871,18,130,10,8
24700,53133,443,4728,443,5610,1599,4011,24,17,14,10
24701,65219,53,52496,53,197,102,95,2,31,1,1
24702,62478,443,29633,443,10391,7059,3332,27,27,15,12
24703,62479,443,46621,443,14673,3914,10759,31,27,14,17
24704,50609,80,7480,80,12986,6816,6170,26,26,12,14
24705,44086,443,28968,443,8542,4191,4351,84,616,46,38
24706,52006,49849,60139,49849,70,70,0,1,5,1,0
24707,64768,80,26612,80,18045,3544,14501,28,156,12,16
24708,49326,53,56279,53,765,102,663,2,30,1,1
24709,123,123,56817,123,184,94,90,2,30,1,1
24710,53258,53,63456,53,277,78,199,2,30,1,1
24711,59802,53,61597,53,168,78,90,2,30,1,1
24712,50418,53,14403,53,177,94,83,2,30,1,1
24713,61255,445,0,0,70,70,0,1,0,1,0
24714,45964,3111,0,0,60,60,0,1,0,1,0
24715,62424,37965,0,0,66,66,0,1,0,1,0
24716,28221,37965,0,0,62,62,0,1,0,1,0
24717,63888,57470,0,0,62,62,0,1,0,1,0
24718,61250,445,0,0,70,70,0,1,0,1,0
24719,61248,445,0,0,70,70,0,1,0,1,0
24720,3478,61463,0,0,1163,1163,0,1,0,1,0
24721,49708,445,0,0,70,70,0,1,0,1,0
24722,49705,445,0,0,70,70,0,1,0,1,0
24723,14023,37965,0,0,62,62,0,1,0,1,0
24724,50211,51050,0,0,66,66,0,1,0,1,0
24725,61463,445,0,0,66,66,0,1,0,1,0
24726,61469,445,0,0,66,66,0,1,0,1,0
24727,61462,445,0,0,66,66,0,1,0,1,0
24728,61467,445,0,0,66,66,0,1,0,1,0
24729,61464,445,0,0,66,66,0,1,0,1,0
24730,61465,445,0,0,66,66,0,1,0,1,0
24731,61468,445,0,0,66,66,0,1,0,1,0
24732,55008,21247,0,0,66,66,0,1,0,1,0
24733,61244,445,0,0,70,70,0,1,0,1,0
24734,3212,22114,0,0,62,62,0,1,0,1,0
24735,11716,37965,0,0,62,62,0,1,0,1,0
24736,3212,22114,0,0,146,146,0,1,0,1,0
24737,14696,42707,0,0,62,62,0,1,0,1,0
24738,3478,61463,0,0,451,451,0,1,0,1,0
24739,3478,61463,0,0,174,174,0,1,0,1,0
24740,61243,445,0,0,70,70,0,1,0,1,0
24741,63030,25174,0,0,146,146,0,1,0,1,0
24742,3478,61463,0,0,68,68,0,1,0,1,0
24743,39132,44847,0,0,66,66,0,1,0,1,0
24744,49701,445,0,0,70,70,0,1,0,1,0
24745,49700,445,0,0,70,70,0,1,0,1,0
24746,49695,445,0,0,70,70,0,1,0,1,0
24747,49688,445,0,0,70,70,0,1,0,1,0
24748,64543,50265,0,0,66,66,0,1,0,1,0
24749,3478,61463,0,0,944,944,0,1,0,1,0
24750,61448,445,0,0,66,66,0,1,0,1,0
24751,61449,445,0,0,66,66,0,1,0,1,0
24752,61447,445,0,0,66,66,0,1,0,1,0
24753,33405,37965,0,0,62,62,0,1,0,1,0
24754,61238,445,0,0,70,70,0,1,0,1,0
24755,10333,22114,0,0,62,62,0,1,0,1,0
24756,11136,57587,0,0,62,62,0,1,0,1,0
24757,59451,50584,0,0,66,66,0,1,0,1,0
24758,55713,25174,0,0,62,62,0,1,0,1,0
24759,49685,445,0,0,70,70,0,1,0,1,0
24760,55674,5900,0,0,60,60,0,1,0,1,0
24761,3478,61463,0,0,927,927,0,1,0,1,0
24762,49678,445,0,0,70,70,0,1,0,1,0
24763,49677,445,0,0,70,70,0,1,0,1,0
24764,49674,445,0,0,70,70,0,1,0,1,0
24765,2531,30188,0,0,62,62,0,1,0,1,0
24766,15113,25174,0,0,62,62,0,1,0,1,0
24767,49163,22114,0,0,146,146,0,1,0,1,0
24768,15266,55783,0,0,145,145,0,1,0,1,0
24769,50197,64147,0,0,66,66,0,1,0,1,0
24770,50651,25174,0,0,62,62,0,1,0,1,0
24771,63397,26467,0,0,66,66,0,1,0,1,0
24772,3478,61463,0,0,928,928,0,1,0,1,0
24773,14567,37965,0,0,62,62,0,1,0,1,0
24774,61225,445,0,0,70,70,0,1,0,1,0
24775,2886,35440,0,0,66,66,0,1,0,1,0
24776,36717,51505,0,0,146,146,0,1,0,1,0
24777,61222,445,0,0,70,70,0,1,0,1,0
24778,49664,445,0,0,70,70,0,1,0,1,0
24779,53100,443,19603,443,472,406,66,4,0,3,1
24780,49663,445,0,0,70,70,0,1,0,1,0
24781,49661,445,0,0,70,70,0,1,0,1,0
24782,61970,57866,0,0,62,62,0,1,0,1,0
24783,19699,48817,0,0,143,143,0,1,0,1,0
24784,62219,25174,0,0,146,146,0,1,0,1,0
24785,52973,57470,0,0,74,74,0,1,0,1,0
24786,3478,61463,0,0,1188,1188,0,1,0,1,0
24787,3478,61463,0,0,364,364,0,1,0,1,0
24788,3478,61463,0,0,1162,1162,0,1,0,1,0
24789,61435,445,0,0,66,66,0,1,0,1,0
24790,65249,25864,0,0,72,72,0,1,0,1,0
24791,20706,37965,0,0,62,62,0,1,0,1,0
24792,45682,37965,0,0,62,62,0,1,0,1,0
24793,61218,445,0,0,70,70,0,1,0,1,0
24794,1873,37965,0,0,62,62,0,1,0,1,0
24795,61216,445,0,0,70,70,0,1,0,1,0
24796,3478,61463,0,0,164,164,0,1,0,1,0
24797,3478,61463,0,0,214,214,0,1,0,1,0
24798,3478,61463,0,0,1292,1292,0,1,0,1,0
24799,61214,445,0,0,70,70,0,1,0,1,0
24800,49657,445,0,0,70,70,0,1,0,1,0
24801,49651,445,0,0,70,70,0,1,0,1,0
24802,61420,445,0,0,66,66,0,1,0,1,0
24803,61419,445,0,0,66,66,0,1,0,1,0
24804,3478,61463,0,0,933,933,0,1,0,1,0
24805,63460,55160,0,0,66,66,0,1,0,1,0
24806,59043,35440,0,0,62,62,0,1,0,1,0
24807,50339,25174,0,0,146,146,0,1,0,1,0
24808,56943,44847,0,0,62,62,0,1,0,1,0
24809,61207,445,0,0,70,70,0,1,0,1,0
24810,42898,25174,0,0,62,62,0,1,0,1,0
24811,6666,990,0,0,60,60,0,1,0,1,0
24812,10022,55839,0,0,145,145,0,1,0,1,0
24813,49644,445,0,0,70,70,0,1,0,1,0
24814,49646,445,0,0,70,70,0,1,0,1,0
24815,49643,445,0,0,70,70,0,1,0,1,0
24816,49641,445,0,0,70,70,0,1,0,1,0
24817,61205,445,0,0,70,70,0,1,0,1,0
24818,53143,50584,0,0,66,66,0,1,0,1,0
24819,29195,51505,0,0,146,146,0,1,0,1,0
24820,51830,42707,0,0,66,66,0,1,0,1,0
24821,3478,61463,0,0,901,901,0,1,0,1,0
24822,61415,445,0,0,66,66,0,1,0,1,0
24823,61204,445,0,0,70,70,0,1,0,1,0
24824,49540,50584,0,0,66,66,0,1,0,1,0
24825,61203,445,0,0,70,70,0,1,0,1,0
24826,61202,445,0,0,70,70,0,1,0,1,0
24827,61200,445,0,0,70,70,0,1,0,1,0
24828,61197,445,0,0,70,70,0,1,0,1,0
24829,61403,445,0,0,66,66,0,1,0,1,0
24830,61402,445,0,0,66,66,0,1,0,1,0
24831,61410,445,0,0,66,66,0,1,0,1,0
24832,61408,445,0,0,66,66,0,1,0,1,0
24833,61399,445,0,0,66,66,0,1,0,1,0
24834,61405,445,0,0,66,66,0,1,0,1,0
24835,61398,445,0,0,66,66,0,1,0,1,0
24836,52471,22114,0,0,66,66,0,1,0,1,0
24837,49632,445,0,0,70,70,0,1,0,1,0
24838,3478,61463,0,0,1103,1103,0,1,0,1,0
24839,56582,23718,0,0,62,62,0,1,0,1,0
24840,53871,37965,0,0,66,66,0,1,0,1,0
24841,49628,445,0,0,70,70,0,1,0,1,0
24842,49627,445,0,0,70,70,0,1,0,1,0
24843,49625,445,0,0,70,70,0,1,0,1,0
24844,11688,23718,0,0,62,62,0,1,0,1,0
24845,45941,23388,0,0,60,60,0,1,0,1,0
24846,19882,22114,0,0,62,62,0,1,0,1,0
24847,61184,445,0,0,70,70,0,1,0,1,0
24848,61183,445,0,0,70,70,0,1,0,1,0
24849,61181,445,0,0,70,70,0,1,0,1,0
24850,61174,445,0,0,70,70,0,1,0,1,0
24851,61173,445,0,0,70,70,0,1,0,1,0
24852,51155,56205,0,0,66,66,0,1,0,1,0
24853,63840,36829,0,0,66,66,0,1,0,1,0
24854,3478,61463,0,0,491,491,0,1,0,1,0
24855,56005,64147,0,0,62,62,0,1,0,1,0
24856,56131,37807,0,0,66,66,0,1,0,1,0
24857,63984,25174,0,0,62,62,0,1,0,1,0
24858,49624,445,0,0,70,70,0,1,0,1,0
24859,49622,445,0,0,70,70,0,1,0,1,0
24860,49620,445,0,0,70,70,0,1,0,1,0
24861,63984,25174,0,0,146,146,0,1,0,1,0
24862,49686,44847,0,0,66,66,0,1,0,1,0
24863,61394,445,0,0,66,66,0,1,0,1,0
24864,49616,445,0,0,70,70,0,1,0,1,0
24865,53756,50584,0,0,66,66,0,1,0,1,0
24866,5926,25174,0,0,146,146,0,1,0,1,0
24867,61389,445,0,0,66,66,0,1,0,1,0
24868,3478,61463,0,0,1345,1345,0,1,0,1,0
24869,3478,61463,0,0,893,893,0,1,0,1,0
24870,61162,445,0,0,70,70,0,1,0,1,0
24871,61388,445,0,0,66,66,0,1,0,1,0
24872,61386,445,0,0,66,66,0,1,0,1,0
24873,61385,445,0,0,66,66,0,1,0,1,0
24874,64124,25174,0,0,62,62,0,1,0,1,0
24875,64124,25174,0,0,146,146,0,1,0,1,0
24876,19875,30170,0,0,145,145,0,1,0,1,0
24877,7720,44847,0,0,66,66,0,1,0,1,0
24878,3478,61463,0,0,1004,1004,0,1,0,1,0
24879,62408,50584,0,0,66,66,0,1,0,1,0
24880,49333,25174,0,0,146,146,0,1,0,1,0
24881,49608,445,0,0,70,70,0,1,0,1,0
24882,61158,445,0,0,70,70,0,1,0,1,0
24883,32282,8604,0,0,62,62,0,1,0,1,0
24884,64535,37965,0,0,62,62,0,1,0,1,0
24885,49605,445,0,0,70,70,0,1,0,1,0
24886,49604,445,0,0,70,70,0,1,0,1,0
24887,52050,11392,0,0,62,62,0,1,0,1,0
24888,50949,45960,0,0,62,62,0,1,0,1,0
24889,49514,65504,0,0,162,162,0,1,0,1,0
24890,61148,445,0,0,70,70,0,1,0,1,0
24891,61147,445,0,0,70,70,0,1,0,1,0
24892,39268,443,60773,443,7691,1999,5692,35,256,18,17
24893,52803,443,59403,443,4913,751,4162,18,28,8,10
24894,50158,53,45524,53,758,96,662,2,30,1,1
24895,27005,27015,4147,27015,869,126,743,2,30,1,1
24896,50601,53,58017,53,760,97,663,2,30,1,1
24897,26900,27017,32451,27017,422,164,258,6,30,3,3
24898,36148,443,59223,443,2233,1237,996,18,75,9,9
24899,27005,27015,58222,27015,901,126,775,2,30,1,1
24900,49631,80,18406,80,1446,914,532,8,16,5,3
24901,56967,443,1130,443,9222,3148,6074,26,91,14,12
24902,50589,53,50328,53,733,85,648,2,30,1,1
24903,64823,53,49719,53,754,94,660,2,30,1,1
24904,26900,27017,11967,27017,422,164,258,6,30,3,3
24905,56006,53,14148,53,200,102,98,2,30,1,1
24906,56713,443,29098,443,373053,9725,363328,374,45,129,245
24907,50602,53,48380,53,761,100,661,2,30,1,1
24908,50152,53,50662,53,776,102,674,2,30,1,1
24909,39575,53,26625,53,198,93,105,2,30,1,1
24910,52471,443,40608,443,41966,23593,18373,89,154,42,47
24911,56912,443,18350,443,7618,2859,4759,26,17,14,12
24912,35187,443,10629,443,13057,1460,11597,28,255,14,14
24913,56710,80,31559,80,30614,1926,28688,44,45,23,21
24914,33498,443,13950,443,3672,1802,1870,25,129,10,15
24915,56711,443,22373,443,1207531,28695,1178836,1184,45,400,784
24916,53779,24874,46162,24874,70,70,0,1,5,1,0
24917,49654,80,62671,80,1506,914,592,9,16,5,4
24918,36146,443,42647,443,2514,1249,1265,19,76,9,10
24919,55380,53,27233,53,289,97,192,4,45,2,2
24920,49989,53,14607,53,778,103,675,2,30,1,1
24921,58823,443,42336,443,25195,16739,8456,60,20,35,25
24922,39251,53,9429,53,198,93,105,2,30,1,1
24923,45439,443,28530,443,24785,17234,7551,68,421,36,32
24924,56365,53,1142,53,198,101,97,2,30,1,1
24925,56068,53,2215,53,752,93,659,2,30,1,1
24926,50135,53,57045,53,774,101,673,2,30,1,1
24927,56934,53,42274,53,216,110,106,2,31,1,1
24928,33877,443,16562,443,9449,3441,6008,27,41,17,10
24929,52002,34348,46608,34348,66,66,0,1,5,1,0
24930,49429,53,29436,53,188,96,92,2,31,1,1
24931,55849,53,21168,53,190,97,93,2,31,1,1
24932,54563,443,54563,443,109880,24958,84922,154,20,83,71
24933,56709,443,60934,443,1239919,29325,1210594,1214,46,409,805
24934,53817,59216,6687,59216,258,70,188,4,8,2,2
24935,50803,443,40558,443,1590,1038,552,12,48,6,6
24936,53780,47132,52557,47132,70,70,0,1,5,1,0
24937,52001,12514,13607,12514,66,66,0,1,5,1,0
24938,65219,53,39844,53,410,99,311,4,56,2,2
24939,55651,53,31474,53,198,101,97,2,30,1,1
24940,57066,53,53308,53,778,103,675,2,30,1,1
24941,55185,53,27754,53,758,93,665,2,30,1,1
24942,56795,53,37529,53,776,102,674,2,30,1,1
24943,54262,443,59350,443,11356,5509,5847,84,544,44,40
24944,64729,53,52284,53,770,102,668,2,30,1,1
24945,55715,53,53520,53,168,86,82,2,30,1,1
24946,55791,53,26721,53,770,101,669,2,30,1,1
24947,57423,53,20278,53,774,101,673,2,30,1,1
24948,50426,53,23864,53,760,97,663,2,30,1,1
24949,27005,27015,27620,27015,880,126,754,2,30,1,1
24950,56500,53,34519,53,198,101,97,2,31,1,1
24951,57025,53,3380,53,168,86,82,2,31,1,1
24952,65313,53,63714,53,164,84,80,2,31,1,1
24953,57565,443,12958,443,3586,1074,2512,17,137,8,9
24954,64959,53,59416,53,202,103,99,2,31,1,1
24955,26900,27017,61520,27017,422,164,258,6,31,3,3
24956,57157,53,17035,53,755,94,661,2,31,1,1
24957,56290,53,40983,53,716,95,621,2,31,1,1
24958,55439,53,12410,53,738,86,652,2,30,1,1
24959,55390,53,32407,53,778,103,675,2,31,1,1
24960,64687,53,62553,53,182,93,89,2,31,1,1
24961,16387,22226,0,0,60,60,0,1,61,1,0
24962,49593,53,21447,53,762,98,664,2,31,1,1
24963,56804,53,22833,53,760,96,664,2,31,1,1
24964,55443,53,31894,53,751,95,656,2,31,1,1
24965,65112,53,30397,53,202,103,99,2,31,1,1
24966,64054,53,42745,53,182,93,89,2,31,1,1
24967,26900,27017,18355,27017,422,164,258,6,31,3,3
24968,56664,53,62279,53,774,101,673,2,31,1,1
24969,27005,27022,21223,27022,890,126,764,2,31,1,1
24970,27005,27016,17178,27016,914,126,788,2,31,1,1
24971,55262,53,28090,53,762,98,664,2,31,1,1
24972,64330,53,32772,53,186,95,91,2,31,1,1
24973,56544,53,62437,53,760,97,663,2,31,1,1
24974,56245,53,57808,53,200,102,98,2,31,1,1
24975,56624,53,13351,53,198,101,97,2,31,1,1
24976,47756,443,23688,443,8504,4770,3734,46,196,25,21
24977,27005,27015,34776,27015,882,126,756,2,31,1,1
24978,16387,26637,0,0,60,60,0,1,61,1,0
24979,27005,27015,27978,27015,888,126,762,2,31,1,1
24980,55037,443,21745,443,2639,258,2381,9,120,4,5
24981,6881,6881,46331,6881,259,150,109,2,1201,1,1
24982,61146,445,0,0,70,70,0,1,0,1,0
24983,61145,445,0,0,70,70,0,1,0,1,0
24984,61373,445,0,0,66,66,0,1,0,1,0
24985,3478,61463,0,0,918,918,0,1,0,1,0
24986,45766,35440,0,0,62,62,0,1,0,1,0
24987,61142,445,0,0,70,70,0,1,0,1,0
24988,45964,55559,0,0,60,60,0,1,0,1,0
24989,18608,11392,0,0,66,66,0,1,0,1,0
24990,58251,36237,0,0,66,66,0,1,0,1,0
24991,57604,32480,0,0,62,62,0,1,0,1,0
24992,60806,51050,0,0,66,66,0,1,0,1,0
24993,63910,44847,0,0,66,66,0,1,0,1,0
24994,55831,53,65358,53,183,94,89,2,30,1,1
24995,65311,53,5309,53,198,94,104,2,30,1,1
24996,64959,53,9017,53,209,110,99,2,30,1,1
24997,35927,443,23260,443,9102,1205,7897,25,14,14,11
24998,46271,443,30209,443,70,70,0,2,4,2,0
24999,49461,53,38932,53,198,102,96,2,29,1,1
25000,49568,53,53479,53,184,102,82,2,29,1,1
25001,56697,53,16898,53,198,102,96,2,29,1,1
25002,49543,53,5363,53,200,102,98,2,30,1,1
25003,65313,53,62981,53,166,86,80,2,30,1,1
25004,48996,443,35257,443,128299,119001,9298,178,280,103,75
25005,64113,443,11350,443,14057427,329652,13727775,13768,110,4655,9113
25006,51956,443,35785,443,5065,1658,3407,21,16,13,8
25007,60867,443,29499,443,3072,2174,898,14,317,8,6
25008,54439,443,63339,443,44294,9390,34904,167,319,83,84
25009,63901,42053,50757,42053,2980,1647,1333,16,31,10,6
25010,58855,443,45547,443,5168,700,4468,16,14,7,9
25011,53154,44645,45393,44645,320,140,180,6,5,3,3
25012,50667,443,38450,443,8536,2068,6468,36,18,16,20
25013,53823,25291,38093,25291,320,140,180,6,6,3,3
25014,55752,8060,41329,8060,70,70,0,1,4,1,0
25015,55380,53,32660,53,289,97,192,4,44,2,2
25016,55050,443,54563,443,126,60,66,3,5,2,1
25017,55651,53,8251,53,199,102,97,2,29,1,1
25018,65219,53,31087,53,197,102,95,2,29,1,1
25019,56934,53,16279,53,216,110,106,2,29,1,1
25020,49534,53,40703,53,193,102,91,2,29,1,1
25021,49461,53,21062,53,821,102,719,2,29,1,1
25022,56474,53,60230,53,209,110,99,2,29,1,1
25023,55715,53,19164,53,168,86,82,2,29,1,1
25024,49403,53,28281,53,228,102,126,2,29,1,1
25025,57136,53,60175,53,209,110,99,2,29,1,1
25026,50630,53,12018,53,209,110,99,2,29,1,1
25027,49429,53,2752,53,194,102,92,2,30,1,1
25028,55200,53,14143,53,209,110,99,2,30,1,1
25029,37048,53,15129,53,168,78,90,2,29,1,1
25030,50418,53,58072,53,185,102,83,2,30,1,1
25031,60290,53,25533,53,199,94,105,2,29,1,1
25032,42300,53,40798,53,168,78,90,2,29,1,1
25033,54998,53,32757,53,195,102,93,2,29,1,1
25034,58767,53,1096,53,168,78,90,2,29,1,1
25035,65245,53,50630,53,193,102,91,2,30,1,1
25036,55715,53,18469,53,168,86,82,2,30,1,1
25037,65116,53,63151,53,214,110,104,2,30,1,1
25038,56459,53,30479,53,209,110,99,2,30,1,1
25039,56673,53,38951,53,183,94,89,2,30,1,1
25040,49814,53,14666,53,189,102,87,2,30,1,1
25041,55200,53,50421,53,209,110,99,2,30,1,1
25042,26900,27017,38373,27017,422,164,258,6,30,3,3
25043,55712,53,64759,53,164,86,78,2,30,1,1
25044,65323,53,29690,53,816,102,714,2,30,1,1
25045,39054,443,15031,443,7772,4119,3653,31,17,16,15
25046,65116,53,4360,53,214,110,104,2,30,1,1
25047,52003,18150,63580,18150,70,70,0,1,5,1,0
25048,60460,54233,40952,54233,70,70,0,2,8,2,0
25049,55380,53,36013,53,289,97,192,4,45,2,2
25050,50671,443,30836,443,5409,1834,3575,25,17,12,13
25051,49814,53,29277,53,181,94,87,2,30,1,1
25052,42336,443,36600,443,4181,998,3183,14,26,7,7
25053,65152,53,13983,53,167,86,81,2,30,1,1
25054,51999,34619,53326,34619,70,70,0,1,5,1,0
25055,53864,443,51683,443,232,172,60,3,5,2,1
25056,65449,53,42820,53,723,102,621,2,30,1,1
25057,57802,443,19538,443,37181,32491,4690,93,81,54,39
25058,54136,443,48147,443,18716,8002,10714,100,945,51,49
25059,55830,53,32937,53,183,94,89,2,30,1,1
25060,55651,53,20940,53,199,102,97,2,30,1,1
25061,65057,53,5504,53,199,102,97,2,30,1,1
25062,55262,53,4967,53,193,102,91,2,30,1,1
25063,64905,53,62456,53,283,102,181,2,30,1,1
25064,56273,53,10176,53,200,102,98,2,30,1,1
25065,56006,53,56453,53,200,102,98,2,30,1,1
25066,55932,53,42862,53,193,102,91,2,30,1,1
25067,27005,27015,8730,27015,913,126,787,2,30,1,1
25068,56365,53,6321,53,199,102,97,2,30,1,1
25069,62415,53,36183,53,86,86,0,1,30,1,0
25070,27005,27015,31472,27015,888,126,762,2,30,1,1
25071,63951,55255,6079,55255,1277,856,421,9,15,6,3
25072,52426,443,20298,443,8760,1218,7542,25,15,14,11
25073,65245,53,59048,53,193,102,91,2,30,1,1
25074,49429,53,55360,53,194,102,92,2,30,1,1
25075,55169,53,40051,53,199,102,97,2,30,1,1
25076,63084,53,54059,53,86,86,0,1,30,1,0
25077,54966,443,5878,443,4645,2498,2147,14,135,7,7
25078,36109,443,56907,443,26538,7971,18567,70,128,38,32
25079,50614,80,59659,80,318,192,126,6,25,4,2
25080,52005,33191,35955,33191,70,70,0,1,5,1,0
25081,64338,53,13922,53,298,102,196,4,43,2,2
25082,64544,53,63880,53,199,94,105,2,30,1,1
25083,50161,53,38218,53,165,86,79,2,30,1,1
25084,27005,27001,28367,27001,883,126,757,2,30,1,1
25085,64537,53,37078,53,168,86,82,2,30,1,1
25086,64959,53,12491,53,209,110,99,2,30,1,1
25087,53394,53,24735,53,86,86,0,1,30,1,0
25088,57203,53,26707,53,199,102,97,2,30,1,1
25089,58851,443,38942,443,5166,700,4466,16,15,7,9
25090,52024,47600,56931,47600,70,70,0,2,8,2,0
25091,45458,80,54981,80,138,78,60,2,5,1,1
25092,52000,10491,1794,10491,70,70,0,1,5,1,0
25093,62059,443,14919,443,11903,6327,5576,48,15,27,21
25094,55243,443,31338,443,36501,26194,10307,76,71,47,29
25095,53808,56215,39390,56215,70,70,0,2,7,2,0
25096,41925,443,48625,443,8333,2153,6180,31,100,18,13
25097,61552,443,61552,443,38146,3555,34591,57,16,28,29
25098,53814,6725,2877,6725,70,70,0,2,7,2,0
25099,53815,17290,63882,17290,70,70,0,2,7,2,0
25100,51037,80,32981,80,134,60,74,3,4,2,1
25101,52101,443,43263,443,22696,18094,4602,41,315,25,16
25102,65060,53,21160,53,324,97,227,4,52,2,2
25103,39224,53,62138,53,168,78,90,2,29,1,1
25104,60989,443,11071,443,7592,2966,4626,26,15,15,11
25105,56474,53,9698,53,209,110,99,2,29,1,1
25106,58848,443,1963,443,5168,700,4468,16,15,7,9
25107,64943,53,17729,53,341,110,231,2,29,1,1
25108,48458,53,36064,53,289,86,203,2,29,1,1
25109,55362,53,21893,53,195,102,93,2,29,1,1
25110,49317,53,28300,53,194,102,92,2,29,1,1
25111,50137,53,58176,53,183,94,89,2,29,1,1
25112,57838,53,1470,53,70,70,0,1,29,1,0
25113,60548,53,24812,53,199,94,105,2,29,1,1
25114,8283,45858,25688,45858,130,70,60,2,30,1,1
25115,56273,53,30021,53,200,102,98,2,30,1,1
25116,58536,53,15925,53,177,86,91,2,30,1,1
25117,55362,53,39798,53,195,102,93,2,30,1,1
25118,50558,53,44600,53,733,94,639,2,30,1,1
25119,64595,53,8174,53,305,94,211,4,60,2,2
25120,56697,53,1249,53,198,102,96,2,30,1,1
25121,49885,53,38127,53,377,94,283,2,30,1,1
25122,55169,53,58327,53,199,102,97,2,30,1,1
25123,50151,53,17420,53,152,78,74,2,30,1,1
25124,50151,53,44129,53,168,94,74,2,30,1,1
25125,26900,27017,34324,27017,422,164,258,6,30,3,3
25126,27005,27016,31550,27016,884,126,758,2,30,1,1
25127,57867,27019,40046,27019,2338,634,1704,10,30,6,4
25128,56492,53,1811,53,94,94,0,1,30,1,0
25129,57860,443,46825,443,1786,172,1614,7,120,3,4
25130,55831,53,9463,53,183,94,89,2,30,1,1
25131,38288,443,40759,443,8627,2906,5721,10,121,4,6
25132,57025,53,16250,53,168,86,82,2,30,1,1
25133,26900,27017,12136,27017,422,164,258,6,30,3,3
25134,64519,53,39794,53,277,94,183,4,60,2,2
25135,65313,53,7915,53,166,86,80,2,30,1,1
25136,49898,53,22442,53,184,94,90,2,30,1,1
25137,55752,53,44697,53,200,102,98,2,30,1,1
25138,64723,53,38339,53,165,86,79,2,30,1,1
25139,55752,53,6985,53,200,102,98,2,30,1,1
25140,64575,53,5183,53,182,102,80,2,31,1,1
25141,65019,53,29209,53,195,102,93,2,31,1,1
25142,49416,53,31346,53,177,94,83,2,31,1,1
25143,56934,53,21277,53,216,110,106,2,31,1,1
25144,65219,53,20854,53,197,102,95,2,31,1,1
25145,49314,443,60912,443,8599,4862,3737,47,195,26,21
25146,43603,443,42478,443,8420,2986,5434,23,138,13,10
25147,34960,443,6692,443,7029,2223,4806,23,361,12,11
25148,56500,53,23471,53,199,102,97,2,30,1,1
25149,55170,53,27773,53,250,94,156,2,30,1,1
25150,57258,53,22772,53,821,102,719,2,30,1,1
25151,53262,443,5546,443,242149,7606,234543,260,150,92,168
25152,62058,443,34202,443,8666,2933,5733,46,15,27,19
25153,63979,49547,9568,49547,312,132,180,6,6,3,3
25154,42337,443,16716,443,4181,998,3183,14,26,7,7
25155,49402,443,59952,443,7965,4044,3921,63,464,30,33
25156,55200,53,19754,53,209,110,99,2,30,1,1
25157,65057,53,53489,53,199,102,97,2,30,1,1
25158,49689,53,60193,53,812,110,702,2,30,1,1
25159,55262,53,22053,53,193,102,91,2,30,1,1
25160,64261,53,48738,53,295,110,185,2,30,1,1
25161,65101,53,61768,53,402,118,284,2,30,1,1
25162,27005,27015,15666,27015,876,126,750,2,30,1,1
25163,58101,53,38765,53,86,86,0,1,30,1,0
25164,52142,443,7937,443,9911,2041,7870,34,120,17,17
25165,64054,53,33800,53,183,94,89,2,31,1,1
25166,53261,443,39643,443,96485,4565,91920,119,150,45,74
25167,64513,53,5790,53,336,93,243,4,33,2,2
25168,52004,55711,7662,55711,70,70,0,1,5,1,0
25169,3155,23,3155,23,66,66,0,1,5,1,0
25170,42338,443,46950,443,4181,998,3183,14,26,7,7
25171,50633,80,7997,80,1717,1247,470,9,15,5,4
25172,56673,53,13282,53,183,94,89,2,30,1,1
25173,49173,53,27694,53,214,110,104,2,30,1,1
25174,65112,53,26607,53,209,110,99,2,30,1,1
25175,49610,53,38769,53,754,94,660,2,30,1,1
25176,27005,27015,24386,27015,882,126,756,3,31,2,1
25177,49227,53,61588,53,179,94,85,2,30,1,1
25178,26900,27017,45404,27017,422,164,258,6,30,3,3
25179,42341,443,25797,443,276,70,206,5,26,2,3
25180,52425,443,43475,443,8454,978,7476,20,15,10,10
25181,56459,53,20811,53,209,110,99,2,30,1,1
25182,50100,53,17377,53,734,94,640,2,30,1,1
25183,56006,53,30347,53,200,102,98,2,30,1,1
25184,64440,53,9584,53,270,110,160,2,30,1,1
25185,26900,27017,22133,27017,422,164,258,6,30,3,3
25186,50161,53,40110,53,173,94,79,2,30,1,1
25187,49687,53,40743,53,184,102,82,2,30,1,1
25188,65323,53,20486,53,193,102,91,2,30,1,1
25189,64586,53,21236,53,173,94,79,2,30,1,1
25190,57190,53,17320,53,757,102,655,2,30,1,1
25191,48864,123,32657,123,184,94,90,2,30,1,1
25192,56500,53,60506,53,199,102,97,2,30,1,1
25193,49687,53,9331,53,184,102,82,2,30,1,1
25194,55831,53,4843,53,183,94,89,2,30,1,1
25195,56447,53,39784,53,403,110,293,2,30,1,1
25196,26900,27017,18578,27017,422,164,258,6,30,3,3
25197,64959,53,12342,53,209,110,99,2,30,1,1
25198,64330,53,5975,53,193,102,91,2,30,1,1
25199,64054,53,34990,53,183,94,89,2,30,1,1
25200,64586,53,2228,53,173,94,79,2,30,1,1
25201,49365,53,34232,53,199,94,105,2,31,1,1
25202,59191,443,56618,443,4489,2046,2443,23,121,11,12
25203,123,123,23599,123,184,94,90,2,30,1,1
25204,57258,53,32914,53,198,102,96,2,30,1,1
25205,56170,53,19497,53,198,102,96,2,30,1,1
25206,56787,53,40108,53,209,110,99,2,30,1,1
25207,56328,53,20002,53,214,102,112,2,31,1,1
25208,65328,53,29572,53,182,102,80,2,31,1,1
25209,49163,53,27365,53,167,86,81,2,31,1,1
25210,57470,29137,36773,29137,1386,1386,0,22,1610,22,0
25211,15986,8000,55980,8000,274,150,124,4,60,2,2
25212,46531,53,8725,53,209,86,123,2,30,1,1
25213,55849,53,54594,53,195,102,93,2,30,1,1
25214,57647,53,15724,53,265,78,187,2,30,1,1
25215,56697,53,34605,53,198,102,96,2,30,1,1
25216,26900,27017,41768,27017,422,164,258,6,30,3,3
25217,65384,53,4009,53,443,182,261,6,30,3,3
25218,26900,27017,50857,27017,254,82,172,4,30,2,2
25219,64519,53,52190,53,184,94,90,2,30,1,1
25220,49416,53,16616,53,185,102,83,2,30,1,1
25221,49163,53,4379,53,167,86,81,2,30,1,1
25222,56787,53,13426,53,209,110,99,2,30,1,1
25223,65398,53,64225,53,214,110,104,2,30,1,1
25224,49503,53,8833,53,167,86,81,2,30,1,1
25225,55371,53,41494,53,168,86,82,2,30,1,1
25226,64723,53,29424,53,165,86,79,2,31,1,1
25227,49218,53,12399,53,195,102,93,2,31,1,1
25228,49722,53,40518,53,200,102,98,2,31,1,1
25229,49227,53,18246,53,179,94,85,2,31,1,1
25230,64316,53,46275,53,184,94,90,2,31,1,1
25231,65112,53,6227,53,209,110,99,2,31,1,1
25232,52929,443,26411,443,8623,4829,3794,44,195,22,22
25233,50307,443,61889,443,1786,172,1614,7,120,3,4
25234,33912,443,41888,443,6288,3354,2934,9,122,5,4
25235,45558,443,51093,443,6450,1003,5447,21,360,11,10
25236,38169,443,2048,443,7841,2301,5540,18,135,8,10
25237,55070,53,47871,53,195,102,93,2,31,1,1
25238,52233,80,14705,80,1674,708,966,18,392,6,12
25239,49160,52011,11430,52011,800,150,650,4,1200,2,2
25240,63381,443,50807,443,11344,5681,5663,34,3601,20,14
25241,37965,8272,8707,8272,1577,594,983,20,1740,10,10
25242,57470,56098,25356,56098,1359,726,633,6,1199,3,3
25243,54342,80,39601,80,1515,481,1034,11,16,6,5
25244,56006,53,22097,53,200,102,98,2,30,1,1
25245,56695,53,2838,53,183,94,89,2,30,1,1
25246,55362,53,23060,53,374,97,277,4,32,2,2
25247,53807,28630,53835,28630,70,70,0,2,8,2,0
25248,64614,53,5990,53,517,179,338,6,62,3,3
25249,34720,443,52073,443,6453,2318,4135,32,84,16,16
25250,56492,53,62080,53,184,94,90,2,30,1,1
25251,56500,53,41129,53,199,102,97,2,30,1,1
25252,56170,53,52947,53,198,102,96,2,31,1,1
25253,65366,53,44706,53,458,188,270,6,31,3,3
25254,49667,53,30486,53,759,102,657,2,31,1,1
25255,64330,53,52470,53,193,102,91,2,31,1,1
25256,50278,53,13442,53,196,102,94,2,31,1,1
25257,58857,443,13362,443,3439647,103607,3336040,3670,452,1291,2379
25258,45897,443,62629,443,2267946,70852,2197094,2429,316,859,1570
25259,50731,27029,22129,27029,269,78,191,2,31,1,1
25260,50728,27029,42888,27029,269,78,191,2,31,1,1
25261,53806,37267,15309,37267,70,70,0,2,8,2,0
25262,49925,80,18933,80,12290,10150,2140,37,256,19,18
25263,46002,443,21932,443,6299,1424,4875,27,291,10,17
25264,64054,53,41905,53,1299,387,912,10,103,5,5
25265,3478,61463,0,0,1053,1053,0,1,0,1,0
25266,61366,445,0,0,66,66,0,1,0,1,0
25267,37633,44847,0,0,62,62,0,1,0,1,0
25268,49594,445,0,0,70,70,0,1,0,1,0
25269,57339,57470,0,0,66,66,0,1,0,1,0
25270,52114,64147,0,0,62,62,0,1,0,1,0
25271,80,9918,0,0,60,60,0,1,0,1,0
25272,61135,445,0,0,70,70,0,1,0,1,0
25273,63079,64147,0,0,62,62,0,1,0,1,0
25274,61363,445,0,0,66,66,0,1,0,1,0
25275,3478,61463,0,0,164,164,0,1,0,1,0
25276,46491,50584,0,0,66,66,0,1,0,1,0
25277,3478,61463,0,0,743,743,0,1,0,1,0
25278,60297,25604,0,0,62,62,0,1,0,1,0
25279,8889,42210,0,0,60,60,0,1,0,1,0
25280,61355,445,0,0,66,66,0,1,0,1,0
25281,15854,50584,0,0,146,146,0,1,0,1,0
25282,61128,445,0,0,70,70,0,1,0,1,0
25283,61127,445,0,0,70,70,0,1,0,1,0
25284,61349,445,0,0,66,66,0,1,0,1,0
25285,2717,31573,0,0,66,66,0,1,0,1,0
25286,12550,37807,0,0,62,62,0,1,0,1,0
25287,3478,61463,0,0,180,180,0,1,0,1,0
25288,3478,61463,0,0,1267,1267,0,1,0,1,0
25289,15688,56919,0,0,146,146,0,1,0,1,0
25290,61122,445,0,0,70,70,0,1,0,1,0
25291,61120,445,0,0,70,70,0,1,0,1,0
25292,6881,1707,0,0,146,146,0,1,0,1,0
25293,3478,61463,0,0,68,68,0,1,0,1,0
25294,3478,61463,0,0,1188,1188,0,1,0,1,0
25295,57825,13014,0,0,74,74,0,1,0,1,0
25296,3478,61463,0,0,252,252,0,1,0,1,0
25297,3478,61463,0,0,1273,1273,0,1,0,1,0
25298,3478,61463,0,0,156,156,0,1,0,1,0
25299,49576,445,0,0,70,70,0,1,0,1,0
25300,49578,445,0,0,70,70,0,1,0,1,0
25301,49577,445,0,0,70,70,0,1,0,1,0
25302,61334,445,0,0,66,66,0,1,0,1,0
25303,61340,445,0,0,66,66,0,1,0,1,0
25304,61341,445,0,0,66,66,0,1,0,1,0
25305,61337,445,0,0,66,66,0,1,0,1,0
25306,61339,445,0,0,66,66,0,1,0,1,0
25307,61335,445,0,0,66,66,0,1,0,1,0
25308,61336,445,0,0,66,66,0,1,0,1,0
25309,61333,445,0,0,66,66,0,1,0,1,0
25310,18091,32480,0,0,66,66,0,1,0,1,0
25311,61116,445,0,0,70,70,0,1,0,1,0
25312,24606,55783,0,0,72,72,0,1,0,1,0
25313,61115,445,0,0,70,70,0,1,0,1,0
25314,25961,55783,0,0,66,66,0,1,0,1,0
25315,51705,22114,0,0,66,66,0,1,0,1,0
25316,45981,51505,0,0,62,62,0,1,0,1,0
25317,993,54748,0,0,66,66,0,1,0,1,0
25318,23798,23,0,0,60,60,0,1,0,1,0
25319,3478,61463,0,0,935,935,0,1,0,1,0
25320,62709,57470,0,0,62,62,0,1,0,1,0
25321,49575,445,0,0,70,70,0,1,0,1,0
25322,49568,445,0,0,70,70,0,1,0,1,0
25323,49565,445,0,0,70,70,0,1,0,1,0
25324,49566,445,0,0,70,70,0,1,0,1,0
25325,29080,50265,0,0,62,62,0,1,0,1,0
25326,61110,445,0,0,70,70,0,1,0,1,0
25327,34932,38608,0,0,62,62,0,1,0,1,0
25328,61319,445,0,0,66,66,0,1,0,1,0
25329,61321,445,0,0,66,66,0,1,0,1,0
25330,61318,445,0,0,66,66,0,1,0,1,0
25331,3478,61463,0,0,982,982,0,1,0,1,0
25332,49556,445,0,0,70,70,0,1,0,1,0
25333,51999,37965,0,0,62,62,0,1,0,1,0
25334,58914,37965,0,0,66,66,0,1,0,1,0
25335,49555,445,0,0,70,70,0,1,0,1,0
25336,49550,445,0,0,70,70,0,1,0,1,0
25337,49547,445,0,0,70,70,0,1,0,1,0
25338,3478,61463,0,0,902,902,0,1,0,1,0
25339,41648,56205,0,0,66,66,0,1,0,1,0
25340,64626,50584,0,0,62,62,0,1,0,1,0
25341,51064,5529,0,0,146,146,0,1,0,1,0
25342,59618,46824,0,0,66,66,0,1,0,1,0
25343,61097,445,0,0,70,70,0,1,0,1,0
25344,51948,17372,0,0,62,62,0,1,0,1,0
25345,20864,51221,0,0,62,62,0,1,0,1,0
25346,3478,61463,0,0,164,164,0,1,0,1,0
25347,3478,61463,0,0,1118,1118,0,1,0,1,0
25348,61094,445,0,0,70,70,0,1,0,1,0
25349,63345,53,0,0,75,75,0,1,0,1,0
25350,26469,26348,0,0,66,66,0,1,0,1,0
25351,49536,445,0,0,70,70,0,1,0,1,0
25352,49534,445,0,0,70,70,0,1,0,1,0
25353,49533,445,0,0,70,70,0,1,0,1,0
25354,60438,17372,0,0,66,66,0,1,0,1,0
25355,50570,57470,0,0,66,66,0,1,0,1,0
25356,54621,26296,0,0,145,145,0,1,0,1,0
25357,30580,50265,0,0,62,62,0,1,0,1,0
25358,3478,61463,0,0,159,159,0,1,0,1,0
25359,3478,61463,0,0,1306,1306,0,1,0,1,0
25360,61088,445,0,0,70,70,0,1,0,1,0
25361,38592,57209,0,0,62,62,0,1,0,1,0
25362,61087,445,0,0,70,70,0,1,0,1,0
25363,12965,37965,0,0,66,66,0,1,0,1,0
25364,61085,445,0,0,70,70,0,1,0,1,0
25365,49203,51050,0,0,62,62,0,1,0,1,0
25366,3478,61463,0,0,1188,1188,0,1,0,1,0
25367,3478,61463,0,0,967,967,0,1,0,1,0
25368,49529,445,0,0,70,70,0,1,0,1,0
25369,49523,445,0,0,70,70,0,1,0,1,0
25370,24504,37965,0,0,62,62,0,1,0,1,0
25371,60761,51221,0,0,62,62,0,1,0,1,0
25372,58687,11392,0,0,62,62,0,1,0,1,0
25373,9588,37965,0,0,66,66,0,1,0,1,0
25374,61294,445,0,0,66,66,0,1,0,1,0
25375,61293,445,0,0,66,66,0,1,0,1,0
25376,61078,445,0,0,70,70,0,1,0,1,0
25377,3478,61463,0,0,179,179,0,1,0,1,0
25378,3478,61463,0,0,1275,1275,0,1,0,1,0
25379,0,0,0,0,210,210,0,3,0,3,0
25380,61076,445,0,0,70,70,0,1,0,1,0
25381,45304,64147,0,0,72,72,0,1,0,1,0
25382,37455,50584,0,0,66,66,0,1,0,1,0
25383,49520,445,0,0,70,70,0,1,0,1,0
25384,49516,445,0,0,70,70,0,1,0,1,0
25385,49508,445,0,0,70,70,0,1,0,1,0
25386,49511,445,0,0,70,70,0,1,0,1,0
25387,42429,22114,0,0,62,62,0,1,0,1,0
25388,61075,445,0,0,70,70,0,1,0,1,0
25389,61074,445,0,0,70,70,0,1,0,1,0
25390,61073,445,0,0,70,70,0,1,0,1,0
25391,61287,445,0,0,66,66,0,1,0,1,0
25392,61069,445,0,0,70,70,0,1,0,1,0
25393,61068,445,0,0,70,70,0,1,0,1,0
25394,3478,61463,0,0,400,400,0,1,0,1,0
25395,3478,61463,0,0,1290,1290,0,1,0,1,0
25396,25497,44847,0,0,62,62,0,1,0,1,0
25397,61282,445,0,0,66,66,0,1,0,1,0
25398,61280,445,0,0,66,66,0,1,0,1,0
25399,61281,445,0,0,66,66,0,1,0,1,0
25400,61279,445,0,0,66,66,0,1,0,1,0
25401,61271,445,0,0,66,66,0,1,0,1,0
25402,61275,445,0,0,66,66,0,1,0,1,0
25403,61276,445,0,0,66,66,0,1,0,1,0
25404,49505,445,0,0,70,70,0,1,0,1,0
25405,61055,445,0,0,70,70,0,1,0,1,0
25406,61054,445,0,0,70,70,0,1,0,1,0
25407,44117,6881,0,0,62,62,0,1,0,1,0
25408,61051,445,0,0,70,70,0,1,0,1,0
25409,49501,445,0,0,70,70,0,1,0,1,0
25410,49497,445,0,0,70,70,0,1,0,1,0
25411,49499,445,0,0,70,70,0,1,0,1,0
25412,61044,445,0,0,70,70,0,1,0,1,0
25413,61045,445,0,0,70,70,0,1,0,1,0
25414,3478,61463,0,0,217,217,0,1,0,1,0
25415,3478,61463,0,0,1305,1305,0,1,0,1,0
25416,52348,62413,0,0,66,66,0,1,0,1,0
25417,1027,57866,0,0,146,146,0,1,0,1,0
25418,27773,56205,0,0,62,62,0,1,0,1,0
25419,62273,50584,0,0,66,66,0,1,0,1,0
25420,50757,64147,0,0,66,66,0,1,0,1,0
25421,1030,64147,0,0,62,62,0,1,0,1,0
25422,3478,61463,0,0,1188,1188,0,1,0,1,0
25423,57090,51505,0,0,66,66,0,1,0,1,0
25424,56255,44847,0,0,62,62,0,1,0,1,0
25425,49277,51505,0,0,66,66,0,1,0,1,0
25426,3478,61463,0,0,328,328,0,1,0,1,0
25427,3478,61463,0,0,1162,1162,0,1,0,1,0
25428,3478,61463,0,0,1162,1162,0,1,0,1,0
25429,44117,6881,0,0,146,146,0,1,0,1,0
25430,3478,61463,0,0,1302,1302,0,1,0,1,0
25431,5223,59023,0,0,66,66,0,1,0,1,0
25432,49496,445,0,0,70,70,0,1,0,1,0
25433,49494,445,0,0,70,70,0,1,0,1,0
25434,49493,445,0,0,70,70,0,1,0,1,0
25435,61033,445,0,0,70,70,0,1,0,1,0
25436,61264,445,0,0,66,66,0,1,0,1,0
25437,58839,443,29041,443,6270,4231,2039,22,16,11,11
25438,35080,80,13868,80,71843,2833,69010,83,16,36,47
25439,50116,22,50116,22,60,60,0,1,5,1,0
25440,60903,443,60903,443,3672,2294,1378,23,17,13,10
25441,56953,443,23008,443,66324,17448,48876,86,331,39,47
25442,123,123,34455,123,184,94,90,2,30,1,1
25443,54458,443,1235,443,3885,2355,1530,26,270,13,13
25444,56695,53,39577,53,93,93,0,1,30,1,0
25445,60244,80,21449,80,1114,534,580,12,16,7,5
25446,49722,53,48716,53,200,102,98,2,30,1,1
25447,61502,443,14539,443,580643,7944,572699,475,41,86,389
25448,6580,443,39397,443,2227,1018,1209,17,16,8,9
25449,55285,53,1660,53,268,95,173,4,45,2,2
25450,37638,443,24895,443,8134,2717,5417,24,16,15,9
25451,65019,53,42326,53,190,97,93,2,31,1,1
25452,49227,53,39429,53,174,89,85,2,30,1,1
25453,51415,443,38416,443,9284,2172,7112,39,83,19,20
25454,56492,53,6474,53,184,94,90,2,30,1,1
25455,64316,53,59418,53,184,94,90,2,31,1,1
25456,55830,53,59149,53,164,84,80,2,31,1,1
25457,57208,53,63369,53,182,93,89,2,31,1,1
25458,56636,53,8907,53,168,86,82,2,30,1,1
25459,64519,53,20237,53,277,94,183,4,60,2,2
25460,56992,80,9421,80,214,140,74,4,35,3,1
25461,55098,53,22759,53,474,200,274,6,44,3,3
25462,53586,443,61806,443,8510,3207,5303,25,324,13,12
25463,57204,443,59109,443,35981,14676,21305,63,320,31,32
25464,26979,443,43734,443,7343,2586,4757,23,19,11,12
25465,58639,443,58639,443,4380,1473,2907,19,30,11,8
25466,36144,443,59381,443,8859,1662,7197,26,75,14,12
25467,58836,443,51260,443,12230,8144,4086,33,17,18,15
25468,443,10120,443,10120,64,64,0,1,5,1,0
25469,49285,6881,35710,6881,411,225,186,6,16,3,3
25470,26900,27017,37191,27017,422,164,258,6,30,3,3
25471,56320,53,27969,53,761,100,661,2,30,1,1
25472,55616,53,41127,53,776,102,674,2,30,1,1
25473,49582,80,30882,80,454222,9730,444492,425,155,119,306
25474,49390,53,24759,53,204,104,100,2,31,1,1
25475,39914,443,20492,443,26779179,169104,26610075,19911,91,1968,17943
25476,27005,23333,41916,23333,890,126,764,3,32,2,1
25477,63965,11785,23827,11785,66,66,0,2,8,2,0
25478,53803,17637,1467,17637,70,70,0,2,8,2,0
25479,58837,443,12859,443,13120,8597,4523,34,17,18,16
25480,55979,53,36976,53,186,95,91,2,31,1,1
25481,58673,443,29883,443,11116,2910,8206,30,20,16,14
25482,56994,80,47420,80,214,140,74,4,35,3,1
25483,54497,443,36894,443,10017,2436,7581,22,138,10,12
25484,26900,27017,24961,27017,168,82,86,2,30,1,1
25485,56993,80,53078,80,214,140,74,4,35,3,1
25486,49284,6881,63605,6881,411,225,186,6,16,3,3
25487,55932,53,3397,53,186,95,91,2,30,1,1
25488,61501,443,38275,443,633920,7867,626053,505,41,81,424
25489,50154,53,53091,53,756,95,661,2,30,1,1
25490,51449,443,58007,443,9602,3315,6287,25,37,15,10
25491,55539,53,7321,53,814,110,704,2,30,1,1
25492,55083,53,43737,53,751,95,656,2,30,1,1
25493,56170,53,28854,53,196,100,96,2,30,1,1
25494,51452,443,6945,443,7674,2829,4845,23,31,14,9
25495,55154,53,45659,53,184,94,90,2,30,1,1
25496,65398,53,61803,53,212,108,104,2,30,1,1
25497,65384,53,45912,53,735,88,647,2,31,1,1
25498,56658,53,11385,53,186,95,91,2,31,1,1
25499,49205,53,38111,53,188,96,92,2,31,1,1
25500,56226,53,58477,53,780,104,676,2,31,1,1
25501,37316,443,11978,443,19840,6479,13361,57,127,32,25
25502,56603,53,25992,53,1400,97,1303,4,57,2,2
25503,51204,443,55515,443,37173,3712,33461,54,74,24,30
25504,49163,53,24237,53,166,85,81,2,30,1,1
25505,49218,53,62258,53,190,97,93,2,31,1,1
25506,56723,53,2628,53,733,85,648,2,31,1,1
25507,57241,53,11880,53,760,97,663,2,31,1,1
25508,16387,57833,0,0,60,60,0,1,60,1,0
25509,57366,53,63370,53,745,93,652,2,31,1,1
25510,57398,53,10527,53,770,102,668,2,31,1,1
25511,57049,53,52014,53,755,93,662,2,31,1,1
25512,49354,53,30111,53,192,98,94,2,31,1,1
25513,56362,53,49796,53,190,97,93,2,31,1,1
25514,64380,53,29472,53,186,95,91,2,31,1,1
25515,55070,53,2161,53,190,97,93,2,31,1,1
25516,64089,53,25036,53,188,96,92,2,31,1,1
25517,49754,53,54663,53,176,90,86,2,31,1,1
25518,56344,53,27123,53,198,101,97,2,31,1,1
25519,64631,53,41468,53,186,95,91,2,31,1,1
25520,49293,53,58522,53,172,88,84,2,31,1,1
25521,56457,53,47112,53,731,91,640,2,31,1,1
25522,55919,53,57611,53,754,94,660,2,31,1,1
25523,64573,53,7328,53,184,94,90,2,31,1,1
25524,64326,53,28923,53,192,98,94,2,31,1,1
25525,56318,53,8880,53,182,93,89,2,31,1,1
25526,3175,60038,0,0,66,66,0,1,91,1,0
25527,60074,443,12733,443,3465,818,2647,11,122,5,6
25528,55356,53,43051,53,756,95,661,2,31,1,1
25529,58380,80,42000,80,3130,2290,840,15,135,8,7
25530,55976,53,37566,53,758,96,662,2,31,1,1
25531,65096,443,53521,443,2414,639,1775,9,121,5,4
25532,32921,443,5993,443,7578,2270,5308,17,123,8,9
25533,37635,443,51413,443,4883,1327,3556,18,135,9,9
25534,55646,53,39790,53,760,97,663,2,31,1,1
25535,57355,443,34540,443,16483,8545,7938,40,281,21,19
25536,56816,53,44842,53,754,94,660,2,31,1,1
25537,55463,53,53091,53,216,110,106,2,31,1,1
25538,55411,53,60848,53,182,93,89,2,31,1,1
25539,56930,53,53703,53,774,101,673,2,31,1,1
25540,60893,443,56200,443,4252,1594,2658,13,135,6,7
25541,43461,35440,0,0,62,62,0,1,0,1,0
25542,49488,445,0,0,70,70,0,1,0,1,0
25543,61261,445,0,0,66,66,0,1,0,1,0
25544,61258,445,0,0,66,66,0,1,0,1,0
25545,61259,445,0,0,66,66,0,1,0,1,0
25546,3478,61463,0,0,686,686,0,1,0,1,0
25547,53337,1433,0,0,60,60,0,1,0,1,0
25548,22094,23,0,0,60,60,0,1,0,1,0
25549,61256,445,0,0,66,66,0,1,0,1,0
25550,45964,55559,0,0,60,60,0,1,0,1,0
25551,61029,445,0,0,70,70,0,1,0,1,0
25552,49480,445,0,0,70,70,0,1,0,1,0
25553,55979,53,33606,53,193,102,91,2,30,1,1
25554,58994,443,40125,443,4989,1014,3975,16,27,9,7
25555,60981,443,40562,443,22449,19500,2949,53,21,31,22
25556,60976,443,6084,443,5027222,114898,4912324,4763,109,1375,3388
25557,53670,80,8760,80,950,502,448,12,15,7,5
25558,61332,23,0,0,60,60,0,1,0,1,0
25559,3478,61463,0,0,780,780,0,1,0,1,0
25560,49476,445,0,0,70,70,0,1,0,1,0
25561,49474,445,0,0,70,70,0,1,0,1,0
25562,1912,48817,0,0,62,62,0,1,0,1,0
25563,61020,445,0,0,70,70,0,1,0,1,0
25564,61018,445,0,0,70,70,0,1,0,1,0
25565,61017,445,0,0,70,70,0,1,0,1,0
25566,61016,445,0,0,70,70,0,1,0,1,0
25567,24589,10197,0,0,145,145,0,1,0,1,0
25568,59051,27520,0,0,62,62,0,1,0,1,0
25569,61012,445,0,0,70,70,0,1,0,1,0
25570,61140,27520,0,0,66,66,0,1,0,1,0
25571,56250,36237,0,0,66,66,0,1,0,1,0
25572,51244,1,0,0,100,100,0,1,0,1,0
25573,61246,445,0,0,66,66,0,1,0,1,0
25574,45964,3111,0,0,60,60,0,1,0,1,0
25575,3478,61463,0,0,240,240,0,1,0,1,0
25576,7184,15503,0,0,66,66,0,1,0,1,0
25577,61238,445,0,0,66,66,0,1,0,1,0
25578,49390,1433,0,0,60,60,0,1,0,1,0
25579,49464,445,0,0,70,70,0,1,0,1,0
25580,40742,2967,0,0,62,62,0,1,0,1,0
25581,55012,64147,0,0,66,66,0,1,0,1,0
25582,56658,53,53602,53,193,102,91,2,30,1,1
25583,64575,53,7510,53,182,102,80,2,30,1,1
25584,56327,53,30596,53,199,102,97,2,30,1,1
25585,50589,53,14237,53,786,110,676,2,30,1,1
25586,57344,53,11119,53,969,86,883,2,30,1,1
25587,53799,53,39316,53,213,78,135,2,30,1,1
25588,58858,443,56785,443,7413235,214811,7198424,7869,344,2785,5084
25589,58856,443,36240,443,6350667,198580,6152087,6885,451,2497,4388
25590,45896,443,32975,443,1160457,45088,1115369,1320,315,518,802
25591,40408,443,59569,443,6058,1749,4309,22,201,13,9
25592,35654,80,35654,80,7040,5744,1296,16,158,9,7
25593,49214,58485,53751,58485,70,70,0,2,8,2,0
25594,53805,34155,31252,34155,70,70,0,2,7,2,0
25595,59779,443,59854,443,568,568,0,5,10,5,0
25596,57016,53,13360,53,266,110,156,2,30,1,1
25597,53804,24067,52480,24067,70,70,0,2,7,2,0
25598,50458,443,25872,443,523577,34256,489321,1025,208,473,552
25599,50303,443,52524,443,208,60,148,4,11,2,2
25600,55042,443,45406,443,126,60,66,3,5,2,1
25601,55285,53,22135,53,268,95,173,4,45,2,2
25602,55098,53,38857,53,474,200,274,6,43,3,3
25603,63966,42532,21022,42532,66,66,0,2,7,2,0
25604,35941,443,48738,443,190,70,120,4,18,2,2
25605,53798,62166,11396,62166,258,70,188,4,7,2,2
25606,63954,60430,37652,60430,70,70,0,1,4,1,0
25607,64980,53,40885,53,274,88,186,4,35,2,2
25608,65238,53,61898,53,302,104,198,4,46,2,2
25609,50612,80,47441,80,1559,1107,452,9,24,5,4
25610,26900,27017,1081,27017,422,164,258,6,29,3,3
25611,55932,53,10932,53,193,102,91,2,29,1,1
25612,64537,53,60663,53,168,86,82,2,29,1,1
25613,55371,53,15832,53,184,102,82,2,29,1,1
25614,26900,27017,35787,27017,422,164,258,6,29,3,3
25615,56395,53,34668,53,199,102,97,2,29,1,1
25616,26900,27017,23136,27017,422,164,258,6,29,3,3
25617,26900,27017,19370,27017,422,164,258,6,29,3,3
25618,49811,53,10574,53,763,102,661,2,29,1,1
25619,57203,53,8040,53,199,102,97,2,29,1,1
25620,56450,53,8472,53,168,86,82,2,30,1,1
25621,56395,53,54170,53,199,102,97,2,29,1,1
25622,49390,53,36883,53,210,110,100,2,30,1,1
25623,56636,53,49408,53,168,86,82,2,30,1,1
25624,56151,53,10029,53,194,102,92,2,30,1,1
25625,55727,53,33963,53,335,93,242,4,32,2,2
25626,56245,53,35606,53,200,102,98,2,30,1,1
25627,49835,53,19938,53,194,102,92,2,30,1,1
25628,57299,53,60240,53,338,110,228,2,30,1,1
25629,65019,53,36796,53,195,102,93,2,30,1,1
25630,55849,53,49045,53,195,102,93,2,30,1,1
25631,44211,443,12188,443,6263,1804,4459,21,361,11,10
25632,56170,53,63567,53,198,102,96,2,30,1,1
25633,50727,27029,42555,27029,269,78,191,2,30,1,1
25634,55113,53,62631,53,177,94,83,2,30,1,1
25635,49215,52611,46200,52611,70,70,0,2,8,2,0
25636,58993,443,55872,443,416,210,206,7,26,4,3
25637,55098,53,15101,53,474,200,274,6,43,3,3
25638,56998,80,16426,80,214,140,74,4,35,3,1
25639,60971,443,16884,443,4548,2858,1690,42,111,22,20
25640,56327,53,60019,53,199,102,97,2,30,1,1
25641,57467,443,57467,443,4373,1466,2907,19,27,11,8
25642,55154,53,33060,53,184,94,90,2,30,1,1
25643,58774,443,50443,443,7254,838,6416,27,290,9,18
25644,56958,53,59654,53,816,102,714,2,30,1,1
25645,56995,80,29664,80,214,140,74,4,35,3,1
25646,56198,53,28713,53,184,102,82,2,30,1,1
25647,49372,53,16928,53,210,110,100,2,30,1,1
25648,26900,27017,30170,27017,422,164,258,6,30,3,3
25649,60780,28080,48359,28080,70,70,0,1,5,1,0
25650,64980,53,62800,53,180,94,86,2,30,1,1
25651,56001,53,33036,53,196,94,102,2,30,1,1
25652,58844,443,8325,443,5167,700,4467,16,15,7,9
25653,65328,53,18942,53,166,86,80,2,30,1,1
25654,58771,80,60976,80,3312,1569,1743,12,135,7,5
25655,64330,53,10524,53,193,102,91,2,30,1,1
25656,27005,27015,64723,27015,901,126,775,2,30,1,1
25657,48817,25636,48817,25636,481,150,331,2,1200,1,1
25658,27005,27014,60898,27014,879,126,753,2,30,1,1
25659,27005,4444,13134,4444,881,126,755,2,30,1,1
25660,51166,443,54384,443,13072,4708,8364,47,130,24,23
25661,58847,443,48579,443,5167,700,4467,16,15,7,9
25662,50465,80,51689,80,3688274,86827,3601447,3622,32,1228,2394
25663,49354,53,61914,53,196,102,94,2,30,1,1
25664,56624,53,44653,53,199,102,97,2,30,1,1
25665,56988,53,43201,53,216,110,106,2,30,1,1
25666,49205,53,61916,53,194,102,92,2,30,1,1
25667,55098,53,33176,53,474,200,274,6,44,3,3
25668,60965,443,57735,443,1439,718,721,15,111,8,7
25669,35889,443,19640,443,6982,1728,5254,23,27,13,10
25670,50581,80,61624,80,2573,1859,714,9,47,5,4
25671,58776,443,11042,443,7259,842,6417,27,290,9,18
25672,26900,27017,57594,27017,172,86,86,2,30,1,1
25673,55979,53,60691,53,193,102,91,2,30,1,1
25674,49218,53,40400,53,195,102,93,2,30,1,1
25675,56416,53,14432,53,193,102,91,2,30,1,1
25676,55684,53,56434,53,193,102,91,2,30,1,1
25677,55272,53,55902,53,198,110,88,2,30,1,1
25678,64621,53,62273,53,214,102,112,2,30,1,1
25679,50729,27029,59296,27029,269,78,191,2,30,1,1
25680,55877,1049,50494,1049,323,150,173,2,1200,1,1
25681,49212,38306,32120,38306,70,70,0,2,8,2,0
25682,49502,443,21667,443,26402,2904,23498,56,270,29,27
25683,64894,53,1246,53,550,113,437,4,46,2,2
25684,53799,6881,35241,6881,70,70,0,2,7,2,0
25685,64582,443,48743,443,24686,1935,22751,36,19,17,19
25686,49216,63752,46385,63752,70,70,0,2,8,2,0
25687,56492,53,12334,53,184,94,90,2,29,1,1
25688,37175,53,14480,53,231,86,145,2,29,1,1
25689,26900,27017,14698,27017,422,164,258,6,29,3,3
25690,56450,53,45835,53,184,102,82,2,29,1,1
25691,55932,53,12204,53,193,102,91,2,29,1,1
25692,64687,53,10483,53,183,94,89,2,29,1,1
25693,57002,80,6505,80,214,140,74,4,35,3,1
25694,56245,53,14605,53,200,102,98,2,30,1,1
25695,56997,80,45711,80,214,140,74,4,35,3,1
25696,65307,53,36094,53,811,94,717,2,29,1,1
25697,38131,443,7949,443,85590,4656,80934,111,37,47,64
25698,55712,53,52427,53,164,86,78,2,29,1,1
25699,26900,27017,43852,27017,422,164,258,6,29,3,3
25700,56395,53,56804,53,199,102,97,2,29,1,1
25701,52090,443,53299,443,45583818,387905,45195913,35736,272,5246,30490
25702,26900,27017,8503,27017,422,164,258,6,29,3,3
25703,49503,53,43089,53,167,86,81,2,29,1,1
25704,49722,53,64718,53,200,102,98,2,29,1,1
25705,123,123,48945,123,184,94,90,2,29,1,1
25706,64687,53,9775,53,183,94,89,2,29,1,1
25707,64599,53,10160,53,250,94,156,2,29,1,1
25708,26900,27017,44088,27017,250,164,86,4,30,3,1
25709,26900,27017,55434,27017,422,164,258,6,29,3,3
25710,57437,53,35666,53,193,102,91,2,30,1,1
25711,57208,53,39529,53,183,94,89,2,30,1,1
25712,55154,53,5239,53,184,94,90,2,30,1,1
25713,56344,53,2417,53,199,102,97,2,30,1,1
25714,49205,53,36921,53,194,102,92,2,30,1,1
25715,56245,53,47709,53,200,102,98,2,30,1,1
25716,55154,53,39546,53,184,94,90,2,30,1,1
25717,56344,53,47952,53,199,102,97,2,30,1,1
25718,64089,53,37654,53,194,102,92,2,30,1,1
25719,64573,53,39960,53,184,94,90,2,30,1,1
25720,56067,53,59693,53,294,102,192,2,30,1,1
25721,55463,53,9844,53,216,110,106,2,31,1,1
25722,59008,443,16532,443,10214,2669,7545,30,170,14,16
25723,45898,443,17048,443,814431,31637,782794,913,315,346,567
25724,56004,443,20130,443,53826,3670,50156,85,275,41,44
25725,45900,443,8565,443,1277649,37293,1240356,1337,303,459,878
25726,6881,37321,46991,37321,502,150,352,2,1199,1,1
25727,65398,53,27490,53,214,110,104,2,30,1,1
25728,49429,53,47373,53,194,102,92,2,30,1,1
25729,56624,53,64033,53,199,102,97,2,30,1,1
25730,57208,53,19470,53,183,94,89,2,30,1,1
25731,56988,53,29456,53,216,110,106,2,30,1,1
25732,64631,53,8154,53,193,102,91,2,30,1,1
25733,56362,53,16824,53,195,102,93,2,30,1,1
25734,64380,53,47265,53,193,102,91,2,30,1,1
25735,50730,27029,7986,27029,269,78,191,2,30,1,1
25736,55070,53,21493,53,195,102,93,2,30,1,1
25737,55975,53,27530,53,939,678,261,2,30,1,1
25738,55113,53,22722,53,177,94,83,2,30,1,1
25739,56151,53,18710,53,194,102,92,2,30,1,1
25740,56318,53,32737,53,183,94,89,2,30,1,1
25741,49390,53,56282,53,210,110,100,2,30,1,1
25742,64907,53,21503,53,247,86,161,3,31,2,1
25743,55155,53,52768,53,194,102,92,2,31,1,1
25744,40738,443,14631,443,1656,114,1542,5,120,2,3
25745,55830,53,50350,53,166,86,80,2,30,1,1
25746,56198,53,50578,53,184,102,82,2,30,1,1
25747,49211,15576,51582,15576,70,70,0,2,8,2,0
25748,48157,443,51436,443,7209,2331,4878,20,23,11,9
25749,37624,443,54201,443,471102,14016,457086,503,25,191,312
25750,53131,80,64503,80,2957,619,2338,12,15,6,6
25751,53130,80,42031,80,3683,606,3077,12,15,6,6
25752,55078,443,55078,443,4401,1494,2907,19,30,11,8
25753,53671,80,50539,80,956,502,454,12,15,7,5
25754,37641,443,55231,443,8423,2244,6179,32,15,17,15
25755,56655,80,36577,80,234,234,0,4,12,4,0
25756,64266,53,53096,53,1026,383,643,10,84,5,5
25757,55010,443,19028,443,7651,2261,5390,41,255,21,20
25758,56999,80,32577,80,214,140,74,4,35,3,1
25759,56996,80,27965,80,214,140,74,4,35,3,1
25760,57003,80,40780,80,526,304,222,8,35,5,3
25761,51554,443,48017,443,4263,671,3592,14,75,8,6
25762,57076,53,47154,53,184,94,90,2,30,1,1
25763,49878,53,52467,53,262,126,136,2,30,1,1
25764,56958,53,40535,53,193,102,91,2,30,1,1
25765,49835,53,6905,53,817,102,715,2,30,1,1
25766,64573,53,34650,53,184,94,90,2,30,1,1
25767,49372,53,57735,53,210,110,100,2,30,1,1
25768,56988,53,25747,53,216,110,106,2,30,1,1
25769,27005,27015,65078,27015,878,126,752,2,30,1,1
25770,53798,53,26638,53,224,86,138,2,30,1,1
25771,64316,53,5577,53,184,94,90,2,30,1,1
25772,50278,53,34897,53,819,102,717,2,30,1,1
25773,57409,53,6816,53,168,86,82,2,31,1,1
25774,60137,443,42633,443,10407,3966,6441,30,149,18,12
25775,61405,443,43963,443,4810,2361,2449,34,80,16,18
25776,57001,80,47227,80,214,140,74,4,35,3,1
25777,57000,80,51268,80,214,140,74,4,35,3,1
25778,48652,443,38749,443,6388,964,5424,21,255,11,10
25779,37633,443,4674,443,8493,2314,6179,33,16,18,15
25780,57437,53,57480,53,193,102,91,2,30,1,1
25781,64980,53,51851,53,180,94,86,2,30,1,1
25782,56658,53,26187,53,193,102,91,2,30,1,1
25783,57409,53,63027,53,168,86,82,2,30,1,1
25784,56416,53,30154,53,816,102,714,2,30,1,1
25785,49390,53,61910,53,210,110,100,2,30,1,1
25786,55755,53,57482,53,779,86,693,2,30,1,1
25787,50732,27029,64378,27029,269,78,191,2,30,1,1
25788,56636,53,34067,53,168,86,82,2,30,1,1
25789,50025,53,33178,53,761,102,659,2,30,1,1
25790,49354,53,16501,53,196,102,94,2,30,1,1
25791,55085,53,9873,53,301,94,207,2,30,1,1
25792,65398,53,49816,53,214,110,104,2,30,1,1
25793,65356,53,49410,53,199,102,97,2,30,1,1
25794,55979,53,21397,53,193,102,91,2,31,1,1
25795,65019,53,46989,53,195,102,93,2,31,1,1
25796,57243,53,64536,53,165,86,79,2,31,1,1
25797,35577,443,21477,443,15162,8505,6657,55,197,29,26
25798,53427,443,4839,443,9896,2040,7856,34,120,17,17
25799,58859,443,48012,443,39518,2389,37129,54,179,21,33
25800,56880,53,8683,53,209,110,99,2,31,1,1
25801,64326,53,50909,53,196,102,94,2,31,1,1
25802,41321,443,41856,443,9168,1596,7572,22,186,11,11
25803,53797,53,41009,53,260,86,174,2,30,1,1
25804,49813,53,53266,53,775,102,673,2,30,1,1
25805,53686,19010,53686,19010,70,70,0,1,30,1,0
25806,64089,53,3452,53,194,102,92,2,31,1,1
25807,57208,53,46583,53,183,94,89,2,31,1,1
25808,56344,53,6437,53,199,102,97,2,31,1,1
25809,56757,53,30520,53,167,86,81,2,31,1,1
25810,55883,53,56307,53,181,94,87,2,31,1,1
25811,36956,443,8939,443,9273,2731,6542,31,403,10,21
25812,65356,53,36098,53,199,102,97,2,30,1,1
25813,55315,53,5468,53,196,102,94,2,31,1,1
25814,57470,51413,19647,51413,740725,699740,40985,1031,1411,616,415
25815,49218,53,22762,53,195,102,93,2,31,1,1
25816,56637,53,47556,53,214,110,104,2,31,1,1
25817,55684,53,54861,53,193,102,91,2,31,1,1
25818,56318,53,47693,53,183,94,89,2,31,1,1
25819,54527,443,27649,443,13132,7107,6025,45,174,23,22
25820,61626,443,21665,443,5663,3258,2405,19,120,9,10
25821,42076,443,63627,443,22106,5214,16892,23,128,9,14
25822,63964,60705,4477,60705,312,132,180,6,7,3,3
25823,63952,50734,27783,50734,70,70,0,1,5,1,0
25824,49205,53,19317,53,194,102,92,2,31,1,1
25825,55070,53,23784,53,195,102,93,2,31,1,1
25826,64316,53,34882,53,184,94,90,2,31,1,1
25827,64519,53,15868,53,518,185,333,6,60,3,3
25828,52020,28704,45681,28704,70,70,0,2,9,2,0
25829,51995,50031,29706,50031,70,70,0,1,5,1,0
25830,57894,80,58107,80,9800,2228,7572,23,24,12,11
25831,58843,443,44716,443,6033,770,5263,18,16,8,10
25832,20570,53,52597,53,428,78,350,2,31,1,1
25833,57418,53,1554,53,165,86,79,2,31,1,1
25834,61936,443,38328,443,4348,1643,2705,14,138,6,8
25835,56487,53,61282,53,194,102,92,2,31,1,1
25836,52023,41791,61647,41791,70,70,0,2,8,2,0
25837,52018,2425,15478,2425,70,70,0,2,9,2,0
25838,57337,443,40846,443,1169,616,553,12,16,7,5
25839,50584,80,65205,80,1883,995,888,11,47,6,5
25840,25101,50584,0,0,62,62,0,1,0,1,0
25841,61007,445,0,0,70,70,0,1,0,1,0
25842,45313,64147,0,0,62,62,0,1,0,1,0
25843,3478,61463,0,0,804,804,0,1,0,1,0
25844,53816,22114,0,0,62,62,0,1,0,1,0
25845,3478,61463,0,0,164,164,0,1,0,1,0
25846,50772,35440,0,0,62,62,0,1,0,1,0
25847,61235,445,0,0,66,66,0,1,0,1,0
25848,57825,13014,0,0,74,74,0,1,0,1,0
25849,3478,61463,0,0,1292,1292,0,1,0,1,0
25850,45941,23386,0,0,60,60,0,1,0,1,0
25851,60999,445,0,0,70,70,0,1,0,1,0
25852,3478,61463,0,0,877,877,0,1,0,1,0
25853,3478,61463,0,0,68,68,0,1,0,1,0
25854,3478,61463,0,0,409,409,0,1,0,1,0
25855,58829,64147,0,0,62,62,0,1,0,1,0
25856,60997,445,0,0,70,70,0,1,0,1,0
25857,61229,445,0,0,66,66,0,1,0,1,0
25858,61226,445,0,0,66,66,0,1,0,1,0
25859,60993,445,0,0,70,70,0,1,0,1,0
25860,60991,445,0,0,70,70,0,1,0,1,0
25861,5223,14446,0,0,220,220,0,1,0,1,0
25862,60987,445,0,0,70,70,0,1,0,1,0
25863,49450,445,0,0,70,70,0,1,0,1,0
25864,49449,445,0,0,70,70,0,1,0,1,0
25865,49448,445,0,0,70,70,0,1,0,1,0
25866,61211,445,0,0,66,66,0,1,0,1,0
25867,61213,445,0,0,66,66,0,1,0,1,0
25868,61212,445,0,0,66,66,0,1,0,1,0
25869,61209,445,0,0,66,66,0,1,0,1,0
25870,61210,445,0,0,66,66,0,1,0,1,0
25871,61207,445,0,0,66,66,0,1,0,1,0
25872,61208,445,0,0,66,66,0,1,0,1,0
25873,61205,445,0,0,66,66,0,1,0,1,0
25874,3478,61463,0,0,252,252,0,1,0,1,0
25875,57011,49813,0,0,62,62,0,1,0,1,0
25876,60986,445,0,0,70,70,0,1,0,1,0
25877,59366,35440,0,0,66,66,0,1,0,1,0
25878,11005,30188,0,0,146,146,0,1,0,1,0
25879,55766,36237,0,0,62,62,0,1,0,1,0
25880,54464,56205,0,0,62,62,0,1,0,1,0
25881,51769,51505,0,0,66,66,0,1,0,1,0
25882,3478,61463,0,0,1044,1044,0,1,0,1,0
25883,3478,61463,0,0,1288,1288,0,1,0,1,0
25884,38885,21247,0,0,62,62,0,1,0,1,0
25885,60981,445,0,0,70,70,0,1,0,1,0
25886,49447,445,0,0,70,70,0,1,0,1,0
25887,49446,445,0,0,70,70,0,1,0,1,0
25888,49444,445,0,0,70,70,0,1,0,1,0
25889,49443,445,0,0,70,70,0,1,0,1,0
25890,443,62732,0,0,332,332,0,1,0,1,0
25891,61191,445,0,0,66,66,0,1,0,1,0
25892,61193,445,0,0,66,66,0,1,0,1,0
25893,61190,445,0,0,66,66,0,1,0,1,0
25894,14350,56205,0,0,62,62,0,1,0,1,0
25895,48186,51050,0,0,62,62,0,1,0,1,0
25896,3478,61463,0,0,342,342,0,1,0,1,0
25897,28378,56205,0,0,146,146,0,1,0,1,0
25898,49428,445,0,0,70,70,0,1,0,1,0
25899,48176,50584,0,0,146,146,0,1,0,1,0
25900,49423,445,0,0,70,70,0,1,0,1,0
25901,49420,445,0,0,70,70,0,1,0,1,0
25902,49421,445,0,0,70,70,0,1,0,1,0
25903,45908,33330,0,0,60,60,0,1,0,1,0
25904,45908,33330,0,0,60,60,0,1,0,1,0
25905,60968,445,0,0,70,70,0,1,0,1,0
25906,3478,61463,0,0,164,164,0,1,0,1,0
25907,3478,61463,0,0,1094,1094,0,1,0,1,0
25908,54752,31573,0,0,66,66,0,1,0,1,0
25909,58488,37965,0,0,62,62,0,1,0,1,0
25910,62153,35440,0,0,62,62,0,1,0,1,0
25911,60965,445,0,0,70,70,0,1,0,1,0
25912,59400,22114,0,0,62,62,0,1,0,1,0
25913,38664,37965,0,0,62,62,0,1,0,1,0
25914,63569,62413,0,0,66,66,0,1,0,1,0
25915,3478,61463,0,0,857,857,0,1,0,1,0
25916,3478,61463,0,0,437,437,0,1,0,1,0
25917,11136,19910,0,0,62,62,0,1,0,1,0
25918,49411,445,0,0,70,70,0,1,0,1,0
25919,49408,445,0,0,70,70,0,1,0,1,0
25920,49406,445,0,0,70,70,0,1,0,1,0
25921,60960,445,0,0,70,70,0,1,0,1,0
25922,61180,445,0,0,66,66,0,1,0,1,0
25923,60959,445,0,0,70,70,0,1,0,1,0
25924,63467,37807,0,0,62,62,0,1,0,1,0
25925,63331,51221,0,0,62,62,0,1,0,1,0
25926,443,18411,0,0,74,74,0,1,0,1,0
25927,443,60082,0,0,74,74,0,1,0,1,0
25928,443,39711,0,0,74,74,0,1,0,1,0
25929,3478,61463,0,0,814,814,0,1,0,1,0
25930,0,0,0,0,140,140,0,2,0,2,0
25931,0,0,0,0,320,320,0,5,0,5,0
25932,60957,445,0,0,70,70,0,1,0,1,0
25933,13285,29892,0,0,145,145,0,1,0,1,0
25934,443,39999,0,0,74,74,0,1,0,1,0
25935,36374,30228,0,0,145,145,0,1,0,1,0
25936,443,9313,0,0,74,74,0,1,0,1,0
25937,443,49031,0,0,74,74,0,1,0,1,0
25938,443,11817,0,0,74,74,0,1,0,1,0
25939,62493,50584,0,0,62,62,0,1,0,1,0
25940,443,23622,0,0,74,74,0,1,0,1,0
25941,30794,37965,0,0,62,62,0,1,0,1,0
25942,3478,61463,0,0,441,441,0,1,0,1,0
25943,40977,21247,0,0,66,66,0,1,0,1,0
25944,49401,445,0,0,70,70,0,1,0,1,0
25945,49395,445,0,0,70,70,0,1,0,1,0
25946,46218,23,0,0,60,60,0,1,0,1,0
25947,57459,51505,0,0,66,66,0,1,0,1,0
25948,52830,22114,0,0,62,62,0,1,0,1,0
25949,26698,57470,0,0,62,62,0,1,0,1,0
25950,60950,445,0,0,70,70,0,1,0,1,0
25951,63242,50584,0,0,66,66,0,1,0,1,0
25952,61164,445,0,0,66,66,0,1,0,1,0
25953,61163,445,0,0,66,66,0,1,0,1,0
25954,60948,445,0,0,70,70,0,1,0,1,0
25955,49511,57470,0,0,66,66,0,1,0,1,0
25956,50052,65010,0,0,60,60,0,1,0,1,0
25957,57131,8055,0,0,145,145,0,1,0,1,0
25958,3478,61463,0,0,315,315,0,1,0,1,0
25959,64697,37965,0,0,66,66,0,1,0,1,0
25960,59376,5900,0,0,60,60,0,1,0,1,0
25961,60947,445,0,0,70,70,0,1,0,1,0
25962,35291,44847,0,0,66,66,0,1,0,1,0
25963,60946,445,0,0,70,70,0,1,0,1,0
25964,60945,445,0,0,70,70,0,1,0,1,0
25965,49388,445,0,0,70,70,0,1,0,1,0
25966,12143,56205,0,0,66,66,0,1,0,1,0
25967,60939,445,0,0,70,70,0,1,0,1,0
25968,60942,445,0,0,70,70,0,1,0,1,0
25969,49386,445,0,0,70,70,0,1,0,1,0
25970,49383,445,0,0,70,70,0,1,0,1,0
25971,49380,445,0,0,70,70,0,1,0,1,0
25972,52962,35440,0,0,66,66,0,1,0,1,0
25973,14103,35440,0,0,62,62,0,1,0,1,0
25974,59679,37807,0,0,66,66,0,1,0,1,0
25975,61159,445,0,0,66,66,0,1,0,1,0
25976,58836,44847,0,0,70,70,0,1,0,1,0
25977,3478,61463,0,0,627,627,0,1,0,1,0
25978,61154,445,0,0,66,66,0,1,0,1,0
25979,61153,445,0,0,66,66,0,1,0,1,0
25980,61152,445,0,0,66,66,0,1,0,1,0
25981,61150,445,0,0,66,66,0,1,0,1,0
25982,61142,445,0,0,66,66,0,1,0,1,0
25983,61143,445,0,0,66,66,0,1,0,1,0
25984,61148,445,0,0,66,66,0,1,0,1,0
25985,64677,57470,0,0,66,66,0,1,0,1,0
25986,60927,445,0,0,70,70,0,1,0,1,0
25987,60925,445,0,0,70,70,0,1,0,1,0
25988,60923,445,0,0,70,70,0,1,0,1,0
25989,60917,445,0,0,70,70,0,1,0,1,0
25990,60916,445,0,0,70,70,0,1,0,1,0
25991,6881,61980,0,0,150,150,0,1,0,1,0
25992,49377,445,0,0,70,70,0,1,0,1,0
25993,61791,80,61791,80,16848,822,16026,23,16,9,14
25994,62324,443,62324,443,2882,1622,1260,20,86,10,10
25995,62231,443,62231,443,180730,19869,160861,239,171,103,136
25996,36881,443,36881,443,4652,1745,2907,19,28,11,8
25997,49208,6881,3930,6881,70,70,0,2,8,2,0
25998,39198,443,37054,443,6328,850,5478,26,289,9,17
25999,50621,443,42155,443,3171,1473,1698,15,93,9,6
26000,49158,443,3923,443,23613,13099,10514,79,1341,36,43
26001,52021,32202,58767,32202,70,70,0,2,8,2,0
26002,54280,3396,54280,3396,146,60,86,2,10,1,1
26003,51990,42127,1528,42127,66,66,0,1,5,1,0
26004,51202,443,46664,443,7702,2410,5292,26,34,13,13
26005,56487,53,12533,53,188,96,92,2,30,1,1
26006,56779,53,7300,53,757,98,659,2,30,1,1
26007,52017,26175,18735,26175,70,70,0,2,9,2,0
26008,58834,443,42035,443,7880,5105,2775,25,17,13,12
26009,50076,80,29026,80,26128,9214,16914,81,512,40,41
26010,51613,7000,51613,7000,2163,676,1487,14,15,7,7
26011,56169,53,42323,53,204,104,100,2,30,1,1
26012,50279,443,22072,443,21204,10998,10206,51,392,27,24
26013,60856,443,12085,443,8201,2795,5406,43,18,26,17
26014,50625,443,24719,443,9588,1204,8384,29,93,15,14
26015,43632,80,17222,80,2000,710,1290,8,15,5,3
26016,58805,443,25945,443,32148,21507,10641,72,21,42,30
26017,45319,443,29767,443,9284,2430,6854,25,82,14,11
26018,46991,443,46408,443,2809,1884,925,19,26,11,8
26019,52513,80,64881,80,39793,2026,37767,55,16,27,28
26020,55684,53,10799,53,186,95,91,2,30,1,1
26021,27005,30010,26771,30010,887,126,761,2,31,1,1
26022,57092,53,22566,53,756,95,661,2,31,1,1
26023,55155,53,65476,53,188,96,92,2,31,1,1
26024,50584,443,50316,443,36457,2308,34149,52,98,23,29
26025,60540,443,60540,443,4455,1548,2907,19,27,11,8
26026,60870,443,18926,443,8219,2676,5543,40,15,24,16
26027,50517,80,63449,80,5997,1327,4670,18,157,10,8
26028,53912,3478,54737,3478,3532,1792,1740,58,88,29,29
26029,49201,17852,9879,17852,70,70,0,2,8,2,0
26030,50660,443,1887,443,3845,1814,2031,19,38,11,8
26031,47516,80,2518,80,956,541,415,11,316,6,5
26032,49157,443,32525,443,5115,977,4138,18,18,10,8
26033,49209,52030,40486,52030,70,70,0,2,8,2,0
26034,50637,80,48925,80,1742,589,1153,10,87,6,4
26035,52022,53657,34064,53657,70,70,0,2,8,2,0
26036,57721,443,65259,443,1019,644,375,10,37,6,4
26037,51994,25509,12796,25509,66,66,0,1,5,1,0
26038,54912,443,54912,443,4401,1494,2907,19,27,11,8
26039,50092,80,20230,80,11297,8141,3156,52,508,34,18
26040,53687,19010,53687,19010,64,64,0,1,30,1,0
26041,54371,443,51699,443,6120,1305,4815,20,983,10,10
26042,50306,80,39882,80,182517,10761,171756,265,352,130,135
26043,53713,443,33766,443,9555,4200,5355,25,86,15,10
26044,55351,53,4702,53,1497,108,1389,4,53,2,2
26045,50580,443,63411,443,2604,1413,1191,15,98,9,6
26046,55986,53,53201,53,744,89,655,2,30,1,1
26047,55546,53,22275,53,1417,96,1321,4,30,2,2
26048,55315,53,41500,53,192,98,94,2,31,1,1
26049,52385,53,0,0,138,69,69,2,30,1,1
26050,56540,53,53541,53,735,88,647,2,30,1,1
26051,57409,53,7230,53,168,86,82,2,30,1,1
26052,42186,443,1253,443,3562,2096,1466,18,336,9,9
26053,56880,53,23570,53,202,103,99,2,31,1,1
26054,27005,27015,56171,27015,858,126,732,2,31,1,1
26055,55907,53,18391,53,184,94,90,2,31,1,1
26056,55068,53,58274,53,192,98,94,2,31,1,1
26057,56112,53,3199,53,198,101,97,2,31,1,1
26058,56875,53,47885,53,166,85,81,2,31,1,1
26059,46779,5228,25730,5228,3775,2029,1746,30,3637,13,17
26060,50620,443,5914,443,1277,851,426,12,92,7,5
26061,50600,443,20473,443,5035,3194,1841,23,96,12,11
26062,50629,443,47938,443,6553,1034,5519,23,87,12,11
26063,59994,53,59994,53,462,158,304,4,31,2,2
26064,56503,53,8942,53,916,86,830,2,31,1,1
26065,51968,443,14636,443,122815,48545,74270,164,95,76,88
26066,55525,53,23543,53,212,108,104,2,31,1,1
26067,50439,443,55602,443,73712,18850,54862,135,717,61,74
26068,42185,443,3806,443,15233,9395,5838,33,338,16,17
26069,56427,53,59297,53,164,84,80,2,31,1,1
26070,56676,53,4759,53,172,88,84,2,31,1,1
26071,57343,53,26142,53,178,91,87,2,31,1,1
26072,56382,53,19333,53,190,97,93,2,31,1,1
26073,60795,443,29587,443,3282,1018,2264,10,121,5,5
26074,2598,23718,0,0,66,66,0,1,0,1,0
26075,52811,44847,0,0,66,66,0,1,0,1,0
26076,49373,445,0,0,70,70,0,1,0,1,0
26077,49371,445,0,0,70,70,0,1,0,1,0
26078,49369,445,0,0,70,70,0,1,0,1,0
26079,55689,37965,0,0,66,66,0,1,0,1,0
26080,3478,61463,0,0,503,503,0,1,0,1,0
26081,65379,22114,0,0,62,62,0,1,0,1,0
26082,41348,5555,0,0,60,60,0,1,0,1,0
26083,56494,50432,0,0,146,146,0,1,0,1,0
26084,52828,51221,0,0,66,66,0,1,0,1,0
26085,60905,445,0,0,70,70,0,1,0,1,0
26086,56704,53,35730,53,210,94,116,2,30,1,1
26087,64823,53,30935,53,508,102,406,2,30,1,1
26088,55155,53,23280,53,194,102,92,2,30,1,1
26089,50535,80,27169,80,36985,3992,32993,56,151,25,31
26090,1737,80,1737,80,424934,9929,415005,411,95,129,282
26091,58057,80,12753,80,254,128,126,5,15,3,2
26092,51992,22670,31187,22670,70,70,0,1,4,1,0
26093,56105,53,14961,53,372,142,230,2,29,1,1
26094,64999,53,5804,53,178,94,84,2,29,1,1
26095,56560,53,15895,53,164,86,78,2,29,1,1
26096,55777,53,5442,53,733,94,639,2,29,1,1
26097,64999,53,33322,53,178,94,84,2,29,1,1
26098,56632,53,26751,53,200,94,106,2,29,1,1
26099,49373,443,19953,443,1857,1218,639,18,104,11,7
26100,57335,8631,57083,8631,742,298,444,11,16,5,6
26101,49372,443,30393,443,6158,3587,2571,37,104,19,18
26102,44145,443,29432,443,8746,2844,5902,26,315,13,13
26103,50139,443,27090,443,72523,5814,66709,125,255,61,64
26104,51996,41888,46821,41888,70,70,0,1,4,1,0
26105,55803,53,18638,53,261,89,172,4,32,2,2
26106,53796,48019,39849,48019,70,70,0,2,7,2,0
26107,62208,443,62208,443,4497,1590,2907,19,29,11,8
26108,50618,80,9879,80,25890,3442,22448,33,21,13,20
26109,53813,39832,19071,39832,320,140,180,6,5,3,3
26110,50562,443,53886,443,103466,11111,92355,258,140,119,139
26111,45627,443,47069,443,7092,1883,5209,21,21,12,9
26112,1736,80,1736,80,101959,5508,96451,111,95,41,70
26113,43591,443,23363,443,4680,2835,1845,33,80,16,17
26114,55358,53,33999,53,200,94,106,2,29,1,1
26115,56624,53,40354,53,199,102,97,2,29,1,1
26116,64380,53,22158,53,193,102,91,2,29,1,1
26117,55272,53,54690,53,198,110,88,2,29,1,1
26118,64326,53,30580,53,196,102,94,2,29,1,1
26119,50311,443,2014,443,133674,20935,112739,206,350,105,101
26120,56639,53,47791,53,168,86,82,2,32,1,1
26121,1735,80,1735,80,78576,5218,73358,91,95,36,55
26122,54506,80,60844,80,254,128,126,5,15,3,2
26123,56655,53,1875,53,210,110,100,2,30,1,1
26124,57211,53,8547,53,258,110,148,2,30,1,1
26125,57419,53,26611,53,196,102,94,2,30,1,1
26126,55582,53,15587,53,168,86,82,2,30,1,1
26127,39205,53,46384,53,489,94,395,2,30,1,1
26128,55068,53,54785,53,196,102,94,2,30,1,1
26129,15680,53,61838,53,464,287,177,3,30,2,1
26130,65108,53,40239,53,215,94,121,2,30,1,1
26131,55427,53,22421,53,200,102,98,2,33,1,1
26132,34170,53,0,0,82,82,0,2,40,2,0
26133,64424,53,30245,53,211,102,109,2,30,1,1
26134,57593,28678,11489,28678,1806,1806,0,22,225,22,0
26135,49198,64509,42217,64509,70,70,0,2,8,2,0
26136,64721,443,45723,443,5552,927,4625,16,15,10,6
26137,49200,38001,36048,38001,70,70,0,2,8,2,0
26138,55260,53,35785,53,183,94,89,2,30,1,1
26139,58841,443,62984,443,5168,700,4468,16,15,7,9
26140,50057,53,32757,53,718,94,624,2,30,1,1
26141,64104,53,19823,53,288,101,187,4,57,2,2
26142,55411,53,33954,53,183,94,89,2,30,1,1
26143,56107,53,50537,53,817,102,715,2,30,1,1
26144,49924,53,19826,53,718,94,624,2,30,1,1
26145,50574,443,9752,443,9191,2003,7188,25,100,13,12
26146,49293,53,24281,53,178,94,84,2,30,1,1
26147,56487,53,32287,53,194,102,92,2,30,1,1
26148,56995,443,35339,443,8721,2518,6203,29,159,13,16
26149,49935,53,50105,53,177,94,83,2,30,1,1
26150,56757,53,39521,53,167,86,81,2,30,1,1
26151,56107,53,24230,53,194,102,92,2,30,1,1
26152,55411,53,25352,53,183,94,89,2,30,1,1
26153,49754,53,60786,53,180,94,86,2,30,1,1
26154,65391,53,47962,53,720,94,626,2,30,1,1
26155,55427,53,31506,53,200,102,98,2,30,1,1
26156,55411,53,47570,53,183,94,89,2,30,1,1
26157,56111,53,56414,53,152,78,74,2,30,1,1
26158,55791,53,4698,53,811,94,717,2,30,1,1
26159,57243,53,20159,53,173,94,79,2,30,1,1
26160,56667,53,19814,53,244,94,150,2,30,1,1
26161,55261,53,19627,53,173,94,79,2,30,1,1
26162,64326,53,26486,53,196,102,94,2,30,1,1
26163,56941,53,32595,53,212,102,110,2,30,1,1
26164,49625,53,64446,53,251,102,149,2,30,1,1
26165,56362,53,49455,53,195,102,93,2,30,1,1
26166,56860,53,63586,53,184,102,82,2,30,1,1
26167,56888,443,59232,443,10384,2236,8148,28,186,15,13
26168,54953,53,51225,53,289,134,155,2,30,1,1
26169,55250,53,30475,53,416,102,314,2,30,1,1
26170,50567,443,13850,443,1202,720,482,12,139,7,5
26171,50588,443,8589,443,2460,1267,1193,16,98,9,7
26172,49206,12242,32509,12242,70,70,0,2,8,2,0
26173,49210,33757,53103,33757,70,70,0,2,8,2,0
26174,48024,443,44709,443,9194,1066,8128,21,27,12,9
26175,50526,80,52180,80,259593,12828,246765,308,156,118,190
26176,52207,443,22846,443,74711,8646,66065,150,89,70,80
26177,62226,443,62226,443,130836,22940,107896,161,170,72,89
26178,55676,28694,59367,28694,316,190,126,5,15,3,2
26179,52415,443,3677,443,14050,4805,9245,30,158,17,13
26180,57000,53,37935,53,193,94,99,2,30,1,1
26181,63941,53,42926,53,253,102,151,2,30,1,1
26182,55883,53,20281,53,189,102,87,2,30,1,1
26183,56880,53,27129,53,209,110,99,2,30,1,1
26184,56319,53,40959,53,455,94,361,2,30,1,1
26185,49890,443,37248,443,9545,2433,7112,24,142,10,14
26186,1738,80,1738,80,87958,5378,82580,100,95,39,61
26187,50587,443,51277,443,1198,716,482,12,98,7,5
26188,55671,53,24025,53,196,102,94,2,33,1,1
26189,64089,53,43918,53,340,96,244,4,35,2,2
26190,55729,53,3835,53,256,96,160,4,42,2,2
26191,43096,443,6267,443,7098,2628,4470,20,16,12,8
26192,50625,443,48490,443,3090,1707,1383,15,19,9,6
26193,58838,443,31088,443,5167,700,4467,16,15,7,9
26194,40992,443,49820,443,8705,3570,5135,35,100,20,15
26195,55907,53,49379,53,184,94,90,2,30,1,1
26196,57679,443,35639,443,13034,3324,9710,35,120,15,20
26197,60081,443,25599,443,10893,4674,6219,43,121,19,24
26198,27005,27080,21162,27080,926,126,800,2,31,1,1
26199,49293,53,18352,53,294,88,206,4,57,2,2
26200,50528,80,29237,80,66430,7013,59417,93,156,40,53
26201,14438,443,5069,443,2556,1470,1086,17,15,8,9
26202,56787,443,11653,443,5639,846,4793,18,27,10,8
26203,50525,80,36119,80,152171,9332,142839,189,156,78,111
26204,51797,80,10283,80,9897,4338,5559,27,58,16,11
26205,54196,80,31560,80,2640,540,2100,12,45,6,6
26206,27005,29999,55945,29999,887,126,761,2,31,1,1
26207,50595,443,49114,443,2862,1587,1275,15,95,9,6
26208,35549,443,45483,443,9032,2244,6788,36,255,17,19
26209,33643,443,12343,443,163835,28514,135321,310,153,162,148
26210,57340,443,31175,443,1169,616,553,12,16,7,5
26211,53810,8999,16528,8999,320,140,180,6,5,3,3
26212,35196,8635,35196,8635,138,78,60,2,5,1,1
26213,38695,443,12020,443,1185199,19993,1165206,1088,16,289,799
26214,50266,443,54511,443,21634,11226,10408,54,402,35,19
26215,49227,53,40527,53,340,89,251,4,44,2,2
26216,58001,443,15727,443,300,180,120,6,28,4,2
26217,55414,443,59075,443,6053,4104,1949,31,84,17,14
26218,50573,443,20479,443,6575,1995,4580,26,100,13,13
26219,50354,443,37764,443,71226,18632,52594,137,318,63,74
26220,56991,80,27805,80,1638,1324,314,10,15,5,5
26221,56362,53,31120,53,195,102,93,2,29,1,1
26222,55463,53,33769,53,216,110,106,2,29,1,1
26223,50649,443,16928,443,15295,1755,13540,31,77,15,16
26224,56560,53,37508,53,172,94,78,2,29,1,1
26225,50463,80,10843,80,287874,13215,274659,346,204,136,210
26226,55329,53,39839,53,210,102,108,2,29,1,1
26227,56636,53,35098,53,372,86,286,4,54,2,2
26228,55684,53,19288,53,193,102,91,2,29,1,1
26229,56111,53,50559,53,168,94,74,2,30,1,1
26230,49163,53,13314,53,167,86,81,2,29,1,1
26231,64631,53,29007,53,193,102,91,2,29,1,1
26232,55260,53,54111,53,183,94,89,2,30,1,1
26233,51766,443,63491,443,5462,1305,4157,22,121,10,12
26234,34428,443,49184,443,21512,4620,16892,22,127,8,14
26235,64104,53,54315,53,288,101,187,4,58,2,2
26236,27260,443,46156,443,4329,2374,1955,23,520,8,15
26237,60994,443,7195,443,13145,6129,7016,37,34,19,18
26238,65503,53,13139,53,177,94,83,2,30,1,1
26239,56427,53,59591,53,166,86,80,2,30,1,1
26240,56860,53,58794,53,168,86,82,2,30,1,1
26241,56658,53,32323,53,193,102,91,2,30,1,1
26242,56700,53,42094,53,443,182,261,6,30,3,3
26243,56169,53,21391,53,210,110,100,2,30,1,1
26244,56110,53,15545,53,508,102,406,2,30,1,1
26245,56050,53,62054,53,178,94,84,2,30,1,1
26246,55803,53,62058,53,179,94,85,2,30,1,1
26247,65160,53,39178,53,198,94,104,2,30,1,1
26248,57092,53,56689,53,445,86,359,2,30,1,1
26249,55525,53,56574,53,214,110,104,2,30,1,1
26250,56382,53,27838,53,195,102,93,2,30,1,1
26251,65106,53,60145,53,438,180,258,6,30,3,3
26252,56487,53,4784,53,194,102,92,2,30,1,1
26253,27005,27015,3826,27015,876,126,750,2,31,1,1
26254,56917,53,28057,53,194,102,92,2,31,1,1
26255,64631,53,5606,53,193,102,91,2,30,1,1
26256,57419,53,1217,53,819,102,717,2,30,1,1
26257,56847,53,58381,53,252,102,150,2,30,1,1
26258,33836,443,3806,443,18875,13913,4962,116,788,60,56
26259,49387,53,43855,53,323,102,221,2,30,1,1
26260,55030,53,38017,53,185,102,83,2,30,1,1
26261,27005,29999,22693,29999,876,126,750,2,31,1,1
26262,56261,53,47864,53,184,94,90,2,31,1,1
26263,59582,443,37348,443,22106,5214,16892,23,127,9,14
26264,54977,443,65082,443,263411,11905,251506,318,144,118,200
26265,55315,53,24638,53,196,102,94,2,31,1,1
26266,40204,40021,21562,40021,148,86,62,2,31,1,1
26267,1739,80,1739,80,198357,5070,193287,197,95,63,134
26268,57022,443,20898,443,4228,1470,2758,19,131,9,10
26269,1734,80,1734,80,318813,10418,308395,314,95,102,212
26270,50524,80,58944,80,102242,12176,90066,149,156,68,81
26271,57602,443,23488,443,2614,1689,925,18,20,10,8
26272,49202,31719,45347,31719,70,70,0,2,8,2,0
26273,52019,40689,48482,40689,70,70,0,2,8,2,0
26274,64266,53,26877,53,180,94,86,2,35,1,1
26275,50467,80,31924,80,197269,14917,182352,254,204,107,147
26276,50566,443,4143,443,2064,1287,777,16,139,9,7
26277,56571,53,42202,53,325,102,223,2,30,1,1
26278,56655,53,35529,53,210,110,100,2,30,1,1
26279,57428,53,16884,53,198,94,104,2,30,1,1
26280,56637,53,51918,53,214,110,104,2,30,1,1
26281,57396,53,17014,53,212,102,110,2,30,1,1
26282,56637,53,18660,53,214,110,104,2,30,1,1
26283,56169,53,53942,53,210,110,100,2,30,1,1
26284,49935,53,46528,53,177,94,83,2,30,1,1
26285,64573,53,51074,53,184,94,90,2,30,1,1
26286,64992,53,64992,53,180,82,98,2,30,1,1
26287,63948,80,9193,80,314,192,122,6,15,4,2
26288,57021,443,9946,443,4697,1470,3227,20,131,9,11
26289,50527,80,17326,80,261781,16421,245360,330,156,137,193
26290,62227,443,62227,443,197342,62255,135087,232,170,110,122
26291,60866,443,47757,443,14519,9445,5074,35,15,20,15
26292,50592,443,18630,443,1304,878,426,12,96,7,5
26293,64292,53,10616,53,387,94,293,4,51,2,2
26294,55582,53,34252,53,168,86,82,2,30,1,1
26295,65503,53,29061,53,177,94,83,2,30,1,1
26296,55315,53,15960,53,196,102,94,2,30,1,1
26297,49354,53,25819,53,196,102,94,2,30,1,1
26298,64380,53,5955,53,193,102,91,2,30,1,1
26299,55030,53,46316,53,177,94,83,2,30,1,1
26300,39945,80,32105,80,1948,728,1220,11,150,6,5
26301,53267,443,33925,443,6156,2009,4147,26,18,14,12
26302,56786,443,13825,443,5698,906,4792,19,27,11,8
26303,49207,58751,6797,58751,70,70,0,2,8,2,0
26304,58840,443,27383,443,5108,700,4408,15,15,7,8
26305,60865,443,14969,443,9934,4897,5037,43,15,25,18
26306,50462,80,37104,80,113965,10014,103951,154,204,65,89
26307,50222,443,25494,443,178347,31093,147254,290,446,140,150
26308,53431,80,15544,80,1638,1324,314,10,15,5,5
26309,55973,53,5208,53,939,678,261,2,30,1,1
26310,10097,53,3471,53,259,86,173,2,30,1,1
26311,56160,53,10248,53,94,94,0,1,30,1,0
26312,55525,53,5634,53,214,110,104,2,30,1,1
26313,56875,53,43240,53,167,86,81,2,30,1,1
26314,57253,53,58310,53,199,102,97,2,30,1,1
26315,56050,53,60245,53,178,94,84,2,30,1,1
26316,49884,53,8513,53,252,102,150,2,30,1,1
26317,55421,53,47278,53,200,102,98,2,30,1,1
26318,57343,53,25885,53,181,94,87,2,30,1,1
26319,27065,53,10980,53,822,466,356,3,30,2,1
26320,58695,53,54969,53,392,86,306,2,30,1,1
26321,57418,53,45442,53,165,86,79,2,30,1,1
26322,56427,53,42294,53,166,86,80,2,30,1,1
26323,57082,53,9901,53,239,94,145,2,30,1,1
26324,27005,37569,6063,37569,880,126,754,2,31,1,1
26325,56382,53,5952,53,195,102,93,2,31,1,1
26326,27005,27001,35440,27001,887,126,761,2,31,1,1
26327,15503,51508,42580,51508,481,150,331,2,1200,1,1
26328,6881,6881,37919,6881,238,118,120,2,1200,1,1
26329,50230,80,65071,80,12572,8562,4010,48,442,26,22
26330,14437,443,4301,443,2589,1443,1146,18,16,8,10
26331,55276,53,37772,53,215,94,121,2,30,1,1
26332,56167,53,20756,53,461,94,367,2,30,1,1
26333,55463,53,21645,53,216,110,106,2,30,1,1
26334,55666,53,45375,53,211,102,109,2,30,1,1
26335,56112,53,63106,53,199,102,97,2,30,1,1
26336,55934,53,0,0,86,86,0,1,30,1,0
26337,56676,53,9987,53,178,94,84,2,30,1,1
26338,56875,53,55228,53,167,86,81,2,30,1,1
26339,56676,53,39365,53,178,94,84,2,31,1,1
26340,27005,27015,4428,27015,884,126,758,2,31,1,1
26341,57343,53,32639,53,181,94,87,2,31,1,1
26342,56556,53,18816,53,184,94,90,2,31,1,1
26343,55155,53,35899,53,194,102,92,2,31,1,1
26344,55321,53,4307,53,193,102,91,2,31,1,1
26345,43514,443,45895,443,9643,2462,7181,26,146,11,15
26346,55727,53,2697,53,195,102,93,2,31,1,1
26347,57470,12383,34199,12383,5728,4818,910,87,4485,74,13
26348,58453,443,9103,443,9972,2138,7834,39,130,19,20
26349,65238,443,5223,443,26538,8416,18122,54,121,25,29
26350,43130,443,2379,443,207714,9731,197983,267,193,120,147
26351,55002,53,42728,53,196,102,94,2,31,1,1
26352,60822,443,31127,443,4435,2482,1953,10,121,6,4
26353,56297,53,38652,53,228,75,153,4,31,2,2
26354,57032,53,17045,53,166,86,80,2,31,1,1
26355,57409,53,32069,53,168,86,82,2,31,1,1
26356,55645,443,7018,443,9213,3751,5462,17,121,8,9
26357,64824,443,53612,443,2442,356,2086,12,120,5,7
26358,52152,443,39969,443,433460,26631,406829,595,147,224,371
26359,55834,53,32935,53,184,94,90,2,31,1,1
26360,38694,443,56498,443,90289,3481,86808,96,16,31,65
26361,50593,443,18063,443,1745,1068,677,18,95,10,8
26362,50544,443,24381,443,8592,1152,7440,25,150,13,12
26363,59955,80,59955,80,16324,808,15516,25,59,11,14
26364,58761,443,45887,443,318,192,126,6,26,4,2
26365,39342,80,30469,80,1638,1324,314,10,16,5,5
26366,33705,80,63150,80,1288,496,792,8,43,5,3
26367,50547,443,55787,443,5895,1068,4827,22,149,12,10
26368,50657,443,9730,443,3339,2205,1134,21,38,13,8
26369,53801,47933,40487,47933,320,140,180,6,6,3,3
26370,59936,80,54096,80,1281,399,882,10,16,6,4
26371,53129,80,16654,80,5318,685,4633,14,15,7,7
26372,50626,443,22681,443,1604,987,617,16,93,9,7
26373,53802,59932,27956,59932,320,140,180,6,6,3,3
26374,53790,21011,61681,21011,70,70,0,2,8,2,0
26375,3478,61463,0,0,585,585,0,1,0,1,0
26376,46844,34567,0,0,60,60,0,1,0,1,0
26377,49367,445,0,0,70,70,0,1,0,1,0
26378,49366,445,0,0,70,70,0,1,0,1,0
26379,49365,445,0,0,70,70,0,1,0,1,0
26380,50514,52752,0,0,146,146,0,1,0,1,0
26381,61138,445,0,0,66,66,0,1,0,1,0
26382,49360,445,0,0,70,70,0,1,0,1,0
26383,61133,445,0,0,66,66,0,1,0,1,0
26384,6666,16010,0,0,60,60,0,1,0,1,0
26385,61132,445,0,0,66,66,0,1,0,1,0
26386,61130,445,0,0,66,66,0,1,0,1,0
26387,61128,445,0,0,66,66,0,1,0,1,0
26388,3478,61463,0,0,1148,1148,0,1,0,1,0
26389,3478,61463,0,0,431,431,0,1,0,1,0
26390,60899,445,0,0,70,70,0,1,0,1,0
26391,54737,50584,0,0,66,66,0,1,0,1,0
26392,45964,3111,0,0,60,60,0,1,0,1,0
26393,54280,3398,0,0,60,60,0,1,0,1,0
26394,61550,5529,0,0,145,145,0,1,0,1,0
26395,60888,445,0,0,70,70,0,1,0,1,0
26396,60889,445,0,0,70,70,0,1,0,1,0
26397,60887,445,0,0,70,70,0,1,0,1,0
26398,49352,445,0,0,70,70,0,1,0,1,0
26399,36369,51505,0,0,62,62,0,1,0,1,0
26400,60886,445,0,0,70,70,0,1,0,1,0
26401,3341,23117,0,0,66,66,0,1,0,1,0
26402,49351,445,0,0,70,70,0,1,0,1,0
26403,49348,445,0,0,70,70,0,1,0,1,0
26404,60883,445,0,0,70,70,0,1,0,1,0
26405,11716,37965,0,0,62,62,0,1,0,1,0
26406,26553,57470,0,0,66,66,0,1,0,1,0
26407,3478,61463,0,0,252,252,0,1,0,1,0
26408,61589,21247,0,0,66,66,0,1,0,1,0
26409,25448,36827,0,0,62,62,0,1,0,1,0
26410,12285,61248,0,0,139,139,0,1,0,1,0
26411,59592,37965,0,0,62,62,0,1,0,1,0
26412,61117,445,0,0,66,66,0,1,0,1,0
26413,3478,61463,0,0,164,164,0,1,0,1,0
26414,3478,61463,0,0,343,343,0,1,0,1,0
26415,3478,61463,0,0,68,68,0,1,0,1,0
26416,11136,17500,0,0,62,62,0,1,0,1,0
26417,60877,445,0,0,70,70,0,1,0,1,0
26418,54614,37807,0,0,66,66,0,1,0,1,0
26419,61110,445,0,0,66,66,0,1,0,1,0
26420,49335,445,0,0,70,70,0,1,0,1,0
26421,3478,61463,0,0,1109,1109,0,1,0,1,0
26422,3478,61463,0,0,64,64,0,1,0,1,0
26423,14618,6881,0,0,66,66,0,1,0,1,0
26424,7246,59858,0,0,66,66,0,1,0,1,0
26425,12709,51505,0,0,62,62,0,1,0,1,0
26426,61108,445,0,0,66,66,0,1,0,1,0
26427,60869,445,0,0,70,70,0,1,0,1,0
26428,60868,445,0,0,70,70,0,1,0,1,0
26429,11859,64147,0,0,62,62,0,1,0,1,0
26430,59736,51505,0,0,62,62,0,1,0,1,0
26431,61100,445,0,0,66,66,0,1,0,1,0
26432,50478,51505,0,0,66,66,0,1,0,1,0
26433,61096,445,0,0,66,66,0,1,0,1,0
26434,60863,445,0,0,70,70,0,1,0,1,0
26435,2886,35440,0,0,66,66,0,1,0,1,0
26436,60861,445,0,0,70,70,0,1,0,1,0
26437,57131,7774,0,0,145,145,0,1,0,1,0
26438,18029,50584,0,0,66,66,0,1,0,1,0
26439,14183,26467,0,0,62,62,0,1,0,1,0
26440,12651,62413,0,0,62,62,0,1,0,1,0
26441,60857,445,0,0,70,70,0,1,0,1,0
26442,62415,57470,0,0,66,66,0,1,0,1,0
26443,49322,445,0,0,70,70,0,1,0,1,0
26444,49320,445,0,0,70,70,0,1,0,1,0
26445,49321,445,0,0,70,70,0,1,0,1,0
26446,13166,57470,0,0,62,62,0,1,0,1,0
26447,60856,445,0,0,70,70,0,1,0,1,0
26448,61082,445,0,0,66,66,0,1,0,1,0
26449,61077,445,0,0,66,66,0,1,0,1,0
26450,61085,445,0,0,66,66,0,1,0,1,0
26451,61083,445,0,0,66,66,0,1,0,1,0
26452,61078,445,0,0,66,66,0,1,0,1,0
26453,61079,445,0,0,66,66,0,1,0,1,0
26454,61080,445,0,0,66,66,0,1,0,1,0
26455,61081,445,0,0,66,66,0,1,0,1,0
26456,3792,52700,0,0,62,62,0,1,0,1,0
26457,24219,1900,0,0,60,60,0,1,0,1,0
26458,34775,5900,0,0,60,60,0,1,0,1,0
26459,62973,51505,0,0,62,62,0,1,0,1,0
26460,55488,57470,0,0,145,145,0,1,0,1,0
26461,60851,445,0,0,70,70,0,1,0,1,0
26462,41744,37965,0,0,62,62,0,1,0,1,0
26463,60155,23718,0,0,66,66,0,1,0,1,0
26464,61430,37965,0,0,66,66,0,1,0,1,0
26465,49316,445,0,0,70,70,0,1,0,1,0
26466,49310,445,0,0,70,70,0,1,0,1,0
26467,49311,445,0,0,70,70,0,1,0,1,0
26468,49305,445,0,0,70,70,0,1,0,1,0
26469,33062,17,0,0,60,60,0,1,0,1,0
26470,61065,445,0,0,66,66,0,1,0,1,0
26471,61064,445,0,0,66,66,0,1,0,1,0
26472,61063,445,0,0,66,66,0,1,0,1,0
26473,59210,50584,0,0,62,62,0,1,0,1,0
26474,57917,44847,0,0,66,66,0,1,0,1,0
26475,62824,37807,0,0,62,62,0,1,0,1,0
26476,3478,61463,0,0,164,164,0,1,0,1,0
26477,50,64147,0,0,62,62,0,1,0,1,0
26478,11136,57587,0,0,62,62,0,1,0,1,0
26479,49300,445,0,0,70,70,0,1,0,1,0
26480,59422,51221,0,0,66,66,0,1,0,1,0
26481,60838,445,0,0,70,70,0,1,0,1,0
26482,49298,445,0,0,70,70,0,1,0,1,0
26483,49290,445,0,0,70,70,0,1,0,1,0
26484,49289,445,0,0,70,70,0,1,0,1,0
26485,19634,64147,0,0,62,62,0,1,0,1,0
26486,59842,62413,0,0,62,62,0,1,0,1,0
26487,3512,23,0,0,60,60,0,1,0,1,0
26488,50799,37807,0,0,62,62,0,1,0,1,0
26489,60835,445,0,0,70,70,0,1,0,1,0
26490,29697,51221,0,0,62,62,0,1,0,1,0
26491,60818,37965,0,0,66,66,0,1,0,1,0
26492,45682,37965,0,0,62,62,0,1,0,1,0
26493,55862,62413,0,0,62,62,0,1,0,1,0
26494,60070,44847,0,0,66,66,0,1,0,1,0
26495,45682,37965,0,0,145,145,0,1,0,1,0
26496,51903,26467,0,0,62,62,0,1,0,1,0
26497,59663,37965,0,0,66,66,0,1,0,1,0
26498,54365,64147,0,0,62,62,0,1,0,1,0
26499,42252,33303,0,0,60,60,0,1,0,1,0
26500,60830,445,0,0,70,70,0,1,0,1,0
26501,5223,14446,0,0,220,220,0,1,0,1,0
26502,49280,445,0,0,70,70,0,1,0,1,0
26503,49278,445,0,0,70,70,0,1,0,1,0
26504,49277,445,0,0,70,70,0,1,0,1,0
26505,57114,35440,0,0,146,146,0,1,0,1,0
26506,64368,22114,0,0,62,62,0,1,0,1,0
26507,60829,445,0,0,70,70,0,1,0,1,0
26508,6703,21247,0,0,62,62,0,1,0,1,0
26509,44681,31573,0,0,146,146,0,1,0,1,0
26510,60827,445,0,0,70,70,0,1,0,1,0
26511,61050,445,0,0,66,66,0,1,0,1,0
26512,15466,41864,0,0,148,148,0,1,0,1,0
26513,62341,26467,0,0,66,66,0,1,0,1,0
26514,24271,52700,0,0,66,66,0,1,0,1,0
26515,49686,44847,0,0,66,66,0,1,0,1,0
26516,53756,50584,0,0,66,66,0,1,0,1,0
26517,37875,55108,0,0,148,148,0,1,0,1,0
26518,49274,445,0,0,70,70,0,1,0,1,0
26519,49266,445,0,0,70,70,0,1,0,1,0
26520,60820,445,0,0,70,70,0,1,0,1,0
26521,60818,445,0,0,70,70,0,1,0,1,0
26522,30948,50584,0,0,146,146,0,1,0,1,0
26523,61038,445,0,0,66,66,0,1,0,1,0
26524,61037,445,0,0,66,66,0,1,0,1,0
26525,27824,51505,0,0,62,62,0,1,0,1,0
26526,63822,14037,0,0,145,145,0,1,0,1,0
26527,60817,445,0,0,70,70,0,1,0,1,0
26528,18608,11392,0,0,66,66,0,1,0,1,0
26529,47910,7454,0,0,60,60,0,1,0,1,0
26530,55421,53,44471,53,200,102,98,2,30,1,1
26531,55756,53,41764,53,747,90,657,2,30,1,1
26532,50630,443,47610,443,5013,968,4045,20,87,11,9
26533,55834,53,38945,53,184,94,90,2,31,1,1
26534,16384,443,23910,443,2227,1018,1209,17,16,8,9
26535,53794,39607,29958,39607,70,70,0,2,8,2,0
26536,49205,29020,24277,29020,316,136,180,6,7,3,3
26537,49791,443,35792,443,20149,14507,5642,40,355,24,16
26538,56261,53,22541,53,184,94,90,2,31,1,1
26539,56072,80,56072,80,23248,1600,21648,35,31,17,18
26540,53795,22719,37217,22719,258,70,188,4,8,2,2
26541,52016,58318,32216,58318,70,70,0,2,9,2,0
26542,61427,443,64293,443,7288,1763,5525,22,77,12,10
26543,61430,443,43160,443,7288,1763,5525,22,77,12,10
26544,58035,80,60635,80,130,70,60,2,15,1,1
26545,60999,53,14276,53,578,286,292,9,16,5,4
26546,53789,47191,44143,47191,70,70,0,2,8,2,0
26547,53793,20468,60935,20468,70,70,0,2,8,2,0
26548,52013,35185,52958,35185,70,70,0,2,9,2,0
26549,56556,53,58365,53,184,94,90,2,31,1,1
26550,50265,31240,10906,31240,726,726,0,12,1200,12,0
26551,57262,53,44073,53,176,90,86,2,30,1,1
26552,58824,443,46343,443,11863,7694,4169,33,17,17,16
26553,34746,80,56625,80,1299,793,506,12,15,6,6
26554,56639,53,16587,53,168,86,82,2,36,1,1
26555,63962,10115,10126,10115,66,66,0,2,8,2,0
26556,61429,443,58099,443,9504,3379,6125,28,77,15,13
26557,53788,1,8231,1,70,70,0,2,8,2,0
26558,43818,80,62769,80,2005,715,1290,8,15,5,3
26559,41650,443,33832,443,6356,1857,4499,48,229,20,28
26560,51988,32239,13198,32239,66,66,0,1,5,1,0
26561,34942,443,50978,443,4317,2189,2128,29,82,15,14
26562,55803,53,28022,53,174,89,85,3,36,2,1
26563,50576,80,50576,80,24419,8463,15956,49,19,25,24
26564,55321,53,43693,53,186,95,91,2,31,1,1
26565,61428,443,21919,443,7276,1763,5513,22,77,12,10
26566,61426,443,49528,443,7348,1763,5585,23,77,12,11
26567,57193,80,36563,80,2235,1055,1180,12,16,7,5
26568,58821,443,62939,443,16200,10803,5397,42,18,24,18
26569,60929,80,45754,80,2235,1055,1180,12,15,7,5
26570,53791,16881,62073,16881,70,70,0,2,8,2,0
26571,61510,80,61510,80,17105,750,16355,21,15,7,14
26572,42650,3389,42650,3389,4930,2691,2239,24,19,14,10
26573,49990,443,43414,443,622,210,412,10,21,4,6
26574,62620,3389,62620,3389,4410,2321,2089,22,18,12,10
26575,60593,80,43950,80,130,70,60,2,15,1,1
26576,56297,53,44253,53,168,86,82,2,30,1,1
26577,55727,53,51328,53,190,97,93,2,30,1,1
26578,55433,443,16673,443,72759,18547,54212,120,137,49,71
26579,49454,80,13717,80,3920,2138,1782,23,135,12,11
26580,27005,12345,8943,12345,898,126,772,2,31,1,1
26581,44847,31105,50353,31105,324,150,174,2,1200,1,1
26582,53930,443,55523,443,33489,2768,30721,44,121,17,27
26583,56917,53,47484,53,188,96,92,2,31,1,1
26584,57176,53,65163,53,793,101,692,2,31,1,1
26585,55002,53,54595,53,192,98,94,2,31,1,1
26586,54712,443,60548,443,5158,2609,2549,11,121,6,5
26587,48886,443,65287,443,8468,2867,5601,23,144,10,13
26588,60816,445,0,0,70,70,0,1,0,1,0
26589,60815,445,0,0,70,70,0,1,0,1,0
26590,45766,35440,0,0,62,62,0,1,0,1,0
26591,60812,445,0,0,70,70,0,1,0,1,0
26592,60811,445,0,0,70,70,0,1,0,1,0
26593,51756,64147,0,0,66,66,0,1,0,1,0
26594,51655,26467,0,0,62,62,0,1,0,1,0
26595,49259,445,0,0,70,70,0,1,0,1,0
26596,49257,445,0,0,70,70,0,1,0,1,0
26597,49256,445,0,0,70,70,0,1,0,1,0
26598,49252,445,0,0,70,70,0,1,0,1,0
26599,15899,37807,0,0,146,146,0,1,0,1,0
26600,51989,29736,26603,29736,160,70,90,2,5,1,1
26601,60018,443,30525,443,8127,1796,6331,21,79,12,9
26602,52278,443,55005,443,7196,1791,5405,18,31,11,7
26603,56297,53,58728,53,168,86,82,2,30,1,1
26604,56783,53,44308,53,193,102,91,2,30,1,1
26605,39742,80,38417,80,1569,593,976,10,44,6,4
26606,59585,443,47956,443,4815,2461,2354,47,58,26,21
26607,59900,443,59900,443,5980,1122,4858,18,58,9,9
26608,50659,443,57690,443,7128,2589,4539,25,37,15,10
26609,9202,80,37636,80,2949,546,2403,11,25,6,5
26610,51540,443,24638,443,957715,36759,920956,1075,161,378,697
26611,50704,80,48490,80,1082,896,186,18,214,15,3
26612,50498,53,36030,53,751,94,657,2,29,1,1
26613,57032,53,53093,53,166,86,80,2,29,1,1
26614,50598,443,44338,443,1653,1010,643,16,94,9,7
26615,54201,443,42354,443,6500,1064,5436,22,255,12,10
26616,50609,443,29620,443,1738,1061,677,18,94,10,8
26617,50640,443,7427,443,1533,950,583,14,85,8,6
26618,57098,80,38453,80,819,530,289,8,40,5,3
26619,50537,443,21381,443,6250,1595,4655,23,150,12,11
26620,39175,80,7841,80,1712,1324,388,11,16,5,6
26621,60858,443,17492,443,64658,47775,16883,115,16,63,52
26622,53797,14550,19741,14550,320,140,180,6,5,3,3
26623,39724,443,26600,443,6128,1344,4784,19,87,12,7
26624,50645,443,5664,443,1514,852,662,16,86,9,7
26625,50585,443,60446,443,1594,951,643,15,97,8,7
26626,50703,80,64252,80,1082,896,186,18,214,15,3
26627,60785,40010,47744,40010,316,136,180,6,5,3,3
26628,5588,5588,0,0,3354,1792,1562,46,192,23,23
26629,53785,33324,40281,33324,70,70,0,2,7,2,0
26630,59994,53,59994,53,86,86,0,1,29,1,0
26631,43014,443,37896,443,134,60,74,3,5,2,1
26632,22278,53,34234,53,806,458,348,3,29,2,1
26633,56169,53,27417,53,210,110,100,2,29,1,1
26634,56109,53,59181,53,323,102,221,2,29,1,1
26635,55387,53,15050,53,195,94,101,2,29,1,1
26636,55907,53,31154,53,184,94,90,2,29,1,1
26637,49444,443,41469,443,2293735,61874,2231861,2321,87,764,1557
26638,55261,53,55428,53,165,86,79,2,29,1,1
26639,57253,53,25140,53,199,102,97,2,29,1,1
26640,58101,53,12737,53,83,83,0,2,31,2,0
26641,64887,53,53065,53,209,110,99,2,30,1,1
26642,55907,53,18173,53,184,94,90,2,30,1,1
26643,55421,53,56436,53,200,102,98,2,30,1,1
26644,52015,25487,58605,25487,70,70,0,2,8,2,0
26645,64219,53,14756,53,403,94,309,4,38,2,2
26646,41279,443,39948,443,8119,1411,6708,20,200,11,9
26647,65439,53,10579,53,228,110,118,2,30,1,1
26648,55002,53,6216,53,196,102,94,2,30,1,1
26649,49207,443,35081,443,2643240,203689,2439551,3285,576,1237,2048
26650,63084,53,39134,53,86,86,0,2,31,2,0
26651,51984,54606,27351,54606,70,70,0,1,5,1,0
26652,51214,443,63195,443,7924,3247,4677,32,71,19,13
26653,58759,443,21160,443,6012,873,5139,18,25,9,9
26654,57326,53,16719,53,180,94,86,2,35,1,1
26655,58432,443,22620,443,26845,11746,15099,187,161,104,83
26656,61422,443,38584,443,8360,1781,6579,23,77,12,11
26657,51997,14398,36359,14398,130,70,60,2,5,1,1
26658,57131,443,18384,443,6489,1065,5424,22,255,12,10
26659,55679,1024,59914,1024,70,70,0,2,8,2,0
26660,56968,443,61875,443,5649,2005,3644,21,186,11,10
26661,15760,53,32222,53,497,83,414,4,30,2,2
26662,49879,53,57267,53,517,95,422,4,44,2,2
26663,49662,53,37093,53,268,93,175,4,59,2,2
26664,56676,53,50057,53,178,94,84,2,30,1,1
26665,63239,443,35910,443,5725,3290,2435,34,125,19,15
26666,55656,53,30150,53,413,102,311,2,30,1,1
26667,57262,53,58338,53,180,94,86,2,30,1,1
26668,52010,443,6265,443,7722,2568,5154,26,63,15,11
26669,58322,53,48798,53,320,94,226,2,30,1,1
26670,45977,53,27186,53,164,78,86,2,30,1,1
26671,48308,443,61860,443,4654,2499,2155,17,31,9,8
26672,56556,53,50468,53,184,94,90,2,30,1,1
26673,57053,53,14001,53,211,102,109,2,30,1,1
26674,59923,53,29358,53,197,78,119,2,30,1,1
26675,56940,80,57845,80,606,70,536,10,278,2,8
26676,56112,53,18781,53,199,102,97,2,30,1,1
26677,55321,53,63193,53,193,102,91,2,30,1,1
26678,51986,41982,32620,41982,70,70,0,1,5,1,0
26679,49991,443,60218,443,622,210,412,10,21,4,6
26680,41052,80,7228,80,1056,682,374,10,15,6,4
26681,49568,80,26293,80,1515,481,1034,11,15,6,5
26682,56297,53,12569,53,168,86,82,2,30,1,1
26683,56561,443,57452,443,341343,9074,332269,353,121,122,231
26684,50811,443,33324,443,2719275,48822,2670453,2459,127,689,1770
26685,61409,443,48164,443,7839,1726,6113,21,77,11,10
26686,55803,53,42450,53,261,89,172,4,38,2,2
26687,50575,80,50575,80,44569,12221,32348,81,19,42,39
26688,56438,53,21882,53,312,94,218,2,30,1,1
26689,56810,53,20653,53,438,180,258,6,30,3,3
26690,53686,19010,53686,19010,70,70,0,1,30,1,0
26691,56653,53,34935,53,78,78,0,1,30,1,0
26692,56740,443,11618,443,456259,379546,76713,1179,364,656,523
26693,63925,53,36572,53,682,199,483,6,46,3,3
26694,49502,80,22198,80,2300864,53111,2247753,2242,18,755,1487
26695,58835,443,42835,443,5166,700,4466,16,15,7,9
26696,64999,53,20323,53,515,86,429,4,45,2,2
26697,37395,443,29125,443,16590,1630,14960,33,199,15,18
26698,50618,443,39503,443,11054,1724,9330,28,91,15,13
26699,50613,443,53382,443,1512,850,662,16,93,9,7
26700,50644,443,24533,443,1514,852,662,16,86,9,7
26701,58760,443,37477,443,5927,794,5133,17,25,8,9
26702,57342,443,57537,443,10761,5724,5037,43,15,25,18
26703,50606,443,59722,443,1511,849,662,16,94,9,7
26704,50611,443,62610,443,11152,2086,9066,33,93,17,16
26705,55681,31948,3131,31948,70,70,0,2,8,2,0
26706,47052,80,21524,80,1217,486,731,8,43,5,3
26707,55677,16588,6838,16588,70,70,0,1,5,1,0
26708,55399,53,4452,53,405,99,306,4,41,2,2
26709,55729,53,41477,53,256,96,160,4,41,2,2
26710,65466,53,9762,53,298,102,196,4,39,2,2
26711,50610,443,21425,443,9469,1273,8196,29,93,15,14
26712,53792,1,12742,1,70,70,0,2,7,2,0
26713,53784,16671,49140,16671,70,70,0,2,7,2,0
26714,51987,23136,41339,23136,70,70,0,1,5,1,0
26715,54828,443,63990,443,70,70,0,1,5,1,0
26716,58885,443,6031,443,152,86,66,2,5,1,1
26717,63240,443,14470,443,1433,734,699,18,125,10,8
26718,59723,443,10674,443,70,70,0,2,5,2,0
26719,49385,53,59773,53,241,102,139,2,29,1,1
26720,64017,53,10978,53,461,94,367,2,29,1,1
26721,55675,49271,26954,49271,504,318,186,8,16,5,3
26722,49500,53,31434,53,248,118,130,2,29,1,1
26723,45344,53,14086,53,538,328,210,3,29,2,1
26724,64775,53,35140,53,445,86,359,2,29,1,1
26725,55727,53,2459,53,195,102,93,2,29,1,1
26726,55068,53,59463,53,196,102,94,2,29,1,1
26727,56112,53,63692,53,199,102,97,2,29,1,1
26728,40204,40034,20615,40034,164,102,62,2,30,1,1
26729,56318,53,21992,53,183,94,89,2,29,1,1
26730,55421,53,33025,53,200,102,98,2,29,1,1
26731,56880,53,13587,53,209,110,99,2,30,1,1
26732,65071,53,37727,53,93,93,0,2,60,2,0
26733,55868,53,39236,53,458,188,270,6,29,3,3
26734,56261,53,2901,53,184,94,90,2,30,1,1
26735,55525,53,3773,53,214,110,104,2,30,1,1
26736,59923,53,7241,53,197,78,119,2,30,1,1
26737,56556,53,6278,53,184,94,90,2,31,1,1
26738,49450,443,1753,443,2319947,69322,2250625,2464,70,870,1594
26739,45753,80,11896,80,48495,10969,37526,83,477,39,44
26740,61418,443,63876,443,7741,1614,6127,21,77,11,10
26741,58096,443,10840,443,7252,1150,6102,22,199,11,11
26742,55678,52879,22607,52879,70,70,0,1,5,1,0
26743,50580,80,50580,80,18727,8262,10465,44,18,23,21
26744,50258,5228,5532,5228,6764,1575,5189,25,157,14,11
26745,59381,53,5162,53,189,78,111,2,30,1,1
26746,55834,53,17845,53,184,94,90,2,30,1,1
26747,56875,53,33833,53,167,86,81,2,30,1,1
26748,59699,443,10810,443,9015,2221,6794,27,421,13,14
26749,50306,443,42473,443,2474,735,1739,11,120,6,5
26750,51221,6889,53258,6889,481,150,331,2,1200,1,1
26751,50265,32988,60132,32988,1488,930,558,21,1200,12,9
26752,36617,443,29137,443,16276,14463,1813,33,95,20,13
26753,56819,443,59951,443,79878,10479,69399,138,120,68,70
26754,49447,443,42024,443,790501,27378,763123,858,86,322,536
26755,46209,443,22477,443,4900,2781,2119,25,95,13,12
26756,45754,80,23823,80,47137,10210,36927,80,477,38,42
26757,9195,80,8495,80,2819,541,2278,12,31,6,6
26758,58758,443,49380,443,4889,1079,3810,15,25,8,7
26759,51982,56306,51670,56306,70,70,0,1,5,1,0
26760,52837,443,26069,443,843201,50940,792261,1191,159,451,740
26761,57130,443,40605,443,6489,1065,5424,22,255,12,10
26762,56917,53,28541,53,194,102,92,2,30,1,1
26763,56427,53,19551,53,166,86,80,2,30,1,1
26764,57262,53,33477,53,180,94,86,2,30,1,1
26765,57683,53,53315,53,243,94,149,2,30,1,1
26766,57343,53,33500,53,181,94,87,2,30,1,1
26767,57262,53,12912,53,180,94,86,2,30,1,1
26768,62415,53,11045,53,86,86,0,2,31,2,0
26769,49451,443,37319,443,1855625,57182,1798443,1981,70,703,1278
26770,57132,443,41283,443,6489,1065,5424,22,255,12,10
26771,65497,443,27033,443,392197,11800,380397,406,16,143,263
26772,58762,443,39294,443,318,192,126,6,25,4,2
26773,52014,20524,1318,20524,70,70,0,2,8,2,0
26774,55680,23711,23434,23711,70,70,0,2,8,2,0
26775,56864,15646,51512,15646,70,70,0,2,8,2,0
26776,51985,38904,1159,38904,70,70,0,1,5,1,0
26777,51983,30472,5988,30472,70,70,0,1,5,1,0
26778,65498,443,2400,443,92290,4799,87491,107,16,43,64
26779,57206,123,21797,123,184,94,90,2,30,1,1
26780,59381,53,57847,53,189,78,111,2,30,1,1
26781,56639,53,41760,53,168,86,82,2,30,1,1
26782,46000,53,44521,53,164,78,86,2,31,1,1
26783,55068,53,43226,53,196,102,94,2,31,1,1
26784,27005,26259,41193,26259,889,126,763,2,31,1,1
26785,51304,443,39350,443,5839,3609,2230,25,361,13,12
26786,30188,23453,55935,23453,502,150,352,2,1200,1,1
26787,50265,14107,11611,14107,132,132,0,3,1200,3,0
26788,55817,53,30944,53,392,102,290,2,30,1,1
26789,64709,53,47288,53,353,118,235,2,30,1,1
26790,48444,53,53992,53,164,78,86,2,30,1,1
26791,53796,53,64571,53,213,78,135,2,30,1,1
26792,37965,58609,35622,58609,15544,7978,7566,132,3153,72,60
26793,55321,53,21988,53,193,102,91,2,31,1,1
26794,55002,53,11641,53,196,102,94,2,31,1,1
26795,27005,33056,50628,33056,885,126,759,2,31,1,1
26796,64500,53,31734,53,212,102,110,2,30,1,1
26797,56419,53,45684,53,199,102,97,2,30,1,1
26798,56279,53,33232,53,228,110,118,2,30,1,1
26799,27005,27015,32670,27015,912,126,786,2,31,1,1
26800,53746,53,62050,53,164,78,86,2,31,1,1
26801,56544,53,44845,53,183,86,97,2,31,1,1
26802,27005,33058,40872,33058,884,126,758,2,31,1,1
26803,65239,443,50519,443,5780,2572,3208,23,120,11,12
26804,55719,443,5079,443,2936,343,2593,12,120,5,7
26805,25,55987,25,55987,118,118,0,1,120,1,0
26806,36685,443,19672,443,10753,1585,9168,24,120,10,14
26807,10151,27715,29644,27715,460,150,310,2,1200,1,1
26808,57346,443,28545,443,72170,4208,67962,102,186,48,54
26809,50584,20824,62214,20824,324,150,174,2,1200,1,1
26810,27005,27015,23860,27015,871,126,745,2,31,1,1
26811,55582,53,48223,53,344,107,237,4,54,2,2
26812,53771,64351,48425,64351,70,70,0,1,5,1,0
26813,5588,5588,0,0,3354,1792,1562,46,193,23,23
26814,62800,80,25172,80,1437,659,778,11,45,6,5
26815,57945,443,56695,443,3522,1763,1759,31,32,16,15
26816,49662,53,31424,53,268,93,175,4,58,2,2
26817,53782,42855,41001,42855,70,70,0,2,8,2,0
26818,49550,80,26667,80,3531,1965,1566,14,29,8,6
26819,60987,443,57213,443,9029,2323,6706,31,16,17,14
26820,55834,53,8445,53,429,94,335,4,52,2,2
26821,56783,53,44833,53,193,102,91,2,30,1,1
26822,59759,53,58276,53,211,78,133,2,30,1,1
26823,55142,53,43974,53,889,404,485,10,30,5,5
26824,55680,53,53324,53,198,94,104,2,30,1,1
26825,44133,53,62526,53,164,78,86,2,30,1,1
26826,61030,445,0,0,66,66,0,1,0,1,0
26827,58251,36237,0,0,66,66,0,1,0,1,0
26828,1330,53567,0,0,146,146,0,1,0,1,0
26829,60797,445,0,0,70,70,0,1,0,1,0
26830,60795,445,0,0,70,70,0,1,0,1,0
26831,60792,445,0,0,70,70,0,1,0,1,0
26832,63910,44847,0,0,66,66,0,1,0,1,0
26833,1903,43890,0,0,62,62,0,1,0,1,0
26834,60787,445,0,0,70,70,0,1,0,1,0
26835,60786,445,0,0,70,70,0,1,0,1,0
26836,61026,445,0,0,66,66,0,1,0,1,0
26837,61024,445,0,0,66,66,0,1,0,1,0
26838,61019,445,0,0,66,66,0,1,0,1,0
26839,61017,445,0,0,66,66,0,1,0,1,0
26840,61020,445,0,0,66,66,0,1,0,1,0
26841,61022,445,0,0,66,66,0,1,0,1,0
26842,61015,445,0,0,66,66,0,1,0,1,0
26843,37633,44847,0,0,62,62,0,1,0,1,0
26844,49245,445,0,0,70,70,0,1,0,1,0
26845,45964,55559,0,0,60,60,0,1,0,1,0
26846,49242,445,0,0,70,70,0,1,0,1,0
26847,49240,445,0,0,70,70,0,1,0,1,0
26848,49238,445,0,0,70,70,0,1,0,1,0
26849,35232,36602,0,0,74,74,0,1,0,1,0
26850,2990,64147,0,0,66,66,0,1,0,1,0
26851,56462,37965,0,0,62,62,0,1,0,1,0
26852,51732,50934,0,0,146,146,0,1,0,1,0
26853,60775,445,0,0,70,70,0,1,0,1,0
26854,7664,2149,0,0,62,62,0,1,0,1,0
26855,2717,31573,0,0,66,66,0,1,0,1,0
26856,58962,23,0,0,60,60,0,1,0,1,0
26857,49234,445,0,0,70,70,0,1,0,1,0
26858,49232,445,0,0,70,70,0,1,0,1,0
26859,49230,445,0,0,70,70,0,1,0,1,0
26860,61009,445,0,0,66,66,0,1,0,1,0
26861,49227,445,0,0,70,70,0,1,0,1,0
26862,38281,37807,0,0,62,62,0,1,0,1,0
26863,61006,445,0,0,66,66,0,1,0,1,0
26864,61004,445,0,0,66,66,0,1,0,1,0
26865,61002,445,0,0,66,66,0,1,0,1,0
26866,60771,445,0,0,70,70,0,1,0,1,0
26867,61001,445,0,0,66,66,0,1,0,1,0
26868,60761,445,0,0,70,70,0,1,0,1,0
26869,60760,445,0,0,70,70,0,1,0,1,0
26870,60762,445,0,0,70,70,0,1,0,1,0
26871,18091,32480,0,0,66,66,0,1,0,1,0
26872,60756,445,0,0,70,70,0,1,0,1,0
26873,57604,32480,0,0,62,62,0,1,0,1,0
26874,60754,445,0,0,70,70,0,1,0,1,0
26875,26092,23,0,0,60,60,0,1,0,1,0
26876,49218,445,0,0,70,70,0,1,0,1,0
26877,25961,55783,0,0,66,66,0,1,0,1,0
26878,24606,55783,0,0,72,72,0,1,0,1,0
26879,31675,23,0,0,60,60,0,1,0,1,0
26880,53469,36237,0,0,66,66,0,1,0,1,0
26881,17489,50584,0,0,146,146,0,1,0,1,0
26882,49214,445,0,0,70,70,0,1,0,1,0
26883,49189,445,0,0,70,70,0,1,0,1,0
26884,10738,50584,0,0,62,62,0,1,0,1,0
26885,57894,44847,0,0,66,66,0,1,0,1,0
26886,60989,445,0,0,66,66,0,1,0,1,0
26887,60748,445,0,0,70,70,0,1,0,1,0
26888,49629,26467,0,0,66,66,0,1,0,1,0
26889,60982,445,0,0,66,66,0,1,0,1,0
26890,49182,445,0,0,70,70,0,1,0,1,0
26891,23349,30188,0,0,146,146,0,1,0,1,0
26892,64346,51505,0,0,66,66,0,1,0,1,0
26893,60740,445,0,0,70,70,0,1,0,1,0
26894,53012,51050,0,0,66,66,0,1,0,1,0
26895,52050,11392,0,0,62,62,0,1,0,1,0
26896,60738,445,0,0,70,70,0,1,0,1,0
26897,60979,445,0,0,66,66,0,1,0,1,0
26898,51414,22,0,0,60,60,0,1,0,1,0
26899,1059,44847,0,0,62,62,0,1,0,1,0
26900,60734,445,0,0,70,70,0,1,0,1,0
26901,5223,14446,0,0,66,66,0,1,0,1,0
26902,60970,445,0,0,66,66,0,1,0,1,0
26903,45682,25604,0,0,62,62,0,1,0,1,0
26904,60732,445,0,0,70,70,0,1,0,1,0
26905,32551,51221,0,0,66,66,0,1,0,1,0
26906,60969,445,0,0,66,66,0,1,0,1,0
26907,51948,17372,0,0,62,62,0,1,0,1,0
26908,43063,57470,0,0,62,62,0,1,0,1,0
26909,58338,3369,0,0,60,60,0,1,0,1,0
26910,60728,445,0,0,70,70,0,1,0,1,0
26911,60438,17372,0,0,66,66,0,1,0,1,0
26912,58475,11392,0,0,66,66,0,1,0,1,0
26913,62709,57470,0,0,62,62,0,1,0,1,0
26914,60727,445,0,0,70,70,0,1,0,1,0
26915,49169,445,0,0,70,70,0,1,0,1,0
26916,49168,445,0,0,70,70,0,1,0,1,0
26917,49170,445,0,0,70,70,0,1,0,1,0
26918,60949,445,0,0,66,66,0,1,0,1,0
26919,60956,445,0,0,66,66,0,1,0,1,0
26920,60951,445,0,0,66,66,0,1,0,1,0
26921,60953,445,0,0,66,66,0,1,0,1,0
26922,60955,445,0,0,66,66,0,1,0,1,0
26923,60954,445,0,0,66,66,0,1,0,1,0
26924,60952,445,0,0,66,66,0,1,0,1,0
26925,60948,445,0,0,66,66,0,1,0,1,0
26926,56386,50584,0,0,62,62,0,1,0,1,0
26927,49203,51050,0,0,62,62,0,1,0,1,0
26928,59763,25604,0,0,62,62,0,1,0,1,0
26929,3478,61463,0,0,164,164,0,1,0,1,0
26930,60722,445,0,0,70,70,0,1,0,1,0
26931,48706,23393,0,0,60,60,0,1,0,1,0
26932,48706,23393,0,0,60,60,0,1,0,1,0
26933,61230,22114,0,0,66,66,0,1,0,1,0
26934,24504,37965,0,0,62,62,0,1,0,1,0
26935,9588,37965,0,0,66,66,0,1,0,1,0
26936,49166,445,0,0,70,70,0,1,0,1,0
26937,49163,445,0,0,70,70,0,1,0,1,0
26938,65528,445,0,0,70,70,0,1,0,1,0
26939,65526,445,0,0,70,70,0,1,0,1,0
26940,0,0,0,0,480,244,236,4,0,2,2
26941,33582,44847,0,0,66,66,0,1,0,1,0
26942,37455,50584,0,0,66,66,0,1,0,1,0
26943,60933,445,0,0,66,66,0,1,0,1,0
26944,60936,445,0,0,66,66,0,1,0,1,0
26945,60934,445,0,0,66,66,0,1,0,1,0
26946,12965,37965,0,0,66,66,0,1,0,1,0
26947,1045,36237,0,0,62,62,0,1,0,1,0
26948,60709,445,0,0,70,70,0,1,0,1,0
26949,56278,52752,0,0,62,62,0,1,0,1,0
26950,65522,445,0,0,70,70,0,1,0,1,0
26951,65515,445,0,0,70,70,0,1,0,1,0
26952,65516,445,0,0,70,70,0,1,0,1,0
26953,65511,445,0,0,70,70,0,1,0,1,0
26954,60706,445,0,0,70,70,0,1,0,1,0
26955,63461,51505,0,0,66,66,0,1,0,1,0
26956,55496,64097,0,0,66,66,0,1,0,1,0
26957,34400,39004,0,0,74,74,0,1,0,1,0
26958,19875,30170,0,0,145,145,0,1,0,1,0
26959,443,62732,0,0,332,332,0,1,0,1,0
26960,56718,50584,0,0,66,66,0,1,0,1,0
26961,2636,11392,0,0,62,62,0,1,0,1,0
26962,14659,11392,0,0,146,146,0,1,0,1,0
26963,60701,445,0,0,70,70,0,1,0,1,0
26964,23483,57470,0,0,109,109,0,1,0,1,0
26965,60700,445,0,0,70,70,0,1,0,1,0
26966,56015,56205,0,0,66,66,0,1,0,1,0
26967,2305,35440,0,0,62,62,0,1,0,1,0
26968,39460,23117,0,0,66,66,0,1,0,1,0
26969,3585,64147,0,0,62,62,0,1,0,1,0
26970,65502,445,0,0,70,70,0,1,0,1,0
26971,65501,445,0,0,70,70,0,1,0,1,0
26972,65498,445,0,0,70,70,0,1,0,1,0
26973,24972,27262,0,0,60,60,0,1,0,1,0
26974,60698,445,0,0,70,70,0,1,0,1,0
26975,60922,445,0,0,66,66,0,1,0,1,0
26976,42366,57470,0,0,66,66,0,1,0,1,0
26977,55123,64097,0,0,66,66,0,1,0,1,0
26978,10329,7774,0,0,143,143,0,1,0,1,0
26979,56638,64147,0,0,62,62,0,1,0,1,0
26980,54999,443,63007,443,6430,1513,4917,26,40,14,12
26981,55012,443,43376,443,7249,1797,5452,29,32,17,12
26982,41170,443,30807,443,8837,1938,6899,21,17,12,9
26983,41169,443,56459,443,8805,1938,6867,21,17,12,9
26984,41730,443,24945,443,760,422,338,12,28,7,5
26985,27005,37579,44292,37579,886,126,760,2,30,1,1
26986,41164,443,60993,443,8949,1938,7011,21,17,12,9
26987,58294,443,58294,443,7356,1014,6342,20,76,10,10
26988,40970,80,47105,80,1052,612,440,10,15,5,5
26989,40858,53,40858,53,200,90,110,2,30,1,1
26990,56783,53,3501,53,186,95,91,2,30,1,1
26991,56419,53,8331,53,198,101,97,2,30,1,1
26992,41168,443,17875,443,8949,1938,7011,21,17,12,9
26993,58815,443,6132,443,11773,7687,4086,31,17,16,15
26994,58829,443,11100,443,2576,1549,1027,15,15,7,8
26995,47167,15000,34015,15000,130,70,60,2,6,1,1
26996,56101,53,1484,53,188,96,92,2,40,1,1
26997,38504,443,56099,443,2227,1018,1209,17,15,8,9
26998,44628,80,44628,80,2898,1485,1413,10,15,6,4
26999,38367,15000,50286,15000,130,70,60,2,5,1,1
27000,53778,6881,15801,6881,70,70,0,1,5,1,0
27001,56014,53,32746,53,711,87,624,2,30,1,1
27002,50710,443,45536,443,1786,172,1614,7,120,3,4
27003,41165,443,56150,443,8949,1938,7011,21,17,12,9
27004,54327,7000,54327,7000,3310,1535,1775,15,15,8,7
27005,53837,15000,29903,15000,130,70,60,2,6,1,1
27006,39058,443,50860,443,70,70,0,1,5,1,0
27007,58832,443,5090,443,3862,2458,1404,16,15,8,8
27008,39057,443,14567,443,70,70,0,1,5,1,0
27009,53772,14132,42222,14132,70,70,0,1,5,1,0
27010,27005,37569,24806,37569,892,126,766,2,30,1,1
27011,26763,443,27928,443,7343,2586,4757,23,20,11,12
27012,58062,443,59135,443,2257,1225,1032,15,18,8,7
27013,54735,443,61550,443,12507,6114,6393,30,90,18,12
27014,50577,80,50577,80,18679,9115,9564,45,18,24,21
27015,48274,15000,32911,15000,130,70,60,2,6,1,1
27016,57748,15000,46693,15000,130,70,60,2,5,1,1
27017,55806,80,22467,80,1248,755,493,7,81,5,2
27018,5588,5588,0,0,3354,1792,1562,46,196,23,23
27019,9104,443,36522,443,6240,1399,4841,24,44,12,12
27020,35173,53,0,0,82,82,0,1,30,1,0
27021,58825,443,1318,443,6357,4318,2039,22,16,11,11
27022,2839,53,2839,53,229,94,135,2,30,1,1
27023,41167,443,51918,443,8869,1938,6931,21,17,12,9
27024,49662,53,40322,53,268,93,175,4,58,2,2
27025,59779,443,18781,443,6055,3602,2453,16,136,8,8
27026,62333,443,30059,443,3170,1556,1614,7,121,3,4
27027,61937,443,25012,443,24420,19966,4454,64,136,35,29
27028,41317,443,52322,443,4555,2276,2279,27,244,9,18
27029,59556,443,25166,443,3888,1169,2719,13,136,6,7
27030,55483,443,25400,443,4496,2369,2127,15,136,7,8
27031,58890,53,0,0,180,82,98,2,31,1,1
27032,61935,443,10080,443,5214,2561,2653,14,136,7,7
27033,41580,443,42075,443,4354,2166,2188,14,136,7,7
27034,63944,30188,0,0,66,66,0,1,0,1,0
27035,7347,56205,0,0,62,62,0,1,0,1,0
27036,57555,35440,0,0,62,62,0,1,0,1,0
27037,16013,35253,0,0,66,66,0,1,0,1,0
27038,60691,445,0,0,70,70,0,1,0,1,0
27039,65493,445,0,0,70,70,0,1,0,1,0
27040,52141,443,17579,443,15637,4217,11420,42,83,19,23
27041,52450,443,7964,443,9648,3653,5995,37,155,19,18
27042,47773,53,42715,53,236,86,150,2,30,1,1
27043,53794,53,8818,53,260,86,174,2,30,1,1
27044,65487,445,0,0,70,70,0,1,0,1,0
27045,60689,445,0,0,70,70,0,1,0,1,0
27046,31780,11392,0,0,146,146,0,1,0,1,0
27047,64957,5555,0,0,60,60,0,1,0,1,0
27048,46640,8880,0,0,60,60,0,1,0,1,0
27049,60688,445,0,0,70,70,0,1,0,1,0
27050,60908,445,0,0,66,66,0,1,0,1,0
27051,60904,445,0,0,66,66,0,1,0,1,0
27052,60687,445,0,0,70,70,0,1,0,1,0
27053,60686,445,0,0,70,70,0,1,0,1,0
27054,60681,445,0,0,70,70,0,1,0,1,0
27055,60680,445,0,0,70,70,0,1,0,1,0
27056,56494,30228,0,0,146,146,0,1,0,1,0
27057,6927,52752,0,0,100,100,0,1,0,1,0
27058,6927,4660,0,0,100,100,0,1,0,1,0
27059,65484,445,0,0,70,70,0,1,0,1,0
27060,14084,43890,0,0,146,146,0,1,0,1,0
27061,60668,445,0,0,70,70,0,1,0,1,0
27062,2572,35440,0,0,62,62,0,1,0,1,0
27063,60666,445,0,0,70,70,0,1,0,1,0
27064,65479,445,0,0,70,70,0,1,0,1,0
27065,65477,445,0,0,70,70,0,1,0,1,0
27066,65472,445,0,0,70,70,0,1,0,1,0
27067,7184,15503,0,0,66,66,0,1,0,1,0
27068,60665,445,0,0,70,70,0,1,0,1,0
27069,7087,23,0,0,60,60,0,1,0,1,0
27070,60900,445,0,0,66,66,0,1,0,1,0
27071,60658,445,0,0,70,70,0,1,0,1,0
27072,60657,445,0,0,70,70,0,1,0,1,0
27073,15320,30188,0,0,146,146,0,1,0,1,0
27074,13062,52752,0,0,66,66,0,1,0,1,0
27075,25101,50584,0,0,62,62,0,1,0,1,0
27076,5223,14446,0,0,66,66,0,1,0,1,0
27077,5223,14446,0,0,119,119,0,1,0,1,0
27078,5223,14446,0,0,167,167,0,1,0,1,0
27079,60897,445,0,0,66,66,0,1,0,1,0
27080,49662,53,17327,53,268,93,175,4,57,2,2
27081,53773,15459,17716,15459,70,70,0,1,4,1,0
27082,58833,443,6455,443,5167,700,4467,16,14,7,9
27083,55010,443,35131,443,9023,4071,4952,30,35,17,13
27084,49204,54530,41547,54530,316,136,180,6,6,3,3
27085,59933,80,46618,80,1756,414,1342,12,15,6,6
27086,51107,80,41417,80,8827,4961,3866,34,47,18,16
27087,65332,53,55664,53,94,94,0,1,30,1,0
27088,51534,443,19846,443,262,70,192,5,21,2,3
27089,49682,53,35686,53,341,110,231,2,29,1,1
27090,56419,53,27801,53,199,102,97,2,30,1,1
27091,37148,53,21111,53,164,78,86,2,30,1,1
27092,63954,53,25119,53,352,102,250,2,29,1,1
27093,56382,53,40376,53,195,102,93,2,29,1,1
27094,37540,443,32914,443,6749,2315,4434,24,46,14,10
27095,56917,53,8537,53,424,104,320,4,30,2,2
27096,27005,30008,37635,30008,881,126,755,2,30,1,1
27097,56419,53,51375,53,199,102,97,2,30,1,1
27098,60475,443,52273,443,585392,18731,566661,623,119,209,414
27099,56261,53,26001,53,184,94,90,2,29,1,1
27100,37965,8999,11644,8999,402,132,270,6,1208,3,3
27101,45755,80,26274,80,52352,11192,41160,90,476,44,46
27102,56119,53,14584,53,199,102,97,2,33,1,1
27103,58831,443,26619,443,5167,700,4467,16,15,7,9
27104,64539,53,38642,53,276,126,150,2,30,1,1
27105,50613,80,37228,80,21942,2323,19619,28,21,11,17
27106,56161,80,10423,80,2670,799,1871,13,46,8,5
27107,55030,443,37524,443,5372,1221,4151,23,18,14,9
27108,4781,443,51838,443,1191,692,499,12,40,7,5
27109,39042,443,16986,443,19733,3606,16127,43,16,22,21
27110,64561,53,25485,53,270,94,176,2,30,1,1
27111,49459,443,10186,443,10166,3392,6774,35,133,18,17
27112,41480,443,25670,443,6004,1688,4316,22,29,13,9
27113,55081,443,63191,443,19866,7188,12678,18,151,7,11
27114,55548,53,39542,53,197,102,95,2,35,1,1
27115,48346,80,10787,80,1878,1444,434,14,15,7,7
27116,49912,53,25675,53,246,102,144,2,30,1,1
27117,63945,28291,25473,28291,504,382,122,8,15,6,2
27118,43286,80,30144,80,1638,1324,314,10,15,5,5
27119,55281,53,62349,53,94,94,0,1,30,1,0
27120,57915,443,51000,443,4103,2950,1153,26,131,16,10
27121,64811,53,63660,53,446,93,353,4,55,2,2
27122,28618,53,13005,53,236,86,150,2,30,1,1
27123,55972,53,37415,53,699,438,261,2,30,1,1
27124,40207,80,3053,80,1364,860,504,13,32,8,5
27125,37155,443,46832,443,7303,2206,5097,23,255,12,11
27126,49219,53,24039,53,264,102,162,2,30,1,1
27127,43659,443,24456,443,17592,11518,6074,51,248,26,25
27128,60093,443,38976,443,292,172,120,4,15,2,2
27129,51547,443,7780,443,202,70,132,3,11,1,2
27130,53764,6881,51389,6881,1463,821,642,15,15,8,7
27131,58830,443,23946,443,5168,700,4468,16,15,7,9
27132,51538,443,33433,443,262,70,192,5,21,2,3
27133,57910,443,61063,443,1853,1214,639,18,156,11,7
27134,57912,443,23938,443,7953,5153,2800,33,142,19,14
27135,45756,80,2776,80,41602,9508,32094,72,476,36,36
27136,64819,53,53319,53,198,94,104,2,30,1,1
27137,48300,443,42844,443,7762,2247,5515,21,31,11,10
27138,51912,45007,7239,45007,1345,679,666,9,30,5,4
27139,56119,53,4548,53,199,102,97,2,30,1,1
27140,64660,53,61374,53,278,94,184,2,30,1,1
27141,64924,53,49056,53,292,126,166,2,30,1,1
27142,65269,53,14472,53,237,94,143,2,30,1,1
27143,39040,443,45031,443,25034,7042,17992,58,21,29,29
27144,39043,443,33177,443,4832,3054,1778,27,16,14,13
27145,64121,443,64564,443,1411,852,559,13,24,7,6
27146,60359,443,21791,443,9607,3847,5760,51,134,26,25
27147,35628,443,42437,443,7840,1829,6011,24,85,14,10
27148,51260,80,52216,80,23175,13071,10104,134,1929,67,67
27149,51106,80,9259,80,9767,6194,3573,40,47,21,19
27150,51108,80,61739,80,6504,3994,2510,26,47,14,12
27151,60782,20010,60186,20010,70,70,0,2,8,2,0
27152,53787,1,62839,1,320,140,180,6,6,3,3
27153,53777,62955,56420,62955,70,70,0,1,4,1,0
27154,53776,37650,38223,37650,70,70,0,1,4,1,0
27155,53266,443,13911,443,12822,4426,8396,42,18,24,18
27156,49261,80,5363,80,3802643,113349,3689294,3463,206,982,2481
27157,42166,443,20816,443,5309,3110,2199,36,81,18,18
27158,55475,53,3330,53,381,102,279,4,44,2,2
27159,50629,80,39121,80,1658,1247,411,8,15,5,3
27160,55002,443,46892,443,6953,2447,4506,26,37,15,11
27161,57913,443,41913,443,1853,1214,639,18,142,11,7
27162,55013,443,19104,443,7531,1773,5758,30,32,17,13
27163,27005,27056,32268,27056,908,126,782,2,30,1,1
27164,45052,443,46441,443,6084,1723,4361,23,201,13,10
27165,53795,53,11623,53,224,86,138,2,30,1,1
27166,64127,53,10956,53,471,182,289,6,57,3,3
27167,49438,443,56354,443,13740,5392,8348,35,134,18,17
27168,54161,443,65319,443,3157,1827,1330,23,15,11,12
27169,59722,443,18746,443,70,70,0,2,5,2,0
27170,51539,443,19176,443,262,70,192,5,21,2,3
27171,58828,443,9559,443,5166,700,4466,16,15,7,9
27172,55673,54815,52506,54815,316,190,126,5,15,3,2
27173,52467,443,14984,443,5343,1102,4241,22,152,11,11
27174,60854,443,16841,443,10447,2417,8030,26,16,15,11
27175,49419,443,41592,443,318,192,126,6,15,4,2
27176,55014,80,6896,80,1573,1145,428,13,32,8,5
27177,54996,443,52291,443,8637,2889,5748,40,41,23,17
27178,27651,53,46551,53,225,78,147,2,30,1,1
27179,64567,443,55637,443,272081,11032,261049,304,139,107,197
27180,51619,443,27223,443,13526,2192,11334,32,141,16,16
27181,40888,8434,40888,8434,156,156,0,3,8,3,0
27182,60453,24369,51749,24369,70,70,0,2,8,2,0
27183,57911,443,43789,443,10141,5997,4144,56,156,28,28
27184,56783,53,7045,53,193,102,91,2,30,1,1
27185,49356,443,28911,443,5946,1254,4692,20,33,10,10
27186,43661,443,21697,443,11255,7612,3643,36,248,19,17
27187,58057,443,19504,443,6821,1076,5745,21,38,12,9
27188,60452,62582,61377,62582,70,70,0,2,8,2,0
27189,9517,23,9517,23,66,66,0,1,5,1,0
27190,34734,5222,46866,5222,7064,2904,4160,68,88,33,35
27191,47166,443,47166,443,4567,1660,2907,19,28,11,8
27192,65444,53,15259,53,86,86,0,1,30,1,0
27193,32299,40015,58130,40015,148,86,62,2,30,1,1
27194,55747,53,24250,53,258,102,156,2,30,1,1
27195,55377,53,7280,53,164,78,86,2,30,1,1
27196,64119,53,14375,53,259,102,157,2,30,1,1
27197,59762,80,15903,80,1278,774,504,12,361,7,5
27198,65511,53,1627,53,212,102,110,2,30,1,1
27199,57470,22468,25297,22468,726,726,0,12,1200,12,0
27200,57240,53,57857,53,215,94,121,2,30,1,1
27201,5497,53,2342,53,208,78,130,2,30,1,1
27202,49222,53,15691,53,199,94,105,2,30,1,1
27203,49296,443,49940,443,20862040,250452,20611588,16880,170,1832,15048
27204,55739,443,29426,443,10875114,348643,10526471,11702,194,3853,7849
27205,42263,443,55947,443,6431,1665,4766,22,275,12,10
27206,19473,53813,59984,53813,481,150,331,2,1200,1,1
27207,57470,43323,55435,43323,2292,332,1960,11,1200,5,6
27208,9122,80,61976,80,98161,5033,93128,125,37,45,80
27209,51980,45478,64521,45478,70,70,0,1,5,1,0
27210,60983,443,50042,443,7458,2832,4626,26,16,15,11
27211,50610,80,53401,80,3726,1504,2222,13,21,7,6
27212,9123,80,23605,80,65336,2808,62528,73,37,28,45
27213,61415,80,27732,80,28257,2893,25364,64,138,30,34
27214,61408,80,60964,80,420720,29056,391664,771,159,325,446
27215,49418,443,14696,443,318,192,126,6,16,4,2
27216,58827,443,27580,443,5167,700,4467,16,15,7,9
27217,55023,443,26981,443,8527,2218,6309,30,26,17,13
27218,58056,443,24409,443,6821,1076,5745,21,38,12,9
27219,50025,53,20225,53,215,94,121,2,30,1,1
27220,64615,53,13915,53,386,134,252,2,30,1,1
27221,64726,53,22205,53,231,94,137,2,30,1,1
27222,49604,53,53151,53,179,94,85,2,30,1,1
27223,33965,443,25810,443,1409634,52704,1356930,1536,173,533,1003
27224,55006,443,44050,443,2900,2007,893,20,36,12,8
27225,61418,80,59402,80,31954,2972,28982,71,138,36,35
27226,50510,443,23339,443,2259313,91208,2168105,2847,1409,1118,1729
27227,9150,443,24673,443,16023,3677,12346,42,37,21,21
27228,55003,443,26179,443,7925,2114,5811,27,37,16,11
27229,32805,80,38439,80,7450,2372,5078,26,24,15,11
27230,49167,443,26021,443,8271,1357,6914,26,17,12,14
27231,49513,443,49513,443,140969,40311,100658,180,68,92,88
27232,49512,53,64595,53,210,102,108,2,30,1,1
27233,27910,53,18233,53,211,94,117,2,30,1,1
27234,49289,53,50733,53,322,118,204,2,30,1,1
27235,62334,443,24621,443,3244,1630,1614,8,120,4,4
27236,60896,445,0,0,66,66,0,1,0,1,0
27237,60895,445,0,0,66,66,0,1,0,1,0
27238,60894,445,0,0,66,66,0,1,0,1,0
27239,60891,445,0,0,66,66,0,1,0,1,0
27240,60887,445,0,0,66,66,0,1,0,1,0
27241,60885,445,0,0,66,66,0,1,0,1,0
27242,52184,22114,0,0,66,66,0,1,0,1,0
27243,53816,22114,0,0,62,62,0,1,0,1,0
27244,65422,26467,0,0,62,62,0,1,0,1,0
27245,65470,445,0,0,70,70,0,1,0,1,0
27246,65465,445,0,0,70,70,0,1,0,1,0
27247,65463,445,0,0,70,70,0,1,0,1,0
27248,65461,445,0,0,70,70,0,1,0,1,0
27249,65012,32468,0,0,62,62,0,1,0,1,0
27250,40598,23,0,0,60,60,0,1,0,1,0
27251,62079,30188,0,0,66,66,0,1,0,1,0
27252,60646,445,0,0,70,70,0,1,0,1,0
27253,28317,35776,0,0,146,146,0,1,0,1,0
27254,58276,43890,0,0,66,66,0,1,0,1,0
27255,39600,5900,0,0,60,60,0,1,0,1,0
27256,11136,19910,0,0,62,62,0,1,0,1,0
27257,3529,25773,0,0,143,143,0,1,0,1,0
27258,65259,37965,0,0,62,62,0,1,0,1,0
27259,65460,445,0,0,70,70,0,1,0,1,0
27260,12986,64147,0,0,62,62,0,1,0,1,0
27261,65459,445,0,0,70,70,0,1,0,1,0
27262,65456,445,0,0,70,70,0,1,0,1,0
27263,60311,56205,0,0,66,66,0,1,0,1,0
27264,60879,445,0,0,66,66,0,1,0,1,0
27265,65452,445,0,0,70,70,0,1,0,1,0
27266,60641,445,0,0,70,70,0,1,0,1,0
27267,40742,2967,0,0,62,62,0,1,0,1,0
27268,60876,445,0,0,66,66,0,1,0,1,0
27269,17786,44847,0,0,62,62,0,1,0,1,0
27270,60873,445,0,0,66,66,0,1,0,1,0
27271,60874,445,0,0,66,66,0,1,0,1,0
27272,60872,445,0,0,66,66,0,1,0,1,0
27273,60632,445,0,0,70,70,0,1,0,1,0
27274,60633,445,0,0,70,70,0,1,0,1,0
27275,60631,445,0,0,70,70,0,1,0,1,0
27276,60628,445,0,0,70,70,0,1,0,1,0
27277,60625,445,0,0,70,70,0,1,0,1,0
27278,59366,35440,0,0,66,66,0,1,0,1,0
27279,65444,445,0,0,70,70,0,1,0,1,0
27280,65441,445,0,0,70,70,0,1,0,1,0
27281,65437,445,0,0,70,70,0,1,0,1,0
27282,38885,21247,0,0,62,62,0,1,0,1,0
27283,60861,445,0,0,66,66,0,1,0,1,0
27284,64104,53,45169,53,288,101,187,4,28,2,2
27285,58195,38303,0,0,66,66,0,1,0,1,0
27286,60619,445,0,0,70,70,0,1,0,1,0
27287,22194,31573,0,0,146,146,0,1,0,1,0
27288,59934,35440,0,0,66,66,0,1,0,1,0
27289,48186,51050,0,0,62,62,0,1,0,1,0
27290,54973,1433,0,0,60,60,0,1,0,1,0
27291,57393,48983,0,0,146,146,0,1,0,1,0
27292,29577,64147,0,0,62,62,0,1,0,1,0
27293,33651,36237,0,0,62,62,0,1,0,1,0
27294,60853,445,0,0,66,66,0,1,0,1,0
27295,55524,46232,0,0,66,66,0,1,0,1,0
27296,60612,445,0,0,70,70,0,1,0,1,0
27297,65424,445,0,0,70,70,0,1,0,1,0
27298,60609,445,0,0,70,70,0,1,0,1,0
27299,24127,56205,0,0,66,66,0,1,0,1,0
27300,14693,64147,0,0,66,66,0,1,0,1,0
27301,7364,50584,0,0,66,66,0,1,0,1,0
27302,44344,23,0,0,60,60,0,1,0,1,0
27303,54752,31573,0,0,66,66,0,1,0,1,0
27304,60851,445,0,0,66,66,0,1,0,1,0
27305,14487,38303,0,0,146,146,0,1,0,1,0
27306,60606,445,0,0,70,70,0,1,0,1,0
27307,60604,445,0,0,70,70,0,1,0,1,0
27308,52459,33890,0,0,60,60,0,1,0,1,0
27309,16985,57866,0,0,66,66,0,1,0,1,0
27310,10736,35440,0,0,62,62,0,1,0,1,0
27311,60842,445,0,0,66,66,0,1,0,1,0
27312,59886,64147,0,0,72,72,0,1,0,1,0
27313,51453,64147,0,0,66,66,0,1,0,1,0
27314,60839,445,0,0,66,66,0,1,0,1,0
27315,10834,50584,0,0,62,62,0,1,0,1,0
27316,3478,61463,0,0,164,164,0,1,0,1,0
27317,60600,445,0,0,70,70,0,1,0,1,0
27318,60599,445,0,0,70,70,0,1,0,1,0
27319,443,60496,0,0,60,60,0,1,0,1,0
27320,3597,11392,0,0,62,62,0,1,0,1,0
27321,65415,445,0,0,70,70,0,1,0,1,0
27322,65412,445,0,0,70,70,0,1,0,1,0
27323,65413,445,0,0,70,70,0,1,0,1,0
27324,60822,445,0,0,66,66,0,1,0,1,0
27325,60828,445,0,0,66,66,0,1,0,1,0
27326,60825,445,0,0,66,66,0,1,0,1,0
27327,60826,445,0,0,66,66,0,1,0,1,0
27328,60823,445,0,0,66,66,0,1,0,1,0
27329,60821,445,0,0,66,66,0,1,0,1,0
27330,60824,445,0,0,66,66,0,1,0,1,0
27331,60820,445,0,0,66,66,0,1,0,1,0
27332,63848,64147,0,0,66,66,0,1,0,1,0
27333,60594,445,0,0,70,70,0,1,0,1,0
27334,40977,21247,0,0,66,66,0,1,0,1,0
27335,57459,51505,0,0,66,66,0,1,0,1,0
27336,51287,26467,0,0,66,66,0,1,0,1,0
27337,52830,22114,0,0,62,62,0,1,0,1,0
27338,7310,44847,0,0,62,62,0,1,0,1,0
27339,65419,26467,0,0,62,62,0,1,0,1,0
27340,1026,8305,0,0,148,148,0,1,0,1,0
27341,65406,445,0,0,70,70,0,1,0,1,0
27342,65404,445,0,0,70,70,0,1,0,1,0
27343,65405,445,0,0,70,70,0,1,0,1,0
27344,65396,445,0,0,70,70,0,1,0,1,0
27345,7372,61248,0,0,139,139,0,1,0,1,0
27346,51934,36180,0,0,62,62,0,1,0,1,0
27347,56460,22114,0,0,146,146,0,1,0,1,0
27348,60807,445,0,0,66,66,0,1,0,1,0
27349,60806,445,0,0,66,66,0,1,0,1,0
27350,60805,445,0,0,66,66,0,1,0,1,0
27351,35291,44847,0,0,66,66,0,1,0,1,0
27352,60581,445,0,0,70,70,0,1,0,1,0
27353,3375,35253,0,0,66,66,0,1,0,1,0
27354,44411,37965,0,0,62,62,0,1,0,1,0
27355,61461,50584,0,0,66,66,0,1,0,1,0
27356,60771,58414,0,0,62,62,0,1,0,1,0
27357,60578,445,0,0,70,70,0,1,0,1,0
27358,65390,445,0,0,70,70,0,1,0,1,0
27359,65385,445,0,0,70,70,0,1,0,1,0
27360,65381,445,0,0,70,70,0,1,0,1,0
27361,2598,23718,0,0,66,66,0,1,0,1,0
27362,37168,443,59171,443,17716,5150,12566,48,21,25,23
27363,52288,443,59643,443,38314,11683,26631,76,34,38,38
27364,56964,443,49041,443,8085,2164,5921,22,86,12,10
27365,9185,80,20640,80,17855,1067,16788,26,35,11,15
27366,51617,15000,54264,15000,130,70,60,2,5,1,1
27367,21585,443,21585,443,14344,1146,13198,25,19,11,14
27368,58814,443,65401,443,6508,4230,2278,22,16,12,10
27369,55019,443,55019,443,3773,2325,1448,24,18,13,11
27370,47090,15000,28011,15000,138,78,60,2,5,1,1
27371,58566,443,36573,443,34405,7602,26803,53,35,24,29
27372,56168,53,62337,53,745,93,652,2,30,1,1
27373,43708,53,62627,53,168,78,90,2,30,1,1
27374,46081,443,10510,443,125213,5113,120100,153,96,58,95
27375,51588,80,26710,80,2016,1050,966,21,300,11,10
27376,41163,443,48910,443,9045,1938,7107,21,16,12,9
27377,9142,80,13917,80,54219,1884,52335,61,37,23,38
27378,20147,53,20147,53,219,87,132,2,30,1,1
27379,37651,443,37651,443,4659,1752,2907,19,30,11,8
27380,55022,60100,63915,60100,1550,1130,420,15,25,9,6
27381,55427,53,54288,53,200,102,98,2,30,1,1
27382,52012,63475,43517,63475,316,136,180,6,7,3,3
27383,34100,443,31456,443,2044,1024,1020,17,80,9,8
27384,49826,443,3257,443,102548,19098,83450,140,35,60,80
27385,55807,80,52839,80,73021,1232,71789,66,80,14,52
27386,53781,36366,44419,36366,70,70,0,2,8,2,0
27387,57388,53,36277,53,732,89,643,2,30,1,1
27388,57326,53,28871,53,90,90,0,1,30,1,0
27389,53751,443,64587,443,61501,14276,47225,91,35,39,52
27390,21519,443,21519,443,14483,1152,13331,27,19,12,15
27391,47820,443,39799,443,1132,596,536,17,28,9,8
27392,44722,80,3568,80,3162,1159,2003,14,16,8,6
27393,19052,7000,19052,7000,2205,815,1390,13,16,7,6
27394,58507,80,58507,80,348,132,216,6,26,3,3
27395,49169,443,62824,443,11168,3827,7341,42,16,20,22
27396,50248,443,36330,443,8882,3013,5869,29,137,14,15
27397,40022,443,32042,443,6073,1628,4445,23,15,12,11
27398,9187,443,51654,443,158704,5074,153630,184,34,69,115
27399,21839,443,21839,443,13003,1226,11777,25,19,12,13
27400,9186,80,65016,80,17643,1063,16580,26,35,11,15
27401,21716,443,21716,443,10913,762,10151,17,19,7,10
27402,41166,443,62560,443,8933,1938,6995,21,16,12,9
27403,53769,8999,60336,8999,70,70,0,1,5,1,0
27404,58811,443,3266,443,10704,7055,3649,29,17,15,14
27405,45121,15000,17487,15000,130,70,60,2,5,1,1
27406,50193,3389,50193,3389,3473,1518,1955,17,19,9,8
27407,55840,53,9224,53,170,87,83,2,30,1,1
27408,32486,443,32486,443,5497,2520,2977,20,16,11,9
27409,50288,53,0,0,82,82,0,1,30,1,0
27410,58813,443,14180,443,6475,4197,2278,22,16,12,10
27411,56501,53,62547,53,711,87,624,2,31,1,1
27412,64116,53,59357,53,87,87,0,1,31,1,0
27413,53568,443,10135,443,12646,7169,5477,53,198,25,28
27414,54472,443,49806,443,6732,2308,4424,21,141,9,12
27415,56629,53,58033,53,182,93,89,2,30,1,1
27416,64980,53,39962,53,90,90,0,1,31,1,0
27417,53713,443,10339,443,33323,3349,29974,45,123,18,27
27418,41937,53,0,0,82,82,0,1,31,1,0
27419,50017,3389,50017,3389,3428,1714,1714,16,34,8,8
27420,57293,443,21825,443,5161,2421,2740,14,122,7,7
27421,6881,43642,35387,43642,150,150,0,1,1201,1,0
27422,62417,443,4381,443,79513,7480,72033,106,122,39,67
27423,49288,443,26857,443,7332,2907,4425,50,122,22,28
27424,32996,443,27619,443,160,69,91,2,120,1,1
27425,54678,443,37690,443,84066,79714,4352,98,125,66,32
27426,30960,45746,57659,45746,330,330,0,6,3609,6,0
27427,21133,51413,31456,51413,459,149,310,2,1200,1,1
27428,26713,64147,0,0,62,62,0,1,0,1,0
27429,33886,39127,0,0,162,162,0,1,0,1,0
27430,55689,37965,0,0,66,66,0,1,0,1,0
27431,60574,445,0,0,70,70,0,1,0,1,0
27432,58488,37965,0,0,62,62,0,1,0,1,0
27433,60572,445,0,0,70,70,0,1,0,1,0
27434,4581,23,0,0,60,60,0,1,0,1,0
27435,60570,445,0,0,70,70,0,1,0,1,0
27436,25901,50265,0,0,62,62,0,1,0,1,0
27437,26330,26348,0,0,62,62,0,1,0,1,0
27438,65374,445,0,0,70,70,0,1,0,1,0
27439,65372,445,0,0,70,70,0,1,0,1,0
27440,49236,53,51973,53,377,94,283,2,30,1,1
27441,65368,445,0,0,70,70,0,1,0,1,0
27442,60794,445,0,0,66,66,0,1,0,1,0
27443,443,62732,0,0,332,332,0,1,0,1,0
27444,62493,50584,0,0,62,62,0,1,0,1,0
27445,60180,31573,0,0,146,146,0,1,0,1,0
27446,4581,23,0,0,60,60,0,1,0,1,0
27447,35232,36602,0,0,74,74,0,1,0,1,0
27448,60563,445,0,0,70,70,0,1,0,1,0
27449,53519,64147,0,0,66,66,0,1,0,1,0
27450,60560,445,0,0,70,70,0,1,0,1,0
27451,65365,445,0,0,70,70,0,1,0,1,0
27452,65359,445,0,0,70,70,0,1,0,1,0
27453,6666,16010,0,0,60,60,0,1,0,1,0
27454,60559,445,0,0,70,70,0,1,0,1,0
27455,60558,445,0,0,70,70,0,1,0,1,0
27456,60557,445,0,0,70,70,0,1,0,1,0
27457,60555,445,0,0,70,70,0,1,0,1,0
27458,60554,445,0,0,70,70,0,1,0,1,0
27459,60777,445,0,0,66,66,0,1,0,1,0
27460,60778,445,0,0,66,66,0,1,0,1,0
27461,26553,57470,0,0,66,66,0,1,0,1,0
27462,61589,21247,0,0,66,66,0,1,0,1,0
27463,26698,57470,0,0,62,62,0,1,0,1,0
27464,63672,22114,0,0,62,62,0,1,0,1,0
27465,63963,50584,0,0,66,66,0,1,0,1,0
27466,3341,23117,0,0,66,66,0,1,0,1,0
27467,48080,22,0,0,60,60,0,1,0,1,0
27468,52938,64097,0,0,66,66,0,1,0,1,0
27469,50135,50584,0,0,62,62,0,1,0,1,0
27470,60539,445,0,0,70,70,0,1,0,1,0
27471,60537,445,0,0,70,70,0,1,0,1,0
27472,60536,445,0,0,70,70,0,1,0,1,0
27473,28580,64147,0,0,62,62,0,1,0,1,0
27474,65357,445,0,0,70,70,0,1,0,1,0
27475,60528,445,0,0,70,70,0,1,0,1,0
27476,60529,445,0,0,70,70,0,1,0,1,0
27477,13334,41615,0,0,145,145,0,1,0,1,0
27478,64543,50265,0,0,66,66,0,1,0,1,0
27479,65344,445,0,0,70,70,0,1,0,1,0
27480,65347,445,0,0,70,70,0,1,0,1,0
27481,65343,445,0,0,70,70,0,1,0,1,0
27482,60774,445,0,0,66,66,0,1,0,1,0
27483,14696,42707,0,0,62,62,0,1,0,1,0
27484,54614,37807,0,0,66,66,0,1,0,1,0
27485,55616,56205,0,0,62,62,0,1,0,1,0
27486,33405,37965,0,0,62,62,0,1,0,1,0
27487,61639,37965,0,0,66,66,0,1,0,1,0
27488,60757,445,0,0,66,66,0,1,0,1,0
27489,65404,53,13922,53,256,94,162,2,30,1,1
27490,57983,443,8445,443,315701,12378,303323,358,137,129,229
27491,61409,80,63776,80,201243,14555,186688,357,158,145,212
27492,9119,80,62063,80,8732,2438,6294,23,36,11,12
27493,49197,2710,8644,2710,70,70,0,2,7,2,0
27494,62071,443,12103,443,134,60,74,3,4,2,1
27495,55548,53,2209,53,197,102,95,2,29,1,1
27496,55027,53,44978,53,177,94,83,2,29,1,1
27497,56056,53,42855,53,164,86,78,2,29,1,1
27498,50480,443,52040,443,14848,6716,8132,32,30,17,15
27499,50611,80,6797,80,2933,1237,1696,12,20,7,5
27500,36562,443,34526,443,3452,1535,1917,18,82,10,8
27501,58554,80,58554,80,348,132,216,6,26,3,3
27502,55027,443,20215,443,19367,11346,8021,47,19,26,21
27503,56727,443,57540,443,7889,1900,5989,20,14,11,9
27504,65514,53,61722,53,291,98,193,4,33,2,2
27505,9120,80,19755,80,326320,11951,314369,346,36,122,224
27506,52011,10722,20939,10722,70,70,0,2,7,2,0
27507,55001,443,43698,443,8182,3793,4389,27,37,16,11
27508,56726,443,29318,443,7941,1952,5989,20,15,11,9
27509,51589,80,62521,80,2091,1098,993,21,300,11,10
27510,9146,443,17435,443,10056,2310,7746,27,36,14,13
27511,9184,80,49214,80,2066,651,1415,11,35,6,5
27512,62050,443,56297,443,7955,2503,5452,33,16,19,14
27513,35180,443,55162,443,13838,1370,12468,26,34,13,13
27514,56629,53,53878,53,183,94,89,2,30,1,1
27515,65438,53,17432,53,332,94,238,2,29,1,1
27516,56056,53,12861,53,172,94,78,2,29,1,1
27517,55840,53,55617,53,177,94,83,2,30,1,1
27518,64730,53,52714,53,1152,86,1066,2,29,1,1
27519,54496,53,1798,53,164,86,78,2,29,1,1
27520,49698,443,62719,443,14762,1871,12891,30,34,16,14
27521,64703,53,47599,53,306,142,164,2,30,1,1
27522,36394,443,29956,443,8714,1606,7108,24,34,12,12
27523,56724,443,37476,443,7941,1952,5989,20,15,11,9
27524,49432,53,61997,53,312,94,218,2,30,1,1
27525,42894,443,60082,443,448,78,370,6,25,1,5
27526,60730,443,25640,443,5518,1221,4297,16,90,10,6
27527,56541,53,2371,53,294,142,152,2,30,1,1
27528,52601,443,40695,443,2046,1026,1020,17,80,9,8
27529,52599,443,49618,443,2044,1024,1020,17,80,9,8
27530,40386,443,23622,443,600,156,444,8,25,2,6
27531,123,123,35980,123,184,94,90,2,30,1,1
27532,56629,53,25209,53,183,94,89,2,30,1,1
27533,57773,443,16393,443,11544,6888,4656,32,125,17,15
27534,48575,123,43562,123,184,94,90,2,30,1,1
27535,51978,57496,57419,57496,70,70,0,1,5,1,0
27536,51976,11816,28383,11816,70,70,0,1,5,1,0
27537,5588,5588,0,0,3354,1792,1562,46,194,23,23
27538,55840,53,28820,53,177,94,83,2,30,1,1
27539,60848,53,46740,53,168,78,90,2,30,1,1
27540,53158,443,62480,443,4940,2342,2598,21,135,10,11
27541,56429,443,13104,443,227145,7409,219736,252,146,86,166
27542,49160,6886,47580,6886,854,150,704,4,1200,2,2
27543,54269,53,35881,53,86,86,0,1,30,1,0
27544,55527,80,13344,80,20513,1960,18553,39,21,18,21
27545,38274,443,9313,443,600,156,444,8,25,2,6
27546,64638,53,19660,53,397,102,295,2,30,1,1
27547,54460,443,28221,443,7372,1764,5608,27,547,15,12
27548,55024,443,7164,443,6986,1578,5408,26,25,15,11
27549,55000,443,57257,443,16063,2691,13372,38,38,18,20
27550,45546,80,52456,80,1213,471,742,10,255,6,4
27551,55004,443,44724,443,7960,2219,5741,27,35,16,11
27552,58826,443,32981,443,5168,700,4468,16,15,7,9
27553,49193,443,41261,443,11773,2390,9383,29,19,15,14
27554,61411,80,31645,80,145440,11034,134406,292,158,135,157
27555,61413,80,4426,80,283970,23419,260551,574,158,255,319
27556,9103,443,27886,443,7876,1511,6365,29,42,14,15
27557,52008,49383,8718,49383,70,70,0,2,8,2,0
27558,51981,38274,61701,38274,206,136,70,4,13,3,1
27559,49170,443,23155,443,7743,1601,6142,18,16,10,8
27560,45549,80,33456,80,1117,762,355,10,255,6,4
27561,55029,443,11495,443,7682,3198,4484,27,17,16,11
27562,61416,80,26249,80,2366,764,1602,10,137,5,5
27563,44519,443,58426,443,716,428,288,11,26,7,4
27564,54998,443,38889,443,10151,2256,7895,32,39,17,15
27565,50628,80,46976,80,1658,1247,411,8,14,5,3
27566,49168,443,13015,443,17765,1565,16200,29,16,12,17
27567,61414,80,32431,80,22368,2947,19421,53,137,24,29
27568,61410,80,27494,80,297783,19995,277788,543,158,229,314
27569,55021,443,61578,443,8042,2104,5938,27,26,15,12
27570,9140,80,58869,80,49165,1785,47380,56,36,21,35
27571,53150,43918,23563,43918,320,140,180,6,6,3,3
27572,56652,80,38597,80,234,234,0,4,12,4,0
27573,33201,443,28063,443,21805,2081,19724,38,34,19,19
27574,51979,55803,3042,55803,70,70,0,1,4,1,0
27575,64665,53,55262,53,181,94,87,2,31,1,1
27576,42895,443,18411,443,600,156,444,8,25,2,6
27577,55027,53,14460,53,177,94,83,2,29,1,1
27578,52007,37732,15176,37732,70,70,0,2,8,2,0
27579,56379,53,17881,53,94,94,0,1,29,1,0
27580,50380,53,4521,53,737,94,643,2,29,1,1
27581,49604,53,54196,53,179,94,85,2,29,1,1
27582,32804,80,61447,80,7454,2436,5018,26,23,16,10
27583,51977,18504,5519,18504,70,70,0,1,5,1,0
27584,42892,443,39711,443,448,78,370,6,25,1,5
27585,50560,443,29461,443,408090,25873,382217,748,137,354,394
27586,39844,443,3106,443,2042,1022,1020,17,80,9,8
27587,55323,53,29422,53,279,94,185,2,30,1,1
27588,56058,53,33400,53,200,94,106,2,30,1,1
27589,62856,443,62856,443,3743,1654,2089,10,120,5,5
27590,56219,53,57925,53,177,94,83,2,30,1,1
27591,64642,53,2609,53,307,94,213,2,30,1,1
27592,64116,53,59887,53,177,94,83,2,31,1,1
27593,57470,64430,53438,64430,1386,1386,0,22,1526,22,0
27594,53147,26330,24592,26330,70,70,0,1,5,1,0
27595,55672,45682,1314,45682,70,70,0,1,5,1,0
27596,47758,443,3505,443,299614,32024,267590,587,115,304,283
27597,9205,443,26795,443,318,192,126,6,18,4,2
27598,30188,63236,11932,63236,11247,4773,6474,66,1454,32,34
27599,56725,443,10503,443,7889,1900,5989,20,15,11,9
27600,49195,8108,53972,8108,70,70,0,1,5,1,0
27601,38278,443,39999,443,448,78,370,6,25,1,5
27602,52396,443,30033,443,1253628,61672,1191956,1875,220,939,936
27603,58820,443,32869,443,5167,700,4467,16,15,7,9
27604,34165,443,24288,443,14923,1978,12945,32,49,17,15
27605,55840,53,8081,53,177,94,83,2,30,1,1
27606,52667,80,1897,80,1272,633,639,9,150,5,4
27607,43715,443,63901,443,81803,3159,78644,93,20,33,60
27608,54270,443,64669,443,29945,19086,10859,98,736,50,48
27609,58822,443,37574,443,5166,700,4466,16,15,7,9
27610,61295,443,30551,443,134322,10347,123975,220,304,77,143
27611,49772,80,38136,80,70,70,0,2,8,2,0
27612,55674,48870,28202,48870,70,70,0,1,5,1,0
27613,38276,443,11817,443,600,156,444,8,25,2,6
27614,38275,443,49031,443,448,78,370,6,25,1,5
27615,38774,80,38774,80,369073,4523,364550,316,142,59,257
27616,53751,22266,31272,22266,754,502,252,11,20,7,4
27617,65216,53,41251,53,292,94,198,2,30,1,1
27618,60399,123,27117,123,184,94,90,2,30,1,1
27619,64310,53,12682,53,404,102,302,2,30,1,1
27620,53216,443,19039,443,26702,3270,23432,40,136,16,24
27621,56586,53,33852,53,177,94,83,2,31,1,1
27622,50943,443,64250,443,29452,1988,27464,37,3619,10,27
27623,56219,53,60572,53,177,94,83,2,30,1,1
27624,6881,35156,27681,35156,509,150,359,2,1199,1,1
27625,57470,31114,57905,31114,528,528,0,9,1199,9,0
27626,53765,16178,2985,16178,70,70,0,1,5,1,0
27627,62049,443,56388,443,7856,2410,5446,30,17,16,14
27628,60783,40010,46411,40010,316,136,180,6,6,3,3
27629,55490,80,37170,80,186387,10616,175771,243,33,116,127
27630,63944,8999,41992,8999,70,70,0,1,5,1,0
27631,33793,80,7506,80,1286,782,504,12,361,7,5
27632,55752,8060,62936,8060,70,70,0,2,8,2,0
27633,60762,445,0,0,66,66,0,1,0,1,0
27634,60763,445,0,0,66,66,0,1,0,1,0
27635,60768,445,0,0,66,66,0,1,0,1,0
27636,60764,445,0,0,66,66,0,1,0,1,0
27637,60765,445,0,0,66,66,0,1,0,1,0
27638,60756,445,0,0,66,66,0,1,0,1,0
27639,48706,23393,0,0,60,60,0,1,0,1,0
27640,48706,23393,0,0,60,60,0,1,0,1,0
27641,56275,65348,0,0,142,142,0,1,0,1,0
27642,28040,64147,0,0,62,62,0,1,0,1,0
27643,65339,445,0,0,70,70,0,1,0,1,0
27644,37168,5900,0,0,60,60,0,1,0,1,0
27645,2531,30188,0,0,66,66,0,1,0,1,0
27646,59736,51505,0,0,62,62,0,1,0,1,0
27647,14618,6881,0,0,66,66,0,1,0,1,0
27648,65337,445,0,0,70,70,0,1,0,1,0
27649,65336,445,0,0,70,70,0,1,0,1,0
27650,65335,445,0,0,70,70,0,1,0,1,0
27651,60517,445,0,0,70,70,0,1,0,1,0
27652,63397,26467,0,0,66,66,0,1,0,1,0
27653,55255,37965,0,0,146,146,0,1,0,1,0
27654,50478,51505,0,0,66,66,0,1,0,1,0
27655,56442,11392,0,0,62,62,0,1,0,1,0
27656,33503,5529,0,0,146,146,0,1,0,1,0
27657,18029,50584,0,0,66,66,0,1,0,1,0
27658,16327,55442,0,0,66,66,0,1,0,1,0
27659,61537,57866,0,0,66,66,0,1,0,1,0
27660,60513,445,0,0,70,70,0,1,0,1,0
27661,65330,445,0,0,70,70,0,1,0,1,0
27662,65329,445,0,0,70,70,0,1,0,1,0
27663,65327,445,0,0,70,70,0,1,0,1,0
27664,47827,67,0,0,60,60,0,1,0,1,0
27665,60752,445,0,0,66,66,0,1,0,1,0
27666,65324,445,0,0,70,70,0,1,0,1,0
27667,5222,48709,0,0,66,66,0,1,0,1,0
27668,60748,445,0,0,66,66,0,1,0,1,0
27669,25565,52284,0,0,60,60,0,1,0,1,0
27670,59592,37965,0,0,62,62,0,1,0,1,0
27671,60502,445,0,0,70,70,0,1,0,1,0
27672,60501,445,0,0,70,70,0,1,0,1,0
27673,60504,445,0,0,70,70,0,1,0,1,0
27674,60746,445,0,0,66,66,0,1,0,1,0
27675,60745,445,0,0,66,66,0,1,0,1,0
27676,60499,445,0,0,70,70,0,1,0,1,0
27677,60743,445,0,0,66,66,0,1,0,1,0
27678,60496,445,0,0,70,70,0,1,0,1,0
27679,55421,57470,0,0,74,74,0,1,0,1,0
27680,65316,445,0,0,70,70,0,1,0,1,0
27681,65312,445,0,0,70,70,0,1,0,1,0
27682,65307,445,0,0,70,70,0,1,0,1,0
27683,60155,23718,0,0,66,66,0,1,0,1,0
27684,24285,26467,0,0,62,62,0,1,0,1,0
27685,11859,64147,0,0,62,62,0,1,0,1,0
27686,60491,445,0,0,70,70,0,1,0,1,0
27687,60731,445,0,0,66,66,0,1,0,1,0
27688,59043,35440,0,0,66,66,0,1,0,1,0
27689,29697,51221,0,0,62,62,0,1,0,1,0
27690,59422,51221,0,0,66,66,0,1,0,1,0
27691,53143,50584,0,0,66,66,0,1,0,1,0
27692,57917,44847,0,0,66,66,0,1,0,1,0
27693,60483,445,0,0,70,70,0,1,0,1,0
27694,1873,37965,0,0,62,62,0,1,0,1,0
27695,60481,445,0,0,70,70,0,1,0,1,0
27696,61030,21247,0,0,62,62,0,1,0,1,0
27697,51830,42707,0,0,66,66,0,1,0,1,0
27698,60724,445,0,0,66,66,0,1,0,1,0
27699,65299,445,0,0,70,70,0,1,0,1,0
27700,11136,17500,0,0,62,62,0,1,0,1,0
27701,443,43990,0,0,74,74,0,1,0,1,0
27702,49734,23,0,0,60,60,0,1,0,1,0
27703,443,62732,0,0,332,332,0,1,0,1,0
27704,8999,15503,0,0,146,146,0,1,0,1,0
27705,60477,445,0,0,70,70,0,1,0,1,0
27706,13285,29892,0,0,145,145,0,1,0,1,0
27707,14567,37965,0,0,62,62,0,1,0,1,0
27708,60722,445,0,0,66,66,0,1,0,1,0
27709,56582,23718,0,0,66,66,0,1,0,1,0
27710,60475,445,0,0,70,70,0,1,0,1,0
27711,60818,37965,0,0,66,66,0,1,0,1,0
27712,53871,37965,0,0,66,66,0,1,0,1,0
27713,11688,23718,0,0,146,146,0,1,0,1,0
27714,45964,2225,0,0,60,60,0,1,0,1,0
27715,60714,445,0,0,66,66,0,1,0,1,0
27716,60471,445,0,0,70,70,0,1,0,1,0
27717,60710,445,0,0,66,66,0,1,0,1,0
27718,60470,445,0,0,70,70,0,1,0,1,0
27719,6703,21247,0,0,62,62,0,1,0,1,0
27720,62341,26467,0,0,66,66,0,1,0,1,0
27721,65286,445,0,0,70,70,0,1,0,1,0
27722,65284,445,0,0,70,70,0,1,0,1,0
27723,65285,445,0,0,70,70,0,1,0,1,0
27724,61550,5529,0,0,145,145,0,1,0,1,0
27725,60465,445,0,0,70,70,0,1,0,1,0
27726,60696,445,0,0,66,66,0,1,0,1,0
27727,60699,445,0,0,66,66,0,1,0,1,0
27728,60695,445,0,0,66,66,0,1,0,1,0
27729,60692,445,0,0,66,66,0,1,0,1,0
27730,60697,445,0,0,66,66,0,1,0,1,0
27731,60698,445,0,0,66,66,0,1,0,1,0
27732,60693,445,0,0,66,66,0,1,0,1,0
27733,60691,445,0,0,66,66,0,1,0,1,0
27734,51903,26467,0,0,62,62,0,1,0,1,0
27735,56005,64147,0,0,62,62,0,1,0,1,0
27736,50052,65008,0,0,60,60,0,1,0,1,0
27737,64535,37965,0,0,66,66,0,1,0,1,0
27738,59663,37965,0,0,66,66,0,1,0,1,0
27739,50626,80,27963,80,1366,865,501,8,15,5,3
27740,58806,443,62353,443,10442,6793,3649,30,17,16,14
27741,52180,443,15332,443,11127,1324,9803,24,75,12,12
27742,28025,443,15107,443,5578,1390,4188,19,15,9,10
27743,55098,53,8835,53,176,90,86,2,30,1,1
27744,58734,443,48413,443,1413,876,537,12,26,6,6
27745,58809,443,34899,443,4054,2590,1464,18,16,9,9
27746,51975,11998,29831,11998,66,66,0,1,5,1,0
27747,53780,47132,22525,47132,70,70,0,2,8,2,0
27748,28024,443,28708,443,5516,1388,4128,18,15,9,9
27749,58795,443,29024,443,19700,12992,6708,44,18,23,21
27750,53763,50144,49298,50144,492,306,186,8,16,5,3
27751,55835,53,7338,53,176,90,86,2,31,1,1
27752,52182,443,53611,443,10422,1313,9109,23,75,12,11
27753,52009,1035,48428,1035,316,136,180,6,7,3,3
27754,55069,443,55069,443,4517,1610,2907,19,27,11,8
27755,49846,53,37794,53,763,101,662,2,31,1,1
27756,21903,443,21903,443,29203,1859,27344,37,18,14,23
27757,63464,443,46979,443,24271,2640,21631,38,123,16,22
27758,52183,443,6084,443,10107,1324,8783,22,75,12,10
27759,42716,443,52714,443,12561,2901,9660,29,17,15,14
27760,44384,80,20153,80,51651,48866,2785,74,19,38,36
27761,64751,443,49226,443,507753,8795,498958,463,195,122,341
27762,40039,80,11580,80,1112,534,578,12,16,7,5
27763,53768,19067,20998,19067,70,70,0,1,5,1,0
27764,5588,5588,0,0,3354,1792,1562,46,195,23,23
27765,51971,20347,9073,20347,66,66,0,1,5,1,0
27766,52927,443,29135,443,5582,1388,4194,19,15,9,10
27767,56586,53,23269,53,170,87,83,2,30,1,1
27768,56024,53,53250,53,711,87,624,2,30,1,1
27769,52807,443,39495,443,67984,17257,50727,121,148,50,71
27770,52928,443,44110,443,5584,1390,4194,19,15,9,10
27771,14829,443,14829,443,214215,11945,202270,260,94,110,150
27772,53977,443,23449,443,3330,1694,1636,15,30,8,7
27773,53779,24874,26263,24874,70,70,0,2,8,2,0
27774,55021,443,46013,443,31237,2116,29121,57,195,24,33
27775,58735,443,63211,443,1413,876,537,12,26,6,6
27776,51422,443,51422,443,4399,1492,2907,19,27,11,8
27777,64749,443,34361,443,10750,1814,8936,37,195,17,20
27778,45912,443,22419,443,4306,1107,3199,17,30,9,8
27779,64743,443,34069,443,31480,1953,29527,54,196,20,34
27780,42955,80,63046,80,72023,4897,67126,97,115,46,51
27781,52512,80,4200,80,10889,1117,9772,22,16,12,10
27782,65500,443,41851,443,8177,3420,4757,23,124,11,12
27783,58673,443,8091,443,3330,737,2593,10,121,5,5
27784,57470,50321,35732,50321,490,149,341,2,1201,1,1
27785,35833,443,20943,443,5524,1857,3667,27,3652,9,18
27786,65283,445,0,0,70,70,0,1,0,1,0
27787,65274,445,0,0,70,70,0,1,0,1,0
27788,65276,445,0,0,70,70,0,1,0,1,0
27789,65269,445,0,0,70,70,0,1,0,1,0
27790,8999,57470,0,0,146,146,0,1,0,1,0
27791,56494,3033,0,0,146,146,0,1,0,1,0
27792,54365,64147,0,0,62,62,0,1,0,1,0
27793,32282,8604,0,0,66,66,0,1,0,1,0
27794,60452,445,0,0,70,70,0,1,0,1,0
27795,60678,445,0,0,66,66,0,1,0,1,0
27796,60677,445,0,0,66,66,0,1,0,1,0
27797,60675,445,0,0,66,66,0,1,0,1,0
27798,50949,45960,0,0,62,62,0,1,0,1,0
27799,49514,39127,0,0,162,162,0,1,0,1,0
27800,443,62732,0,0,332,332,0,1,0,1,0
27801,56494,15503,0,0,146,146,0,1,0,1,0
27802,8999,57470,0,0,146,146,0,1,0,1,0
27803,60449,445,0,0,70,70,0,1,0,1,0
27804,52605,443,40382,443,3523,518,3005,12,15,6,6
27805,59775,443,26264,443,5024,2538,2486,23,15,13,10
27806,44074,443,54425,443,5498,3406,2092,28,95,16,12
27807,58359,64147,0,0,72,72,0,1,0,1,0
27808,57339,57470,0,0,66,66,0,1,0,1,0
27809,56494,15503,0,0,146,146,0,1,0,1,0
27810,65265,445,0,0,70,70,0,1,0,1,0
27811,38477,5900,0,0,60,60,0,1,0,1,0
27812,65253,445,0,0,70,70,0,1,0,1,0
27813,65254,445,0,0,70,70,0,1,0,1,0
27814,65252,445,0,0,70,70,0,1,0,1,0
27815,55450,64147,0,0,66,66,0,1,0,1,0
27816,56494,57587,0,0,146,146,0,1,0,1,0
27817,58131,15503,0,0,146,146,0,1,0,1,0
27818,2990,64147,0,0,66,66,0,1,0,1,0
27819,63079,64147,0,0,66,66,0,1,0,1,0
27820,60444,445,0,0,70,70,0,1,0,1,0
27821,35232,36602,0,0,74,74,0,1,0,1,0
27822,60443,445,0,0,70,70,0,1,0,1,0
27823,60441,445,0,0,70,70,0,1,0,1,0
27824,56494,1,0,0,146,146,0,1,0,1,0
27825,51655,26467,0,0,62,62,0,1,0,1,0
27826,21213,23,0,0,60,60,0,1,0,1,0
27827,443,62732,0,0,199,199,0,1,0,1,0
27828,65247,445,0,0,70,70,0,1,0,1,0
27829,65245,445,0,0,70,70,0,1,0,1,0
27830,65242,445,0,0,70,70,0,1,0,1,0
27831,48706,23393,0,0,60,60,0,1,0,1,0
27832,48706,23393,0,0,60,60,0,1,0,1,0
27833,3074,64147,0,0,62,62,0,1,0,1,0
27834,15333,44847,0,0,146,146,0,1,0,1,0
27835,60665,445,0,0,66,66,0,1,0,1,0
27836,60297,25604,0,0,62,62,0,1,0,1,0
27837,60434,445,0,0,70,70,0,1,0,1,0
27838,14148,1,0,0,62,62,0,1,0,1,0
27839,54593,51505,0,0,62,62,0,1,0,1,0
27840,2049,23,0,0,60,60,0,1,0,1,0
27841,60431,445,0,0,70,70,0,1,0,1,0
27842,60430,445,0,0,70,70,0,1,0,1,0
27843,65237,445,0,0,70,70,0,1,0,1,0
27844,65231,445,0,0,70,70,0,1,0,1,0
27845,60429,445,0,0,70,70,0,1,0,1,0
27846,47788,1879,0,0,146,146,0,1,0,1,0
27847,60423,445,0,0,70,70,0,1,0,1,0
27848,60424,445,0,0,70,70,0,1,0,1,0
27849,55206,53,49621,53,196,94,102,2,30,1,1
27850,64988,53,16723,53,196,94,102,2,30,1,1
27851,53238,80,59852,80,1726,940,786,8,55,5,3
27852,52006,49849,11177,49849,70,70,0,2,7,2,0
27853,50919,443,16242,443,5962,1621,4341,16,75,9,7
27854,51419,443,59979,443,13049,4849,8200,31,31,15,16
27855,52179,443,33825,443,7439,1156,6283,19,75,11,8
27856,53855,443,61273,443,134631,7253,127378,176,171,79,97
27857,49514,443,49514,443,234110,36300,197810,309,66,160,149
27858,53767,10004,19496,10004,70,70,0,1,4,1,0
27859,55494,80,14370,80,188544,9826,178718,241,32,113,128
27860,51974,54759,44353,54759,70,70,0,1,4,1,0
27861,56723,443,2144,443,7889,1900,5989,20,15,11,9
27862,36100,443,53812,443,812,440,372,14,25,8,6
27863,34657,443,29815,443,3521,516,3005,12,15,6,6
27864,63937,53,8865,53,183,94,89,2,30,1,1
27865,53766,3596,6099,3596,70,70,0,1,4,1,0
27866,60786,80,13349,80,1638,1324,314,10,15,5,5
27867,56367,53,12261,53,900,110,790,2,29,1,1
27868,56405,53,42424,53,226,102,124,2,30,1,1
27869,64477,443,32832,443,8965,3771,5194,33,124,14,19
27870,51108,80,16411,80,2794,2075,719,15,30,9,6
27871,56184,53,63317,53,215,94,121,2,30,1,1
27872,55835,53,25257,53,180,94,86,2,30,1,1
27873,49932,53,2052,53,289,94,195,2,30,1,1
27874,34658,443,51529,443,3521,516,3005,12,15,6,6
27875,50522,443,6531,443,1579,988,591,13,45,7,6
27876,58903,80,49363,80,22851,3171,19680,39,147,20,19
27877,60438,53,9919,53,77,77,0,2,31,2,0
27878,35667,80,40101,80,1638,1324,314,10,15,5,5
27879,52004,55711,12562,55711,70,70,0,2,7,2,0
27880,56722,443,4374,443,7941,1952,5989,20,15,11,9
27881,59758,53,7104,53,211,78,133,2,30,1,1
27882,39748,80,44062,80,1638,1324,314,10,15,5,5
27883,64648,53,9787,53,215,94,121,2,30,1,1
27884,52295,53,54282,53,322,102,220,2,30,1,1
27885,57303,53,6094,53,177,94,83,2,30,1,1
27886,61637,53,32273,53,82,82,0,2,31,2,0
27887,57159,53,30985,53,292,94,198,2,30,1,1
27888,57303,53,43423,53,177,94,83,2,30,1,1
27889,56951,443,25621,443,4679,2071,2608,14,135,7,7
27890,55835,53,39257,53,180,94,86,2,30,1,1
27891,55243,53,43461,53,356,118,238,2,30,1,1
27892,17750,55265,61135,55265,481,150,331,2,1200,1,1
27893,46939,443,46939,443,4657,1750,2907,19,28,11,8
27894,50726,443,27589,443,12350,2504,9846,41,137,21,20
27895,62995,53,59527,53,101,101,0,2,31,2,0
27896,52003,18150,42315,18150,70,70,0,2,7,2,0
27897,29972,53,62142,53,300,94,206,2,30,1,1
27898,65355,53,22974,53,321,102,219,2,30,1,1
27899,53791,53,14073,53,102,102,0,2,31,2,0
27900,60449,28260,32141,28260,70,70,0,1,5,1,0
27901,53761,54363,63571,54363,618,432,186,9,16,6,3
27902,50663,443,57930,443,7732,3046,4686,22,26,12,10
27903,59629,80,40534,80,1652,1264,388,10,17,4,6
27904,58736,443,28275,443,7978,1143,6835,19,26,9,10
27905,56721,443,14378,443,7889,1900,5989,20,15,11,9
27906,53848,443,21534,443,7015200,135026,6880174,6063,438,1252,4811
27907,49194,443,5495,443,605037,246018,359019,1735,1300,846,889
27908,59011,443,8442,443,9619,6442,3177,33,122,15,18
27909,55553,443,62763,443,6639,3918,2721,16,135,8,8
27910,59180,443,21871,443,2592,1486,1106,20,275,10,10
27911,50265,38978,6940,38978,481,150,331,2,1200,1,1
27912,54553,53,43102,53,101,101,0,2,31,2,0
27913,50523,443,11789,443,1579,988,591,13,45,7,6
27914,43494,443,46566,443,670,382,288,10,133,6,4
27915,55305,53,15624,53,88,88,0,2,31,2,0
27916,34656,443,55937,443,3521,516,3005,12,15,6,6
27917,58812,443,22392,443,5167,700,4467,16,15,7,9
27918,52005,33191,61687,33191,70,70,0,2,7,2,0
27919,58816,443,57126,443,5168,700,4468,16,15,7,9
27920,53237,80,8152,80,194,128,66,4,55,3,1
27921,34220,80,10366,80,672,300,372,12,30,6,6
27922,58819,443,22154,443,5168,700,4468,16,14,7,9
27923,54744,443,54744,443,4737,2854,1883,25,117,13,12
27924,54259,443,22869,443,7508,2864,4644,18,75,11,7
27925,53799,3478,23545,3478,3736,1944,1792,58,91,29,29
27926,36661,443,26709,443,16244,2265,13979,35,262,19,16
27927,39674,443,32592,443,2828,1800,1028,27,184,15,12
27928,51972,13604,43742,13604,160,70,90,2,5,1,1
27929,56629,53,45116,53,183,94,89,2,29,1,1
27930,55318,53,29370,53,215,102,113,2,30,1,1
27931,49988,443,8213,443,642,582,60,2,5,1,1
27932,55034,443,40095,443,14671,2953,11718,31,31,17,14
27933,49509,443,49509,443,242669,43830,198839,310,67,159,151
27934,55248,443,36636,443,30281,3919,26362,44,62,21,23
27935,52993,53,60182,53,70,70,0,1,29,1,0
27936,57152,53,56256,53,720,94,626,2,30,1,1
27937,55098,53,14805,53,180,94,86,2,30,1,1
27938,49153,53,32682,53,214,102,112,2,29,1,1
27939,59757,53,47514,53,260,86,174,2,30,1,1
27940,64199,53,4669,53,215,102,113,2,30,1,1
27941,56586,53,39065,53,177,94,83,2,30,1,1
27942,51106,80,64772,80,14616,6227,8389,32,31,16,16
27943,38970,443,29135,443,4144,2479,1665,19,361,10,9
27944,56621,53,30051,53,177,94,83,2,31,1,1
27945,53434,53,34860,53,87,87,0,2,31,2,0
27946,54138,443,3905,443,5702,1212,4490,19,139,10,9
27947,49983,53,19113,53,267,110,157,2,30,1,1
27948,5176,53,35292,53,86,86,0,1,30,1,0
27949,63931,443,46072,443,103248,6121,97127,124,144,47,77
27950,40685,80,25851,80,1278,774,504,12,360,7,5
27951,62617,443,37156,443,3931,678,3253,15,140,6,9
27952,64406,53,8536,53,102,102,0,2,31,2,0
27953,60450,56494,22389,56494,70,70,0,1,5,1,0
27954,64714,53,5629,53,250,86,164,4,36,2,2
27955,65183,53,12672,53,381,89,292,4,43,2,2
27956,50326,443,38402,443,552885,34781,518104,733,245,314,419
27957,64201,53,54602,53,434,96,338,4,30,2,2
27958,54267,53,33061,53,86,86,0,1,30,1,0
27959,61566,53,28325,53,86,86,0,1,30,1,0
27960,54983,53,35853,53,728,102,626,2,30,1,1
27961,56654,53,54903,53,102,102,0,2,31,2,0
27962,65466,53,31281,53,200,102,98,2,33,1,1
27963,55492,80,58922,80,164902,9835,155067,227,32,114,113
27964,51970,18752,15573,18752,70,70,0,1,5,1,0
27965,54080,443,47688,443,1173681,52597,1121084,1428,177,642,786
27966,54079,443,33342,443,1050267,44816,1005451,1276,177,580,696
27967,53853,443,32341,443,1966450,57437,1909013,1885,338,544,1341
27968,49771,53,61386,53,86,86,0,1,30,1,0
27969,49165,53,19244,53,379,94,285,2,30,1,1
27970,64505,53,53732,53,388,134,254,2,30,1,1
27971,57189,53,13765,53,78,78,0,1,30,1,0
27972,56621,53,19745,53,177,94,83,2,30,1,1
27973,6881,55980,18375,55980,226,118,108,2,1199,1,1
27974,58311,443,32362,443,6128,1394,4734,24,146,10,14
27975,48320,80,28314,80,12110,3853,8257,35,1075,13,22
27976,55101,443,55990,443,1786,172,1614,7,120,3,4
27977,60423,443,39132,443,11488,7258,4230,47,122,27,20
27978,55445,53,54858,53,96,96,0,2,31,2,0
27979,34357,443,9724,443,33131,26333,6798,49,121,28,21
27980,56950,443,1900,443,4391,2171,2220,14,135,7,7
27981,60403,443,22407,443,3802,1769,2033,15,135,7,8
27982,55489,80,62350,80,180504,12712,167792,229,32,105,124
27983,56720,443,57174,443,7941,1952,5989,20,15,11,9
27984,55199,53,62103,53,196,94,102,2,30,1,1
27985,63954,60430,18529,60430,66,66,0,2,8,2,0
27986,63937,53,33435,53,183,94,89,2,30,1,1
27987,56075,53,1883,53,215,102,113,2,30,1,1
27988,56020,53,51205,53,199,102,97,2,32,1,1
27989,35292,8100,23509,8100,78,78,0,1,5,1,0
27990,55225,53,24302,53,199,102,97,2,30,1,1
27991,55225,53,48958,53,822,102,720,2,30,1,1
27992,34662,443,60147,443,50100,46087,4013,73,121,43,30
27993,57894,44847,0,0,66,66,0,1,0,1,0
27994,28878,51505,0,0,62,62,0,1,0,1,0
27995,443,62732,0,0,199,199,0,1,0,1,0
27996,53469,36237,0,0,66,66,0,1,0,1,0
27997,60649,445,0,0,66,66,0,1,0,1,0
27998,60648,445,0,0,66,66,0,1,0,1,0
27999,6889,48817,0,0,143,143,0,1,0,1,0
28000,10738,50584,0,0,62,62,0,1,0,1,0
28001,63988,50584,0,0,62,62,0,1,0,1,0
28002,60411,445,0,0,70,70,0,1,0,1,0
28003,60410,445,0,0,70,70,0,1,0,1,0
28004,60408,445,0,0,70,70,0,1,0,1,0
28005,29080,50265,0,0,62,62,0,1,0,1,0
28006,51414,22,0,0,60,60,0,1,0,1,0
28007,60401,445,0,0,70,70,0,1,0,1,0
28008,60400,445,0,0,70,70,0,1,0,1,0
28009,65227,445,0,0,70,70,0,1,0,1,0
28010,16630,44847,0,0,62,62,0,1,0,1,0
28011,65219,445,0,0,70,70,0,1,0,1,0
28012,65220,445,0,0,70,70,0,1,0,1,0
28013,65216,445,0,0,70,70,0,1,0,1,0
28014,60644,445,0,0,66,66,0,1,0,1,0
28015,49629,26467,0,0,66,66,0,1,0,1,0
28016,60633,445,0,0,66,66,0,1,0,1,0
28017,60636,445,0,0,66,66,0,1,0,1,0
28018,60635,445,0,0,66,66,0,1,0,1,0
28019,60634,445,0,0,66,66,0,1,0,1,0
28020,60630,445,0,0,66,66,0,1,0,1,0
28021,60632,445,0,0,66,66,0,1,0,1,0
28022,60629,445,0,0,66,66,0,1,0,1,0
28023,14336,64147,0,0,62,62,0,1,0,1,0
28024,53012,51050,0,0,66,66,0,1,0,1,0
28025,65211,445,0,0,70,70,0,1,0,1,0
28026,60389,445,0,0,70,70,0,1,0,1,0
28027,27824,51505,0,0,62,62,0,1,0,1,0
28028,20864,51221,0,0,62,62,0,1,0,1,0
28029,65209,445,0,0,70,70,0,1,0,1,0
28030,65208,445,0,0,70,70,0,1,0,1,0
28031,65205,445,0,0,70,70,0,1,0,1,0
28032,41648,56205,0,0,66,66,0,1,0,1,0
28033,64626,50584,0,0,66,66,0,1,0,1,0
28034,59618,46824,0,0,66,66,0,1,0,1,0
28035,17378,44847,0,0,62,62,0,1,0,1,0
28036,24910,64147,0,0,66,66,0,1,0,1,0
28037,32551,51221,0,0,66,66,0,1,0,1,0
28038,60385,445,0,0,70,70,0,1,0,1,0
28039,59365,42873,0,0,74,74,0,1,0,1,0
28040,65204,445,0,0,70,70,0,1,0,1,0
28041,65202,445,0,0,70,70,0,1,0,1,0
28042,65201,445,0,0,70,70,0,1,0,1,0
28043,60141,62413,0,0,66,66,0,1,0,1,0
28044,443,61686,0,0,1484,1484,0,1,0,1,0
28045,60621,445,0,0,66,66,0,1,0,1,0
28046,60375,445,0,0,70,70,0,1,0,1,0
28047,60376,445,0,0,70,70,0,1,0,1,0
28048,60374,445,0,0,70,70,0,1,0,1,0
28049,65196,445,0,0,70,70,0,1,0,1,0
28050,60372,445,0,0,70,70,0,1,0,1,0
28051,60619,445,0,0,66,66,0,1,0,1,0
28052,60368,445,0,0,70,70,0,1,0,1,0
28053,60617,445,0,0,66,66,0,1,0,1,0
28054,60616,445,0,0,66,66,0,1,0,1,0
28055,60614,445,0,0,66,66,0,1,0,1,0
28056,23478,1433,0,0,60,60,0,1,0,1,0
28057,6881,6881,0,0,146,146,0,1,0,1,0
28058,30580,50265,0,0,66,66,0,1,0,1,0
28059,50806,51505,0,0,66,66,0,1,0,1,0
28060,65188,445,0,0,70,70,0,1,0,1,0
28061,61230,22114,0,0,66,66,0,1,0,1,0
28062,11136,15503,0,0,145,145,0,1,0,1,0
28063,58825,44847,0,0,146,146,0,1,0,1,0
28064,65184,445,0,0,70,70,0,1,0,1,0
28065,65179,445,0,0,70,70,0,1,0,1,0
28066,60362,445,0,0,70,70,0,1,0,1,0
28067,58687,11392,0,0,66,66,0,1,0,1,0
28068,60761,51221,0,0,66,66,0,1,0,1,0
28069,38281,37807,0,0,62,62,0,1,0,1,0
28070,52252,46314,0,0,62,62,0,1,0,1,0
28071,60603,445,0,0,66,66,0,1,0,1,0
28072,5087,22114,0,0,62,62,0,1,0,1,0
28073,60355,445,0,0,70,70,0,1,0,1,0
28074,60354,445,0,0,70,70,0,1,0,1,0
28075,42094,35440,0,0,146,146,0,1,0,1,0
28076,48706,23393,0,0,60,60,0,1,0,1,0
28077,60595,445,0,0,66,66,0,1,0,1,0
28078,65171,445,0,0,70,70,0,1,0,1,0
28079,60349,445,0,0,70,70,0,1,0,1,0
28080,60347,445,0,0,70,70,0,1,0,1,0
28081,60593,445,0,0,66,66,0,1,0,1,0
28082,19698,502,0,0,60,60,0,1,0,1,0
28083,55496,64097,0,0,66,66,0,1,0,1,0
28084,58114,11119,0,0,148,148,0,1,0,1,0
28085,60343,445,0,0,70,70,0,1,0,1,0
28086,52348,62413,0,0,66,66,0,1,0,1,0
28087,33582,44847,0,0,66,66,0,1,0,1,0
28088,60584,445,0,0,66,66,0,1,0,1,0
28089,56718,50584,0,0,66,66,0,1,0,1,0
28090,57131,7774,0,0,145,145,0,1,0,1,0
28091,60342,445,0,0,70,70,0,1,0,1,0
28092,60575,445,0,0,66,66,0,1,0,1,0
28093,49276,51505,0,0,66,66,0,1,0,1,0
28094,56255,44847,0,0,66,66,0,1,0,1,0
28095,56015,56205,0,0,66,66,0,1,0,1,0
28096,2305,35440,0,0,62,62,0,1,0,1,0
28097,39460,23117,0,0,66,66,0,1,0,1,0
28098,3585,64147,0,0,62,62,0,1,0,1,0
28099,6666,5000,0,0,60,60,0,1,0,1,0
28100,13062,52752,0,0,66,66,0,1,0,1,0
28101,56281,53,50630,53,170,87,83,2,31,1,1
28102,51970,443,63530,443,17072,6138,10934,33,85,18,15
28103,58801,443,36000,443,8937,5785,3152,26,16,14,12
28104,52002,34348,16658,34348,70,70,0,2,7,2,0
28105,54816,3389,54816,3389,3413,1458,1955,16,17,8,8
28106,55624,53,27462,53,701,88,613,2,30,1,1
28107,58045,80,55044,80,62067,24127,37940,79,34,33,46
28108,58055,80,48571,80,3791,2804,987,14,31,8,6
28109,38661,15000,5688,15000,138,78,60,2,5,1,1
28110,51966,18716,18361,18716,66,66,0,1,5,1,0
28111,49503,443,13223,443,9678,4552,5126,22,76,12,10
28112,49270,53,43465,53,216,110,106,2,30,1,1
28113,58034,443,53963,443,10192,3621,6571,24,36,12,12
28114,2885,443,2885,443,28717,3437,25280,45,23,23,22
28115,2359,443,2359,443,8209,1695,6514,21,23,13,8
28116,37554,443,12881,443,13220,4632,8588,32,37,19,13
28117,41628,15000,25474,15000,130,70,60,2,6,1,1
28118,56982,80,33665,80,3817,829,2988,11,16,7,4
28119,58672,443,27008,443,4649,2114,2535,11,120,6,5
28120,2434,443,2434,443,8209,1695,6514,21,23,13,8
28121,52013,443,52013,443,43964,6675,37289,60,49,25,35
28122,57157,443,64238,443,1647,1375,272,9,48,5,4
28123,49270,53,27956,53,216,110,106,2,31,1,1
28124,53974,443,28676,443,3330,1694,1636,15,30,8,7
28125,47207,443,60906,443,11085,2554,8531,48,19,24,24
28126,55576,443,55576,443,4665,1758,2907,19,28,11,8
28127,44687,443,14376,443,3054,1741,1313,20,27,8,12
28128,65418,443,32664,443,2494,1643,851,17,26,9,8
28129,52016,443,52016,443,219803,9390,210413,222,49,72,150
28130,58053,80,60672,80,3751,3009,742,14,31,8,6
28131,51216,22,51216,22,5806,2153,3653,33,24,18,15
28132,5908,3389,5908,3389,3850,1745,2105,19,18,11,8
28133,63937,53,56505,53,182,93,89,2,30,1,1
28134,50583,53,30118,53,783,96,687,2,30,1,1
28135,55071,53,28115,53,711,87,624,2,30,1,1
28136,65442,443,8292,443,3783,1087,2696,11,120,5,6
28137,55307,53,50101,53,1415,101,1314,4,51,2,2
28138,55810,80,19012,80,11093,1415,9678,18,18,8,10
28139,60165,80,45319,80,1982,692,1290,8,15,5,3
28140,39644,80,29707,80,2631,1207,1424,14,16,9,5
28141,52001,12514,64945,12514,70,70,0,2,7,2,0
28142,58799,443,29874,443,7899,5184,2715,24,16,13,11
28143,58054,80,39200,80,3561,3028,533,14,31,8,6
28144,58796,443,44743,443,14463,9503,4960,34,17,17,17
28145,47120,443,47120,443,4380,1473,2907,19,29,11,8
28146,56621,53,42291,53,170,87,83,2,30,1,1
28147,51307,80,27411,80,5912,5182,730,15,23,9,6
28148,63936,14832,6153,14832,312,190,122,5,16,3,2
28149,2252,443,2252,443,11489,1827,9662,25,23,15,10
28150,2226,443,2226,443,46743,4890,41853,69,23,35,34
28151,2506,443,2506,443,35555,4646,30909,59,23,33,26
28152,56119,53,42460,53,198,101,97,2,30,1,1
28153,59115,443,45739,443,30048,2775,27273,41,137,16,25
28154,62623,443,47203,443,5311,1546,3765,15,122,7,8
28155,36099,443,40194,443,48494,10293,38201,71,129,26,45
28156,55199,443,36951,443,4086,1248,2838,24,140,11,13
28157,50319,53,41804,53,188,96,92,2,31,1,1
28158,56138,53,1894,53,783,96,687,2,31,1,1
28159,52426,53,52426,53,310,94,216,2,31,1,1
28160,55563,53,56094,53,188,96,92,2,31,1,1
28161,59715,443,21725,443,3420,983,2437,15,121,7,8
28162,35776,443,4893,443,7500,2339,5161,18,136,8,10
28163,54667,443,17668,443,3989,1104,2885,12,122,5,7
28164,58386,443,54159,443,17470103,920642,16549461,18410,181,6438,11972
28165,55021,53,4080,53,174,89,85,2,31,1,1
28166,49845,443,54304,443,8518,2260,6258,32,806,12,20
28167,54944,443,7511,443,4891,2237,2654,12,121,6,6
28168,49937,443,1883,443,240,240,0,5,338,5,0
28169,54344,443,13534,443,10015,6047,3968,22,122,12,10
28170,46554,5228,16651,5228,4520,2520,2000,40,3961,20,20
28171,34997,22,0,0,60,60,0,1,0,1,0
28172,60337,445,0,0,70,70,0,1,0,1,0
28173,1059,44847,0,0,62,62,0,1,0,1,0
28174,56278,52752,0,0,62,62,0,1,0,1,0
28175,65157,445,0,0,70,70,0,1,0,1,0
28176,65158,445,0,0,70,70,0,1,0,1,0
28177,65156,445,0,0,70,70,0,1,0,1,0
28178,38891,64147,0,0,145,145,0,1,0,1,0
28179,55123,64097,0,0,66,66,0,1,0,1,0
28180,60568,445,0,0,66,66,0,1,0,1,0
28181,60561,445,0,0,66,66,0,1,0,1,0
28182,60569,445,0,0,66,66,0,1,0,1,0
28183,60566,445,0,0,66,66,0,1,0,1,0
28184,60563,445,0,0,66,66,0,1,0,1,0
28185,60565,445,0,0,66,66,0,1,0,1,0
28186,60564,445,0,0,66,66,0,1,0,1,0
28187,23415,11392,0,0,62,62,0,1,0,1,0
28188,8592,35993,0,0,62,62,0,1,0,1,0
28189,63944,30188,0,0,66,66,0,1,0,1,0
28190,50052,65008,0,0,60,60,0,1,0,1,0
28191,60324,445,0,0,70,70,0,1,0,1,0
28192,2695,48817,0,0,62,62,0,1,0,1,0
28193,65155,445,0,0,70,70,0,1,0,1,0
28194,65153,445,0,0,70,70,0,1,0,1,0
28195,49270,53,46560,53,322,110,212,4,30,2,2
28196,65146,445,0,0,70,70,0,1,0,1,0
28197,65143,445,0,0,70,70,0,1,0,1,0
28198,56250,36237,0,0,66,66,0,1,0,1,0
28199,1912,48817,0,0,62,62,0,1,0,1,0
28200,56098,55442,0,0,66,66,0,1,0,1,0
28201,60549,445,0,0,66,66,0,1,0,1,0
28202,60548,445,0,0,66,66,0,1,0,1,0
28203,60546,445,0,0,66,66,0,1,0,1,0
28204,56218,43890,0,0,62,62,0,1,0,1,0
28205,53902,67,0,0,60,60,0,1,0,1,0
28206,60319,445,0,0,70,70,0,1,0,1,0
28207,26601,22114,0,0,62,62,0,1,0,1,0
28208,45304,64147,0,0,72,72,0,1,0,1,0
28209,9445,56205,0,0,62,62,0,1,0,1,0
28210,3052,7302,0,0,66,66,0,1,0,1,0
28211,65136,445,0,0,70,70,0,1,0,1,0
28212,51779,31652,0,0,62,62,0,1,0,1,0
28213,65134,445,0,0,70,70,0,1,0,1,0
28214,53759,40826,3442,40826,492,306,186,8,15,5,3
28215,56718,443,49535,443,7940,1951,5989,20,15,11,9
28216,56281,53,4042,53,177,94,83,2,30,1,1
28217,39945,443,42447,443,5446,805,4641,17,26,9,8
28218,37542,443,40273,443,13299,2872,10427,34,41,19,15
28219,37559,443,47158,443,9845,2815,7030,26,37,15,11
28220,52010,23685,49442,23685,316,136,180,6,5,3,3
28221,51968,43622,30970,43622,70,70,0,1,4,1,0
28222,53721,443,6188,443,70,70,0,1,4,1,0
28223,55835,53,15423,53,180,94,86,2,29,1,1
28224,56020,53,34140,53,199,102,97,2,29,1,1
28225,57350,53,53074,53,257,94,163,2,30,1,1
28226,49344,443,51198,443,272627,89686,182941,461,149,220,241
28227,64191,443,64191,443,18608,1844,16764,31,16,16,15
28228,49365,443,7020,443,442336,371266,71070,1143,762,651,492
28229,37546,80,60597,80,10438,979,9459,21,38,11,10
28230,55493,80,50792,80,133558,8265,125293,186,31,93,93
28231,47495,443,53611,443,490,210,280,8,28,4,4
28232,60572,80,35245,80,556,280,276,9,28,5,4
28233,37552,443,42195,443,9959,2495,7464,27,37,15,12
28234,63937,53,1528,53,183,94,89,2,29,1,1
28235,64919,53,28952,53,199,102,97,2,29,1,1
28236,64919,53,63713,53,822,102,720,2,29,1,1
28237,5588,5588,0,0,3354,1792,1562,46,193,23,23
28238,56586,53,17774,53,177,94,83,2,29,1,1
28239,57438,53,26523,53,340,110,230,2,29,1,1
28240,65514,53,51532,53,177,94,83,2,30,1,1
28241,50288,80,24804,80,2032,600,1432,10,45,6,4
28242,52014,443,52014,443,16507,6060,10447,32,49,16,16
28243,54069,443,6998,443,887350,41179,846171,1082,210,487,595
28244,38692,443,1550,443,1188751,17817,1170934,1053,16,255,798
28245,60742,443,40207,443,2258,559,1699,22,120,6,16
28246,49270,53,44798,53,216,110,106,2,30,1,1
28247,44732,80,44732,80,369759,9557,360202,388,22,137,251
28248,9199,80,13955,80,60838,1648,59190,68,27,25,43
28249,53146,50393,43018,50393,70,70,0,1,5,1,0
28250,58810,443,59123,443,5167,700,4467,16,15,7,9
28251,60448,8106,52879,8106,3105,1298,1807,20,16,10,10
28252,49264,80,49264,80,698,366,332,12,44,7,5
28253,55862,53,15902,53,177,94,83,2,30,1,1
28254,27242,443,3447,443,19477,14323,5154,45,309,22,23
28255,58139,443,5557,443,9521,5450,4071,30,120,15,15
28256,64170,53,8544,53,355,118,237,2,30,1,1
28257,56119,53,10048,53,199,102,97,2,33,1,1
28258,57852,7635,57852,7635,216,156,60,4,8,3,1
28259,52009,443,52009,443,588633,17490,571143,578,51,186,392
28260,52011,443,52011,443,110812,7779,103033,122,49,44,78
28261,54078,443,47563,443,1060654,45683,1014971,1265,176,560,705
28262,49194,65100,3468,65100,624,318,306,10,15,5,5
28263,53858,53,53858,53,832,106,726,2,30,1,1
28264,63313,443,9713,443,1786,172,1614,7,120,3,4
28265,47657,443,24927,443,502,140,362,8,140,3,5
28266,50287,80,60290,80,3325,607,2718,11,45,6,5
28267,36754,443,35340,443,1320,822,498,16,41,9,7
28268,45350,443,10693,443,918,358,560,14,40,6,8
28269,56650,80,32144,80,234,234,0,4,12,4,0
28270,64984,53,22465,53,177,94,83,2,30,1,1
28271,57837,443,45626,443,9767,2606,7161,23,120,11,12
28272,10037,443,24188,443,6061,1884,4177,27,16,15,12
28273,51824,80,16784,80,15487,8701,6786,29,44,17,12
28274,55289,53,47764,53,446,94,352,4,44,2,2
28275,55491,80,9905,80,204936,10932,194004,277,31,140,137
28276,55172,443,53179,443,25605,3359,22246,47,82,26,21
28277,42889,443,3091,443,3961,1595,2366,21,15,12,9
28278,60899,443,59717,443,847673,42767,804906,1045,89,441,604
28279,37544,443,15194,443,23647,9422,14225,52,40,28,24
28280,56719,443,65516,443,7888,1899,5989,20,15,11,9
28281,37551,443,6245,443,9381,2351,7030,26,37,15,11
28282,37557,443,30973,443,9824,2477,7347,27,37,16,11
28283,51967,12110,53548,12110,70,70,0,1,4,1,0
28284,60780,28080,29726,28080,70,70,0,2,8,2,0
28285,58718,443,59357,443,1129,599,530,12,25,6,6
28286,49863,8100,2379,8100,78,78,0,1,4,1,0
28287,51969,37558,33450,37558,70,70,0,1,4,1,0
28288,58807,443,28426,443,6033,770,5263,18,15,8,10
28289,65321,53,63779,53,283,103,180,4,54,2,2
28290,59433,53,26803,53,218,78,140,2,29,1,1
28291,49886,53,25717,53,275,94,181,2,30,1,1
28292,48082,443,55722,443,5619,885,4734,17,26,9,8
28293,55862,53,22118,53,177,94,83,2,30,1,1
28294,57113,53,7922,53,215,102,113,2,30,1,1
28295,49256,53,15315,53,212,102,110,2,30,1,1
28296,56621,53,63745,53,177,94,83,2,29,1,1
28297,45099,123,62953,123,184,94,90,2,30,1,1
28298,50319,53,7471,53,194,102,92,2,30,1,1
28299,49741,53,12587,53,211,102,109,2,30,1,1
28300,48941,443,53829,443,10085,3487,6598,21,120,9,12
28301,55641,443,52887,443,6133,1655,4478,12,119,5,7
28302,6881,6881,48136,6881,238,118,120,2,1200,1,1
28303,54081,443,47129,443,444890,27602,417288,580,176,265,315
28304,51459,443,30706,443,6779,2365,4414,19,15,10,9
28305,54070,443,51450,443,828875,45659,783216,1020,210,456,564
28306,50722,80,43079,80,7550,5292,2258,13,29,7,6
28307,52000,10491,3122,10491,70,70,0,2,8,2,0
28308,58808,443,58470,443,5167,700,4467,16,15,7,9
28309,46845,443,36578,443,5506,878,4628,16,26,9,7
28310,55958,53,14478,53,212,102,110,2,30,1,1
28311,50319,53,65506,53,194,102,92,2,30,1,1
28312,51764,443,27947,443,5660,3864,1796,27,95,14,13
28313,60969,443,65231,443,1373,712,661,14,105,8,6
28314,43841,443,59699,443,6516,3085,3431,33,80,17,16
28315,64917,53,19019,53,718,94,624,2,30,1,1
28316,64984,53,54223,53,177,94,83,2,30,1,1
28317,50287,53,47633,53,177,94,83,2,30,1,1
28318,56281,53,7565,53,177,94,83,2,30,1,1
28319,57513,443,18231,443,4346,1212,3134,13,120,6,7
28320,63941,80,15778,80,314,192,122,6,15,4,2
28321,60966,443,26414,443,60331,12765,47566,119,105,57,62
28322,52015,443,52015,443,32358,7474,24884,49,49,23,26
28323,47130,80,63322,80,613,539,74,7,15,6,1
28324,43865,443,4892,443,560,280,280,9,26,5,4
28325,64642,53,25504,53,718,94,624,2,30,1,1
28326,50287,53,45385,53,177,94,83,2,30,1,1
28327,49173,53,47440,53,234,94,140,2,30,1,1
28328,55871,443,13590,443,21179,8150,13029,46,153,25,21
28329,123,123,44210,123,184,94,90,2,30,1,1
28330,55563,53,47239,53,194,102,92,2,31,1,1
28331,55221,443,37010,443,12954,2333,10621,20,120,9,11
28332,62624,443,17860,443,6990,2057,4933,19,121,9,10
28333,59976,80,48173,80,890,469,421,10,360,5,5
28334,37965,35771,32766,35771,481,150,331,2,1199,1,1
28335,54538,443,10842,443,2936,1546,1390,17,70,10,7
28336,63952,50734,54501,50734,66,66,0,2,8,2,0
28337,51963,21638,43079,21638,70,70,0,1,5,1,0
28338,58804,443,5956,443,5167,700,4467,16,15,7,9
28339,60934,80,21512,80,1212,774,438,11,81,7,4
28340,56281,53,38618,53,177,94,83,2,31,1,1
28341,56388,443,34459,443,70,70,0,1,5,1,0
28342,59928,53,64195,53,168,78,90,2,30,1,1
28343,58744,53,27095,53,368,86,282,2,30,1,1
28344,50140,53,14261,53,177,94,83,2,30,1,1
28345,56578,53,41828,53,219,86,133,2,31,1,1
28346,56717,443,27833,443,8006,1986,6020,20,15,11,9
28347,55028,443,57444,443,7196,2834,4362,28,17,16,12
28348,50735,443,6692,443,22676,8150,14526,33,16,17,16
28349,64113,53,33491,53,294,134,160,2,30,1,1
28350,56056,53,19190,53,184,86,98,2,30,1,1
28351,60442,53,50367,53,184,78,106,2,30,1,1
28352,65133,445,0,0,70,70,0,1,0,1,0
28353,65125,445,0,0,70,70,0,1,0,1,0
28354,46837,57470,0,0,62,62,0,1,0,1,0
28355,60315,445,0,0,70,70,0,1,0,1,0
28356,60313,445,0,0,70,70,0,1,0,1,0
28357,60311,445,0,0,70,70,0,1,0,1,0
28358,50321,23684,0,0,143,143,0,1,0,1,0
28359,50772,35440,0,0,66,66,0,1,0,1,0
28360,62079,30188,0,0,66,66,0,1,0,1,0
28361,58829,64147,0,0,66,66,0,1,0,1,0
28362,11907,57470,0,0,66,66,0,1,0,1,0
28363,58276,43890,0,0,66,66,0,1,0,1,0
28364,65118,445,0,0,70,70,0,1,0,1,0
28365,34417,50265,0,0,145,145,0,1,0,1,0
28366,65112,445,0,0,70,70,0,1,0,1,0
28367,65114,445,0,0,70,70,0,1,0,1,0
28368,33003,28543,0,0,62,62,0,1,0,1,0
28369,60304,445,0,0,70,70,0,1,0,1,0
28370,60537,445,0,0,66,66,0,1,0,1,0
28371,20280,30188,0,0,146,146,0,1,0,1,0
28372,60311,56205,0,0,66,66,0,1,0,1,0
28373,60302,445,0,0,70,70,0,1,0,1,0
28374,17786,44847,0,0,62,62,0,1,0,1,0
28375,49522,21247,0,0,62,62,0,1,0,1,0
28376,60301,445,0,0,70,70,0,1,0,1,0
28377,60300,445,0,0,70,70,0,1,0,1,0
28378,60299,445,0,0,70,70,0,1,0,1,0
28379,60297,445,0,0,70,70,0,1,0,1,0
28380,60295,445,0,0,70,70,0,1,0,1,0
28381,57011,49813,0,0,66,66,0,1,0,1,0
28382,65111,445,0,0,70,70,0,1,0,1,0
28383,65110,445,0,0,70,70,0,1,0,1,0
28384,65398,7129,0,0,62,62,0,1,0,1,0
28385,54464,56205,0,0,66,66,0,1,0,1,0
28386,60281,445,0,0,70,70,0,1,0,1,0
28387,60280,445,0,0,70,70,0,1,0,1,0
28388,53856,443,18832,443,495,421,74,4,0,3,1
28389,60521,445,0,0,66,66,0,1,0,1,0
28390,60520,445,0,0,66,66,0,1,0,1,0
28391,60278,445,0,0,70,70,0,1,0,1,0
28392,60271,445,0,0,70,70,0,1,0,1,0
28393,60270,445,0,0,70,70,0,1,0,1,0
28394,10445,46824,0,0,62,62,0,1,0,1,0
28395,59413,51505,0,0,62,62,0,1,0,1,0
28396,18252,18242,0,0,62,62,0,1,0,1,0
28397,60557,23117,0,0,62,62,0,1,0,1,0
28398,58195,38303,0,0,66,66,0,1,0,1,0
28399,65099,445,0,0,70,70,0,1,0,1,0
28400,38741,37965,0,0,146,146,0,1,0,1,0
28401,59934,35440,0,0,66,66,0,1,0,1,0
28402,65095,445,0,0,70,70,0,1,0,1,0
28403,65091,445,0,0,70,70,0,1,0,1,0
28404,65092,445,0,0,70,70,0,1,0,1,0
28405,60516,445,0,0,66,66,0,1,0,1,0
28406,24127,56205,0,0,66,66,0,1,0,1,0
28407,55524,46232,0,0,66,66,0,1,0,1,0
28408,60259,445,0,0,70,70,0,1,0,1,0
28409,60508,445,0,0,66,66,0,1,0,1,0
28410,60509,445,0,0,66,66,0,1,0,1,0
28411,60504,445,0,0,66,66,0,1,0,1,0
28412,60506,445,0,0,66,66,0,1,0,1,0
28413,60502,445,0,0,66,66,0,1,0,1,0
28414,60498,445,0,0,66,66,0,1,0,1,0
28415,60500,445,0,0,66,66,0,1,0,1,0
28416,12986,64147,0,0,62,62,0,1,0,1,0
28417,65085,445,0,0,70,70,0,1,0,1,0
28418,14693,64147,0,0,66,66,0,1,0,1,0
28419,62153,35440,0,0,66,66,0,1,0,1,0
28420,65081,445,0,0,70,70,0,1,0,1,0
28421,65079,445,0,0,70,70,0,1,0,1,0
28422,65077,445,0,0,70,70,0,1,0,1,0
28423,59400,22114,0,0,66,66,0,1,0,1,0
28424,60255,445,0,0,70,70,0,1,0,1,0
28425,51453,64147,0,0,66,66,0,1,0,1,0
28426,48706,23393,0,0,60,60,0,1,0,1,0
28427,38664,37965,0,0,62,62,0,1,0,1,0
28428,59886,64147,0,0,72,72,0,1,0,1,0
28429,11136,19910,0,0,62,62,0,1,0,1,0
28430,1114,46824,0,0,62,62,0,1,0,1,0
28431,60243,445,0,0,70,70,0,1,0,1,0
28432,60244,445,0,0,70,70,0,1,0,1,0
28433,60246,445,0,0,70,70,0,1,0,1,0
28434,65075,445,0,0,70,70,0,1,0,1,0
28435,65073,445,0,0,70,70,0,1,0,1,0
28436,65072,445,0,0,70,70,0,1,0,1,0
28437,60241,445,0,0,70,70,0,1,0,1,0
28438,60493,445,0,0,66,66,0,1,0,1,0
28439,60238,445,0,0,70,70,0,1,0,1,0
28440,65068,445,0,0,70,70,0,1,0,1,0
28441,60489,445,0,0,66,66,0,1,0,1,0
28442,54389,28543,0,0,62,62,0,1,0,1,0
28443,0,0,0,0,320,320,0,5,0,5,0
28444,60486,445,0,0,66,66,0,1,0,1,0
28445,60487,445,0,0,66,66,0,1,0,1,0
28446,60485,445,0,0,66,66,0,1,0,1,0
28447,63331,51221,0,0,62,62,0,1,0,1,0
28448,65344,46824,0,0,62,62,0,1,0,1,0
28449,48513,44847,0,0,62,62,0,1,0,1,0
28450,60232,445,0,0,70,70,0,1,0,1,0
28451,65060,445,0,0,70,70,0,1,0,1,0
28452,63344,53,0,0,73,73,0,1,0,1,0
28453,30794,37965,0,0,62,62,0,1,0,1,0
28454,65058,445,0,0,70,70,0,1,0,1,0
28455,65059,445,0,0,70,70,0,1,0,1,0
28456,57365,38303,0,0,62,62,0,1,0,1,0
28457,26085,8305,0,0,148,148,0,1,0,1,0
28458,64697,37965,0,0,66,66,0,1,0,1,0
28459,60474,445,0,0,66,66,0,1,0,1,0
28460,60223,445,0,0,70,70,0,1,0,1,0
28461,59679,37807,0,0,66,66,0,1,0,1,0
28462,3608,25773,0,0,146,146,0,1,0,1,0
28463,3375,35253,0,0,66,66,0,1,0,1,0
28464,19875,30170,0,0,145,145,0,1,0,1,0
28465,60219,445,0,0,70,70,0,1,0,1,0
28466,52390,2323,0,0,60,60,0,1,0,1,0
28467,11821,64147,0,0,62,62,0,1,0,1,0
28468,60466,445,0,0,66,66,0,1,0,1,0
28469,58836,44847,0,0,74,74,0,1,0,1,0
28470,60217,445,0,0,70,70,0,1,0,1,0
28471,65041,445,0,0,70,70,0,1,0,1,0
28472,64677,57470,0,0,66,66,0,1,0,1,0
28473,23553,37965,0,0,62,62,0,1,0,1,0
28474,60463,445,0,0,66,66,0,1,0,1,0
28475,61461,50584,0,0,66,66,0,1,0,1,0
28476,13413,44847,0,0,62,62,0,1,0,1,0
28477,49604,53,29103,53,89,89,0,1,30,1,0
28478,54202,53,3615,53,578,286,292,9,16,5,4
28479,40801,443,33203,443,3289,1265,2024,13,32,7,6
28480,51965,48708,36849,48708,66,66,0,1,5,1,0
28481,44799,443,2515,443,3467,2186,1281,16,15,9,7
28482,49322,443,25281,443,3005,2082,923,18,28,9,9
28483,38469,80,38469,80,555104,4582,550522,446,20,60,386
28484,57987,3478,61463,3478,60483,25857,34626,136,47,63,73
28485,55877,14966,41407,14966,480,149,331,2,1200,1,1
28486,33856,443,15583,443,7298,2661,4637,21,21,11,10
28487,53145,44634,36222,44634,70,70,0,1,5,1,0
28488,5588,5588,0,0,3354,1792,1562,46,193,23,23
28489,58800,443,5645,443,3874,2470,1404,17,15,9,8
28490,44794,443,36304,443,11158,3338,7820,27,16,16,11
28491,49307,443,35042,443,245382,6838,238544,214,31,44,170
28492,65514,53,50854,53,170,87,83,2,30,1,1
28493,57470,43611,57055,43611,3960,3960,0,61,3411,61,0
28494,64540,53,58172,53,174,89,85,2,30,1,1
28495,23683,53,23683,53,338,225,113,3,30,2,1
28496,51932,443,23132,443,3207,2430,777,21,26,11,10
28497,26805,443,51812,443,7343,2586,4757,23,20,11,12
28498,44798,443,42874,443,3239,2220,1019,16,15,9,7
28499,35440,443,40080,443,7419,2136,5283,23,255,11,12
28500,55913,53,58939,53,170,87,83,2,31,1,1
28501,49914,53,39261,53,815,95,720,2,30,1,1
28502,53370,443,49689,443,6877,1694,5183,24,306,13,11
28503,58792,443,15545,443,9278,6126,3152,27,16,15,12
28504,55230,443,41463,443,39555,12054,27501,78,66,41,37
28505,63931,16528,26745,16528,376,254,122,6,17,4,2
28506,58888,15000,44683,15000,138,78,60,2,5,1,1
28507,58048,80,12048,80,5171,3018,2153,16,30,8,8
28508,53701,8999,10439,8999,1328,960,368,10,32,5,5
28509,55249,53,63785,53,711,87,624,2,30,1,1
28510,55034,443,55034,443,154907,10748,144159,217,20,101,116
28511,36714,80,19257,80,1792,703,1089,12,16,7,5
28512,59040,24184,0,0,62,62,0,1,60,1,0
28513,56020,53,53467,53,198,101,97,2,31,1,1
28514,54539,443,59530,443,4867,1208,3659,16,23,10,6
28515,55336,443,52055,443,209596,37190,172406,378,79,184,194
28516,53264,443,22628,443,7424,1825,5599,25,18,13,12
28517,51994,25509,30907,25509,70,70,0,2,8,2,0
28518,49321,443,15064,443,3005,2082,923,18,28,9,9
28519,49044,443,55687,443,5150,853,4297,16,27,9,7
28520,51387,443,34318,443,5795,3322,2473,22,93,13,9
28521,39629,53,0,0,82,82,0,1,30,1,0
28522,6882,16276,42707,16276,150,150,0,1,1200,1,0
28523,58789,443,17140,443,14261,9361,4900,35,16,19,16
28524,40802,443,39888,443,3321,1297,2024,13,32,7,6
28525,55504,53,5700,53,711,87,624,2,30,1,1
28526,57275,53,65357,53,170,87,83,2,31,1,1
28527,62873,443,13983,443,3049,988,2061,14,135,7,7
28528,63593,443,12181,443,36819,3967,32852,59,152,30,29
28529,50362,53,31941,53,181,98,83,2,31,1,1
28530,64915,53,25917,53,98,98,0,1,31,1,0
28531,51494,443,60286,443,8140,5384,2756,15,122,8,7
28532,30960,45744,39744,45744,330,330,0,6,3609,6,0
28533,60213,445,0,0,70,70,0,1,0,1,0
28534,46839,51050,0,0,62,62,0,1,0,1,0
28535,26835,47993,0,0,62,62,0,1,0,1,0
28536,65379,22114,0,0,66,66,0,1,0,1,0
28537,60212,445,0,0,70,70,0,1,0,1,0
28538,60455,445,0,0,66,66,0,1,0,1,0
28539,60446,445,0,0,66,66,0,1,0,1,0
28540,22784,9571,0,0,62,62,0,1,0,1,0
28541,33651,36237,0,0,62,62,0,1,0,1,0
28542,26330,26348,0,0,62,62,0,1,0,1,0
28543,58745,30188,0,0,66,66,0,1,0,1,0
28544,52828,51221,0,0,66,66,0,1,0,1,0
28545,57275,53,56267,53,177,94,83,2,30,1,1
28546,65495,443,43238,443,418463,12360,406103,430,16,151,279
28547,49604,53,12616,53,179,94,85,2,30,1,1
28548,56161,53,11132,53,199,94,105,2,30,1,1
28549,60472,443,5896,443,3779,2809,970,23,47,12,11
28550,35743,443,39300,443,560,280,280,9,28,5,4
28551,9197,80,56702,80,1701,883,818,14,26,7,7
28552,52643,6881,27552,6881,719,413,306,10,14,5,5
28553,49840,53,47224,53,463,87,376,4,38,2,2
28554,65061,53,50134,53,297,101,196,4,33,2,2
28555,49339,443,31744,443,208,70,138,4,25,2,2
28556,49604,53,14213,53,86,86,0,1,29,1,0
28557,56876,53,26048,53,283,110,173,2,29,1,1
28558,35628,443,46062,443,8414,4131,4283,36,64,16,20
28559,54148,443,30287,443,272587,11910,260677,336,76,140,196
28560,54151,443,32501,443,1749,966,783,13,75,8,5
28561,35617,443,43217,443,2981,1719,1262,17,79,10,7
28562,56716,443,64304,443,8058,2038,6020,20,15,11,9
28563,36834,443,25361,443,7251,5852,1399,34,75,18,16
28564,48992,443,21581,443,5952,1328,4624,19,76,11,8
28565,57435,443,34425,443,13536,5529,8007,55,18,24,31
28566,42587,443,6188,443,7733,1203,6530,21,15,12,9
28567,55425,5222,24173,5222,9151,4417,4734,84,77,44,40
28568,51996,41888,55881,41888,70,70,0,2,7,2,0
28569,43628,53,19035,53,168,78,90,2,29,1,1
28570,65514,53,17473,53,177,94,83,2,29,1,1
28571,25237,53,25237,53,216,82,134,2,33,1,1
28572,65153,53,31638,53,184,86,98,2,29,1,1
28573,65492,53,51377,53,707,94,613,2,29,1,1
28574,65014,53,11511,53,718,94,624,2,29,1,1
28575,49198,53,16713,53,261,94,167,2,29,1,1
28576,64145,53,4283,53,177,94,83,2,31,1,1
28577,55021,53,44725,53,179,94,85,2,30,1,1
28578,49646,53,41795,53,209,102,107,2,30,1,1
28579,28237,443,25955,443,7876,1540,6336,21,124,10,11
28580,56352,53,18136,53,177,94,83,2,30,1,1
28581,55021,53,50748,53,179,94,85,2,30,1,1
28582,59636,443,44710,443,3197,1047,2150,15,120,8,7
28583,58249,443,38085,443,4192,2267,1925,12,120,6,6
28584,55330,53,64550,53,194,102,92,2,31,1,1
28585,64540,53,24153,53,179,94,85,2,30,1,1
28586,60036,53,52040,53,86,86,0,1,30,1,0
28587,64768,53,30874,53,78,78,0,1,30,1,0
28588,60903,443,18682,443,333062,18123,314939,420,88,182,238
28589,64714,53,29165,53,168,86,82,2,32,1,1
28590,51170,443,40281,443,9894856,232425,9662431,9829,90,3300,6529
28591,52588,443,7205,443,3523,518,3005,12,15,6,6
28592,48282,8080,0,0,184,78,106,3,9,2,1
28593,50233,80,29881,80,2388,1066,1322,16,135,8,8
28594,28236,443,42527,443,9686,2335,7351,28,124,13,15
28595,58803,443,12977,443,5166,700,4466,16,15,7,9
28596,55671,17758,7518,17758,422,140,282,6,15,3,3
28597,36668,443,55888,443,142299,120615,21684,348,336,180,168
28598,54336,443,1774,443,172701,6397,166304,202,246,72,130
28599,9206,443,23255,443,5043,432,4611,12,15,6,6
28600,65124,53,4615,53,353,118,235,2,30,1,1
28601,32927,443,11670,443,5746,1079,4667,17,27,10,7
28602,64889,53,50666,53,215,102,113,2,30,1,1
28603,55872,53,55616,53,177,94,83,2,30,1,1
28604,58798,443,46435,443,5167,700,4467,16,15,7,9
28605,56352,53,39464,53,177,94,83,2,30,1,1
28606,55343,53,44963,53,366,94,272,2,30,1,1
28607,54924,443,20791,443,53816,22991,30825,139,306,71,68
28608,55021,53,26465,53,94,94,0,1,30,1,0
28609,46261,80,62301,80,3578,1673,1905,16,186,9,7
28610,46597,53,0,0,86,86,0,1,30,1,0
28611,55913,53,60589,53,177,94,83,2,30,1,1
28612,47765,443,53985,443,8035,2176,5859,25,331,12,13
28613,60971,443,2878,443,2732,1359,1373,29,193,16,13
28614,33136,443,16239,443,6648,1556,5092,23,29,13,10
28615,37906,443,31579,443,416,210,206,7,26,4,3
28616,57149,53,29225,53,612,114,498,4,52,2,2
28617,65158,53,9153,53,728,102,626,2,30,1,1
28618,52847,53,50629,53,86,86,0,1,30,1,0
28619,64145,53,46343,53,177,94,83,2,30,1,1
28620,64475,53,57543,53,314,99,215,4,39,2,2
28621,59925,80,15613,80,2287,1534,753,11,16,6,5
28622,64108,53,41542,53,296,126,170,2,30,1,1
28623,55667,53,30119,53,305,126,179,2,30,1,1
28624,48817,51413,48817,51413,460,150,310,2,1200,1,1
28625,35967,443,11420,443,3870,1743,2127,13,120,6,7
28626,54535,443,39884,443,9859,3252,6607,24,74,12,12
28627,55033,443,56054,443,13944,2069,11875,28,30,15,13
28628,54150,443,60800,443,230997,10675,220322,291,75,122,169
28629,64694,53,58763,53,361,107,254,4,37,2,2
28630,54534,443,41952,443,7153,2581,4572,28,74,15,13
28631,64956,53,28840,53,322,84,238,4,36,2,2
28632,51995,50031,39289,50031,70,70,0,2,8,2,0
28633,51964,1103,26830,1103,70,70,0,1,4,1,0
28634,51961,40373,22472,40373,70,70,0,1,5,1,0
28635,38693,443,10334,443,90177,3481,86696,96,15,31,65
28636,49777,53,2324,53,485,79,406,4,31,2,2
28637,37965,33149,27231,33149,3957,2324,1633,51,1732,29,22
28638,58802,443,8176,443,5167,700,4467,16,15,7,9
28639,30188,55886,45541,55886,502,150,352,2,1200,1,1
28640,56715,443,60472,443,8005,1985,6020,20,15,11,9
28641,50140,53,8390,53,177,94,83,2,30,1,1
28642,49512,443,49512,443,217225,47956,169269,284,64,149,135
28643,65496,443,16540,443,92799,4939,87860,111,16,45,66
28644,28235,443,3343,443,8830,2388,6442,29,124,14,15
28645,49383,53,63729,53,226,110,116,2,30,1,1
28646,55872,53,18177,53,177,94,83,2,30,1,1
28647,30651,53,22880,53,86,86,0,1,30,1,0
28648,27988,40040,49340,40040,148,86,62,2,30,1,1
28649,55913,53,2700,53,177,94,83,2,30,1,1
28650,50495,53,47068,53,195,102,93,2,30,1,1
28651,36567,53,0,0,86,86,0,1,30,1,0
28652,57275,53,32208,53,177,94,83,2,31,1,1
28653,55565,443,12183,443,21087,4784,16303,25,146,7,18
28654,44780,80,17326,80,120,120,0,3,122,3,0
28655,44847,23628,55980,23628,509,150,359,2,1200,1,1
28656,61806,443,30997,443,7439,1156,6283,19,75,11,8
28657,51960,58601,34616,58601,70,70,0,1,5,1,0
28658,64540,53,45439,53,179,94,85,2,30,1,1
28659,49519,53,62256,53,264,94,170,2,30,1,1
28660,50495,53,56662,53,195,102,93,2,30,1,1
28661,49369,53,17790,53,246,94,152,2,30,1,1
28662,57990,443,7309,443,3182,1568,1614,8,120,4,4
28663,62759,443,5744,443,9928,5183,4745,34,134,17,17
28664,46258,80,9234,80,3711,1806,1905,17,186,10,7
28665,10103,443,54343,443,6334,910,5424,20,360,10,10
28666,46410,443,3591,443,4568,2057,2511,17,62,9,8
28667,62338,443,61578,443,13396186,148566,13247620,10474,59,1498,8976
28668,38663,443,44632,443,16002,4305,11697,60,138,29,31
28669,60904,443,17681,443,2356,1309,1047,16,31,9,7
28670,49285,53,46992,53,94,94,0,1,30,1,0
28671,55563,53,39714,53,194,102,92,2,30,1,1
28672,46260,80,59881,80,3459,1620,1839,16,186,10,6
28673,46259,80,22858,80,3574,1669,1905,17,186,10,7
28674,57985,443,21475,443,140109,5229,134880,159,46,59,100
28675,44220,443,37375,443,2709,1698,1011,20,1143,11,9
28676,53143,24796,50959,24796,698,320,378,10,16,6,4
28677,59859,443,33487,443,10266,7336,2930,49,222,24,25
28678,56434,80,3931,80,17128,1499,15629,24,25,9,15
28679,56714,443,39694,443,8057,2037,6020,20,15,11,9
28680,57736,443,25293,443,3345,823,2522,12,120,6,6
28681,50584,2775,5247,2775,150,150,0,1,1200,1,0
28682,55686,443,35273,443,319563,13365,306198,344,123,119,225
28683,10102,443,2452,443,5415,864,4551,19,360,9,10
28684,50365,443,19679,443,712,374,338,11,28,6,5
28685,53758,63975,2179,63975,2016,1076,940,14,17,8,6
28686,56580,443,55118,443,2343,1296,1047,17,196,10,7
28687,56410,443,52137,443,16167,1392,14775,25,105,12,13
28688,47211,80,37416,80,1638,1324,314,10,16,5,5
28689,56639,53,13077,53,168,86,82,2,31,1,1
28690,63937,43443,65141,43443,160,70,90,2,5,1,1
28691,56409,443,57180,443,25302,1733,23569,35,121,16,19
28692,57275,53,14863,53,177,94,83,2,30,1,1
28693,61016,443,27858,443,56191,3435,52756,81,271,37,44
28694,42283,443,51990,443,16831,14003,2828,31,63,18,13
28695,64204,53,12423,53,211,102,109,2,30,1,1
28696,59950,53,40733,53,168,78,90,2,31,1,1
28697,57470,19853,37734,19853,132,132,0,3,1200,3,0
28698,57455,443,26313,443,9124,5296,3828,54,120,29,25
28699,33633,443,34965,443,5698,1585,4113,23,1108,13,10
28700,55589,53,12456,53,177,94,83,2,30,1,1
28701,59998,53,31845,53,481,110,371,2,31,1,1
28702,60207,445,0,0,70,70,0,1,0,1,0
28703,43323,1,0,0,62,62,0,1,0,1,0
28704,10026,50584,0,0,146,146,0,1,0,1,0
28705,59876,44847,0,0,62,62,0,1,0,1,0
28706,65029,445,0,0,70,70,0,1,0,1,0
28707,65030,445,0,0,70,70,0,1,0,1,0
28708,65028,445,0,0,70,70,0,1,0,1,0
28709,60435,445,0,0,66,66,0,1,0,1,0
28710,60436,445,0,0,66,66,0,1,0,1,0
28711,60438,445,0,0,66,66,0,1,0,1,0
28712,60432,445,0,0,66,66,0,1,0,1,0
28713,60437,445,0,0,66,66,0,1,0,1,0
28714,60439,445,0,0,66,66,0,1,0,1,0
28715,60433,445,0,0,66,66,0,1,0,1,0
28716,60440,445,0,0,66,66,0,1,0,1,0
28717,64104,22114,0,0,62,62,0,1,0,1,0
28718,54737,50584,0,0,66,66,0,1,0,1,0
28719,61550,5529,0,0,145,145,0,1,0,1,0
28720,3170,53567,0,0,66,66,0,1,0,1,0
28721,59483,23,0,0,60,60,0,1,0,1,0
28722,51743,64147,0,0,62,62,0,1,0,1,0
28723,25901,50265,0,0,62,62,0,1,0,1,0
28724,25054,36827,0,0,66,66,0,1,0,1,0
28725,36369,51505,0,0,66,66,0,1,0,1,0
28726,51148,9571,0,0,66,66,0,1,0,1,0
28727,60194,445,0,0,70,70,0,1,0,1,0
28728,53500,1,0,0,66,66,0,1,0,1,0
28729,26301,22114,0,0,62,62,0,1,0,1,0
28730,65027,445,0,0,70,70,0,1,0,1,0
28731,65026,445,0,0,70,70,0,1,0,1,0
28732,65024,445,0,0,70,70,0,1,0,1,0
28733,65012,445,0,0,70,70,0,1,0,1,0
28734,9227,9000,0,0,60,60,0,1,0,1,0
28735,60191,445,0,0,70,70,0,1,0,1,0
28736,50052,65008,0,0,60,60,0,1,0,1,0
28737,60419,445,0,0,66,66,0,1,0,1,0
28738,60417,445,0,0,66,66,0,1,0,1,0
28739,60416,445,0,0,66,66,0,1,0,1,0
28740,39681,37965,0,0,62,62,0,1,0,1,0
28741,64543,50265,0,0,66,66,0,1,0,1,0
28742,13938,64147,0,0,145,145,0,1,0,1,0
28743,31235,22114,0,0,146,146,0,1,0,1,0
28744,65008,445,0,0,70,70,0,1,0,1,0
28745,60186,445,0,0,70,70,0,1,0,1,0
28746,60185,445,0,0,70,70,0,1,0,1,0
28747,65000,445,0,0,70,70,0,1,0,1,0
28748,65002,445,0,0,70,70,0,1,0,1,0
28749,60183,445,0,0,70,70,0,1,0,1,0
28750,2531,30188,0,0,66,66,0,1,0,1,0
28751,12709,51505,0,0,62,62,0,1,0,1,0
28752,45964,3111,0,0,60,60,0,1,0,1,0
28753,7246,59858,0,0,66,66,0,1,0,1,0
28754,45908,3383,0,0,60,60,0,1,0,1,0
28755,63397,26467,0,0,66,66,0,1,0,1,0
28756,63041,50584,0,0,62,62,0,1,0,1,0
28757,40571,26467,0,0,62,62,0,1,0,1,0
28758,17643,50584,0,0,62,62,0,1,0,1,0
28759,27908,23,0,0,60,60,0,1,0,1,0
28760,60176,445,0,0,70,70,0,1,0,1,0
28761,64986,445,0,0,70,70,0,1,0,1,0
28762,64987,445,0,0,70,70,0,1,0,1,0
28763,64988,445,0,0,70,70,0,1,0,1,0
28764,61537,57866,0,0,66,66,0,1,0,1,0
28765,60174,445,0,0,70,70,0,1,0,1,0
28766,32520,47993,0,0,62,62,0,1,0,1,0
28767,60406,445,0,0,66,66,0,1,0,1,0
28768,65081,26467,0,0,66,66,0,1,0,1,0
28769,12663,62413,0,0,66,66,0,1,0,1,0
28770,60173,445,0,0,70,70,0,1,0,1,0
28771,27828,56205,0,0,146,146,0,1,0,1,0
28772,60172,445,0,0,70,70,0,1,0,1,0
28773,60171,445,0,0,70,70,0,1,0,1,0
28774,60169,445,0,0,70,70,0,1,0,1,0
28775,60167,445,0,0,70,70,0,1,0,1,0
28776,14343,6881,0,0,62,62,0,1,0,1,0
28777,3792,52700,0,0,62,62,0,1,0,1,0
28778,64982,445,0,0,70,70,0,1,0,1,0
28779,64975,445,0,0,70,70,0,1,0,1,0
28780,57034,44847,0,0,62,62,0,1,0,1,0
28781,60786,51505,0,0,62,62,0,1,0,1,0
28782,60153,445,0,0,70,70,0,1,0,1,0
28783,60151,445,0,0,70,70,0,1,0,1,0
28784,60150,445,0,0,70,70,0,1,0,1,0
28785,59365,42873,0,0,74,74,0,1,0,1,0
28786,22975,23,0,0,60,60,0,1,0,1,0
28787,60142,445,0,0,70,70,0,1,0,1,0
28788,60143,445,0,0,70,70,0,1,0,1,0
28789,24809,52700,0,0,66,66,0,1,0,1,0
28790,60388,445,0,0,66,66,0,1,0,1,0
28791,60387,445,0,0,66,66,0,1,0,1,0
28792,61430,37965,0,0,66,66,0,1,0,1,0
28793,45908,33330,0,0,60,60,0,1,0,1,0
28794,41744,37965,0,0,62,62,0,1,0,1,0
28795,62973,51505,0,0,62,62,0,1,0,1,0
28796,64969,445,0,0,70,70,0,1,0,1,0
28797,64967,445,0,0,70,70,0,1,0,1,0
28798,64965,445,0,0,70,70,0,1,0,1,0
28799,64964,445,0,0,70,70,0,1,0,1,0
28800,59043,35440,0,0,66,66,0,1,0,1,0
28801,13090,36237,0,0,62,62,0,1,0,1,0
28802,53143,50584,0,0,66,66,0,1,0,1,0
28803,11878,37807,0,0,146,146,0,1,0,1,0
28804,62824,37807,0,0,66,66,0,1,0,1,0
28805,14696,42707,0,0,62,62,0,1,0,1,0
28806,51830,42707,0,0,66,66,0,1,0,1,0
28807,60383,445,0,0,66,66,0,1,0,1,0
28808,60131,445,0,0,70,70,0,1,0,1,0
28809,50,64147,0,0,66,66,0,1,0,1,0
28810,60371,445,0,0,66,66,0,1,0,1,0
28811,60370,445,0,0,66,66,0,1,0,1,0
28812,60380,445,0,0,66,66,0,1,0,1,0
28813,60375,445,0,0,66,66,0,1,0,1,0
28814,60369,445,0,0,66,66,0,1,0,1,0
28815,60373,445,0,0,66,66,0,1,0,1,0
28816,60372,445,0,0,66,66,0,1,0,1,0
28817,58858,15503,0,0,66,66,0,1,0,1,0
28818,33405,37965,0,0,62,62,0,1,0,1,0
28819,53871,37965,0,0,66,66,0,1,0,1,0
28820,59210,50584,0,0,66,66,0,1,0,1,0
28821,64957,445,0,0,70,70,0,1,0,1,0
28822,59842,62413,0,0,66,66,0,1,0,1,0
28823,64953,445,0,0,70,70,0,1,0,1,0
28824,64952,445,0,0,70,70,0,1,0,1,0
28825,64949,445,0,0,70,70,0,1,0,1,0
28826,56582,23718,0,0,66,66,0,1,0,1,0
28827,50799,37807,0,0,66,66,0,1,0,1,0
28828,0,0,0,0,98,98,0,1,0,1,0
28829,0,0,0,0,98,98,0,1,0,1,0
28830,0,0,0,0,98,98,0,1,0,1,0
28831,0,0,0,0,98,98,0,1,0,1,0
28832,0,0,0,0,98,98,0,1,0,1,0
28833,0,0,0,0,98,98,0,1,0,1,0
28834,0,0,0,0,98,98,0,1,0,1,0
28835,0,0,0,0,244,244,0,2,0,2,0
28836,0,0,0,0,98,98,0,1,0,1,0
28837,0,0,0,0,156,156,0,2,0,2,0
28838,50135,50584,0,0,62,62,0,1,0,1,0
28839,8403,46824,0,0,62,62,0,1,0,1,0
28840,60127,445,0,0,70,70,0,1,0,1,0
28841,55862,62413,0,0,66,66,0,1,0,1,0
28842,11562,30188,0,0,62,62,0,1,0,1,0
28843,6289,44847,0,0,66,66,0,1,0,1,0
28844,60118,445,0,0,70,70,0,1,0,1,0
28845,60117,445,0,0,70,70,0,1,0,1,0
28846,60116,445,0,0,70,70,0,1,0,1,0
28847,60114,445,0,0,70,70,0,1,0,1,0
28848,56191,22114,0,0,62,62,0,1,0,1,0
28849,60110,445,0,0,70,70,0,1,0,1,0
28850,38306,51221,0,0,62,62,0,1,0,1,0
28851,64948,445,0,0,70,70,0,1,0,1,0
28852,64947,445,0,0,70,70,0,1,0,1,0
28853,64944,445,0,0,70,70,0,1,0,1,0
28854,58972,57866,0,0,62,62,0,1,0,1,0
28855,64368,22114,0,0,66,66,0,1,0,1,0
28856,60364,445,0,0,66,66,0,1,0,1,0
28857,64940,445,0,0,70,70,0,1,0,1,0
28858,60360,445,0,0,66,66,0,1,0,1,0
28859,24271,52700,0,0,66,66,0,1,0,1,0
28860,14183,26467,0,0,62,62,0,1,0,1,0
28861,60357,445,0,0,66,66,0,1,0,1,0
28862,60356,445,0,0,66,66,0,1,0,1,0
28863,1114,46824,0,0,62,62,0,1,0,1,0
28864,60355,445,0,0,66,66,0,1,0,1,0
28865,43578,15503,0,0,74,74,0,1,0,1,0
28866,46149,23,0,0,60,60,0,1,0,1,0
28867,17781,50265,0,0,62,62,0,1,0,1,0
28868,60105,445,0,0,70,70,0,1,0,1,0
28869,50424,55777,0,0,62,62,0,1,0,1,0
28870,64932,445,0,0,70,70,0,1,0,1,0
28871,14567,37965,0,0,62,62,0,1,0,1,0
28872,64927,445,0,0,70,70,0,1,0,1,0
28873,64926,445,0,0,70,70,0,1,0,1,0
28874,1873,37965,0,0,62,62,0,1,0,1,0
28875,64535,37965,0,0,66,66,0,1,0,1,0
28876,60097,445,0,0,70,70,0,1,0,1,0
28877,60094,445,0,0,70,70,0,1,0,1,0
28878,30315,57470,0,0,145,145,0,1,0,1,0
28879,32282,8604,0,0,66,66,0,1,0,1,0
28880,54886,443,54886,443,136775,6729,130046,181,18,82,99
28881,47111,80,20951,80,162355,7124,155231,207,27,96,111
28882,51988,32239,6773,32239,70,70,0,2,8,2,0
28883,53144,58987,40200,58987,70,70,0,1,5,1,0
28884,51827,443,46992,443,11946,8904,3042,42,42,26,16
28885,56419,80,4193,80,34098,808,33290,34,104,9,25
28886,54849,22448,0,0,66,66,0,1,90,1,0
28887,33569,443,7892,443,7418,1880,5538,28,396,9,19
28888,54644,443,54644,443,103968,5475,98493,141,18,63,78
28889,58765,443,24675,443,26158,17265,8893,57,19,31,26
28890,55670,31056,27603,31056,70,70,0,1,5,1,0
28891,56420,80,57757,80,34636,928,33708,37,104,11,26
28892,56413,80,48301,80,31432,748,30684,32,104,8,24
28893,56412,80,47207,80,34476,818,33658,35,104,9,26
28894,55921,53,30522,53,711,87,624,2,30,1,1
28895,56733,53,13870,53,170,87,83,2,30,1,1
28896,54470,443,54470,443,101021,6173,94848,142,18,65,77
28897,51990,42127,13506,42127,70,70,0,2,8,2,0
28898,47279,443,50478,443,7948,1520,6428,21,16,13,8
28899,44795,443,55624,443,9608,1958,7650,21,15,11,10
28900,56423,80,12556,80,33937,628,33309,31,104,6,25
28901,58790,443,27687,443,3558,2453,1105,17,15,9,8
28902,52479,443,9730,443,11052,4417,6635,19,137,10,9
28903,56561,443,49349,443,26334,2210,24124,49,66,22,27
28904,56025,53,63426,53,761,100,661,2,30,1,1
28905,65449,53,25371,53,170,87,83,2,31,1,1
28906,56417,80,64869,80,38188,688,37500,35,104,7,28
28907,59920,443,3699,443,7359,2050,5309,18,16,10,8
28908,44792,443,44086,443,9700,2137,7563,21,16,12,9
28909,62413,6881,56796,6881,311,311,0,3,1200,3,0
28910,55230,443,46201,443,42376115,1180708,41195407,45399,148,13976,31423
28911,54952,443,11665,443,61842,4466,57376,109,293,46,63
28912,49570,443,15727,443,8058,1806,6252,22,15,12,10
28913,56427,443,19838,443,9901,1298,8603,19,79,10,9
28914,58785,443,24870,443,11873,7787,4086,32,16,17,15
28915,58786,443,62467,443,13240,8717,4523,33,16,17,16
28916,56418,80,22380,80,39249,938,38311,40,104,11,29
28917,51956,36995,10789,36995,66,66,0,1,5,1,0
28918,56414,80,4969,80,33712,928,32784,36,104,11,25
28919,50436,443,10408,443,18959,3307,15652,33,19,16,17
28920,37420,443,37420,443,4624,1717,2907,19,27,11,8
28921,53245,443,26528,443,7705,2005,5700,26,120,13,13
28922,39496,80,39496,80,2898,1485,1413,10,15,6,4
28923,64145,53,55779,53,170,87,83,2,30,1,1
28924,53114,443,28454,443,3796,1523,2273,20,135,10,10
28925,64742,443,6500,443,6372,1582,4790,32,195,15,17
28926,45913,443,64072,443,4046,967,3079,13,27,7,6
28927,56416,80,36682,80,33755,928,32827,36,104,11,25
28928,56421,80,51921,80,34300,868,33432,35,104,10,25
28929,56422,80,3635,80,35833,938,34895,37,104,11,26
28930,56411,80,44029,80,35574,868,34706,36,104,10,26
28931,56415,80,5751,80,38339,808,37531,37,104,9,28
28932,50734,80,62871,80,3498,2696,802,9,26,5,4
28933,55660,42459,61425,42459,1717,1129,588,17,25,10,7
28934,1319,443,12846,443,448,256,192,8,25,5,3
28935,56368,53,19422,53,817,98,719,2,30,1,1
28936,55548,53,25199,53,194,99,95,2,30,1,1
28937,65048,443,9174,443,3283,1019,2264,10,120,5,5
28938,40151,5228,21276,5228,19172,3089,16083,43,3601,20,23
28939,60342,445,0,0,66,66,0,1,0,1,0
28940,6666,80,0,0,60,60,0,1,0,1,0
28941,27368,22114,0,0,146,146,0,1,0,1,0
28942,40308,67,0,0,60,60,0,1,0,1,0
28943,19634,64147,0,0,62,62,0,1,0,1,0
28944,50949,45960,0,0,62,62,0,1,0,1,0
28945,16376,35440,0,0,146,146,0,1,0,1,0
28946,32704,46824,0,0,66,66,0,1,0,1,0
28947,57339,57470,0,0,66,66,0,1,0,1,0
28948,36453,23,0,0,60,60,0,1,0,1,0
28949,60091,445,0,0,70,70,0,1,0,1,0
28950,33886,39127,0,0,162,162,0,1,0,1,0
28951,60089,445,0,0,70,70,0,1,0,1,0
28952,60335,445,0,0,66,66,0,1,0,1,0
28953,64914,445,0,0,70,70,0,1,0,1,0
28954,6666,138,0,0,60,60,0,1,0,1,0
28955,12969,55777,0,0,66,66,0,1,0,1,0
28956,58359,64147,0,0,72,72,0,1,0,1,0
28957,65024,53,8030,53,295,101,194,4,33,2,2
28958,55678,52879,10322,52879,70,70,0,2,8,2,0
28959,57456,443,23040,443,1857,1218,639,18,119,11,7
28960,40182,443,51089,443,6865,1958,4907,21,16,13,8
28961,49262,80,49262,80,515211,10976,504235,506,49,169,337
28962,63938,26204,59342,26204,70,70,0,1,4,1,0
28963,46408,443,13228,443,15452,3787,11665,36,62,19,17
28964,53006,443,3727,443,2651,1504,1147,24,68,13,11
28965,56405,443,6737,443,12470,1570,10900,21,125,10,11
28966,56408,443,36804,443,17704,1456,16248,25,123,11,14
28967,56713,443,15450,443,8006,1986,6020,20,15,11,9
28968,60716,443,33650,443,6898,2843,4055,21,17,11,10
28969,58797,443,17991,443,5167,700,4467,16,15,7,9
28970,50299,443,56417,443,86,86,0,1,4,1,0
28971,63932,63241,5696,63241,436,254,182,7,15,4,3
28972,51959,42269,61621,42269,70,70,0,1,4,1,0
28973,51958,51322,1745,51322,70,70,0,1,4,1,0
28974,55589,53,33223,53,177,94,83,2,29,1,1
28975,33857,123,20930,123,184,94,90,2,30,1,1
28976,64634,53,6012,53,211,102,109,2,29,1,1
28977,51441,443,56551,443,642,582,60,2,15,1,1
28978,53142,47933,51357,47933,698,320,378,10,17,6,4
28979,57226,53,37479,53,178,94,84,2,30,1,1
28980,59823,443,6570,443,27406,15466,11940,123,188,62,61
28981,58788,443,39752,443,5166,700,4466,16,15,7,9
28982,37587,443,9282,443,6912,1841,5071,33,27,17,16
28983,58794,443,62373,443,5166,700,4466,16,15,7,9
28984,60713,443,57689,443,6287,1742,4545,17,19,10,7
28985,35001,53,37388,53,78,78,0,1,30,1,0
28986,56648,80,59981,80,234,234,0,4,12,4,0
28987,55677,16588,61905,16588,70,70,0,2,8,2,0
28988,51955,39871,39902,39871,70,70,0,1,5,1,0
28989,51952,50967,20758,50967,70,70,0,1,5,1,0
28990,52126,443,32440,443,12096,3734,8362,53,102,25,28
28991,37739,443,17741,443,138037,13843,124194,197,206,94,103
28992,64145,53,59140,53,177,94,83,2,30,1,1
28993,59049,53,37929,53,199,94,105,2,30,1,1
28994,61838,443,61838,443,36811,5190,31621,60,150,24,36
28995,56887,53,15011,53,312,94,218,2,30,1,1
28996,60184,443,52371,443,26293,7740,18553,55,121,26,29
28997,65449,53,31955,53,177,94,83,2,30,1,1
28998,33070,80,34842,80,3483,1578,1905,17,186,10,7
28999,56733,53,1965,53,177,94,83,2,30,1,1
29000,15503,19168,41378,19168,481,150,331,2,1200,1,1
29001,64161,53,62669,53,261,102,159,2,30,1,1
29002,52310,53,0,0,247,76,171,2,30,1,1
29003,49987,443,39263,443,426,180,246,8,21,4,4
29004,51985,38904,27850,38904,70,70,0,2,8,2,0
29005,51987,23136,59906,23136,70,70,0,2,8,2,0
29006,33830,443,43990,443,448,78,370,6,25,1,5
29007,52090,443,7071,443,6383,5237,1146,19,16,11,8
29008,58791,443,11218,443,5167,700,4467,16,15,7,9
29009,37736,443,40675,443,498507,26210,472297,544,207,200,344
29010,55545,53,1793,53,821,102,719,2,30,1,1
29011,56712,443,63256,443,8058,2038,6020,20,15,11,9
29012,39426,443,8694,443,903603,21528,882075,858,57,234,624
29013,34454,80,32778,80,1638,1324,314,10,14,5,5
29014,43693,443,24547,443,6389,1439,4950,22,18,11,11
29015,56406,443,10804,443,8328,1391,6937,18,123,10,8
29016,41850,443,17792,443,6714,1515,5199,23,196,13,10
29017,57887,443,20597,443,6938,1531,5407,23,195,13,10
29018,51715,80,53478,80,3309,2152,1157,18,150,10,8
29019,50617,80,45162,80,1658,1247,411,8,14,5,3
29020,51985,80,53937,80,14233438,253696,13979742,12752,54,3515,9237
29021,51998,1877,49263,1877,316,136,180,6,6,3,3
29022,63931,53,21564,53,380,105,275,4,35,2,2
29023,55548,53,43983,53,197,102,95,2,33,1,1
29024,49638,53,28303,53,331,88,243,4,32,2,2
29025,51992,22670,60663,22670,70,70,0,2,7,2,0
29026,53760,45682,20604,45682,70,70,0,1,4,1,0
29027,55545,53,34965,53,196,100,96,3,33,2,1
29028,58793,443,26304,443,5167,700,4467,16,15,7,9
29029,53762,9587,5160,9587,70,70,0,1,4,1,0
29030,37738,443,40273,443,296068,21814,274254,358,206,150,208
29031,64456,53,28818,53,341,110,231,2,29,1,1
29032,55913,53,19739,53,177,94,83,2,30,1,1
29033,65449,53,22193,53,177,94,83,2,30,1,1
29034,64509,53,38948,53,385,134,251,2,30,1,1
29035,56733,53,65238,53,177,94,83,2,30,1,1
29036,41126,53,30186,53,199,94,105,2,30,1,1
29037,64657,53,12172,53,312,94,218,2,30,1,1
29038,50362,53,19652,53,177,94,83,2,30,1,1
29039,33255,53,27087,53,86,86,0,1,30,1,0
29040,55796,53,34450,53,214,94,120,2,30,1,1
29041,56020,53,46192,53,199,102,97,2,30,1,1
29042,46026,443,9317,443,8908,3897,5011,19,135,9,10
29043,49342,53,61829,53,402,118,284,2,30,1,1
29044,33071,443,36886,443,4234,2185,2049,36,1099,16,20
29045,42604,443,37985,443,3243,2026,1217,16,15,8,8
29046,51993,55279,27826,55279,316,136,180,6,7,3,3
29047,51989,29736,40433,29736,258,70,188,4,8,2,2
29048,51954,12380,41427,12380,70,70,0,1,5,1,0
29049,39918,443,58004,443,7542,1235,6307,23,15,12,11
29050,57226,53,25603,53,178,94,84,2,30,1,1
29051,41267,8245,14045,8245,280,214,66,2,30,1,1
29052,49761,53,37619,53,382,94,288,2,30,1,1
29053,22539,53,19206,53,86,86,0,1,30,1,0
29054,49396,80,45610,80,13738839,196158,13542681,11272,248,2231,9041
29055,63928,61494,31292,61494,1691,446,1245,10,15,7,3
29056,65418,53,5528,53,197,94,103,2,30,1,1
29057,37757,53,12221,53,86,86,0,1,30,1,0
29058,38496,5228,27256,5228,3397,1506,1891,26,640,8,18
29059,33684,443,39270,443,6829,1261,5568,21,197,11,10
29060,51986,41982,47346,41982,70,70,0,2,8,2,0
29061,56711,443,47786,443,8005,1985,6020,20,15,11,9
29062,49321,53,65339,53,225,102,123,2,30,1,1
29063,37737,443,61948,443,190013,14784,175229,238,206,101,137
29064,55526,53,8264,53,250,86,164,2,30,1,1
29065,55815,443,3642,443,8602,1050,7552,16,120,7,9
29066,43275,443,50486,443,9093,4719,4374,52,310,24,28
29067,55207,443,50638,443,1803,1029,774,16,185,9,7
29068,54159,443,5303,443,10945,2478,8467,39,18,19,20
29069,65449,53,26123,53,315,87,228,4,40,2,2
29070,52635,443,48519,443,8993,5205,3788,48,167,25,23
29071,42601,443,52311,443,3238,2021,1217,16,16,8,8
29072,43288,443,20649,443,11123,2634,8489,22,121,10,12
29073,53756,61137,24650,61137,672,306,366,11,16,5,6
29074,55025,443,11622,443,7599,3113,4486,30,20,17,13
29075,53771,64351,44787,64351,70,70,0,2,8,2,0
29076,57069,53,3710,53,177,94,83,2,30,1,1
29077,57069,53,52685,53,177,94,83,2,31,1,1
29078,1903,43890,0,0,66,66,0,1,0,1,0
29079,53906,44512,0,0,62,62,0,1,0,1,0
29080,56462,37965,0,0,66,66,0,1,0,1,0
29081,60085,445,0,0,70,70,0,1,0,1,0
29082,8313,51505,0,0,62,62,0,1,0,1,0
29083,51346,51221,0,0,70,70,0,1,0,1,0
29084,60332,445,0,0,66,66,0,1,0,1,0
29085,56005,64147,0,0,62,62,0,1,0,1,0
29086,63079,64147,0,0,66,66,0,1,0,1,0
29087,60297,25604,0,0,62,62,0,1,0,1,0
29088,60083,445,0,0,70,70,0,1,0,1,0
29089,54305,39004,0,0,62,62,0,1,0,1,0
29090,55450,64147,0,0,66,66,0,1,0,1,0
29091,60324,445,0,0,66,66,0,1,0,1,0
29092,27402,37628,0,0,62,62,0,1,0,1,0
29093,60316,445,0,0,66,66,0,1,0,1,0
29094,37911,443,2261,443,466,392,74,4,0,3,1
29095,7664,2149,0,0,66,66,0,1,0,1,0
29096,60079,445,0,0,70,70,0,1,0,1,0
29097,48706,23393,0,0,60,60,0,1,0,1,0
29098,20012,444,0,0,60,60,0,1,0,1,0
29099,6666,6001,0,0,60,60,0,1,0,1,0
29100,24768,22114,0,0,146,146,0,1,0,1,0
29101,64903,445,0,0,70,70,0,1,0,1,0
29102,64901,445,0,0,70,70,0,1,0,1,0
29103,64900,445,0,0,70,70,0,1,0,1,0
29104,60310,445,0,0,66,66,0,1,0,1,0
29105,60308,445,0,0,66,66,0,1,0,1,0
29106,60304,445,0,0,66,66,0,1,0,1,0
29107,60306,445,0,0,66,66,0,1,0,1,0
29108,60309,445,0,0,66,66,0,1,0,1,0
29109,60307,445,0,0,66,66,0,1,0,1,0
29110,60303,445,0,0,66,66,0,1,0,1,0
29111,60302,445,0,0,66,66,0,1,0,1,0
29112,61078,57470,0,0,145,145,0,1,0,1,0
29113,60066,445,0,0,70,70,0,1,0,1,0
29114,28878,51505,0,0,62,62,0,1,0,1,0
29115,54276,37628,0,0,66,66,0,1,0,1,0
29116,40512,57470,0,0,74,74,0,1,0,1,0
29117,60063,445,0,0,70,70,0,1,0,1,0
29118,64891,445,0,0,70,70,0,1,0,1,0
29119,64890,445,0,0,70,70,0,1,0,1,0
29120,64886,445,0,0,70,70,0,1,0,1,0
29121,64883,445,0,0,70,70,0,1,0,1,0
29122,33098,443,16704,443,466,392,74,4,0,3,1
29123,28413,64147,0,0,62,62,0,1,0,1,0
29124,60288,445,0,0,66,66,0,1,0,1,0
29125,60290,445,0,0,66,66,0,1,0,1,0
29126,60287,445,0,0,66,66,0,1,0,1,0
29127,60058,445,0,0,70,70,0,1,0,1,0
29128,60057,445,0,0,70,70,0,1,0,1,0
29129,64880,445,0,0,70,70,0,1,0,1,0
29130,60055,445,0,0,70,70,0,1,0,1,0
29131,50245,44847,0,0,62,62,0,1,0,1,0
29132,64877,445,0,0,70,70,0,1,0,1,0
29133,64872,445,0,0,70,70,0,1,0,1,0
29134,64874,445,0,0,70,70,0,1,0,1,0
29135,64346,51505,0,0,66,66,0,1,0,1,0
29136,55111,39004,0,0,66,66,0,1,0,1,0
29137,57173,44847,0,0,62,62,0,1,0,1,0
29138,13840,37965,0,0,146,146,0,1,0,1,0
29139,41648,56205,0,0,66,66,0,1,0,1,0
29140,59618,46824,0,0,66,66,0,1,0,1,0
29141,1114,46824,0,0,62,62,0,1,0,1,0
29142,64626,50584,0,0,66,66,0,1,0,1,0
29143,443,28215,0,0,60,60,0,1,0,1,0
29144,24110,23,0,0,60,60,0,1,0,1,0
29145,60048,445,0,0,70,70,0,1,0,1,0
29146,60046,445,0,0,70,70,0,1,0,1,0
29147,64862,445,0,0,70,70,0,1,0,1,0
29148,64860,445,0,0,70,70,0,1,0,1,0
29149,64857,445,0,0,70,70,0,1,0,1,0
29150,20830,1433,0,0,60,60,0,1,0,1,0
29151,59365,42873,0,0,74,74,0,1,0,1,0
29152,29080,50265,0,0,62,62,0,1,0,1,0
29153,52094,22114,0,0,146,146,0,1,0,1,0
29154,60045,445,0,0,70,70,0,1,0,1,0
29155,60276,445,0,0,66,66,0,1,0,1,0
29156,60044,445,0,0,70,70,0,1,0,1,0
29157,58475,11392,0,0,66,66,0,1,0,1,0
29158,30580,50265,0,0,66,66,0,1,0,1,0
29159,60043,445,0,0,70,70,0,1,0,1,0
29160,60038,445,0,0,70,70,0,1,0,1,0
29161,60037,445,0,0,70,70,0,1,0,1,0
29162,45682,25604,0,0,62,62,0,1,0,1,0
29163,43063,57470,0,0,62,62,0,1,0,1,0
29164,47910,7454,0,0,60,60,0,1,0,1,0
29165,21750,39004,0,0,62,62,0,1,0,1,0
29166,3068,36237,0,0,62,62,0,1,0,1,0
29167,59763,25604,0,0,66,66,0,1,0,1,0
29168,56386,50584,0,0,66,66,0,1,0,1,0
29169,60025,445,0,0,70,70,0,1,0,1,0
29170,60024,445,0,0,70,70,0,1,0,1,0
29171,60018,445,0,0,70,70,0,1,0,1,0
29172,20864,51221,0,0,62,62,0,1,0,1,0
29173,64853,445,0,0,70,70,0,1,0,1,0
29174,64847,445,0,0,70,70,0,1,0,1,0
29175,58791,30188,0,0,146,146,0,1,0,1,0
29176,60015,445,0,0,70,70,0,1,0,1,0
29177,60014,445,0,0,70,70,0,1,0,1,0
29178,56035,1310,0,0,62,62,0,1,0,1,0
29179,58021,17,0,0,60,60,0,1,0,1,0
29180,60761,51221,0,0,66,66,0,1,0,1,0
29181,60263,445,0,0,66,66,0,1,0,1,0
29182,60260,445,0,0,66,66,0,1,0,1,0
29183,58687,11392,0,0,66,66,0,1,0,1,0
29184,30602,36237,0,0,146,146,0,1,0,1,0
29185,13285,29892,0,0,145,145,0,1,0,1,0
29186,0,0,0,0,185,185,0,1,0,1,0
29187,64844,445,0,0,70,70,0,1,0,1,0
29188,60003,445,0,0,70,70,0,1,0,1,0
29189,64839,445,0,0,70,70,0,1,0,1,0
29190,64838,445,0,0,70,70,0,1,0,1,0
29191,64837,445,0,0,70,70,0,1,0,1,0
29192,36679,443,65477,443,466,392,74,4,0,3,1
29193,1045,36237,0,0,66,66,0,1,0,1,0
29194,60257,445,0,0,66,66,0,1,0,1,0
29195,60249,445,0,0,66,66,0,1,0,1,0
29196,60251,445,0,0,66,66,0,1,0,1,0
29197,60240,445,0,0,66,66,0,1,0,1,0
29198,60245,445,0,0,66,66,0,1,0,1,0
29199,60246,445,0,0,66,66,0,1,0,1,0
29200,60241,445,0,0,66,66,0,1,0,1,0
29201,60239,445,0,0,66,66,0,1,0,1,0
29202,28370,23,0,0,60,60,0,1,0,1,0
29203,65166,62413,0,0,62,62,0,1,0,1,0
29204,80,63761,0,0,66,66,0,1,0,1,0
29205,64827,445,0,0,70,70,0,1,0,1,0
29206,63461,51505,0,0,66,66,0,1,0,1,0
29207,59999,445,0,0,70,70,0,1,0,1,0
29208,64825,445,0,0,70,70,0,1,0,1,0
29209,64823,445,0,0,70,70,0,1,0,1,0
29210,64821,445,0,0,70,70,0,1,0,1,0
29211,45238,44847,0,0,62,62,0,1,0,1,0
29212,16630,44847,0,0,62,62,0,1,0,1,0
29213,34400,39004,0,0,74,74,0,1,0,1,0
29214,16630,44847,0,0,146,146,0,1,0,1,0
29215,59989,445,0,0,70,70,0,1,0,1,0
29216,59987,445,0,0,70,70,0,1,0,1,0
29217,59990,445,0,0,70,70,0,1,0,1,0
29218,59985,445,0,0,70,70,0,1,0,1,0
29219,51731,57470,0,0,78,78,0,1,0,1,0
29220,443,10010,0,0,60,60,0,1,0,1,0
29221,1091,37965,0,0,62,62,0,1,0,1,0
29222,49276,51505,0,0,66,66,0,1,0,1,0
29223,59982,445,0,0,70,70,0,1,0,1,0
29224,56255,44847,0,0,66,66,0,1,0,1,0
29225,64819,445,0,0,70,70,0,1,0,1,0
29226,64818,445,0,0,70,70,0,1,0,1,0
29227,64817,445,0,0,70,70,0,1,0,1,0
29228,2636,11392,0,0,66,66,0,1,0,1,0
29229,60232,445,0,0,66,66,0,1,0,1,0
29230,57302,62413,0,0,66,66,0,1,0,1,0
29231,64812,445,0,0,70,70,0,1,0,1,0
29232,52348,62413,0,0,66,66,0,1,0,1,0
29233,60228,445,0,0,66,66,0,1,0,1,0
29234,60226,445,0,0,66,66,0,1,0,1,0
29235,42366,57470,0,0,66,66,0,1,0,1,0
29236,51148,443,4211,443,4942,2409,2533,11,120,6,5
29237,56450,53,26592,53,170,87,83,2,30,1,1
29238,58907,80,55384,80,694,350,344,11,28,6,5
29239,61129,443,47713,443,3854,1233,2621,19,120,9,10
29240,4651,443,4651,443,14579,1280,13299,25,16,9,16
29241,55101,53,3206,53,711,87,624,2,30,1,1
29242,50820,53,0,0,371,77,294,2,30,1,1
29243,59283,80,59283,80,72354,14398,57956,123,15,40,83
29244,58775,443,62135,443,9017,5865,3152,26,16,14,12
29245,55671,53,32686,53,98,98,0,1,30,1,0
29246,50224,443,62141,443,9530,2104,7426,18,121,9,9
29247,49510,443,40862,443,9571,3757,5814,48,221,26,22
29248,56734,53,17479,53,751,95,656,2,30,1,1
29249,58781,443,48906,443,6673,4335,2338,22,16,11,11
29250,53772,14132,16590,14132,70,70,0,2,8,2,0
29251,54326,7000,54326,7000,2958,1567,1391,15,15,8,7
29252,6881,30279,63096,30279,150,150,0,1,1200,1,0
29253,64477,3478,36622,3478,189,79,110,2,301,1,1
29254,50110,53,49491,53,172,88,84,2,31,1,1
29255,51950,17499,60701,17499,66,66,0,1,5,1,0
29256,59282,80,59282,80,181627,17128,164499,277,15,79,198
29257,55531,53,64298,53,216,110,106,2,30,1,1
29258,58777,443,42281,443,2577,1550,1027,15,16,7,8
29259,53263,443,15903,443,14269,5761,8508,43,18,23,20
29260,58764,443,5482,443,21960,14378,7582,49,18,26,23
29261,53257,443,51156,443,8715,1814,6901,26,29,15,11
29262,48513,443,48513,443,4566,1659,2907,19,27,11,8
29263,59281,80,59281,80,108922,4633,104289,194,16,66,128
29264,58012,53,0,0,82,82,0,1,30,1,0
29265,56997,53,59115,53,711,87,624,2,30,1,1
29266,55711,53,2553,53,728,96,632,2,30,1,1
29267,64763,53,29524,53,728,96,632,2,30,1,1
29268,38634,443,57626,443,9398,4241,5157,22,135,11,11
29269,58782,443,19890,443,5397,3496,1901,20,16,10,10
29270,65024,53,40250,53,198,101,97,2,32,1,1
29271,51991,56980,61136,56980,316,136,180,6,7,3,3
29272,58768,443,60756,443,18568,12357,6211,43,18,24,19
29273,53778,6881,23099,6881,70,70,0,2,8,2,0
29274,51409,443,64493,443,36713,3193,33520,57,623,23,34
29275,54325,7000,54325,7000,755529,16895,738634,785,16,264,521
29276,5416,53,5416,53,213,79,134,2,33,1,1
29277,60342,7000,60342,7000,3114,1659,1455,17,15,9,8
29278,61504,443,15507,443,16708,2331,14377,31,21,14,17
29279,52150,443,44913,443,5481,3086,2395,26,49,13,13
29280,58936,443,47053,443,9081,3368,5713,42,76,24,18
29281,59279,80,59279,80,108786,4563,104223,192,16,65,127
29282,50466,53,25118,53,295,101,194,4,30,2,2
29283,55330,53,46578,53,188,96,92,2,30,1,1
29284,55720,443,32771,443,2494,719,1775,9,120,5,4
29285,55531,53,31789,53,216,110,106,2,30,1,1
29286,58776,443,47713,443,3991,2587,1404,17,16,9,8
29287,57238,53,18077,53,701,88,613,2,31,1,1
29288,55850,53,22849,53,711,87,624,2,31,1,1
29289,55655,53,43785,53,754,94,660,2,31,1,1
29290,58906,80,61612,80,742,350,392,12,28,6,6
29291,64788,53,8538,53,749,94,655,2,31,1,1
29292,57143,53,34750,53,184,94,90,2,31,1,1
29293,49454,53,56383,53,762,97,665,2,31,1,1
29294,36657,443,2188,443,10985,3186,7799,29,204,14,15
29295,61349,443,14011,443,1786,172,1614,7,120,3,4
29296,47966,443,16155,443,10895,2151,8744,26,362,11,15
29297,34357,443,37129,443,17372,10352,7020,91,422,52,39
29298,51221,51413,63036,51413,459,149,310,2,1200,1,1
29299,10151,34592,23117,34592,480,149,331,2,1200,1,1
29300,35051,53,35051,53,194,87,107,2,31,1,1
29301,55705,53,6400,53,281,101,180,4,60,2,2
29302,64792,53,58723,53,768,99,669,2,31,1,1
29303,56612,53,23653,53,172,88,84,2,31,1,1
29304,60435,443,42755,443,38888447,473172,38415275,31568,128,5708,25860
29305,33877,53,33877,53,643,88,555,2,31,1,1
29306,57470,62314,37389,62314,1188,1188,0,19,2338,19,0
29307,49160,16919,59131,16919,868,150,718,4,1200,2,2
29308,51382,56205,0,0,62,62,0,1,0,1,0
29309,59977,445,0,0,70,70,0,1,0,1,0
29310,60224,445,0,0,66,66,0,1,0,1,0
29311,57555,35440,0,0,66,66,0,1,0,1,0
29312,16013,35253,0,0,66,66,0,1,0,1,0
29313,2464,50584,0,0,62,62,0,1,0,1,0
29314,57940,24748,0,0,148,148,0,1,0,1,0
29315,49514,39127,0,0,162,162,0,1,0,1,0
29316,64804,445,0,0,70,70,0,1,0,1,0
29317,59969,445,0,0,70,70,0,1,0,1,0
29318,1912,48817,0,0,62,62,0,1,0,1,0
29319,64797,445,0,0,70,70,0,1,0,1,0
29320,64795,445,0,0,70,70,0,1,0,1,0
29321,59967,445,0,0,70,70,0,1,0,1,0
29322,7347,56205,0,0,66,66,0,1,0,1,0
29323,54866,37965,0,0,62,62,0,1,0,1,0
29324,10480,26467,0,0,62,62,0,1,0,1,0
29325,42717,5900,0,0,60,60,0,1,0,1,0
29326,37607,443,8291,443,499,425,74,4,0,3,1
29327,37609,443,19871,443,499,425,74,4,0,3,1
29328,37610,443,1253,443,499,425,74,4,0,3,1
29329,37612,443,15502,443,499,425,74,4,0,3,1
29330,37611,443,44824,443,499,425,74,4,0,3,1
29331,37608,443,17459,443,499,425,74,4,0,3,1
29332,60214,445,0,0,66,66,0,1,0,1,0
29333,62348,48817,0,0,145,145,0,1,0,1,0
29334,56250,36237,0,0,66,66,0,1,0,1,0
29335,59962,445,0,0,70,70,0,1,0,1,0
29336,59961,445,0,0,70,70,0,1,0,1,0
29337,2572,35440,0,0,66,66,0,1,0,1,0
29338,56638,64147,0,0,62,62,0,1,0,1,0
29339,51429,22114,0,0,62,62,0,1,0,1,0
29340,60206,445,0,0,66,66,0,1,0,1,0
29341,64785,445,0,0,70,70,0,1,0,1,0
29342,15978,50584,0,0,146,146,0,1,0,1,0
29343,59957,445,0,0,70,70,0,1,0,1,0
29344,47201,44847,0,0,66,66,0,1,0,1,0
29345,59956,445,0,0,70,70,0,1,0,1,0
29346,3830,26467,0,0,66,66,0,1,0,1,0
29347,52184,22114,0,0,66,66,0,1,0,1,0
29348,60204,445,0,0,66,66,0,1,0,1,0
29349,65012,32468,0,0,66,66,0,1,0,1,0
29350,28136,443,42266,443,8805,3429,5376,33,475,16,17
29351,50466,53,28614,53,199,102,97,2,30,1,1
29352,62062,443,21250,443,134,60,74,3,5,2,1
29353,55026,443,23738,443,11413,6823,4590,34,18,19,15
29354,49493,53,48045,53,241,118,123,2,30,1,1
29355,62043,80,35524,80,3466,665,2801,14,16,7,7
29356,40244,443,63008,443,21525,15159,6366,43,315,25,18
29357,56199,53,11587,53,79,79,0,2,33,2,0
29358,53777,62955,35330,62955,70,70,0,2,7,2,0
29359,57436,66,1487,66,70,70,0,1,4,1,0
29360,56832,53,34537,53,214,102,112,2,29,1,1
29361,64747,53,39095,53,216,94,122,2,29,1,1
29362,65082,53,4469,53,718,94,624,2,29,1,1
29363,56312,53,57178,53,214,102,112,2,29,1,1
29364,55330,53,28011,53,194,102,92,2,29,1,1
29365,55126,53,7380,53,177,94,83,2,30,1,1
29366,64374,53,21299,53,194,94,100,2,30,1,1
29367,62961,53,49359,53,209,102,107,2,30,1,1
29368,52932,443,50755,443,3032,1082,1950,9,120,5,4
29369,46883,443,30067,443,40443,5300,35143,88,134,38,50
29370,42600,443,64399,443,3137,1986,1151,15,15,8,7
29371,63907,54218,37939,54218,696,452,244,11,21,7,4
29372,56450,53,63813,53,177,94,83,2,30,1,1
29373,55126,53,57162,53,177,94,83,2,30,1,1
29374,48745,443,43215,443,229628,10653,218975,263,49,103,160
29375,38000,443,20816,443,13123,6654,6469,29,135,15,14
29376,51982,56306,48759,56306,70,70,0,2,8,2,0
29377,51179,53,60232,53,86,86,0,1,30,1,0
29378,57646,443,57646,443,4492,1585,2907,19,30,11,8
29379,56361,53,48019,53,816,102,714,2,30,1,1
29380,56707,443,22633,443,8005,1985,6020,20,15,11,9
29381,36498,80,36498,80,161054,3432,157622,140,158,24,116
29382,51983,30472,23592,30472,70,70,0,2,8,2,0
29383,51951,65387,33774,65387,70,70,0,1,5,1,0
29384,58780,443,38511,443,5971,706,5265,17,15,7,10
29385,56101,53,11714,53,194,102,92,2,30,1,1
29386,56708,443,4344,443,8059,2039,6020,20,15,11,9
29387,49183,53,38350,53,177,94,83,2,30,1,1
29388,64937,53,49091,53,94,94,0,1,30,1,0
29389,53496,3389,53496,3389,3624,1910,1714,19,33,11,8
29390,54429,53,0,0,195,70,125,2,30,1,1
29391,56450,53,31149,53,177,94,83,2,30,1,1
29392,45939,5228,13443,5228,7528,1416,6112,29,811,11,18
29393,64172,53,37844,53,197,102,95,2,33,1,1
29394,56969,443,46839,443,6431,1792,4639,22,80,13,9
29395,35568,443,33534,443,5383,3710,1673,27,309,14,13
29396,53753,46790,44362,46790,492,306,186,8,15,5,3
29397,64729,53,36616,53,262,94,168,2,30,1,1
29398,33421,443,28800,443,9917,3184,6733,30,91,12,18
29399,56986,53,20950,53,259,87,172,4,37,2,2
29400,53249,443,22744,443,12082,5745,6337,32,61,16,16
29401,9203,443,1918,443,318,192,126,6,17,4,2
29402,43666,443,10694,443,13212,9431,3781,41,238,21,20
29403,50466,53,34951,53,199,102,97,2,30,1,1
29404,34998,443,4497,443,9114,2208,6906,36,120,19,17
29405,49266,53,11642,53,330,97,233,4,33,2,2
29406,53773,15459,13024,15459,70,70,0,2,7,2,0
29407,56710,443,25252,443,8057,2037,6020,20,15,11,9
29408,54820,443,53134,443,16366,4160,12206,41,55,20,21
29409,52636,443,34549,443,1309,670,639,16,166,9,7
29410,35913,443,5129,443,14329,8250,6079,26,22,16,10
29411,35804,443,35654,443,232,172,60,3,5,2,1
29412,48541,80,51953,80,812,672,140,6,28,4,2
29413,37339,443,37972,443,130,70,60,3,5,2,1
29414,53265,443,57484,443,4995,1414,3581,21,15,12,9
29415,44236,80,40314,80,2982,2565,417,12,15,7,5
29416,55671,53,40091,53,196,102,94,2,33,1,1
29417,53752,35446,60472,35446,492,306,186,8,15,5,3
29418,37907,443,63465,443,9227,2999,6228,64,616,35,29
29419,60781,40010,23139,40010,316,136,180,6,5,3,3
29420,39774,443,8618,443,69542,11991,57551,139,157,60,79
29421,53776,37650,27111,37650,70,70,0,2,7,2,0
29422,58783,443,56867,443,5166,700,4466,16,15,7,9
29423,41246,443,49001,443,78,78,0,1,5,1,0
29424,63823,51558,31200,51558,1518,1396,122,12,45,10,2
29425,32970,443,36092,443,8910,2660,6250,24,18,13,11
29426,64981,53,62988,53,214,102,112,2,29,1,1
29427,56733,53,5825,53,177,94,83,2,29,1,1
29428,50336,53,8935,53,102,102,0,1,30,1,0
29429,58856,443,44646,443,4552,2750,1802,27,95,15,12
29430,51877,53,28972,53,254,78,176,2,29,1,1
29431,48606,443,28779,443,4160,2675,1485,25,95,14,11
29432,49668,53,14674,53,214,102,112,2,29,1,1
29433,55531,53,2010,53,322,110,212,4,30,2,2
29434,64192,53,23253,53,308,110,198,2,29,1,1
29435,56446,443,39205,443,15813,5998,9815,30,120,14,16
29436,49183,53,55748,53,177,94,83,2,30,1,1
29437,57772,443,4338,443,6783,3270,3513,22,120,11,11
29438,65510,53,46580,53,229,102,127,2,30,1,1
29439,37965,61282,39357,61282,402,132,270,6,1208,3,3
29440,55531,53,46307,53,216,110,106,2,30,1,1
29441,60985,443,15568,443,30399,22692,7707,57,144,31,26
29442,54870,443,33932,443,424,210,214,7,131,4,3
29443,39004,443,10788,443,38459,27564,10895,97,189,49,48
29444,58779,443,44782,443,5166,700,4466,16,15,7,9
29445,55067,443,38448,443,3136,2025,1111,19,26,10,9
29446,64000,53,28661,53,241,102,139,2,30,1,1
29447,50252,53,45062,53,173,94,79,2,30,1,1
29448,49981,53,44663,53,360,102,258,2,30,1,1
29449,49688,53,10693,53,782,110,672,2,30,1,1
29450,56273,53,37875,53,330,126,204,2,30,1,1
29451,50010,53,28513,53,330,126,204,2,31,1,1
29452,56177,53,3037,53,807,94,713,2,31,1,1
29453,49812,53,26847,53,193,102,91,2,31,1,1
29454,39009,443,34628,443,12197,2338,9859,34,122,14,20
29455,49948,53,31894,53,755,102,653,2,30,1,1
29456,65049,53,34852,53,199,102,97,2,30,1,1
29457,56709,443,54114,443,8007,1987,6020,20,15,11,9
29458,51984,54606,5412,54606,70,70,0,2,8,2,0
29459,60287,80,59923,80,10135,7433,2702,28,164,19,9
29460,49328,53,46932,53,748,94,654,2,30,1,1
29461,50110,53,63137,53,178,94,84,2,30,1,1
29462,2890,53,28510,53,78,78,0,1,30,1,0
29463,56361,53,14867,53,193,102,91,2,30,1,1
29464,57019,53,54333,53,193,102,91,2,30,1,1
29465,1934,53,51604,53,210,78,132,2,30,1,1
29466,49896,53,58946,53,772,102,670,2,30,1,1
29467,57241,53,26543,53,224,102,122,2,30,1,1
29468,50466,53,18896,53,199,102,97,2,30,1,1
29469,56628,80,40916,80,1359,435,924,13,30,7,6
29470,58784,443,22318,443,5168,700,4468,16,15,7,9
29471,58787,443,18932,443,5107,700,4407,15,15,7,8
29472,49190,443,44351,443,568536,16389,552147,598,19,224,374
29473,51999,34619,15741,34619,70,70,0,1,5,1,0
29474,60286,80,21753,80,5836,2829,3007,19,164,14,5
29475,64226,53,55510,53,211,102,109,2,30,1,1
29476,56101,53,64581,53,194,102,92,2,30,1,1
29477,65206,53,13449,53,330,118,212,2,30,1,1
29478,42819,443,36580,443,10837,3411,7426,34,272,17,17
29479,65212,53,36121,53,230,102,128,2,30,1,1
29480,64097,443,12441,443,6372,1893,4479,15,120,8,7
29481,52933,443,12830,443,3517,993,2524,12,120,6,6
29482,55007,443,13149,443,14030,7043,6987,32,123,18,14
29483,33044,443,19147,443,268582,23654,244928,341,190,128,213
29484,51566,53,46943,53,239,102,137,2,30,1,1
29485,49587,53,25936,53,229,102,127,2,30,1,1
29486,58805,53,42120,53,237,86,151,2,30,1,1
29487,36701,53,35437,53,199,94,105,2,30,1,1
29488,55334,53,17897,53,199,102,97,2,31,1,1
29489,49708,443,3133,443,7772,2563,5209,18,121,9,9
29490,39064,443,7055,443,11356,4341,7015,33,128,16,17
29491,54299,443,30059,443,9986,2440,7546,17,120,8,9
29492,56000,53,26233,53,177,94,83,2,30,1,1
29493,57019,53,50222,53,193,102,91,2,30,1,1
29494,65277,53,2071,53,775,102,673,2,30,1,1
29495,65275,53,62237,53,184,94,90,2,30,1,1
29496,55330,53,61986,53,194,102,92,2,31,1,1
29497,44881,53,62824,53,212,78,134,2,30,1,1
29498,59982,443,10585,443,3640,870,2770,13,120,6,7
29499,50468,443,35607,443,227265,6450,220815,225,124,63,162
29500,63930,44330,31365,44330,70,70,0,1,5,1,0
29501,51949,5484,40071,5484,70,70,0,1,5,1,0
29502,61832,80,61832,80,2221,1482,739,11,149,6,5
29503,65114,443,65114,443,4480,1573,2907,19,30,11,8
29504,65275,53,60428,53,807,94,713,2,30,1,1
29505,46985,53,9920,53,199,94,105,2,30,1,1
29506,49348,53,64482,53,214,94,120,2,31,1,1
29507,56000,53,8849,53,177,94,83,2,31,1,1
29508,64475,443,53340,443,251092,8989,242103,282,123,98,184
29509,61860,10443,7961,10443,10811,2571,8240,27,48,15,12
29510,64665,53,12742,53,181,94,87,2,32,1,1
29511,63929,48477,13540,48477,70,70,0,1,5,1,0
29512,60195,445,0,0,66,66,0,1,0,1,0
29513,59951,445,0,0,70,70,0,1,0,1,0
29514,60193,445,0,0,66,66,0,1,0,1,0
29515,62257,2767,0,0,66,66,0,1,0,1,0
29516,58829,64147,0,0,66,66,0,1,0,1,0
29517,45304,64147,0,0,72,72,0,1,0,1,0
29518,65259,37965,0,0,66,66,0,1,0,1,0
29519,50772,35440,0,0,66,66,0,1,0,1,0
29520,64773,445,0,0,70,70,0,1,0,1,0
29521,64774,445,0,0,70,70,0,1,0,1,0
29522,64772,445,0,0,70,70,0,1,0,1,0
29523,60174,445,0,0,66,66,0,1,0,1,0
29524,60180,445,0,0,66,66,0,1,0,1,0
29525,60175,445,0,0,66,66,0,1,0,1,0
29526,60179,445,0,0,66,66,0,1,0,1,0
29527,60177,445,0,0,66,66,0,1,0,1,0
29528,60181,445,0,0,66,66,0,1,0,1,0
29529,60178,445,0,0,66,66,0,1,0,1,0
29530,60176,445,0,0,66,66,0,1,0,1,0
29531,45908,33330,0,0,60,60,0,1,0,1,0
29532,59938,445,0,0,70,70,0,1,0,1,0
29533,57011,49813,0,0,66,66,0,1,0,1,0
29534,59935,445,0,0,70,70,0,1,0,1,0
29535,16826,22,0,0,60,60,0,1,0,1,0
29536,54464,56205,0,0,66,66,0,1,0,1,0
29537,64765,445,0,0,70,70,0,1,0,1,0
29538,64763,445,0,0,70,70,0,1,0,1,0
29539,64758,445,0,0,70,70,0,1,0,1,0
29540,64755,445,0,0,70,70,0,1,0,1,0
29541,7889,48817,0,0,146,146,0,1,0,1,0
29542,37603,443,61350,443,573,425,148,5,1,3,2
29543,37602,443,57970,443,573,425,148,5,0,3,2
29544,37601,443,50258,443,573,425,148,5,0,3,2
29545,54251,443,43085,443,499,425,74,4,0,3,1
29546,54252,443,11078,443,499,425,74,4,0,3,1
29547,54250,443,54030,443,499,425,74,4,0,3,1
29548,60161,445,0,0,66,66,0,1,0,1,0
29549,60160,445,0,0,66,66,0,1,0,1,0
29550,60159,445,0,0,66,66,0,1,0,1,0
29551,59930,445,0,0,70,70,0,1,0,1,0
29552,59929,445,0,0,70,70,0,1,0,1,0
29553,6817,23,0,0,60,60,0,1,0,1,0
29554,59927,445,0,0,70,70,0,1,0,1,0
29555,65422,26467,0,0,62,62,0,1,0,1,0
29556,64752,445,0,0,70,70,0,1,0,1,0
29557,50920,60182,0,0,62,62,0,1,0,1,0
29558,64747,445,0,0,70,70,0,1,0,1,0
29559,64746,445,0,0,70,70,0,1,0,1,0
29560,54249,443,37595,443,499,425,74,4,0,3,1
29561,37605,443,2336,443,573,425,148,5,0,3,2
29562,37604,443,27839,443,573,425,148,5,0,3,2
29563,54248,443,24435,443,499,425,74,4,0,3,1
29564,37606,443,60055,443,499,425,74,4,0,3,1
29565,54245,443,40246,443,499,425,74,4,0,3,1
29566,64743,445,0,0,70,70,0,1,0,1,0
29567,64824,36829,0,0,62,62,0,1,0,1,0
29568,63956,38211,0,0,62,62,0,1,0,1,0
29569,7364,50584,0,0,66,66,0,1,0,1,0
29570,20217,8333,0,0,60,60,0,1,0,1,0
29571,4110,35440,0,0,62,62,0,1,0,1,0
29572,443,61686,0,0,1484,1484,0,1,0,1,0
29573,59920,445,0,0,70,70,0,1,0,1,0
29574,16905,57866,0,0,66,66,0,1,0,1,0
29575,25565,27960,0,0,60,60,0,1,0,1,0
29576,10736,35440,0,0,66,66,0,1,0,1,0
29577,62153,35440,0,0,66,66,0,1,0,1,0
29578,59400,22114,0,0,66,66,0,1,0,1,0
29579,59918,445,0,0,70,70,0,1,0,1,0
29580,64735,445,0,0,70,70,0,1,0,1,0
29581,64729,445,0,0,70,70,0,1,0,1,0
29582,64730,445,0,0,70,70,0,1,0,1,0
29583,59917,445,0,0,70,70,0,1,0,1,0
29584,48706,23393,0,0,60,60,0,1,0,1,0
29585,11136,19910,0,0,62,62,0,1,0,1,0
29586,59916,445,0,0,70,70,0,1,0,1,0
29587,11136,19910,0,0,145,145,0,1,0,1,0
29588,59915,445,0,0,70,70,0,1,0,1,0
29589,59911,445,0,0,70,70,0,1,0,1,0
29590,59910,445,0,0,70,70,0,1,0,1,0
29591,60149,445,0,0,66,66,0,1,0,1,0
29592,48513,44847,0,0,62,62,0,1,0,1,0
29593,3597,11392,0,0,66,66,0,1,0,1,0
29594,16477,37807,0,0,66,66,0,1,0,1,0
29595,10834,50584,0,0,66,66,0,1,0,1,0
29596,38664,37965,0,0,62,62,0,1,0,1,0
29597,59897,445,0,0,70,70,0,1,0,1,0
29598,59896,445,0,0,70,70,0,1,0,1,0
29599,59891,445,0,0,70,70,0,1,0,1,0
29600,1024,48817,0,0,148,148,0,1,0,1,0
29601,59886,445,0,0,70,70,0,1,0,1,0
29602,59887,445,0,0,70,70,0,1,0,1,0
29603,52022,52752,0,0,74,74,0,1,0,1,0
29604,64725,445,0,0,70,70,0,1,0,1,0
29605,64719,445,0,0,70,70,0,1,0,1,0
29606,50,38211,0,0,66,66,0,1,0,1,0
29607,7310,44847,0,0,66,66,0,1,0,1,0
29608,8889,26330,0,0,60,60,0,1,0,1,0
29609,60134,445,0,0,66,66,0,1,0,1,0
29610,60132,445,0,0,66,66,0,1,0,1,0
29611,25497,44847,0,0,146,146,0,1,0,1,0
29612,52062,443,35040,443,466,392,74,4,0,3,1
29613,23461,34021,0,0,62,62,0,1,0,1,0
29614,59875,445,0,0,70,70,0,1,0,1,0
29615,51934,36180,0,0,66,66,0,1,0,1,0
29616,64697,37965,0,0,66,66,0,1,0,1,0
29617,30794,37965,0,0,62,62,0,1,0,1,0
29618,64714,445,0,0,70,70,0,1,0,1,0
29619,64709,445,0,0,70,70,0,1,0,1,0
29620,64708,445,0,0,70,70,0,1,0,1,0
29621,64707,445,0,0,70,70,0,1,0,1,0
29622,60125,445,0,0,66,66,0,1,0,1,0
29623,60771,58414,0,0,66,66,0,1,0,1,0
29624,58836,44847,0,0,74,74,0,1,0,1,0
29625,60120,445,0,0,66,66,0,1,0,1,0
29626,60122,445,0,0,66,66,0,1,0,1,0
29627,60114,445,0,0,66,66,0,1,0,1,0
29628,60118,445,0,0,66,66,0,1,0,1,0
29629,60111,445,0,0,66,66,0,1,0,1,0
29630,60110,445,0,0,66,66,0,1,0,1,0
29631,59871,445,0,0,70,70,0,1,0,1,0
29632,49113,50584,0,0,62,62,0,1,0,1,0
29633,64701,445,0,0,70,70,0,1,0,1,0
29634,55387,53,17527,53,761,100,661,2,31,1,1
29635,57311,53,52829,53,768,99,669,2,31,1,1
29636,45550,80,42274,80,890,420,470,14,27,7,7
29637,49904,80,22359,80,1647,508,1139,8,138,5,3
29638,54990,443,49240,443,20961,10306,10655,49,48,25,24
29639,54617,443,54617,443,3186,1836,1350,16,17,10,6
29640,58769,443,51640,443,3923,2459,1464,17,17,8,9
29641,62905,443,5789,443,8426,2893,5533,27,16,15,12
29642,53774,58433,12540,58433,320,140,180,6,7,3,3
29643,56654,53,59245,53,202,103,99,2,31,1,1
29644,57444,53,22248,53,170,87,83,2,30,1,1
29645,54604,80,54604,80,2244,1549,695,11,18,7,4
29646,35439,443,50661,443,3730,2455,1275,18,256,10,8
29647,50036,80,50018,80,1665,923,742,7,32,4,3
29648,45552,80,5282,80,890,420,470,14,27,7,7
29649,65251,53,54208,53,183,98,85,3,36,2,1
29650,64665,53,63171,53,91,91,0,1,30,1,0
29651,55196,53,52555,53,711,87,624,2,30,1,1
29652,65266,53,41690,53,216,110,106,2,31,1,1
29653,52326,443,52326,443,5433,2251,3182,23,86,12,11
29654,52332,443,52332,443,960,539,421,9,52,5,4
29655,50578,80,53375,80,1114,534,580,12,16,7,5
29656,57259,443,65344,443,6439,1702,4737,21,68,13,8
29657,45551,80,20742,80,694,350,344,11,27,6,5
29658,52616,80,52616,80,3366,2547,819,15,49,8,7
29659,52946,80,25585,80,2043,1331,712,13,17,7,6
29660,52667,80,52667,80,2011,1422,589,12,48,6,6
29661,65061,53,34099,53,297,101,196,4,31,2,2
29662,48867,443,13159,443,6107,2079,4028,19,68,11,8
29663,56440,53,14356,53,742,88,654,2,30,1,1
29664,57106,443,27171,443,38893,31305,7588,107,101,55,52
29665,55949,53,62692,53,774,101,673,2,30,1,1
29666,53769,8999,35608,8999,70,70,0,2,8,2,0
29667,56169,53,29884,53,749,94,655,2,30,1,1
29668,49515,443,49515,443,102168,31819,70349,140,62,75,65
29669,57019,53,12115,53,186,95,91,2,30,1,1
29670,56479,53,28725,53,775,103,672,2,30,1,1
29671,58773,443,53074,443,3854,2390,1464,17,15,8,9
29672,59670,443,52276,443,11549,6152,5397,28,156,16,12
29673,42920,443,33787,443,883886,26396,857490,947,444,340,607
29674,24463,3389,24463,3389,3910,1805,2105,20,18,12,8
29675,54415,443,40112,443,7129,4391,2738,32,196,16,16
29676,55019,53,16040,53,299,110,189,4,32,2,2
29677,48245,443,12754,443,7417,1760,5657,21,256,12,9
29678,56986,53,50579,53,259,87,172,4,37,2,2
29679,40736,443,40736,443,4380,1473,2907,19,26,11,8
29680,5588,5588,0,0,3354,1792,1562,46,195,23,23
29681,62460,443,33310,443,4608,3133,1475,18,35,10,8
29682,52329,443,52329,443,4453,1546,2907,21,86,11,10
29683,19473,20467,44164,20467,480,149,331,2,1200,1,1
29684,56240,53,50619,53,748,95,653,2,30,1,1
29685,65244,53,43768,53,170,87,83,2,30,1,1
29686,64016,53,54219,53,184,94,90,2,31,1,1
29687,45987,443,65054,443,3160640,65300,3095340,2786,144,547,2239
29688,49552,53,40374,53,760,97,663,2,31,1,1
29689,60184,443,18301,443,3915,1934,1981,14,122,7,7
29690,44355,443,45033,443,354,140,214,6,131,3,3
29691,55066,53,26532,53,815,95,720,2,31,1,1
29692,65180,53,32141,53,198,101,97,2,31,1,1
29693,50089,53,38993,53,752,93,659,2,31,1,1
29694,50621,53,54722,53,256,93,163,2,31,1,1
29695,42867,443,28433,443,15769,1619,14150,17,137,4,13
29696,62618,443,27342,443,6939,2970,3969,19,144,9,10
29697,51334,443,42102,443,8407,2034,6373,19,121,8,11
29698,56755,53,37076,53,184,94,90,2,31,1,1
29699,51338,443,48161,443,424,210,214,7,131,4,3
29700,45995,443,45995,443,1494,898,596,12,142,6,6
29701,30960,45721,23609,45721,66,66,0,1,3600,1,0
29702,43300,18242,0,0,62,62,0,1,60,1,0
29703,64697,445,0,0,70,70,0,1,0,1,0
29704,64695,445,0,0,70,70,0,1,0,1,0
29705,64693,445,0,0,70,70,0,1,0,1,0
29706,44411,37965,0,0,62,62,0,1,0,1,0
29707,59861,445,0,0,70,70,0,1,0,1,0
29708,59862,445,0,0,70,70,0,1,0,1,0
29709,59860,445,0,0,70,70,0,1,0,1,0
29710,64677,57470,0,0,66,66,0,1,0,1,0
29711,1025,50584,0,0,62,62,0,1,0,1,0
29712,39287,57470,0,0,62,62,0,1,0,1,0
29713,59856,445,0,0,70,70,0,1,0,1,0
29714,46839,51050,0,0,62,62,0,1,0,1,0
29715,65379,22114,0,0,66,66,0,1,0,1,0
29716,59855,445,0,0,70,70,0,1,0,1,0
29717,26713,64147,0,0,62,62,0,1,0,1,0
29718,29577,64147,0,0,62,62,0,1,0,1,0
29719,64689,445,0,0,70,70,0,1,0,1,0
29720,64688,445,0,0,70,70,0,1,0,1,0
29721,57074,53,2955,53,195,102,93,2,30,1,1
29722,64580,443,64391,443,24686,1935,22751,36,20,17,19
29723,56612,53,28216,53,178,94,84,2,30,1,1
29724,56681,53,9758,53,195,102,93,2,30,1,1
29725,64156,53,39777,53,409,92,317,4,30,2,2
29726,56986,53,34763,53,259,87,172,4,36,2,2
29727,51980,45478,12123,45478,70,70,0,2,7,2,0
29728,51997,14398,23393,14398,130,70,60,2,4,1,1
29729,62053,443,33820,443,134,60,74,3,5,2,1
29730,65251,53,36655,53,277,98,179,4,36,2,2
29731,57265,443,12728,443,9633,4368,5265,32,71,18,14
29732,55334,53,36263,53,199,102,97,2,30,1,1
29733,56706,443,32876,443,8057,2037,6020,20,15,11,9
29734,55665,44235,23820,44235,504,318,186,8,15,5,3
29735,51100,443,10929,443,9429,1978,7451,27,46,14,13
29736,49945,53,62137,53,198,102,96,2,30,1,1
29737,49942,443,49942,443,29781,5947,23834,63,47,32,31
29738,65049,53,13947,53,199,102,97,2,29,1,1
29739,40349,443,1831,443,7128,1336,5792,22,83,11,11
29740,51979,55803,35511,55803,70,70,0,2,7,2,0
29741,56450,53,17647,53,177,94,83,2,29,1,1
29742,64345,53,39290,53,499,94,405,2,29,1,1
29743,65435,53,59924,53,196,94,102,2,29,1,1
29744,64561,53,50313,53,209,110,99,2,30,1,1
29745,56654,53,7307,53,209,110,99,2,30,1,1
29746,64578,443,29592,443,9156,2109,7047,27,32,15,12
29747,37384,443,22279,443,416,210,206,7,29,4,3
29748,59014,443,31435,443,27298,11122,16176,59,31,30,29
29749,49918,80,19931,80,751,455,296,8,125,5,3
29750,64561,53,6022,53,209,110,99,2,30,1,1
29751,53940,53,37682,53,70,70,0,1,30,1,0
29752,65244,53,54645,53,177,94,83,2,30,1,1
29753,49945,53,22837,53,821,102,719,2,30,1,1
29754,55019,53,27465,53,299,110,189,4,31,2,2
29755,37995,49152,51662,49152,156,156,0,3,8,3,0
29756,51947,16935,4514,16935,70,70,0,1,5,1,0
29757,65224,53,18679,53,197,102,95,2,30,1,1
29758,52572,80,52572,80,1899,1310,589,12,48,6,6
29759,52328,443,52328,443,5438,2255,3183,23,86,12,11
29760,56717,53,2347,53,178,94,84,2,30,1,1
29761,52325,443,52325,443,17806,3169,14637,41,86,18,23
29762,48768,443,48768,443,4398,1491,2907,19,27,11,8
29763,38693,443,23499,443,16959,8920,8039,46,33,24,22
29764,52333,443,52333,443,960,539,421,9,52,5,4
29765,65127,443,50841,443,48029,4540,43489,91,120,40,51
29766,49919,80,15298,80,992,524,468,10,125,6,4
29767,64266,53,18916,53,180,94,86,2,31,1,1
29768,53437,6057,55735,6057,245,245,0,2,30,2,0
29769,50169,53,12431,53,211,78,133,2,30,1,1
29770,51977,18504,24364,18504,70,70,0,2,8,2,0
29771,56177,53,33735,53,184,94,90,2,30,1,1
29772,57143,53,42791,53,184,94,90,2,30,1,1
29773,37581,443,19620,443,13435,2441,10994,30,26,16,14
29774,55938,53,31705,53,209,110,99,2,30,1,1
29775,65224,53,46834,53,197,102,95,2,30,1,1
29776,55770,53,22601,53,177,94,83,2,30,1,1
29777,57444,53,32931,53,177,94,83,2,30,1,1
29778,49812,53,34841,53,193,102,91,2,30,1,1
29779,57444,53,54223,53,177,94,83,2,30,1,1
29780,39060,443,26337,443,8554,2353,6201,29,138,14,15
29781,64125,53,55658,53,370,94,276,2,30,1,1
29782,50920,443,1716,443,24070,16123,7947,82,6308,42,40
29783,56717,53,46335,53,178,94,84,2,31,1,1
29784,53301,11000,8510,11000,1642,822,820,5,30,1,4
29785,52330,443,52330,443,11451,5432,6019,34,86,17,17
29786,55705,53,9254,53,281,101,180,4,58,2,2
29787,56035,53,45102,53,173,94,79,2,30,1,1
29788,38832,443,4622,443,23292,17154,6138,141,522,79,62
29789,58774,443,43846,443,5167,700,4467,16,15,7,9
29790,57601,443,61546,443,2614,1689,925,18,20,10,8
29791,55672,45682,48139,45682,70,70,0,2,8,2,0
29792,51976,11816,61215,11816,70,70,0,2,8,2,0
29793,49195,8108,11315,8108,70,70,0,2,8,2,0
29794,51666,443,12470,443,30210,2106,28104,46,201,17,29
29795,52251,80,52251,80,1838,1319,519,11,48,6,5
29796,56704,443,41939,443,8125,2039,6086,21,15,11,10
29797,62337,443,30628,443,3908576,93181,3815395,3743,56,1160,2583
29798,63939,53,40762,53,226,110,116,2,30,1,1
29799,49258,53,9142,53,228,102,126,2,30,1,1
29800,56938,9600,62767,9600,86,86,0,1,30,1,0
29801,55019,53,59602,53,299,110,189,4,31,2,2
29802,60130,443,10266,443,16291,9102,7189,94,508,42,52
29803,55063,80,20796,80,2776,1333,1443,12,37,7,5
29804,52986,443,58135,443,280,140,140,5,130,3,2
29805,48738,443,11931,443,131514,7190,124324,183,53,72,111
29806,63912,18318,13803,18318,1295,926,369,13,17,9,4
29807,65244,53,26357,53,177,94,83,2,31,1,1
29808,43220,5222,35739,5222,5415,2041,3374,53,467,23,30
29809,65061,53,31774,53,299,103,196,4,33,2,2
29810,61027,80,42775,80,9483,767,8716,18,14,10,8
29811,55065,80,56775,80,306,180,126,6,28,4,2
29812,64174,53,47378,53,438,130,308,4,35,2,2
29813,55674,48870,19113,48870,70,70,0,2,8,2,0
29814,49749,443,51214,443,54416,3219,51197,76,240,30,46
29815,56647,80,55289,80,234,234,0,4,12,4,0
29816,62461,443,18805,443,14832,3978,10854,32,34,15,17
29817,62463,443,34613,443,4203,2748,1455,18,33,10,8
29818,53123,443,38611,443,1630,1089,541,14,15,8,6
29819,58772,443,9884,443,5106,700,4406,15,15,7,8
29820,1933,53,18812,53,210,78,132,2,29,1,1
29821,50252,53,7370,53,165,86,79,2,30,1,1
29822,57143,53,50787,53,184,94,90,2,30,1,1
29823,56789,443,21644,443,257154,11550,245604,303,54,121,182
29824,56654,53,36546,53,209,110,99,2,30,1,1
29825,49786,53,64235,53,209,110,99,2,30,1,1
29826,49927,53,25486,53,763,102,661,2,30,1,1
29827,56929,53,14776,53,177,94,83,2,30,1,1
29828,57074,53,22735,53,195,102,93,2,30,1,1
29829,56357,53,35688,53,270,110,160,2,30,1,1
29830,65256,53,14067,53,213,102,111,2,30,1,1
29831,64016,53,18748,53,184,94,90,2,31,1,1
29832,56855,443,28597,443,8114,2511,5603,19,135,9,10
29833,57019,53,31067,53,193,102,91,2,31,1,1
29834,57377,443,4552,443,5553,927,4626,16,15,10,6
29835,59658,443,21276,443,6695,1617,5078,23,200,13,10
29836,62464,443,10700,443,4595,3120,1475,18,33,10,8
29837,52327,443,52327,443,5444,2263,3181,23,86,12,11
29838,51234,80,58624,80,6798,4486,2312,42,107,22,20
29839,39931,443,19532,443,4464,2847,1617,29,80,15,14
29840,55705,53,13969,53,281,101,180,4,58,2,2
29841,64064,53,52675,53,257,94,163,2,30,1,1
29842,64114,53,8208,53,251,102,149,2,30,1,1
29843,56705,443,63668,443,8007,1987,6020,20,15,11,9
29844,58778,443,47598,443,5168,700,4468,16,15,7,9
29845,51978,57496,25018,57496,70,70,0,2,8,2,0
29846,55668,80,57634,80,70,70,0,1,5,1,0
29847,52712,80,52712,80,2012,1423,589,12,48,6,6
29848,52341,80,52341,80,1928,1339,589,12,48,6,6
29849,14432,443,31078,443,7420,1078,6342,21,75,11,10
29850,50393,443,41486,443,7356,1014,6342,20,75,10,10
29851,56035,53,24305,53,173,94,79,2,30,1,1
29852,64524,53,53824,53,235,102,133,2,30,1,1
29853,52647,443,40426,443,46502,33690,12812,93,234,55,38
29854,56796,443,3501,443,5475,1610,3865,19,255,11,8
29855,53147,26330,14316,26330,70,70,0,2,8,2,0
29856,37996,49152,50684,49152,156,156,0,3,8,3,0
29857,56986,53,7478,53,259,87,172,4,37,2,2
29858,37579,443,40926,443,7982,2392,5590,25,26,14,11
29859,55603,32520,10079,32520,5982,1890,4092,30,75,15,15
29860,54977,443,46620,443,322265,12756,309509,409,270,173,236
29861,55705,53,27815,53,281,101,180,4,59,2,2
29862,56681,53,26694,53,195,102,93,2,30,1,1
29863,55938,53,44450,53,209,110,99,2,30,1,1
29864,50411,53,28874,53,86,86,0,1,30,1,0
29865,55770,53,9659,53,177,94,83,2,30,1,1
29866,65266,53,21692,53,216,110,106,2,30,1,1
29867,64313,53,9214,53,226,110,116,2,30,1,1
29868,62711,443,43946,443,266781,12334,254447,323,161,119,204
29869,45996,443,45996,443,1494,898,596,12,142,6,6
29870,64556,53,40982,53,195,102,93,2,30,1,1
29871,51784,8245,58196,8245,280,214,66,2,31,1,1
29872,35832,443,44222,443,17110,4513,12597,42,121,19,23
29873,57275,443,62988,443,45483074,398771,45084303,36307,333,3386,32921
29874,6881,6881,1541,6881,237,118,119,2,1200,1,1
29875,59701,443,37154,443,6155,1819,4336,18,181,8,10
29876,56766,443,14480,443,10137,4019,6118,42,8169,24,18
29877,55019,53,16750,53,299,110,189,4,31,2,2
29878,6881,52563,53881,52563,228,118,110,2,1199,1,1
29879,45992,443,45992,443,1494,898,596,12,142,6,6
29880,49557,53,61895,53,1298,100,1198,4,32,2,2
29881,60204,80,20326,80,70,70,0,2,8,2,0
29882,63944,8999,33141,8999,66,66,0,2,8,2,0
29883,55846,53,27827,53,198,102,96,2,30,1,1
29884,49774,53,49900,53,225,110,115,2,30,1,1
29885,56755,53,26920,53,184,94,90,2,31,1,1
29886,57201,53,17693,53,195,102,93,2,31,1,1
29887,45997,443,45997,443,1494,898,596,12,142,6,6
29888,45994,443,45994,443,1494,898,596,12,142,6,6
29889,45993,443,45993,443,1494,898,596,12,142,6,6
29890,53766,3596,64680,3596,70,70,0,2,8,2,0
29891,53757,1,5970,1,70,70,0,1,5,1,0
29892,53749,53572,44841,53572,492,306,186,8,15,5,3
29893,55475,80,10225,80,350,210,140,6,27,4,2
29894,62904,80,35309,80,1515,481,1034,11,16,6,5
29895,43095,443,34288,443,6513,2043,4470,20,17,12,8
29896,49518,53,34385,53,299,90,209,4,49,2,2
29897,65180,53,7905,53,199,102,97,2,30,1,1
29898,55968,53,21608,53,243,94,149,2,30,1,1
29899,57143,53,17926,53,184,94,90,2,30,1,1
29900,56929,53,47625,53,177,94,83,2,30,1,1
29901,56654,53,22372,53,209,110,99,2,30,1,1
29902,64191,53,5419,53,197,94,103,2,30,1,1
29903,49536,53,5228,53,239,94,145,2,30,1,1
29904,64690,445,0,0,70,70,0,1,0,1,0
29905,63331,51221,0,0,62,62,0,1,0,1,0
29906,52828,51221,0,0,66,66,0,1,0,1,0
29907,60104,445,0,0,66,66,0,1,0,1,0
29908,64684,445,0,0,70,70,0,1,0,1,0
29909,60100,445,0,0,66,66,0,1,0,1,0
29910,59848,445,0,0,70,70,0,1,0,1,0
29911,60097,445,0,0,66,66,0,1,0,1,0
29912,60098,445,0,0,66,66,0,1,0,1,0
29913,60095,445,0,0,66,66,0,1,0,1,0
29914,64449,30188,0,0,62,62,0,1,0,1,0
29915,59679,37807,0,0,66,66,0,1,0,1,0
29916,54737,50584,0,0,66,66,0,1,0,1,0
29917,59841,445,0,0,70,70,0,1,0,1,0
29918,65419,26467,0,0,62,62,0,1,0,1,0
29919,59840,445,0,0,70,70,0,1,0,1,0
29920,33416,23,0,0,60,60,0,1,0,1,0
29921,64676,445,0,0,70,70,0,1,0,1,0
29922,24662,26467,0,0,66,66,0,1,0,1,0
29923,63963,50584,0,0,66,66,0,1,0,1,0
29924,64669,445,0,0,70,70,0,1,0,1,0
29925,64671,445,0,0,70,70,0,1,0,1,0
29926,36369,51505,0,0,66,66,0,1,0,1,0
29927,59834,445,0,0,70,70,0,1,0,1,0
29928,59191,35440,0,0,62,62,0,1,0,1,0
29929,63672,22114,0,0,66,66,0,1,0,1,0
29930,59833,445,0,0,70,70,0,1,0,1,0
29931,25054,36827,0,0,66,66,0,1,0,1,0
29932,60085,445,0,0,66,66,0,1,0,1,0
29933,52938,64097,0,0,66,66,0,1,0,1,0
29934,59829,445,0,0,70,70,0,1,0,1,0
29935,60077,445,0,0,66,66,0,1,0,1,0
29936,41996,5900,0,0,60,60,0,1,0,1,0
29937,64659,445,0,0,70,70,0,1,0,1,0
29938,59828,445,0,0,70,70,0,1,0,1,0
29939,55616,56205,0,0,66,66,0,1,0,1,0
29940,443,39947,0,0,74,74,0,1,0,1,0
29941,61639,37965,0,0,66,66,0,1,0,1,0
29942,60075,445,0,0,66,66,0,1,0,1,0
29943,12709,51505,0,0,62,62,0,1,0,1,0
29944,7246,59858,0,0,66,66,0,1,0,1,0
29945,28040,64147,0,0,66,66,0,1,0,1,0
29946,59823,445,0,0,70,70,0,1,0,1,0
29947,11821,64147,0,0,62,62,0,1,0,1,0
29948,60066,445,0,0,66,66,0,1,0,1,0
29949,60059,445,0,0,66,66,0,1,0,1,0
29950,25237,57470,0,0,62,62,0,1,0,1,0
29951,32770,51505,0,0,62,62,0,1,0,1,0
29952,57468,57470,0,0,66,66,0,1,0,1,0
29953,8889,34659,0,0,60,60,0,1,0,1,0
29954,50927,44847,0,0,62,62,0,1,0,1,0
29955,56442,11392,0,0,66,66,0,1,0,1,0
29956,31500,34729,0,0,146,146,0,1,0,1,0
29957,54280,3398,0,0,60,60,0,1,0,1,0
29958,26810,5033,0,0,145,145,0,1,0,1,0
29959,60357,5900,0,0,60,60,0,1,0,1,0
29960,62757,44847,0,0,146,146,0,1,0,1,0
29961,16693,36237,0,0,62,62,0,1,0,1,0
29962,12663,62413,0,0,66,66,0,1,0,1,0
29963,64646,445,0,0,70,70,0,1,0,1,0
29964,64645,445,0,0,70,70,0,1,0,1,0
29965,64644,445,0,0,70,70,0,1,0,1,0
29966,61005,50584,0,0,146,146,0,1,0,1,0
29967,60052,445,0,0,66,66,0,1,0,1,0
29968,60049,445,0,0,66,66,0,1,0,1,0
29969,60051,445,0,0,66,66,0,1,0,1,0
29970,60048,445,0,0,66,66,0,1,0,1,0
29971,60046,445,0,0,66,66,0,1,0,1,0
29972,60045,445,0,0,66,66,0,1,0,1,0
29973,60050,445,0,0,66,66,0,1,0,1,0
29974,60044,445,0,0,66,66,0,1,0,1,0
29975,59810,445,0,0,70,70,0,1,0,1,0
29976,7524,23,0,0,60,60,0,1,0,1,0
29977,49168,57470,0,0,66,66,0,1,0,1,0
29978,59807,445,0,0,70,70,0,1,0,1,0
29979,55421,57470,0,0,74,74,0,1,0,1,0
29980,54578,64147,0,0,66,66,0,1,0,1,0
29981,27209,25198,0,0,145,145,0,1,0,1,0
29982,64640,445,0,0,70,70,0,1,0,1,0
29983,64641,445,0,0,70,70,0,1,0,1,0
29984,64634,445,0,0,70,70,0,1,0,1,0
29985,64629,445,0,0,70,70,0,1,0,1,0
29986,59802,445,0,0,70,70,0,1,0,1,0
29987,61430,37965,0,0,66,66,0,1,0,1,0
29988,59801,445,0,0,70,70,0,1,0,1,0
29989,60030,445,0,0,66,66,0,1,0,1,0
29990,60032,445,0,0,66,66,0,1,0,1,0
29991,60029,445,0,0,66,66,0,1,0,1,0
29992,13285,29892,0,0,145,145,0,1,0,1,0
29993,61477,57470,0,0,62,62,0,1,0,1,0
29994,59799,445,0,0,70,70,0,1,0,1,0
29995,61030,21247,0,0,66,66,0,1,0,1,0
29996,50,64147,0,0,66,66,0,1,0,1,0
29997,64624,445,0,0,70,70,0,1,0,1,0
29998,62824,37807,0,0,66,66,0,1,0,1,0
29999,26301,22114,0,0,62,62,0,1,0,1,0
30000,64616,445,0,0,70,70,0,1,0,1,0
30001,64617,445,0,0,70,70,0,1,0,1,0
30002,64612,445,0,0,70,70,0,1,0,1,0
30003,59842,62413,0,0,66,66,0,1,0,1,0
30004,28580,64147,0,0,62,62,0,1,0,1,0
30005,59792,445,0,0,70,70,0,1,0,1,0
30006,0,0,0,0,102,102,0,1,0,1,0
30007,50799,37807,0,0,66,66,0,1,0,1,0
30008,59790,445,0,0,70,70,0,1,0,1,0
30009,55862,62413,0,0,66,66,0,1,0,1,0
30010,47453,6881,0,0,146,146,0,1,0,1,0
30011,11562,30188,0,0,62,62,0,1,0,1,0
30012,61059,32480,0,0,146,146,0,1,0,1,0
30013,62973,51505,0,0,62,62,0,1,0,1,0
30014,54280,3398,0,0,60,60,0,1,0,1,0
30015,52022,52752,0,0,74,74,0,1,0,1,0
30016,59210,50584,0,0,66,66,0,1,0,1,0
30017,59789,445,0,0,70,70,0,1,0,1,0
30018,60070,44847,0,0,66,66,0,1,0,1,0
30019,5538,23,0,0,60,60,0,1,0,1,0
30020,59788,445,0,0,70,70,0,1,0,1,0
30021,59787,445,0,0,70,70,0,1,0,1,0
30022,59785,445,0,0,70,70,0,1,0,1,0
30023,59783,445,0,0,70,70,0,1,0,1,0
30024,64606,445,0,0,70,70,0,1,0,1,0
30025,64605,445,0,0,70,70,0,1,0,1,0
30026,64600,445,0,0,70,70,0,1,0,1,0
30027,3792,52700,0,0,62,62,0,1,0,1,0
30028,24271,52700,0,0,66,66,0,1,0,1,0
30029,64368,22114,0,0,66,66,0,1,0,1,0
30030,60020,445,0,0,66,66,0,1,0,1,0
30031,26048,21,0,0,60,60,0,1,0,1,0
30032,59769,445,0,0,70,70,0,1,0,1,0
30033,59767,445,0,0,70,70,0,1,0,1,0
30034,59763,445,0,0,70,70,0,1,0,1,0
30035,59758,445,0,0,70,70,0,1,0,1,0
30036,59759,445,0,0,70,70,0,1,0,1,0
30037,16327,55442,0,0,66,66,0,1,0,1,0
30038,19875,30170,0,0,145,145,0,1,0,1,0
30039,63041,50584,0,0,62,62,0,1,0,1,0
30040,64598,445,0,0,70,70,0,1,0,1,0
30041,64591,445,0,0,70,70,0,1,0,1,0
30042,48676,53393,0,0,60,60,0,1,0,1,0
30043,48676,53399,0,0,60,60,0,1,0,1,0
30044,29136,31652,0,0,145,145,0,1,0,1,0
30045,21492,51505,0,0,146,146,0,1,0,1,0
30046,62819,56205,0,0,62,62,0,1,0,1,0
30047,60002,445,0,0,66,66,0,1,0,1,0
30048,60001,445,0,0,66,66,0,1,0,1,0
30049,29922,2750,0,0,145,145,0,1,0,1,0
30050,59747,445,0,0,70,70,0,1,0,1,0
30051,9128,80,3849,80,318,192,126,6,30,4,2
30052,64647,3389,64647,3389,3327,1438,1889,15,17,8,7
30053,26778,443,2994,443,7407,2650,4757,24,20,12,12
30054,51971,20347,9863,20347,70,70,0,2,8,2,0
30055,56203,53,21719,53,751,95,656,2,30,1,1
30056,51081,443,34616,443,8192,2781,5411,22,374,12,10
30057,49297,443,47840,443,5341,3636,1705,30,76,16,14
30058,9132,80,49560,80,318,192,126,6,30,4,2
30059,39724,443,28049,443,45852,4123,41729,61,17,25,36
30060,58755,443,8030,443,11839,7753,4086,30,17,15,15
30061,53768,19067,41942,19067,70,70,0,2,8,2,0
30062,51945,1587,2517,1587,66,66,0,1,5,1,0
30063,57330,443,48576,443,36551,3569,32982,57,46,28,29
30064,9130,80,10198,80,318,192,126,6,30,4,2
30065,38428,443,25567,443,9483,2964,6519,23,17,13,10
30066,48551,443,15020,443,7433,2086,5347,26,316,12,14
30067,64892,53,1067,53,751,95,656,2,30,1,1
30068,61488,53,0,0,314,93,221,2,30,1,1
30069,64154,53,29072,53,188,96,92,2,30,1,1
30070,2088,7010,2088,7010,10300,8829,1471,24,15,13,11
30071,9133,80,26542,80,318,192,126,6,30,4,2
30072,56563,53,31162,53,751,95,656,2,30,1,1
30073,55962,53,39113,53,186,95,91,2,31,1,1
30074,7871,3389,7871,3389,4166,2141,2025,18,18,9,9
30075,49966,80,31375,80,1210,788,422,9,33,5,4
30076,52474,443,15526,443,14908,4027,10881,28,136,11,17
30077,51975,11998,3978,11998,70,70,0,2,8,2,0
30078,58060,80,29313,80,1854,735,1119,8,16,5,3
30079,9126,80,52469,80,318,192,126,6,30,4,2
30080,36361,80,36361,80,514,246,268,9,76,5,4
30081,55081,80,13620,80,1680,697,983,10,52,6,4
30082,9144,80,51086,80,378,192,186,7,30,4,3
30083,36548,80,36548,80,514,246,268,9,76,5,4
30084,58726,443,45284,443,39202,21598,17604,72,20,39,33
30085,9129,80,33910,80,318,192,126,6,30,4,2
30086,36132,80,36132,80,514,246,268,9,76,5,4
30087,9145,80,20559,80,318,192,126,6,30,4,2
30088,5588,5588,0,0,3354,1792,1562,46,194,23,23
30089,5588,5588,0,0,3354,1792,1562,46,195,23,23
30090,5588,5588,0,0,3354,1792,1562,46,195,23,23
30091,56579,53,34186,53,711,87,624,2,30,1,1
30092,56929,53,5055,53,170,87,83,2,30,1,1
30093,56717,53,51715,53,172,88,84,2,31,1,1
30094,53587,3389,53587,3389,3504,1790,1714,17,31,9,8
30095,51838,443,42521,443,9329,3898,5431,21,39,12,9
30096,42665,443,42665,443,4620,1713,2907,19,26,11,8
30097,27005,27021,28946,27021,879,126,753,2,31,1,1
30098,57424,2258,57424,2258,156,156,0,3,8,3,0
30099,36084,80,36084,80,514,246,268,9,76,5,4
30100,5588,5588,0,0,3354,1792,1562,46,193,23,23
30101,61942,3389,61942,3389,3347,1458,1889,15,18,8,7
30102,56811,53,1928,53,762,97,665,2,30,1,1
30103,49009,53,49009,53,172,76,96,2,30,1,1
30104,57074,53,56571,53,190,97,93,2,30,1,1
30105,56417,53,44124,53,752,93,659,2,30,1,1
30106,65491,53,39082,53,186,95,91,2,30,1,1
30107,61732,3389,61732,3389,3380,1730,1650,15,33,8,7
30108,55840,53,25093,53,711,87,624,2,30,1,1
30109,36866,443,19337,443,6798,2901,3897,22,151,13,9
30110,52475,443,47203,443,14713,3210,11503,24,135,9,15
30111,57385,53,40272,53,194,99,95,2,31,1,1
30112,21133,26205,8150,26205,480,149,331,2,1200,1,1
30113,56422,53,35593,53,716,95,621,2,30,1,1
30114,55343,53,13186,53,770,101,669,2,31,1,1
30115,55752,53,35033,53,170,87,83,2,31,1,1
30116,54084,443,63980,443,37440,7952,29488,67,128,28,39
30117,55192,53,1273,53,760,97,663,2,31,1,1
30118,50209,53,45881,53,780,104,676,2,31,1,1
30119,27005,30007,42736,30007,890,126,764,2,31,1,1
30120,57365,53,10039,53,780,104,676,2,31,1,1
30121,55890,53,50894,53,186,95,91,2,31,1,1
30122,65485,53,57081,53,184,94,90,2,31,1,1
30123,49949,53,60223,53,186,95,91,2,31,1,1
30124,65220,53,55552,53,172,88,84,2,31,1,1
30125,50584,53743,42258,53743,1356,300,1056,6,1201,3,3
30126,57122,53,5518,53,295,101,194,4,31,2,2
30127,57128,53,45410,53,755,93,662,2,31,1,1
30128,27005,30006,22484,30006,890,126,764,2,31,1,1
30129,55197,53,53428,53,701,88,613,2,31,1,1
30130,55808,53,19839,53,182,93,89,2,31,1,1
30131,64786,53,39238,53,810,108,702,2,31,1,1
30132,43514,5223,35160,5223,3651,1103,2548,17,1802,10,7
30133,64792,443,39397,443,16199,7657,8542,58,127,28,30
30134,56529,53,60444,53,711,87,624,2,31,1,1
30135,65303,53,22620,53,760,96,664,2,31,1,1
30136,64793,53,59763,53,168,86,82,2,31,1,1
30137,55064,53,40731,53,774,101,673,2,31,1,1
30138,55934,53,55732,53,192,98,94,2,31,1,1
30139,55878,53,54979,53,760,97,663,2,31,1,1
30140,49421,53,15245,53,744,89,655,2,31,1,1
30141,33013,443,50966,443,88895,4807,84088,104,136,37,67
30142,57043,53,5828,53,735,88,647,2,31,1,1
30143,30960,45743,2927,45743,330,330,0,6,3609,6,0
30144,37965,46994,50866,46994,4089,2456,1633,53,1773,31,22
30145,23030,30170,0,0,159,159,0,1,0,1,0
30146,43461,35440,0,0,146,146,0,1,0,1,0
30147,13996,56205,0,0,62,62,0,1,0,1,0
30148,64589,445,0,0,70,70,0,1,0,1,0
30149,24285,26467,0,0,62,62,0,1,0,1,0
30150,64582,445,0,0,70,70,0,1,0,1,0
30151,64583,445,0,0,70,70,0,1,0,1,0
30152,64580,445,0,0,70,70,0,1,0,1,0
30153,53746,36237,0,0,66,66,0,1,0,1,0
30154,59997,445,0,0,66,66,0,1,0,1,0
30155,59743,445,0,0,70,70,0,1,0,1,0
30156,59991,445,0,0,66,66,0,1,0,1,0
30157,65047,53,39231,53,645,185,460,6,40,3,3
30158,50552,53,61704,53,757,102,655,2,30,1,1
30159,65206,53,7490,53,816,102,714,2,30,1,1
30160,56929,53,59011,53,177,94,83,2,30,1,1
30161,64950,53,10318,53,765,102,663,2,30,1,1
30162,64977,53,18612,53,334,94,240,2,30,1,1
30163,65443,53,21010,53,164,86,78,2,30,1,1
30164,55727,53,48303,53,177,94,83,2,30,1,1
30165,64227,53,63621,53,302,92,210,4,30,2,2
30166,53775,8999,38559,8999,320,140,180,6,5,3,3
30167,55666,36653,34073,36653,70,70,0,1,5,1,0
30168,51946,9407,60623,9407,70,70,0,1,4,1,0
30169,65123,53,59199,53,816,102,714,2,29,1,1
30170,65474,53,42125,53,197,94,103,2,29,1,1
30171,57424,53,63565,53,197,102,95,2,30,1,1
30172,43136,443,64659,443,9329,2900,6429,27,135,15,12
30173,55476,80,7666,80,498,280,218,8,26,5,3
30174,57051,53,10858,53,354,90,264,4,50,2,2
30175,51823,80,56758,80,4456,1889,2567,11,39,6,5
30176,37578,443,36969,443,7534,2392,5142,25,25,14,11
30177,53750,27352,15975,27352,70,70,0,1,4,1,0
30178,53765,16178,52610,16178,70,70,0,2,7,2,0
30179,50607,80,15942,80,1657,1247,410,8,14,5,3
30180,53767,10004,34912,10004,70,70,0,2,7,2,0
30181,55477,80,28863,80,498,280,218,8,26,5,3
30182,51942,22272,28402,22272,140,70,70,2,5,1,1
30183,64556,53,11651,53,195,102,93,2,29,1,1
30184,55337,53,41001,53,198,102,96,2,29,1,1
30185,57424,53,59355,53,197,102,95,2,29,1,1
30186,55846,53,44796,53,821,102,719,2,29,1,1
30187,50001,53,34185,53,239,94,145,2,29,1,1
30188,56755,53,13799,53,184,94,90,2,29,1,1
30189,64741,53,21274,53,198,86,112,2,29,1,1
30190,57444,53,35555,53,177,94,83,2,29,1,1
30191,64255,53,12895,53,200,94,106,2,29,1,1
30192,55593,53,62454,53,193,102,91,2,30,1,1
30193,49607,53,13201,53,259,102,157,2,29,1,1
30194,65266,53,57275,53,216,110,106,2,29,1,1
30195,56496,53,21788,53,164,86,78,2,30,1,1
30196,56702,443,53688,443,8058,2038,6020,20,15,11,9
30197,36731,80,36731,80,514,246,268,9,75,5,4
30198,51079,80,14506,80,19699,2094,17605,32,229,14,18
30199,9170,80,30007,80,318,192,126,6,29,4,2
30200,64639,3389,64639,3389,3409,1454,1955,16,16,8,8
30201,65180,53,35991,53,199,102,97,2,30,1,1
30202,49393,53,14583,53,183,86,97,2,30,1,1
30203,65213,53,57292,53,198,94,104,2,30,1,1
30204,64257,53,4953,53,261,94,167,2,30,1,1
30205,49675,53,53697,53,199,102,97,2,30,1,1
30206,55444,53,60851,53,193,102,91,2,30,1,1
30207,50265,443,41315,443,10788,6022,4766,36,144,20,16
30208,48436,53,48436,53,216,82,134,2,32,1,1
30209,51972,13604,16172,13604,258,70,188,4,8,2,2
30210,35615,443,10957,443,6179,1242,4937,22,42,11,11
30211,38690,443,51124,443,1107678,21465,1086213,1058,16,312,746
30212,9154,443,7257,443,6258,843,5415,19,29,10,9
30213,9149,443,28137,443,6128,763,5365,17,29,9,8
30214,9151,443,63028,443,6128,763,5365,17,29,9,8
30215,9148,443,13581,443,6334,840,5494,19,29,10,9
30216,27005,50019,16642,50019,877,126,751,2,30,1,1
30217,65206,53,37251,53,193,102,91,2,30,1,1
30218,64714,53,3550,53,168,86,82,2,31,1,1
30219,64433,53,29795,53,214,102,112,2,30,1,1
30220,59788,443,42215,443,162,102,60,2,5,1,1
30221,56814,53,9627,53,193,102,91,2,30,1,1
30222,50599,80,5247,80,8601,6265,2336,18,26,10,8
30223,55962,53,37019,53,193,102,91,2,30,1,1
30224,42597,443,16661,443,8533,2023,6510,23,15,12,11
30225,9175,443,52821,443,6331,837,5494,19,28,10,9
30226,65330,53,53724,53,723,102,621,2,30,1,1
30227,9177,443,23456,443,6331,837,5494,19,28,10,9
30228,64385,53,21883,53,307,105,202,4,47,2,2
30229,49228,53,7287,53,193,102,91,2,30,1,1
30230,65443,53,23920,53,172,94,78,2,30,1,1
30231,49876,53,41654,53,199,102,97,2,30,1,1
30232,65280,53,36660,53,213,102,111,2,30,1,1
30233,49228,53,30182,53,193,102,91,2,30,1,1
30234,55727,53,61818,53,177,94,83,2,30,1,1
30235,27005,28002,21197,28002,918,126,792,2,30,1,1
30236,56138,53,42749,53,259,86,173,2,30,1,1
30237,61128,80,61128,80,1382,855,527,11,20,6,5
30238,9169,80,55933,80,318,192,126,6,29,4,2
30239,9117,80,20757,80,318,192,126,6,29,4,2
30240,9138,80,8999,80,318,192,126,6,29,4,2
30241,50086,53,16389,53,193,102,91,2,30,1,1
30242,49876,53,54830,53,199,102,97,2,30,1,1
30243,55043,53,56264,53,274,110,164,2,30,1,1
30244,51943,55464,52953,55464,70,70,0,1,5,1,0
30245,55663,19994,24256,19994,70,70,0,1,5,1,0
30246,45435,443,1325,443,8034,400,7634,14,193,2,12
30247,9134,80,9239,80,318,192,126,6,29,4,2
30248,7100,53,7100,53,644,90,554,2,30,1,1
30249,49555,53,24625,53,193,102,91,2,30,1,1
30250,65024,53,20074,53,199,102,97,2,30,1,1
30251,64569,53,52034,53,258,102,156,2,30,1,1
30252,33084,443,45325,443,15474,4188,11286,14,139,4,10
30253,64154,53,27741,53,194,102,92,2,31,1,1
30254,46299,443,43257,443,648083,28117,619966,751,30,323,428
30255,27005,32036,10706,32036,876,126,750,2,30,1,1
30256,52027,443,40345,443,8698,1393,7305,22,16,12,10
30257,56703,443,53583,443,8006,1986,6020,20,15,11,9
30258,47552,443,59060,443,6268,1904,4364,30,119,16,14
30259,38692,443,23262,443,10335,2523,7812,42,32,20,22
30260,34979,80,8756,80,1150,465,685,14,268,5,9
30261,42598,443,46015,443,3134,1983,1151,15,15,8,7
30262,51941,19333,59185,19333,70,70,0,1,5,1,0
30263,60450,56494,22867,56494,70,70,0,2,8,2,0
30264,51974,54759,44030,54759,70,70,0,2,7,2,0
30265,41980,443,47669,443,11377,7703,3674,26,162,19,7
30266,41741,443,53387,443,5379,1424,3955,19,507,11,8
30267,9171,80,16073,80,318,192,126,6,29,4,2
30268,40125,443,1221,443,7000,1799,5201,20,256,12,8
30269,55080,80,25795,80,2305712,80795,2224917,2771,52,1293,1478
30270,9121,80,6298,80,318,192,126,6,29,4,2
30271,56701,443,57052,443,8007,1987,6020,20,15,11,9
30272,34419,443,53851,443,2713,1386,1327,18,316,10,8
30273,9141,80,1670,80,378,192,186,7,29,4,3
30274,64892,53,50035,53,252,102,150,2,29,1,1
30275,55593,53,42641,53,193,102,91,2,29,1,1
30276,55562,53,27476,53,239,94,145,2,29,1,1
30277,65123,53,3182,53,193,102,91,2,29,1,1
30278,56884,53,31028,53,177,94,83,2,30,1,1
30279,56884,53,27069,53,177,94,83,2,30,1,1
30280,54996,53,30248,53,252,102,150,2,29,1,1
30281,49687,53,63012,53,241,94,147,2,29,1,1
30282,64154,53,35293,53,194,102,92,2,29,1,1
30283,64195,53,9148,53,270,110,160,2,29,1,1
30284,65180,53,28162,53,199,102,97,2,30,1,1
30285,65491,53,7417,53,193,102,91,2,30,1,1
30286,65266,53,39575,53,216,110,106,2,30,1,1
30287,57029,53,63160,53,246,94,152,2,30,1,1
30288,49555,53,29992,53,193,102,91,2,30,1,1
30289,56521,53,59104,53,310,126,184,2,30,1,1
30290,49876,53,33233,53,199,102,97,2,30,1,1
30291,27005,32056,3703,32056,886,126,760,2,30,1,1
30292,56212,53,11758,53,168,86,82,2,31,1,1
30293,55742,53,55832,53,193,102,91,2,30,1,1
30294,64491,53,54856,53,244,94,150,2,30,1,1
30295,55752,53,39716,53,177,94,83,2,30,1,1
30296,49355,53,45330,53,184,102,82,2,30,1,1
30297,27005,27055,18786,27055,915,126,789,2,30,1,1
30298,55580,53,57711,53,195,102,93,2,31,1,1
30299,49920,443,59929,443,6489,2137,4352,28,143,14,14
30300,51970,18752,54925,18752,70,70,0,2,8,2,0
30301,55667,19667,61736,19667,70,70,0,1,5,1,0
30302,65061,53,60210,53,733,204,529,6,40,3,3
30303,62896,993,54480,993,178,118,60,2,15,1,1
30304,9153,443,27123,443,6059,773,5286,17,29,9,8
30305,9147,443,1443,443,6334,840,5494,19,29,10,9
30306,49961,53,12419,53,377,107,270,4,45,2,2
30307,50011,53,8163,53,272,110,162,2,30,1,1
30308,65416,53,1423,53,758,102,656,2,30,1,1
30309,57385,53,34809,53,197,102,95,2,30,1,1
30310,56393,53,59869,53,197,94,103,2,30,1,1
30311,49696,53,15575,53,200,94,106,2,30,1,1
30312,55133,53,36178,53,184,102,82,2,31,1,1
30313,65485,53,34553,53,184,94,90,2,31,1,1
30314,27005,27054,38944,27054,921,126,795,2,30,1,1
30315,27005,27058,35794,27058,908,126,782,2,30,1,1
30316,63919,80,26463,80,314,192,122,6,15,4,2
30317,49359,53,64327,53,412,122,290,4,45,2,2
30318,9176,443,40179,443,6331,837,5494,19,28,10,9
30319,49856,443,13732,443,18685,4528,14157,31,151,13,18
30320,1039,53,1039,53,644,90,554,2,30,1,1
30321,64940,53,17775,53,758,102,656,2,30,1,1
30322,49684,53,44986,53,265,110,155,2,30,1,1
30323,57074,53,64644,53,195,102,93,2,30,1,1
30324,49291,53,21649,53,771,102,669,2,30,1,1
30325,55444,53,54146,53,193,102,91,2,30,1,1
30326,62758,443,37429,443,22187,14208,7979,52,130,25,27
30327,45210,443,36516,443,1699,1038,661,16,276,9,7
30328,55742,53,11069,53,193,102,91,2,31,1,1
30329,55358,53,28706,53,183,94,89,2,31,1,1
30330,60449,28260,44457,28260,70,70,0,2,8,2,0
30331,51854,80,4415,80,5438,1822,3616,17,38,11,6
30332,9166,443,13455,443,5242,902,4340,16,29,8,8
30333,58771,443,23708,443,5167,700,4467,16,15,7,9
30334,64540,53,29410,53,94,94,0,1,30,1,0
30335,50086,53,18970,53,816,102,714,2,30,1,1
30336,56814,53,30689,53,816,102,714,2,30,1,1
30337,57201,53,63092,53,195,102,93,2,30,1,1
30338,55898,53,25351,53,757,102,655,2,30,1,1
30339,51261,53,15838,53,259,86,173,2,30,1,1
30340,55890,53,43973,53,193,102,91,2,30,1,1
30341,63970,53,14367,53,200,94,106,2,30,1,1
30342,49229,53,47924,53,183,94,89,2,30,1,1
30343,65466,53,32995,53,200,102,98,2,30,1,1
30344,55962,53,28186,53,193,102,91,2,30,1,1
30345,56755,53,24589,53,184,94,90,2,30,1,1
30346,55580,53,20402,53,195,102,93,2,30,1,1
30347,57385,53,56308,53,197,102,95,2,30,1,1
30348,56212,53,23655,53,184,102,82,2,30,1,1
30349,57275,53,22195,53,199,102,97,2,31,1,1
30350,49966,53,5626,53,168,78,90,2,30,1,1
30351,55890,53,44710,53,193,102,91,2,31,1,1
30352,57226,53,39140,53,178,94,84,2,31,1,1
30353,64955,53,63777,53,210,110,100,2,30,1,1
30354,55752,53,65323,53,177,94,83,2,30,1,1
30355,64526,53,11461,53,377,94,283,2,30,1,1
30356,55337,53,8844,53,198,102,96,2,31,1,1
30357,55391,53,35560,53,210,110,100,2,31,1,1
30358,56892,53,51389,53,199,102,97,2,31,1,1
30359,56004,53,52519,53,178,94,84,2,31,1,1
30360,6881,6881,2586,6881,237,118,119,2,1200,1,1
30361,65304,53,24960,53,195,102,93,2,31,1,1
30362,53258,443,49616,443,26995,3729,23266,40,137,16,24
30363,64016,53,59779,53,184,94,90,2,31,1,1
30364,57464,443,33460,443,7715,1772,5943,25,275,13,12
30365,57470,22796,55699,22796,2224,1852,372,33,1565,27,6
30366,65491,53,33767,53,193,102,91,2,31,1,1
30367,55441,53,20150,53,216,110,106,2,31,1,1
30368,55776,53,14354,53,271,93,178,4,31,2,2
30369,57470,26247,60262,26247,1320,1320,0,21,1624,21,0
30370,57228,53,47856,53,199,102,97,2,31,1,1
30371,35186,443,1570,443,130,70,60,3,5,2,1
30372,58767,443,20066,443,5167,700,4467,16,15,7,9
30373,52441,53,0,0,86,86,0,1,30,1,0
30374,51968,43622,9817,43622,70,70,0,2,8,2,0
30375,51969,37558,21407,37558,70,70,0,2,8,2,0
30376,43109,80,31634,80,7607,3563,4044,18,20,9,9
30377,56704,53,49275,53,177,94,83,2,31,1,1
30378,57591,53,13897,53,165,78,87,2,31,1,1
30379,55934,53,39869,53,196,102,94,2,31,1,1
30380,6882,27032,16689,27032,1200,1200,0,9,1201,9,0
30381,56700,443,13069,443,8059,2039,6020,20,16,11,9
30382,58770,443,24221,443,6033,770,5263,18,15,8,10
30383,53748,51413,19666,51413,70,70,0,1,5,1,0
30384,46771,80,6345,80,2066,1369,697,13,84,7,6
30385,34418,443,25762,443,6402,1595,4807,23,316,12,11
30386,59982,445,0,0,66,66,0,1,0,1,0
30387,59989,445,0,0,66,66,0,1,0,1,0
30388,59986,445,0,0,66,66,0,1,0,1,0
30389,59985,445,0,0,66,66,0,1,0,1,0
30390,59984,445,0,0,66,66,0,1,0,1,0
30391,59979,445,0,0,66,66,0,1,0,1,0
30392,1903,43890,0,0,66,66,0,1,0,1,0
30393,64573,445,0,0,70,70,0,1,0,1,0
30394,1034,26296,0,0,159,159,0,1,0,1,0
30395,59734,445,0,0,70,70,0,1,0,1,0
30396,59732,445,0,0,70,70,0,1,0,1,0
30397,59733,445,0,0,70,70,0,1,0,1,0
30398,64569,445,0,0,70,70,0,1,0,1,0
30399,64567,445,0,0,70,70,0,1,0,1,0
30400,64565,445,0,0,70,70,0,1,0,1,0
30401,59728,445,0,0,70,70,0,1,0,1,0
30402,22409,55442,0,0,74,74,0,1,0,1,0
30403,59726,445,0,0,70,70,0,1,0,1,0
30404,12458,161,0,0,85,85,0,1,0,1,0
30405,51414,22,0,0,60,60,0,1,0,1,0
30406,41744,37965,0,0,62,62,0,1,0,1,0
30407,45908,33330,0,0,60,60,0,1,0,1,0
30408,12737,35440,0,0,62,62,0,1,0,1,0
30409,56462,37965,0,0,66,66,0,1,0,1,0
30410,14042,22114,0,0,62,62,0,1,0,1,0
30411,16387,8455,0,0,60,60,0,1,0,1,0
30412,16387,49252,0,0,60,60,0,1,0,1,0
30413,16387,35244,0,0,60,60,0,1,0,1,0
30414,7664,2149,0,0,66,66,0,1,0,1,0
30415,64563,445,0,0,70,70,0,1,0,1,0
30416,64561,445,0,0,70,70,0,1,0,1,0
30417,64557,445,0,0,70,70,0,1,0,1,0
30418,36237,23,0,0,60,60,0,1,0,1,0
30419,59718,445,0,0,70,70,0,1,0,1,0
30420,59974,445,0,0,66,66,0,1,0,1,0
30421,64556,445,0,0,70,70,0,1,0,1,0
30422,59970,445,0,0,66,66,0,1,0,1,0
30423,3074,64147,0,0,62,62,0,1,0,1,0
30424,59969,445,0,0,66,66,0,1,0,1,0
30425,59967,445,0,0,66,66,0,1,0,1,0
30426,21759,51505,0,0,62,62,0,1,0,1,0
30427,19617,39004,0,0,62,62,0,1,0,1,0
30428,14148,1,0,0,66,66,0,1,0,1,0
30429,7655,23,0,0,60,60,0,1,0,1,0
30430,59965,445,0,0,66,66,0,1,0,1,0
30431,62731,21247,0,0,62,62,0,1,0,1,0
30432,59711,445,0,0,70,70,0,1,0,1,0
30433,59710,445,0,0,70,70,0,1,0,1,0
30434,54593,51505,0,0,66,66,0,1,0,1,0
30435,57131,26296,0,0,145,145,0,1,0,1,0
30436,14183,26467,0,0,62,62,0,1,0,1,0
30437,62912,26467,0,0,62,62,0,1,0,1,0
30438,31500,1,0,0,146,146,0,1,0,1,0
30439,64548,445,0,0,70,70,0,1,0,1,0
30440,5859,11392,0,0,62,62,0,1,0,1,0
30441,64544,445,0,0,70,70,0,1,0,1,0
30442,64540,445,0,0,70,70,0,1,0,1,0
30443,59705,445,0,0,70,70,0,1,0,1,0
30444,59703,445,0,0,70,70,0,1,0,1,0
30445,59954,445,0,0,66,66,0,1,0,1,0
30446,19634,64147,0,0,62,62,0,1,0,1,0
30447,54351,23,0,0,60,60,0,1,0,1,0
30448,59699,445,0,0,70,70,0,1,0,1,0
30449,12262,22114,0,0,146,146,0,1,0,1,0
30450,59698,445,0,0,70,70,0,1,0,1,0
30451,41249,50584,0,0,62,62,0,1,0,1,0
30452,59947,445,0,0,66,66,0,1,0,1,0
30453,64530,445,0,0,70,70,0,1,0,1,0
30454,64346,51505,0,0,66,66,0,1,0,1,0
30455,53906,44512,0,0,62,62,0,1,0,1,0
30456,59944,445,0,0,66,66,0,1,0,1,0
30457,35015,17,0,0,60,60,0,1,0,1,0
30458,59693,445,0,0,70,70,0,1,0,1,0
30459,55600,22,0,0,60,60,0,1,0,1,0
30460,44466,443,54385,443,466,392,74,4,0,3,1
30461,54779,50584,0,0,62,62,0,1,0,1,0
30462,59936,445,0,0,66,66,0,1,0,1,0
30463,59935,445,0,0,66,66,0,1,0,1,0
30464,24910,64147,0,0,66,66,0,1,0,1,0
30465,60514,39004,0,0,62,62,0,1,0,1,0
30466,46640,4443,0,0,60,60,0,1,0,1,0
30467,17378,44847,0,0,66,66,0,1,0,1,0
30468,60141,62413,0,0,66,66,0,1,0,1,0
30469,58475,11392,0,0,66,66,0,1,0,1,0
30470,59680,445,0,0,70,70,0,1,0,1,0
30471,1024,22114,0,0,146,146,0,1,0,1,0
30472,64518,445,0,0,70,70,0,1,0,1,0
30473,64516,445,0,0,70,70,0,1,0,1,0
30474,64517,445,0,0,70,70,0,1,0,1,0
30475,59919,445,0,0,66,66,0,1,0,1,0
30476,59922,445,0,0,66,66,0,1,0,1,0
30477,59917,445,0,0,66,66,0,1,0,1,0
30478,59920,445,0,0,66,66,0,1,0,1,0
30479,59921,445,0,0,66,66,0,1,0,1,0
30480,59918,445,0,0,66,66,0,1,0,1,0
30481,59916,445,0,0,66,66,0,1,0,1,0
30482,59914,445,0,0,66,66,0,1,0,1,0
30483,443,51550,0,0,100,100,0,1,0,1,0
30484,59677,445,0,0,70,70,0,1,0,1,0
30485,45682,25604,0,0,62,62,0,1,0,1,0
30486,59763,25604,0,0,66,66,0,1,0,1,0
30487,59486,50584,0,0,62,62,0,1,0,1,0
30488,56386,50584,0,0,66,66,0,1,0,1,0
30489,443,61686,0,0,1484,1484,0,1,0,1,0
30490,58371,23,0,0,60,60,0,1,0,1,0
30491,17957,64097,0,0,66,66,0,1,0,1,0
30492,63988,50584,0,0,66,66,0,1,0,1,0
30493,49167,19750,0,0,66,66,0,1,0,1,0
30494,50806,51505,0,0,66,66,0,1,0,1,0
30495,35864,44847,0,0,78,78,0,1,0,1,0
30496,37028,51505,0,0,62,62,0,1,0,1,0
30497,57937,22114,0,0,146,146,0,1,0,1,0
30498,59673,445,0,0,70,70,0,1,0,1,0
30499,59671,445,0,0,70,70,0,1,0,1,0
30500,64511,445,0,0,70,70,0,1,0,1,0
30501,64509,445,0,0,70,70,0,1,0,1,0
30502,57538,23,0,0,60,60,0,1,0,1,0
30503,64499,445,0,0,70,70,0,1,0,1,0
30504,64504,445,0,0,70,70,0,1,0,1,0
30505,14336,64147,0,0,62,62,0,1,0,1,0
30506,0,0,0,0,124,64,60,2,0,1,1
30507,59669,445,0,0,70,70,0,1,0,1,0
30508,59900,445,0,0,66,66,0,1,0,1,0
30509,59902,445,0,0,66,66,0,1,0,1,0
30510,59899,445,0,0,66,66,0,1,0,1,0
30511,27337,51505,0,0,62,62,0,1,0,1,0
30512,50052,65008,0,0,60,60,0,1,0,1,0
30513,54280,3385,0,0,60,60,0,1,0,1,0
30514,723,3389,0,0,74,74,0,1,0,1,0
30515,1045,36237,0,0,66,66,0,1,0,1,0
30516,5087,22114,0,0,66,66,0,1,0,1,0
30517,64497,445,0,0,70,70,0,1,0,1,0
30518,64490,445,0,0,70,70,0,1,0,1,0
30519,64489,445,0,0,70,70,0,1,0,1,0
30520,64485,445,0,0,70,70,0,1,0,1,0
30521,47910,7464,0,0,60,60,0,1,0,1,0
30522,59662,445,0,0,70,70,0,1,0,1,0
30523,63461,51505,0,0,66,66,0,1,0,1,0
30524,12260,51505,0,0,62,62,0,1,0,1,0
30525,59660,445,0,0,70,70,0,1,0,1,0
30526,59659,445,0,0,70,70,0,1,0,1,0
30527,34400,39004,0,0,74,74,0,1,0,1,0
30528,59658,445,0,0,70,70,0,1,0,1,0
30529,59657,445,0,0,70,70,0,1,0,1,0
30530,52695,26467,0,0,66,66,0,1,0,1,0
30531,59654,445,0,0,70,70,0,1,0,1,0
30532,59651,445,0,0,70,70,0,1,0,1,0
30533,64478,445,0,0,70,70,0,1,0,1,0
30534,64477,445,0,0,70,70,0,1,0,1,0
30535,64474,445,0,0,70,70,0,1,0,1,0
30536,7286,44847,0,0,66,66,0,1,0,1,0
30537,61766,44847,0,0,62,62,0,1,0,1,0
30538,59889,445,0,0,66,66,0,1,0,1,0
30539,59639,445,0,0,70,70,0,1,0,1,0
30540,59638,445,0,0,70,70,0,1,0,1,0
30541,59634,445,0,0,70,70,0,1,0,1,0
30542,11450,57470,0,0,62,62,0,1,0,1,0
30543,26872,44847,0,0,62,62,0,1,0,1,0
30544,59628,445,0,0,70,70,0,1,0,1,0
30545,56766,53,34150,53,204,104,100,2,30,1,1
30546,55022,53,30402,53,772,103,669,2,30,1,1
30547,56004,53,42302,53,172,88,84,2,30,1,1
30548,64068,53,64068,53,1184,83,1101,4,59,2,2
30549,55742,53,41755,53,186,95,91,2,31,1,1
30550,57321,53,34343,53,762,98,664,2,30,1,1
30551,49177,53,53466,53,735,88,647,2,30,1,1
30552,65264,53,2001,53,738,86,652,2,30,1,1
30553,64810,53,33589,53,272,93,179,4,33,2,2
30554,27005,30008,3198,30008,890,126,764,2,31,1,1
30555,49759,53,54195,53,164,84,80,2,31,1,1
30556,50930,443,59751,443,9354,2370,6984,24,16,13,11
30557,63154,443,63154,443,4642,1735,2907,19,30,11,8
30558,58751,443,12034,443,10505,6856,3649,29,16,15,14
30559,55025,80,12764,80,1142,626,516,8,180,5,3
30560,50299,53,31351,53,770,102,668,2,30,1,1
30561,49314,443,47530,443,3185,2263,922,18,25,9,9
30562,55580,53,25974,53,190,97,93,2,30,1,1
30563,51940,26399,4423,26399,66,66,0,1,5,1,0
30564,49742,53,64012,53,731,91,640,2,30,1,1
30565,39718,443,11292,443,10186,3128,7058,26,16,13,13
30566,60445,20555,38160,20555,70,70,0,1,5,1,0
30567,64172,53,18592,53,194,99,95,2,30,1,1
30568,60776,4156,29632,4156,66,66,0,1,5,1,0
30569,52607,443,60417,443,18341,14819,3522,59,1044,31,28
30570,57226,53,4215,53,88,88,0,1,30,1,0
30571,55187,53,20282,53,256,93,163,2,30,1,1
30572,55337,53,28465,53,196,100,96,2,30,1,1
30573,65304,53,37771,53,190,97,93,2,30,1,1
30574,56974,53,21612,53,814,110,704,2,30,1,1
30575,27005,27017,35539,27017,873,126,747,2,31,1,1
30576,49313,443,5265,443,3185,2263,922,18,25,9,9
30577,55238,53,7598,53,168,86,82,2,31,1,1
30578,52478,443,48158,443,9844,3089,6755,21,133,10,11
30579,58754,443,12477,443,7674,4959,2715,24,16,13,11
30580,57992,80,4887,80,10247,3696,6551,32,33,16,16
30581,55776,53,13718,53,182,93,89,3,33,2,1
30582,51966,18716,12930,18716,70,70,0,2,8,2,0
30583,58745,443,47699,443,14654,9694,4960,36,17,19,17
30584,58749,443,22893,443,6246,4267,1979,21,16,11,10
30585,56829,53,58561,53,170,87,83,2,30,1,1
30586,64711,53,23065,53,760,97,663,2,30,1,1
30587,55211,53,19820,53,760,97,663,2,30,1,1
30588,64902,53,48255,53,762,98,664,2,30,1,1
30589,56509,53,41875,53,747,90,657,2,31,1,1
30590,57307,53,57558,53,170,87,83,2,31,1,1
30591,61850,34021,0,0,66,66,0,1,91,1,0
30592,49421,5228,11226,5228,8399,1901,6498,39,1562,16,23
30593,27005,30005,45159,30005,890,126,764,2,31,1,1
30594,33525,53,23050,53,168,78,90,2,31,1,1
30595,56128,53,30035,53,744,89,655,2,31,1,1
30596,55820,53,6966,53,168,86,82,2,31,1,1
30597,56470,53,21021,53,196,100,96,2,31,1,1
30598,64421,53,64542,53,172,88,84,2,31,1,1
30599,56204,53,35079,53,190,97,93,2,31,1,1
30600,64081,443,44288,443,7280,2277,5003,19,136,9,10
30601,50265,34311,31562,34311,480,149,331,2,1200,1,1
30602,50324,53,1643,53,754,94,660,2,31,1,1
30603,57907,53,57907,53,228,97,131,2,31,1,1
30604,56180,53,48216,53,757,98,659,2,31,1,1
30605,49918,53,24031,53,196,100,96,2,31,1,1
30606,56892,53,3600,53,198,101,97,2,31,1,1
30607,55067,53,2725,53,164,84,80,2,31,1,1
30608,57302,53,18711,53,770,102,668,2,31,1,1
30609,55413,53,9671,53,216,110,106,2,31,1,1
30610,64976,53,22301,53,186,95,91,2,31,1,1
30611,55912,53,49501,53,198,101,97,2,31,1,1
30612,56310,53,55159,53,760,97,663,2,31,1,1
30613,55283,53,5653,53,754,94,660,2,31,1,1
30614,64628,53,57301,53,198,101,97,2,31,1,1
30615,55970,53,39090,53,810,108,702,2,31,1,1
30616,49410,53,65177,53,172,88,84,2,31,1,1
30617,56152,53,61194,53,190,97,93,2,31,1,1
30618,55808,53,45901,53,738,86,652,2,31,1,1
30619,64692,53,27620,53,760,97,663,2,31,1,1
30620,55399,53,7515,53,176,90,86,2,31,1,1
30621,56330,53,30393,53,198,101,97,2,31,1,1
30622,56461,53,50926,53,760,96,664,2,31,1,1
30623,57363,53,6725,53,172,88,84,2,31,1,1
30624,49451,53,46529,53,757,98,659,2,31,1,1
30625,51234,443,8944,443,31736,1463,30273,43,32,14,29
30626,50010,53,39739,53,756,95,661,2,31,1,1
30627,57418,53,27035,53,758,96,662,2,31,1,1
30628,55969,53,43128,53,731,91,640,2,31,1,1
30629,65515,53,32592,53,204,104,100,2,31,1,1
30630,50518,53,60220,53,802,104,698,2,31,1,1
30631,40940,443,13530,443,12685,7319,5366,36,398,15,21
30632,30960,45742,3769,45742,330,330,0,6,3609,6,0
30633,44847,51413,1303,51413,475,150,325,2,1200,1,1
30634,30960,45741,31412,45741,330,330,0,6,3609,6,0
30635,59629,445,0,0,70,70,0,1,0,1,0
30636,43063,57470,0,0,62,62,0,1,0,1,0
30637,42366,57470,0,0,66,66,0,1,0,1,0
30638,57555,35440,0,0,66,66,0,1,0,1,0
30639,16013,35253,0,0,66,66,0,1,0,1,0
30640,1025,51221,0,0,62,62,0,1,0,1,0
30641,8592,35993,0,0,66,66,0,1,0,1,0
30642,23415,11392,0,0,66,66,0,1,0,1,0
30643,52252,46314,0,0,62,62,0,1,0,1,0
30644,64469,445,0,0,70,70,0,1,0,1,0
30645,64467,445,0,0,70,70,0,1,0,1,0
30646,59617,445,0,0,70,70,0,1,0,1,0
30647,49298,53,53447,53,230,102,128,2,30,1,1
30648,64366,53,57312,53,234,94,140,2,30,1,1
30649,35339,443,19701,443,6677,1006,5671,19,27,11,8
30650,56698,443,46123,443,8058,2038,6020,20,15,11,9
30651,49773,53,59337,53,225,110,115,2,30,1,1
30652,64559,53,24538,53,182,94,88,2,30,1,1
30653,56004,53,58058,53,178,94,84,2,30,1,1
30654,49953,53,45166,53,214,110,104,2,30,1,1
30655,46773,80,41646,80,2075,1376,699,13,83,7,6
30656,38691,443,60473,443,90369,3417,86952,95,15,30,65
30657,60779,40010,64094,40010,316,136,180,6,5,3,3
30658,60863,443,14093,443,134,60,74,3,5,2,1
30659,63925,18912,12626,18912,70,70,0,1,4,1,0
30660,64391,53,9777,53,209,102,107,2,29,1,1
30661,56204,53,35086,53,195,102,93,2,30,1,1
30662,46774,80,26120,80,2074,1375,699,13,83,7,6
30663,43879,443,28850,443,71822,4809,67013,112,241,54,58
30664,34312,80,11906,80,874,500,374,10,14,6,4
30665,64665,53,19631,53,181,94,87,2,31,1,1
30666,38936,443,16870,443,3217,2090,1127,16,255,9,7
30667,56470,53,41515,53,198,102,96,2,30,1,1
30668,40306,443,40306,443,4520,1613,2907,19,26,11,8
30669,57434,443,22130,443,9237,2447,6790,30,16,14,16
30670,56984,53,20901,53,199,102,97,2,29,1,1
30671,49906,53,24653,53,200,94,106,2,29,1,1
30672,50427,443,32859,443,783009,84254,698755,776,706,250,526
30673,57122,53,4958,53,199,102,97,2,29,1,1
30674,45862,443,6882,443,234,234,0,4,11,4,0
30675,49229,53,40938,53,183,94,89,2,29,1,1
30676,55358,53,38932,53,183,94,89,2,29,1,1
30677,65430,53,43606,53,305,94,211,2,29,1,1
30678,57122,53,16456,53,199,102,97,2,29,1,1
30679,56984,53,7040,53,199,102,97,2,29,1,1
30680,56984,53,53152,53,199,102,97,2,29,1,1
30681,49949,53,18474,53,193,102,91,2,30,1,1
30682,34415,443,34473,443,6397,1590,4807,23,315,12,11
30683,58763,443,45079,443,5108,700,4408,15,15,7,8
30684,63913,24806,2171,24806,630,508,122,9,15,7,2
30685,51794,80,29436,80,5480,3236,2244,19,47,12,7
30686,57275,53,57643,53,199,102,97,2,30,1,1
30687,55752,53,32253,53,177,94,83,2,30,1,1
30688,37565,123,4980,123,184,94,90,2,30,1,1
30689,50581,53,22242,53,177,94,83,2,30,1,1
30690,63033,443,16495,443,6869,3059,3810,30,123,15,15
30691,65273,53,64303,53,226,102,124,2,30,1,1
30692,49181,53,18919,53,184,102,82,2,30,1,1
30693,49167,53,55211,53,258,94,164,2,30,1,1
30694,43163,443,21681,443,10100,3072,7028,25,16,14,11
30695,36368,80,54133,80,78,78,0,1,5,1,0
30696,56766,53,19363,53,210,110,100,2,30,1,1
30697,52914,443,10656,443,70,70,0,1,5,1,0
30698,56894,53,27064,53,178,94,84,2,30,1,1
30699,64949,53,27960,53,472,124,348,4,39,2,2
30700,55489,53,44022,53,185,102,83,2,30,1,1
30701,57590,53,59223,53,260,86,174,2,30,1,1
30702,60462,80,40235,80,1588,553,1035,10,75,6,4
30703,56422,53,41175,53,199,102,97,2,30,1,1
30704,55808,53,32888,53,183,94,89,2,30,1,1
30705,64445,53,20808,53,269,94,175,2,30,1,1
30706,46378,443,41415,443,10675,4478,6197,25,16,13,12
30707,43025,443,51895,443,25223,13115,12108,63,116,33,30
30708,27005,33026,58261,33026,879,126,753,3,32,2,1
30709,55808,53,36895,53,183,94,89,2,30,1,1
30710,34416,443,50099,443,6396,1589,4807,23,315,12,11
30711,14421,443,39143,443,15204,8747,6457,83,167,44,39
30712,56646,80,51204,80,234,234,0,4,12,4,0
30713,64559,53,29849,53,198,110,88,2,30,1,1
30714,64172,53,61363,53,361,99,262,4,54,2,2
30715,56766,53,15187,53,210,110,100,2,30,1,1
30716,49812,53,48839,53,392,101,291,4,39,2,2
30717,56236,53,43042,53,241,94,147,2,30,1,1
30718,55934,53,48489,53,196,102,94,2,30,1,1
30719,43162,443,31273,443,10096,3002,7094,25,16,13,12
30720,55934,53,60885,53,196,102,94,2,30,1,1
30721,49181,53,64897,53,168,86,82,2,30,1,1
30722,49364,53,61056,53,779,86,693,2,30,1,1
30723,51814,80,8693,80,11975,2907,9068,24,38,14,10
30724,56766,53,59139,53,210,110,100,2,30,1,1
30725,56892,53,6597,53,199,102,97,2,30,1,1
30726,64068,53,64068,53,1184,83,1101,4,59,2,2
30727,64579,53,56844,53,178,94,84,2,30,1,1
30728,49837,53,44716,53,734,86,648,2,30,1,1
30729,49734,53,20221,53,216,110,106,2,30,1,1
30730,50966,443,50616,443,17161,1619,15542,18,143,4,14
30731,55391,53,33139,53,210,110,100,2,30,1,1
30732,17750,44597,35749,44597,481,150,331,2,1200,1,1
30733,27005,33084,13746,33084,906,126,780,2,30,1,1
30734,55912,53,11122,53,199,102,97,2,30,1,1
30735,57385,53,7964,53,197,102,95,2,30,1,1
30736,65491,53,31323,53,193,102,91,2,33,1,1
30737,9916,53,9916,53,235,90,145,2,33,1,1
30738,53146,50393,21783,50393,70,70,0,2,8,2,0
30739,50700,80,7007,80,142,142,0,1,5,1,0
30740,65493,443,45559,443,438968,12780,426188,449,16,157,292
30741,62525,7080,62525,7080,2960,432,2528,11,15,6,5
30742,64276,53,63257,53,398,105,293,4,46,2,2
30743,50195,53,23918,53,199,102,97,2,30,1,1
30744,64879,53,48255,53,356,118,238,2,30,1,1
30745,50581,53,15550,53,185,102,83,2,30,1,1
30746,64579,53,27350,53,178,94,84,2,30,1,1
30747,50168,53,56159,53,211,78,133,2,30,1,1
30748,64867,53,35181,53,184,86,98,2,30,1,1
30749,36406,5228,24879,5228,17762,4403,13359,92,616,47,45
30750,43676,443,26633,443,5903,1367,4536,18,16,10,8
30751,9192,443,26579,443,318,192,126,6,22,4,2
30752,56829,53,52849,53,185,102,83,2,30,1,1
30753,55133,53,13417,53,168,86,82,2,30,1,1
30754,37027,53,20580,53,168,78,90,2,30,1,1
30755,1931,53,26121,53,210,78,132,2,30,1,1
30756,56152,53,29649,53,195,102,93,2,30,1,1
30757,56704,53,2195,53,177,94,83,2,30,1,1
30758,53221,53,3242,53,165,78,87,2,30,1,1
30759,64421,53,34149,53,178,94,84,2,30,1,1
30760,49174,53,10014,53,323,107,216,4,47,2,2
30761,49192,8106,32598,8106,2050,1277,773,15,15,8,7
30762,46772,80,10171,80,2068,1371,697,13,83,7,6
30763,63915,23225,23322,23225,564,382,182,9,15,6,3
30764,46770,80,34528,80,2068,1371,697,13,83,7,6
30765,56699,443,19537,443,8006,1986,6020,20,15,11,9
30766,48086,443,38296,443,3138,2011,1127,16,255,9,7
30767,35340,443,44611,443,7470,1088,6382,21,27,12,9
30768,65304,53,22589,53,308,97,211,4,33,2,2
30769,51967,12110,50176,12110,70,70,0,2,7,2,0
30770,52477,443,18110,443,8788,2185,6603,15,134,7,8
30771,46769,80,58026,80,3589,2432,1157,17,86,9,8
30772,53721,443,43069,443,70,70,0,2,7,2,0
30773,48135,443,38274,443,6426,1858,4568,22,16,12,10
30774,42438,443,37580,443,7747,1737,6010,27,316,13,14
30775,63924,26328,47247,26328,70,70,0,1,4,1,0
30776,63923,59177,22656,59177,70,70,0,1,4,1,0
30777,51939,34393,16792,34393,70,70,0,1,5,1,0
30778,51938,11218,41228,11218,70,70,0,1,5,1,0
30779,49577,53,58264,53,389,134,255,2,29,1,1
30780,49734,53,21745,53,216,110,106,2,30,1,1
30781,55238,53,10880,53,168,86,82,2,30,1,1
30782,65304,53,31926,53,195,102,93,2,29,1,1
30783,50347,53,2188,53,756,94,662,2,29,1,1
30784,49675,53,62598,53,199,102,97,2,29,1,1
30785,56496,53,36684,53,164,86,78,2,29,1,1
30786,65494,443,61063,443,92044,4379,87665,102,16,37,65
30787,55776,53,26753,53,271,93,178,4,30,2,2
30788,56004,53,60416,53,178,94,84,2,29,1,1
30789,49355,53,6777,53,168,86,82,2,29,1,1
30790,49825,53,24008,53,814,110,704,2,29,1,1
30791,55890,53,15703,53,193,102,91,2,29,1,1
30792,57122,53,57720,53,199,102,97,2,29,1,1
30793,56717,53,63655,53,178,94,84,2,30,1,1
30794,56416,53,40943,53,969,86,883,2,29,1,1
30795,64955,53,3638,53,210,110,100,2,29,1,1
30796,55238,53,60752,53,168,86,82,2,29,1,1
30797,49734,53,34033,53,216,110,106,2,30,1,1
30798,1929,53,20387,53,260,86,174,2,30,1,1
30799,55489,53,35095,53,177,94,83,2,30,1,1
30800,27005,32038,39933,32038,868,126,742,2,30,1,1
30801,56263,53,57632,53,214,110,104,2,31,1,1
30802,55884,53,23694,53,438,180,258,6,30,3,3
30803,57307,53,5441,53,177,94,83,2,30,1,1
30804,57057,53,64992,53,194,102,92,2,31,1,1
30805,55820,53,20613,53,168,86,82,2,30,1,1
30806,58766,443,24380,443,6031,770,5261,18,15,8,10
30807,50081,443,5325,443,11958,2983,8975,28,48,15,13
30808,49650,443,26849,443,92597,47158,45439,747,1187,422,325
30809,35341,443,55051,443,1473,988,485,12,26,7,5
30810,35336,443,36436,443,6821,1076,5745,21,27,12,9
30811,64810,53,44808,53,272,93,179,4,33,2,2
30812,60446,6882,37809,6882,70,70,0,1,5,1,0
30813,51275,10924,1826,10924,70,70,0,1,5,1,0
30814,14429,443,41458,443,4118,2905,1213,27,87,16,11
30815,36314,443,44182,443,6287,1476,4811,25,16,13,12
30816,64632,443,35078,443,8391,5178,3213,41,256,20,21
30817,51667,25826,43054,25826,9415,9415,0,11,30,11,0
30818,49986,53,46060,53,779,110,669,2,30,1,1
30819,55808,53,41787,53,183,94,89,2,30,1,1
30820,49935,53,57757,53,775,102,673,2,30,1,1
30821,49949,53,15582,53,193,102,91,2,30,1,1
30822,55441,53,20729,53,216,110,106,2,30,1,1
30823,55337,53,58173,53,198,102,96,2,30,1,1
30824,27005,33086,33799,33086,877,126,751,2,30,1,1
30825,50605,80,49790,80,1657,1247,410,8,15,5,3
30826,60447,36396,58005,36396,70,70,0,1,5,1,0
30827,51796,80,13753,80,2188,1282,906,13,47,8,5
30828,1932,53,37462,53,210,78,132,2,30,1,1
30829,59899,3389,59899,3389,3504,1790,1714,17,32,9,8
30830,49610,53,48262,53,241,94,147,2,30,1,1
30831,50195,53,43781,53,199,102,97,2,30,1,1
30832,64016,53,52366,53,184,94,90,2,30,1,1
30833,64985,53,37843,53,194,102,92,2,30,1,1
30834,49759,53,54239,53,166,86,80,2,30,1,1
30835,65018,53,21026,53,168,94,74,2,31,1,1
30836,55912,53,4881,53,199,102,97,2,31,1,1
30837,57363,53,22472,53,178,94,84,2,30,1,1
30838,43164,443,24293,443,10030,3002,7028,24,16,13,11
30839,34417,443,59906,443,6378,1571,4807,23,315,12,11
30840,14420,443,3846,443,5103,3164,1939,32,168,17,15
30841,43161,443,23414,443,10102,3072,7030,25,16,14,11
30842,51795,80,9427,80,3955,2325,1630,18,47,11,7
30843,51793,80,57988,80,3960,2330,1630,18,47,11,7
30844,51792,80,21440,80,3840,2265,1575,16,47,10,6
30845,50070,443,16090,443,9148,1570,7578,31,257,13,18
30846,50699,443,40507,443,9382,3057,6325,35,1220,17,18
30847,53631,443,46993,443,31965,26754,5211,63,22,34,29
30848,50187,53,34456,53,168,78,90,2,30,1,1
30849,39115,443,62542,443,335190,17497,317693,449,42,211,238
30850,65220,53,55029,53,178,94,84,2,30,1,1
30851,55441,53,33231,53,216,110,106,2,30,1,1
30852,49953,53,46343,53,214,110,104,2,30,1,1
30853,56422,53,18940,53,199,102,97,2,30,1,1
30854,64956,53,29274,53,196,102,94,2,30,1,1
30855,64814,53,26949,53,165,86,79,2,31,1,1
30856,65485,53,26521,53,184,94,90,2,31,1,1
30857,65238,53,15919,53,168,86,82,2,31,1,1
30858,65275,53,14086,53,168,86,82,2,31,1,1
30859,55413,53,59906,53,216,110,106,2,31,1,1
30860,41886,53,64973,53,168,78,90,2,31,1,1
30861,55186,443,62291,443,7375,1549,5826,31,353,10,21
30862,65249,53,43445,53,733,94,639,2,30,1,1
30863,56330,53,49598,53,199,102,97,2,30,1,1
30864,27005,33111,34326,33111,895,126,769,2,30,1,1
30865,50340,53,17641,53,189,102,87,2,31,1,1
30866,64450,53,63147,53,196,94,102,2,31,1,1
30867,55051,53,44193,53,167,86,81,2,31,1,1
30868,49532,53,18389,53,443,182,261,6,31,3,3
30869,56979,53,43376,53,180,94,86,2,31,1,1
30870,57307,53,15696,53,177,94,83,2,30,1,1
30871,56979,53,3476,53,180,94,86,2,30,1,1
30872,27005,32025,26233,32025,887,126,761,2,30,1,1
30873,64964,53,59512,53,197,102,95,2,31,1,1
30874,56470,53,54674,53,198,102,96,2,31,1,1
30875,45211,443,19368,443,1629,968,661,15,275,8,7
30876,57142,53,22612,53,165,86,79,2,31,1,1
30877,56152,53,5986,53,195,102,93,2,31,1,1
30878,49849,53,33985,53,173,94,79,2,31,1,1
30879,56575,443,16584,443,14284,5729,8555,31,61,19,12
30880,50167,53,41841,53,260,86,174,2,30,1,1
30881,56770,53,31600,53,779,86,693,2,30,1,1
30882,55962,53,7744,53,193,102,91,2,30,1,1
30883,27005,27111,65327,27111,913,126,787,2,30,1,1
30884,49626,53,39799,53,969,86,883,2,30,1,1
30885,64592,53,28124,53,197,94,103,2,30,1,1
30886,64154,53,43771,53,194,102,92,2,30,1,1
30887,55238,53,27709,53,168,86,82,2,31,1,1
30888,64956,53,26166,53,196,102,94,2,30,1,1
30889,56101,53,38415,53,194,102,92,2,31,1,1
30890,64814,53,35715,53,173,94,79,2,30,1,1
30891,57228,53,47428,53,199,102,97,2,30,1,1
30892,55399,53,9206,53,180,94,86,2,31,1,1
30893,65039,53,20269,53,258,94,164,2,31,1,1
30894,64976,53,40742,53,193,102,91,2,31,1,1
30895,56892,53,32986,53,199,102,97,2,31,1,1
30896,49918,53,25518,53,198,102,96,2,31,1,1
30897,64547,53,28372,53,367,102,265,2,31,1,1
30898,56063,53,29074,53,196,102,94,2,31,1,1
30899,55580,53,4575,53,195,102,93,2,31,1,1
30900,32299,40034,44134,40034,253,190,63,2,31,1,1
30901,47473,443,41796,443,11072,3983,7089,27,186,15,12
30902,51388,443,47694,443,4209,1570,2639,14,136,7,7
30903,55850,443,57703,443,4344,2189,2155,15,126,7,8
30904,43674,80,54012,80,3714,1646,2068,18,186,9,9
30905,55392,53,27900,53,195,102,93,2,31,1,1
30906,64624,53,46919,53,228,94,134,2,30,1,1
30907,49918,53,41805,53,198,102,96,2,30,1,1
30908,49410,53,54828,53,178,94,84,2,30,1,1
30909,56330,53,48273,53,199,102,97,2,30,1,1
30910,49671,53,2651,53,166,86,80,2,31,1,1
30911,51964,1103,52197,1103,70,70,0,2,8,2,0
30912,58756,443,10542,443,5168,700,4468,16,15,7,9
30913,51451,443,12053,443,6957,1775,5182,22,17,12,10
30914,57891,80,37829,80,6518,1210,5308,15,24,8,7
30915,56553,443,45538,443,116577,6817,109760,137,62,54,83
30916,64985,53,34087,53,194,102,92,2,30,1,1
30917,51235,80,15389,80,3588,2362,1226,24,87,13,11
30918,53118,443,63279,443,21933,11660,10273,206,188,114,92
30919,51963,21638,62624,21638,70,70,0,2,8,2,0
30920,50321,53,23352,53,438,180,258,6,30,3,3
30921,65018,53,37688,53,152,78,74,2,30,1,1
30922,56204,53,16211,53,195,102,93,2,30,1,1
30923,55399,53,43504,53,180,94,86,2,30,1,1
30924,59874,445,0,0,66,66,0,1,0,1,0
30925,59871,445,0,0,66,66,0,1,0,1,0
30926,7347,56205,0,0,66,66,0,1,0,1,0
30927,34731,22114,0,0,146,146,0,1,0,1,0
30928,64460,445,0,0,70,70,0,1,0,1,0
30929,61000,50432,0,0,146,146,0,1,0,1,0
30930,56098,55442,0,0,66,66,0,1,0,1,0
30931,56218,43890,0,0,66,66,0,1,0,1,0
30932,26601,22114,0,0,66,66,0,1,0,1,0
30933,64455,445,0,0,70,70,0,1,0,1,0
30934,64454,445,0,0,70,70,0,1,0,1,0
30935,64452,445,0,0,70,70,0,1,0,1,0
30936,59613,445,0,0,70,70,0,1,0,1,0
30937,59865,445,0,0,66,66,0,1,0,1,0
30938,2572,35440,0,0,66,66,0,1,0,1,0
30939,9445,56205,0,0,66,66,0,1,0,1,0
30940,57260,51221,0,0,66,66,0,1,0,1,0
30941,59862,445,0,0,66,66,0,1,0,1,0
30942,59857,445,0,0,66,66,0,1,0,1,0
30943,59855,445,0,0,66,66,0,1,0,1,0
30944,59861,445,0,0,66,66,0,1,0,1,0
30945,59853,445,0,0,66,66,0,1,0,1,0
30946,59851,445,0,0,66,66,0,1,0,1,0
30947,59850,445,0,0,66,66,0,1,0,1,0
30948,59604,445,0,0,70,70,0,1,0,1,0
30949,59602,445,0,0,70,70,0,1,0,1,0
30950,59601,445,0,0,70,70,0,1,0,1,0
30951,59598,445,0,0,70,70,0,1,0,1,0
30952,56638,64147,0,0,62,62,0,1,0,1,0
30953,3549,64147,0,0,62,62,0,1,0,1,0
30954,64444,445,0,0,70,70,0,1,0,1,0
30955,59597,445,0,0,70,70,0,1,0,1,0
30956,14036,48817,0,0,62,62,0,1,0,1,0
30957,43129,15503,0,0,62,62,0,1,0,1,0
30958,64441,445,0,0,70,70,0,1,0,1,0
30959,64439,445,0,0,70,70,0,1,0,1,0
30960,64437,445,0,0,70,70,0,1,0,1,0
30961,65012,32468,0,0,66,66,0,1,0,1,0
30962,54313,64147,0,0,66,66,0,1,0,1,0
30963,53044,36237,0,0,62,62,0,1,0,1,0
30964,44459,37807,0,0,62,62,0,1,0,1,0
30965,20563,21247,0,0,66,66,0,1,0,1,0
30966,1560,51505,0,0,62,62,0,1,0,1,0
30967,52184,22114,0,0,66,66,0,1,0,1,0
30968,15465,64147,0,0,62,62,0,1,0,1,0
30969,11136,15503,0,0,145,145,0,1,0,1,0
30970,59591,445,0,0,70,70,0,1,0,1,0
30971,46837,57470,0,0,62,62,0,1,0,1,0
30972,1024,44847,0,0,62,62,0,1,0,1,0
30973,11907,57470,0,0,66,66,0,1,0,1,0
30974,62131,50584,0,0,62,62,0,1,0,1,0
30975,8820,41864,0,0,143,143,0,1,0,1,0
30976,64436,445,0,0,70,70,0,1,0,1,0
30977,64432,445,0,0,70,70,0,1,0,1,0
30978,64429,445,0,0,70,70,0,1,0,1,0
30979,59846,445,0,0,66,66,0,1,0,1,0
30980,64428,445,0,0,70,70,0,1,0,1,0
30981,59841,445,0,0,66,66,0,1,0,1,0
30982,65259,37965,0,0,66,66,0,1,0,1,0
30983,59840,445,0,0,66,66,0,1,0,1,0
30984,59838,445,0,0,66,66,0,1,0,1,0
30985,59583,445,0,0,70,70,0,1,0,1,0
30986,59580,445,0,0,70,70,0,1,0,1,0
30987,59837,445,0,0,66,66,0,1,0,1,0
30988,48903,25773,0,0,157,157,0,1,0,1,0
30989,59576,445,0,0,70,70,0,1,0,1,0
30990,64420,445,0,0,70,70,0,1,0,1,0
30991,59575,445,0,0,70,70,0,1,0,1,0
30992,54280,3398,0,0,60,60,0,1,0,1,0
30993,64415,445,0,0,70,70,0,1,0,1,0
30994,64410,445,0,0,70,70,0,1,0,1,0
30995,61392,50584,0,0,62,62,0,1,0,1,0
30996,16721,22114,0,0,146,146,0,1,0,1,0
30997,25565,38308,0,0,60,60,0,1,0,1,0
30998,65398,7129,0,0,66,66,0,1,0,1,0
30999,10445,46824,0,0,62,62,0,1,0,1,0
31000,38411,17372,0,0,62,62,0,1,0,1,0
31001,59571,445,0,0,70,70,0,1,0,1,0
31002,59826,445,0,0,66,66,0,1,0,1,0
31003,60557,23117,0,0,66,66,0,1,0,1,0
31004,59569,445,0,0,70,70,0,1,0,1,0
31005,33003,28543,0,0,62,62,0,1,0,1,0
31006,55027,37965,0,0,145,145,0,1,0,1,0
31007,50106,31573,0,0,62,62,0,1,0,1,0
31008,60272,26467,0,0,66,66,0,1,0,1,0
31009,59818,445,0,0,66,66,0,1,0,1,0
31010,64404,445,0,0,70,70,0,1,0,1,0
31011,7364,50584,0,0,66,66,0,1,0,1,0
31012,59565,445,0,0,70,70,0,1,0,1,0
31013,26131,56205,0,0,62,62,0,1,0,1,0
31014,59815,445,0,0,66,66,0,1,0,1,0
31015,59413,51505,0,0,66,66,0,1,0,1,0
31016,16905,57866,0,0,66,66,0,1,0,1,0
31017,59809,445,0,0,66,66,0,1,0,1,0
31018,10736,35440,0,0,66,66,0,1,0,1,0
31019,59803,445,0,0,66,66,0,1,0,1,0
31020,54324,7000,54324,7000,4007,1690,2317,15,0,8,7
31021,443,61686,0,0,78,78,0,1,0,1,0
31022,443,61686,0,0,642,642,0,1,0,1,0
31023,443,61686,0,0,90,90,0,1,0,1,0
31024,443,61686,0,0,1484,1484,0,1,0,1,0
31025,65422,26467,0,0,62,62,0,1,0,1,0
31026,10834,50584,0,0,66,66,0,1,0,1,0
31027,59552,445,0,0,70,70,0,1,0,1,0
31028,49636,44847,0,0,62,62,0,1,0,1,0
31029,3597,11392,0,0,66,66,0,1,0,1,0
31030,64390,445,0,0,70,70,0,1,0,1,0
31031,64388,445,0,0,70,70,0,1,0,1,0
31032,64389,445,0,0,70,70,0,1,0,1,0
31033,0,0,0,0,480,244,236,4,0,2,2
31034,59549,445,0,0,70,70,0,1,0,1,0
31035,59791,445,0,0,66,66,0,1,0,1,0
31036,59785,445,0,0,66,66,0,1,0,1,0
31037,59789,445,0,0,66,66,0,1,0,1,0
31038,59790,445,0,0,66,66,0,1,0,1,0
31039,59787,445,0,0,66,66,0,1,0,1,0
31040,59792,445,0,0,66,66,0,1,0,1,0
31041,59788,445,0,0,66,66,0,1,0,1,0
31042,59786,445,0,0,66,66,0,1,0,1,0
31043,54389,28543,0,0,66,66,0,1,0,1,0
31044,58686,18375,0,0,66,66,0,1,0,1,0
31045,65344,46824,0,0,66,66,0,1,0,1,0
31046,31727,57470,0,0,62,62,0,1,0,1,0
31047,38253,23117,0,0,146,146,0,1,0,1,0
31048,59544,445,0,0,70,70,0,1,0,1,0
31049,59543,445,0,0,70,70,0,1,0,1,0
31050,7310,44847,0,0,66,66,0,1,0,1,0
31051,35154,42707,0,0,62,62,0,1,0,1,0
31052,57170,38303,0,0,66,66,0,1,0,1,0
31053,59541,445,0,0,70,70,0,1,0,1,0
31054,32648,55108,0,0,145,145,0,1,0,1,0
31055,64381,445,0,0,70,70,0,1,0,1,0
31056,64379,445,0,0,70,70,0,1,0,1,0
31057,64378,445,0,0,70,70,0,1,0,1,0
31058,64375,445,0,0,70,70,0,1,0,1,0
31059,56308,22114,0,0,146,146,0,1,0,1,0
31060,58745,30188,0,0,66,66,0,1,0,1,0
31061,64237,51505,0,0,62,62,0,1,0,1,0
31062,51934,36180,0,0,66,66,0,1,0,1,0
31063,59770,445,0,0,66,66,0,1,0,1,0
31064,59773,445,0,0,66,66,0,1,0,1,0
31065,59771,445,0,0,66,66,0,1,0,1,0
31066,65012,2767,0,0,62,62,0,1,0,1,0
31067,1404,51180,0,0,145,145,0,1,0,1,0
31068,33524,10387,0,0,159,159,0,1,0,1,0
31069,60771,58414,0,0,66,66,0,1,0,1,0
31070,64368,445,0,0,70,70,0,1,0,1,0
31071,13554,44847,0,0,62,62,0,1,0,1,0
31072,59534,445,0,0,70,70,0,1,0,1,0
31073,64361,445,0,0,70,70,0,1,0,1,0
31074,64358,445,0,0,70,70,0,1,0,1,0
31075,64357,445,0,0,70,70,0,1,0,1,0
31076,59532,445,0,0,70,70,0,1,0,1,0
31077,39098,51505,0,0,62,62,0,1,0,1,0
31078,13413,44847,0,0,66,66,0,1,0,1,0
31079,2323,23117,0,0,146,146,0,1,0,1,0
31080,64091,53,52948,53,172,88,84,2,30,1,1
31081,55006,53,7313,53,711,87,624,2,30,1,1
31082,52787,443,54390,443,1550,834,716,19,141,10,9
31083,56330,53,38670,53,760,97,663,2,30,1,1
31084,33898,80,33898,80,14448,2001,12447,26,16,14,12
31085,37619,443,7866,443,6169,4980,1189,28,16,15,13
31086,62387,80,62387,80,548903,4452,544451,440,20,58,382
31087,49566,80,39778,80,10134,1142,8992,24,46,12,12
31088,52729,80,27175,80,2255,997,1258,16,152,8,8
31089,50562,80,50562,80,1696,996,700,11,22,6,5
31090,42999,3389,42999,3389,3910,1805,2105,20,19,12,8
31091,35543,443,52290,443,7298,2601,4697,21,26,10,11
31092,61315,53,20800,53,8616,4944,3672,22,87,11,11
31093,50578,443,12552,443,13595,7140,6455,39,116,24,15
31094,64964,53,20852,53,194,99,95,2,31,1,1
31095,55857,53,27164,53,192,98,94,2,30,1,1
31096,56940,443,15296,443,4184,2787,1397,19,345,10,9
31097,37617,443,6093,443,1654,931,723,20,16,11,9
31098,58034,80,58034,80,21684,903,20781,30,41,12,18
31099,27005,27023,20750,27023,875,126,749,3,32,2,1
31100,42550,5222,16634,5222,2060,981,1079,21,15,11,10
31101,53145,44634,28253,44634,70,70,0,2,8,2,0
31102,51975,443,63500,443,35746,4732,31014,68,67,33,35
31103,65363,53,16393,53,747,93,654,2,30,1,1
31104,60092,443,60092,443,4700,1793,2907,19,28,11,8
31105,58727,443,14813,443,26922,13251,13671,50,18,26,24
31106,46987,443,48389,443,3847,2650,1197,22,32,13,9
31107,52786,443,4838,443,9032,2673,6359,30,142,16,14
31108,43921,443,8788,443,8324,1658,6666,24,83,14,10
31109,37618,443,28939,443,28034,26485,1549,48,16,29,19
31110,57985,80,36501,80,3703,2068,1635,17,33,10,7
31111,64986,53,36194,53,182,93,89,2,31,1,1
31112,58696,443,11326,443,6889,4719,2170,25,330,14,11
31113,58750,443,9806,443,3776,2372,1404,17,15,9,8
31114,55229,443,47978,443,3602,1519,2083,18,60,10,8
31115,58297,443,46075,443,7338,2419,4919,19,17,12,7
31116,46014,443,8499,443,13661,2246,11415,28,256,14,14
31117,58853,443,20470,443,155516,6298,149218,174,107,49,125
31118,50444,443,31610,443,47752,21819,25933,119,704,59,60
31119,55256,443,41393,443,3524,2973,551,15,16,9,6
31120,49208,53,22620,53,578,286,292,9,15,5,4
31121,53742,63344,47218,63344,1294,797,497,13,15,7,6
31122,54489,80,6564,80,2828,1710,1118,10,255,6,4
31123,51937,38056,49622,38056,66,66,0,1,5,1,0
31124,51965,48708,39312,48708,70,70,0,2,8,2,0
31125,62039,443,46235,443,356,60,296,6,18,2,4
31126,52788,443,21903,443,1550,834,716,19,141,10,9
31127,64956,53,25279,53,192,98,94,2,30,1,1
31128,49272,53,25138,53,168,86,82,3,44,2,1
31129,57993,80,1572,80,3822,2132,1690,19,32,11,8
31130,56775,53,1038,53,733,85,648,2,30,1,1
31131,55271,53,11910,53,754,94,660,2,30,1,1
31132,56979,53,36485,53,176,90,86,2,31,1,1
31133,57371,53,32883,53,212,108,104,2,31,1,1
31134,55392,53,38891,53,190,97,93,2,31,1,1
31135,56611,53,54936,53,170,87,83,2,31,1,1
31136,49209,53,10202,53,198,101,97,2,31,1,1
31137,49769,53,37724,53,780,93,687,2,31,1,1
31138,57228,53,5585,53,198,101,97,2,30,1,1
31139,64029,53,31401,53,176,90,86,2,30,1,1
31140,57115,53,15026,53,756,95,661,2,30,1,1
31141,56620,53,43601,53,762,98,664,2,30,1,1
31142,27005,27027,61298,27027,880,126,754,2,31,1,1
31143,49931,53,19319,53,190,97,93,2,31,1,1
31144,32940,443,60631,443,13056,4233,8823,27,121,12,15
31145,49663,53,12596,53,190,97,93,2,31,1,1
31146,50509,53,14571,53,789,110,679,2,31,1,1
31147,65024,53,56492,53,174,89,85,2,31,1,1
31148,56085,53,59161,53,166,85,81,2,31,1,1
31149,55867,53,4524,53,184,94,90,2,31,1,1
31150,8878,80,27996,80,1220,403,817,15,414,4,11
31151,41953,443,3719,443,4129,2865,1264,17,361,9,8
31152,56063,53,65199,53,192,98,94,2,31,1,1
31153,27005,27019,23362,27019,873,126,747,2,31,1,1
31154,55000,53,30925,53,753,93,660,2,31,1,1
31155,64321,53,31319,53,190,97,93,2,31,1,1
31156,57071,53,61611,53,164,84,80,2,31,1,1
31157,50407,53,51161,53,749,89,660,2,31,1,1
31158,33545,443,31253,443,9737,3353,6384,27,32,13,14
31159,59596,3389,59596,3389,3523,1714,1809,17,34,8,9
31160,49372,53,17589,53,216,110,106,2,31,1,1
31161,56626,53,22670,53,710,89,621,2,31,1,1
31162,57177,53,5547,53,174,89,85,2,31,1,1
31163,55728,53,39278,53,190,97,93,2,31,1,1
31164,49783,53,20382,53,174,89,85,2,31,1,1
31165,56009,53,7541,53,172,88,84,2,31,1,1
31166,56927,53,57010,53,749,94,655,2,31,1,1
31167,54663,443,5282,443,18311,11567,6744,43,363,21,22
31168,23553,37965,0,0,62,62,0,1,0,1,0
31169,59531,445,0,0,70,70,0,1,0,1,0
31170,59530,445,0,0,70,70,0,1,0,1,0
31171,1025,50584,0,0,62,62,0,1,0,1,0
31172,59529,445,0,0,70,70,0,1,0,1,0
31173,1026,64147,0,0,62,62,0,1,0,1,0
31174,59526,445,0,0,70,70,0,1,0,1,0
31175,59523,445,0,0,70,70,0,1,0,1,0
31176,9518,30228,0,0,100,100,0,1,0,1,0
31177,9518,57587,0,0,100,100,0,1,0,1,0
31178,9518,3855,0,0,100,100,0,1,0,1,0
31179,6712,44818,0,0,66,66,0,1,0,1,0
31180,55153,53,36786,53,733,94,639,2,30,1,1
31181,64351,445,0,0,70,70,0,1,0,1,0
31182,64349,445,0,0,70,70,0,1,0,1,0
31183,64346,445,0,0,70,70,0,1,0,1,0
31184,37647,29892,0,0,145,145,0,1,0,1,0
31185,26835,47993,0,0,62,62,0,1,0,1,0
31186,59511,445,0,0,70,70,0,1,0,1,0
31187,59510,445,0,0,70,70,0,1,0,1,0
31188,59507,445,0,0,70,70,0,1,0,1,0
31189,61419,57470,0,0,66,66,0,1,0,1,0
31190,59501,445,0,0,70,70,0,1,0,1,0
31191,59500,445,0,0,70,70,0,1,0,1,0
31192,59761,445,0,0,66,66,0,1,0,1,0
31193,27160,64147,0,0,62,62,0,1,0,1,0
31194,59876,44847,0,0,66,66,0,1,0,1,0
31195,64104,22114,0,0,66,66,0,1,0,1,0
31196,63963,50584,0,0,66,66,0,1,0,1,0
31197,22784,9571,0,0,62,62,0,1,0,1,0
31198,44491,50584,0,0,62,62,0,1,0,1,0
31199,56869,17637,0,0,66,66,0,1,0,1,0
31200,64342,445,0,0,70,70,0,1,0,1,0
31201,64338,445,0,0,70,70,0,1,0,1,0
31202,3181,53567,0,0,66,66,0,1,0,1,0
31203,59489,445,0,0,70,70,0,1,0,1,0
31204,43323,1,0,0,62,62,0,1,0,1,0
31205,50577,53,36248,53,196,102,94,2,30,1,1
31206,49498,53,4790,53,245,102,143,2,30,1,1
31207,49467,53,63815,53,811,94,717,2,30,1,1
31208,55051,53,56758,53,167,86,81,2,30,1,1
31209,37555,16386,35583,16386,432,192,240,8,30,4,4
31210,11295,40032,25935,40032,148,86,62,2,30,1,1
31211,11295,40018,13039,40018,156,94,62,2,30,1,1
31212,52765,443,7289,443,10359,1566,8793,27,150,13,14
31213,65485,53,26681,53,184,94,90,2,29,1,1
31214,64793,53,25945,53,168,86,82,2,29,1,1
31215,55868,53,29665,53,198,110,88,2,29,1,1
31216,64991,53,31407,53,196,94,102,2,29,1,1
31217,50576,53,22318,53,765,102,663,2,29,1,1
31218,55868,53,11909,53,198,110,88,2,29,1,1
31219,65275,53,52488,53,184,102,82,2,29,1,1
31220,49191,51253,24345,51253,504,318,186,8,15,5,3
31221,48346,443,9051,443,2272788,106549,2166239,2492,190,850,1642
31222,55776,53,11984,53,271,93,178,4,32,2,2
31223,50994,443,11381,443,6349,1072,5277,18,21,10,8
31224,41876,443,3381,443,55975,2553,53422,72,105,29,43
31225,32877,443,56293,443,5701,1585,4116,23,1102,13,10
31226,51452,443,19936,443,6936,1761,5175,17,16,11,6
31227,5240,36828,56682,36828,166456,128,166328,270,35,3,267
31228,65220,53,8622,53,178,94,84,2,29,1,1
31229,64602,53,17194,53,751,94,657,2,29,1,1
31230,55809,443,31063,443,62,62,0,1,4,1,0
31231,56349,53,33887,53,168,86,82,2,29,1,1
31232,50340,53,41286,53,181,94,87,2,29,1,1
31233,56349,53,14775,53,184,102,82,2,29,1,1
31234,50561,80,50561,80,1695,995,700,11,21,6,5
31235,49410,53,7557,53,178,94,84,2,30,1,1
31236,64898,53,53869,53,167,86,81,2,29,1,1
31237,55413,53,38303,53,216,110,106,2,29,1,1
31238,65515,53,42704,53,210,110,100,2,29,1,1
31239,64029,53,34743,53,180,94,86,2,30,1,1
31240,55392,53,8146,53,195,102,93,2,30,1,1
31241,55244,53,26585,53,184,102,82,2,30,1,1
31242,50241,53,50241,53,260,106,154,2,32,1,1
31243,45275,443,27366,443,130,70,60,3,5,2,1
31244,51935,38639,36468,38639,70,70,0,1,5,1,0
31245,51535,443,45578,443,202,70,132,3,11,1,2
31246,63136,443,35141,443,6781,1289,5492,17,15,9,8
31247,57709,443,55185,443,10392,2789,7603,25,16,13,12
31248,57363,53,32810,53,178,94,84,2,30,1,1
31249,37555,16385,63752,16385,556,256,300,10,30,5,5
31250,64776,53,62229,53,198,94,104,2,30,1,1
31251,49534,53,49440,53,168,86,82,2,30,1,1
31252,55176,53,23799,53,181,94,87,2,30,1,1
31253,10151,22208,55626,22208,323,150,173,2,1203,1,1
31254,27005,27091,18957,27091,883,126,757,2,31,1,1
31255,64091,53,16270,53,178,94,84,2,30,1,1
31256,57402,9992,42519,9992,47040,13931,33109,428,129,207,221
31257,49209,53,59782,53,199,102,97,2,30,1,1
31258,58058,443,59293,443,560,280,280,9,28,5,4
31259,56695,443,5124,443,8006,1986,6020,20,15,11,9
31260,57071,53,59373,53,166,86,80,2,30,1,1
31261,55045,443,7851,443,4660,3048,1612,31,81,15,16
31262,65361,53,5566,53,764,102,662,2,30,1,1
31263,52168,443,14996,443,73105,13398,59707,220,374,108,112
31264,50495,53,24606,53,182,102,80,2,30,1,1
31265,58752,443,52846,443,5167,700,4467,16,15,7,9
31266,64989,53,13455,53,167,86,81,2,30,1,1
31267,38122,443,65050,443,191454,11241,180213,262,42,128,134
31268,57057,53,25166,53,194,102,92,2,30,1,1
31269,50932,443,17054,443,167483,7402,160081,221,23,93,128
31270,49410,53,12703,53,178,94,84,2,30,1,1
31271,37558,16386,20045,16386,432,192,240,8,30,4,4
31272,44849,443,64447,443,13791,7866,5925,35,46,20,15
31273,56330,53,26400,53,199,102,97,2,30,1,1
31274,64091,53,24113,53,178,94,84,2,30,1,1
31275,64419,53,6330,53,210,102,108,2,30,1,1
31276,37558,16385,3655,16385,432,192,240,8,30,4,4
31277,64628,53,28992,53,199,102,97,2,30,1,1
31278,57142,53,15103,53,165,86,79,2,30,1,1
31279,37556,16386,44427,16386,432,192,240,8,30,4,4
31280,55857,53,49437,53,196,102,94,2,30,1,1
31281,57307,53,14179,53,177,94,83,2,30,1,1
31282,56526,53,41730,53,168,94,74,2,30,1,1
31283,64989,53,9165,53,183,102,81,2,30,1,1
31284,64602,53,26542,53,185,102,83,2,30,1,1
31285,56204,53,48094,53,195,102,93,2,30,1,1
31286,57371,53,64674,53,214,110,104,2,30,1,1
31287,52758,80,33293,80,1746,980,766,15,151,8,7
31288,49510,53,7986,53,754,94,660,2,30,1,1
31289,37556,16384,16862,16384,556,256,300,10,30,5,5
31290,49849,53,18692,53,173,94,79,2,30,1,1
31291,64562,53,22327,53,371,94,277,2,30,1,1
31292,54748,53,4076,53,245,110,135,2,30,1,1
31293,56063,53,52462,53,196,102,94,2,30,1,1
31294,50009,80,24998,80,186,64,122,4,29,2,2
31295,36688,443,22490,443,86101,7312,78789,145,128,63,82
31296,57994,443,19602,443,14465,1797,12668,30,170,14,16
31297,56263,53,42126,53,214,110,104,2,30,1,1
31298,55342,53,5897,53,323,110,213,2,30,1,1
31299,49605,53,37521,53,239,110,129,2,30,1,1
31300,55067,53,28702,53,166,86,80,2,30,1,1
31301,37558,16384,22272,16384,556,256,300,10,30,5,5
31302,37555,16384,64075,16384,432,192,240,8,30,4,4
31303,50495,53,55393,53,166,86,80,2,30,1,1
31304,64029,53,26038,53,180,94,86,2,30,1,1
31305,56696,443,57667,443,8059,2039,6020,20,15,11,9
31306,59784,443,16677,443,6698,1606,5092,23,19,13,10
31307,49155,443,35211,443,8941,1776,7165,22,136,12,10
31308,50931,443,19777,443,4178,2310,1868,39,30,23,16
31309,48343,443,59139,443,1985333,91427,1893906,2159,190,721,1438
31310,58391,443,1299,443,347192,61325,285867,643,191,297,346
31311,58396,443,53120,443,138065,109491,28574,429,186,230,199
31312,48345,443,50795,443,940826,59470,881356,1101,190,412,689
31313,62037,80,19447,80,1670,422,1248,13,17,5,8
31314,37075,80,59950,80,1597,783,814,10,15,5,5
31315,55019,443,34089,443,12411,7888,4523,33,17,19,14
31316,48952,443,47489,443,15944,6988,8956,135,324,72,63
31317,49737,443,51096,443,334252,14917,319335,405,73,179,226
31318,64810,53,55417,53,272,93,179,4,33,2,2
31319,49788,53,26549,53,302,97,205,4,43,2,2
31320,48344,443,64214,443,2588313,95154,2493159,2645,190,811,1834
31321,64810,53,65205,53,272,93,179,4,32,2,2
31322,52587,443,5455,443,6170,918,5252,18,15,10,8
31323,58753,443,55994,443,5167,700,4467,16,14,7,9
31324,49953,53,27349,53,214,110,104,2,29,1,1
31325,56697,443,20511,443,8007,1987,6020,20,15,11,9
31326,56894,53,54448,53,178,94,84,2,29,1,1
31327,51961,40373,19759,40373,70,70,0,2,8,2,0
31328,56152,53,35520,53,195,102,93,2,29,1,1
31329,62038,80,20471,80,668,224,444,10,18,4,6
31330,64162,53,51950,53,255,118,137,2,29,1,1
31331,51933,80,57196,80,717,651,66,7,15,6,1
31332,56710,53,63295,53,193,94,99,2,29,1,1
31333,53629,443,28491,443,123122,115571,7551,161,23,93,68
31334,57363,53,20262,53,178,94,84,2,29,1,1
31335,64898,53,30399,53,167,86,81,2,29,1,1
31336,64296,53,31060,53,215,94,121,2,29,1,1
31337,51924,80,58410,80,32222,3146,29076,43,31,18,25
31338,10002,80,8568,80,3759,741,3018,15,45,8,7
31339,58748,443,31963,443,5167,700,4467,16,15,7,9
31340,52757,80,11666,80,2426,1594,832,17,151,9,8
31341,56694,443,1542,443,8058,2038,6020,20,15,11,9
31342,56263,53,62395,53,214,110,104,2,29,1,1
31343,49949,53,12218,53,193,102,91,2,29,1,1
31344,64480,53,30625,53,276,126,150,2,30,1,1
31345,55848,53,34320,53,168,86,82,2,30,1,1
31346,55848,53,45545,53,184,102,82,2,30,1,1
31347,57313,53,1093,53,811,94,717,2,30,1,1
31348,27005,32039,29138,32039,883,126,757,2,31,1,1
31349,65176,53,36351,53,193,102,91,2,31,1,1
31350,49209,53,48140,53,199,102,97,2,31,1,1
31351,55495,53,27718,53,210,110,100,2,31,1,1
31352,64628,53,1942,53,199,102,97,2,30,1,1
31353,55166,53,22324,53,177,94,83,2,30,1,1
31354,64321,53,62198,53,195,102,93,2,30,1,1
31355,64091,53,62313,53,178,94,84,2,30,1,1
31356,46123,443,37747,443,5161,3826,1335,16,137,9,7
31357,49931,53,55078,53,195,102,93,2,30,1,1
31358,65013,53,26292,53,473,105,368,4,30,2,2
31359,49567,53,30320,53,195,94,101,2,30,1,1
31360,55867,53,6696,53,184,94,90,2,30,1,1
31361,64822,53,9057,53,200,94,106,2,30,1,1
31362,49622,53,6128,53,209,102,107,2,30,1,1
31363,55413,53,32368,53,216,110,106,2,31,1,1
31364,55828,53,29834,53,181,94,87,2,31,1,1
31365,49837,443,55049,443,4685,2421,2264,10,119,5,5
31366,30188,58770,26804,58770,14172,5733,8439,79,1531,37,42
31367,37845,443,37845,443,4441,1534,2907,19,25,11,8
31368,52991,53,52991,53,235,90,145,2,32,1,1
31369,55857,53,19177,53,437,98,339,4,41,2,2
31370,10010,80,10501,80,2166,600,1566,10,45,6,4
31371,52695,443,43213,443,34402,2328,32074,55,153,23,32
31372,59422,53,43330,53,168,78,90,2,30,1,1
31373,49534,53,53329,53,168,86,82,2,30,1,1
31374,65437,53,6994,53,173,94,79,2,30,1,1
31375,55176,53,15853,53,181,94,87,2,30,1,1
31376,55771,53,22517,53,819,102,717,2,30,1,1
31377,65437,53,4286,53,165,86,79,2,30,1,1
31378,64602,53,18957,53,185,102,83,2,30,1,1
31379,60578,443,8619,443,27150,3104,24046,55,157,24,31
31380,51936,17650,3656,17650,70,70,0,1,5,1,0
31381,56526,53,17737,53,168,94,74,2,30,1,1
31382,37556,16385,7205,16385,432,192,240,8,30,4,4
31383,65152,53,2972,53,763,102,661,2,30,1,1
31384,64986,53,9099,53,183,94,89,2,30,1,1
31385,56470,53,63709,53,198,102,96,2,30,1,1
31386,56938,8000,45584,8000,110,110,0,1,30,1,0
31387,56085,53,41627,53,167,86,81,2,30,1,1
31388,58123,80,21790,80,3641,1784,1857,19,375,10,9
31389,50272,53,61330,53,210,110,100,2,30,1,1
31390,36710,443,45580,443,6786,1795,4991,18,16,11,7
31391,51960,58601,12629,58601,70,70,0,2,8,2,0
31392,49181,53,15171,53,491,98,393,4,40,2,2
31393,52769,443,2032,443,8083,1790,6293,27,150,14,13
31394,52764,443,33185,443,14001,2908,11093,35,150,18,17
31395,64421,53,53236,53,398,88,310,4,54,2,2
31396,50577,53,42323,53,819,102,717,2,30,1,1
31397,65253,53,8346,53,766,102,664,2,30,1,1
31398,55771,53,25077,53,196,102,94,2,30,1,1
31399,65515,53,3298,53,210,110,100,2,30,1,1
31400,49379,53,52143,53,260,102,158,2,30,1,1
31401,55166,53,19784,53,177,94,83,2,30,1,1
31402,56594,53,5143,53,173,94,79,2,30,1,1
31403,55857,53,31762,53,196,102,94,2,30,1,1
31404,56185,53,13789,53,167,86,81,2,30,1,1
31405,57371,53,5536,53,214,110,104,2,30,1,1
31406,55742,53,18944,53,193,102,91,2,30,1,1
31407,55244,53,24318,53,184,102,82,2,30,1,1
31408,64029,53,40003,53,180,94,86,2,30,1,1
31409,57228,53,13792,53,199,102,97,2,30,1,1
31410,49663,53,65385,53,195,102,93,2,30,1,1
31411,57177,53,13049,53,179,94,85,2,30,1,1
31412,44385,53,19261,53,212,78,134,2,30,1,1
31413,64781,53,27529,53,209,102,107,2,30,1,1
31414,64169,53,50395,53,209,102,107,2,30,1,1
31415,27005,27999,8243,27999,913,126,787,2,31,1,1
31416,57177,53,17706,53,179,94,85,2,31,1,1
31417,64244,53,63345,53,199,102,97,2,31,1,1
31418,64986,53,17110,53,183,94,89,2,31,1,1
31419,55728,53,24572,53,195,102,93,2,31,1,1
31420,49378,53,42308,53,306,94,212,2,30,1,1
31421,64586,53,9543,53,183,94,89,2,30,1,1
31422,57445,53,50878,53,342,142,200,2,30,1,1
31423,64598,53,46493,53,342,142,200,2,30,1,1
31424,65052,53,39393,53,200,94,106,2,30,1,1
31425,56142,53,42662,53,194,102,92,2,31,1,1
31426,57147,53,3974,53,166,86,80,2,31,1,1
31427,64174,53,10238,53,180,94,86,2,31,1,1
31428,27005,32073,35249,32073,884,126,758,2,31,1,1
31429,64965,53,42321,53,200,94,106,2,31,1,1
31430,64964,53,28757,53,197,102,95,2,31,1,1
31431,56643,53,21130,53,195,102,93,2,31,1,1
31432,55641,53,24406,53,184,94,90,2,31,1,1
31433,57127,53,61936,53,193,102,91,2,31,1,1
31434,64627,53,3343,53,199,102,97,2,31,1,1
31435,55392,53,19876,53,195,102,93,2,31,1,1
31436,27005,32065,5075,32065,877,126,751,2,31,1,1
31437,57126,53,6801,53,183,94,89,2,31,1,1
31438,56381,53,14303,53,196,102,94,2,31,1,1
31439,52992,443,3497,443,97763,8230,89533,131,150,49,82
31440,37965,28596,25273,28596,479,150,329,2,1199,1,1
31441,41790,443,64093,443,2350,1392,958,17,275,9,8
31442,50000,53,12799,53,216,110,106,2,31,1,1
31443,64989,53,29167,53,214,94,120,2,31,1,1
31444,64607,53,58592,53,211,110,101,2,31,1,1
31445,37957,443,45183,443,7280,2250,5030,15,120,7,8
31446,33995,443,61498,443,6419,995,5424,21,361,11,10
31447,60461,443,30128,443,18515,2899,15616,32,148,15,17
31448,49214,53,64649,53,227,102,125,2,30,1,1
31449,56005,53,41493,53,403,142,261,2,30,1,1
31450,64922,53,2264,53,209,102,107,2,30,1,1
31451,64803,53,18696,53,403,142,261,2,31,1,1
31452,56085,53,39673,53,167,86,81,2,31,1,1
31453,27005,27057,9296,27057,917,126,791,2,31,1,1
31454,55596,53,25789,53,194,102,92,2,31,1,1
31455,56063,53,23721,53,196,102,94,2,31,1,1
31456,55867,53,63583,53,184,94,90,2,31,1,1
31457,49209,53,27106,53,199,102,97,2,31,1,1
31458,49346,53,44128,53,164,78,86,2,31,1,1
31459,56145,53,42798,53,458,188,270,6,31,3,3
31460,49420,53,64966,53,183,94,89,2,31,1,1
31461,8886,80,28945,80,1748,716,1032,19,395,6,13
31462,43549,443,50179,443,10316,2303,8013,39,120,20,19
31463,64911,53,26816,53,209,110,99,2,31,1,1
31464,36266,443,8453,443,6043,1568,4475,11,119,4,7
31465,54664,443,18558,443,8263,1279,6984,15,136,7,8
31466,45549,443,52830,443,7951,1449,6502,22,125,12,10
31467,57470,54058,20688,54058,150,150,0,1,1199,1,0
31468,57278,443,35481,443,8960,2949,6011,21,122,10,11
31469,56411,53,33416,53,184,94,90,2,31,1,1
31470,63917,57826,39527,57826,70,70,0,1,5,1,0
31471,53745,18569,18242,18569,70,70,0,1,5,1,0
31472,48634,443,39947,443,448,78,370,6,25,1,5
31473,58747,443,20889,443,5167,700,4467,16,15,7,9
31474,44911,80,13176,80,1052,612,440,10,15,5,5
31475,35176,80,37365,80,1987,1329,658,10,136,6,4
31476,50543,443,11342,443,11275,4454,6821,24,36,13,11
31477,63651,443,19234,443,333668,12291,321377,321,170,72,249
31478,49968,53,62146,53,1412,94,1318,4,33,2,2
31479,51959,42269,57888,42269,70,70,0,2,8,2,0
31480,51921,80,46796,80,35092,3319,31773,48,31,21,27
31481,64987,53,36862,53,410,100,310,4,55,2,2
31482,55126,53,10895,53,193,102,91,2,31,1,1
31483,56381,443,16712,443,7236,2290,4946,18,16,11,7
31484,5232,46495,40739,46495,832,832,0,14,96,14,0
31485,38450,443,8906,443,593,473,120,4,15,2,2
31486,56693,443,47203,443,7862,1873,5989,20,16,11,9
31487,51148,9571,0,0,66,66,0,1,0,1,0
31488,39681,37965,0,0,66,66,0,1,0,1,0
31489,59744,445,0,0,66,66,0,1,0,1,0
31490,59743,445,0,0,66,66,0,1,0,1,0
31491,29577,64147,0,0,62,62,0,1,0,1,0
31492,16387,25619,0,0,60,60,0,1,0,1,0
31493,16387,64660,0,0,60,60,0,1,0,1,0
31494,16387,24782,0,0,60,60,0,1,0,1,0
31495,53500,1,0,0,66,66,0,1,0,1,0
31496,18088,23,0,0,60,60,0,1,0,1,0
31497,63672,22114,0,0,66,66,0,1,0,1,0
31498,52938,64097,0,0,66,66,0,1,0,1,0
31499,64332,445,0,0,70,70,0,1,0,1,0
31500,59485,445,0,0,70,70,0,1,0,1,0
31501,64325,445,0,0,70,70,0,1,0,1,0
31502,64324,445,0,0,70,70,0,1,0,1,0
31503,64323,445,0,0,70,70,0,1,0,1,0
31504,59738,445,0,0,66,66,0,1,0,1,0
31505,45964,5333,0,0,60,60,0,1,0,1,0
31506,52418,46314,0,0,66,66,0,1,0,1,0
31507,59476,445,0,0,70,70,0,1,0,1,0
31508,59474,445,0,0,70,70,0,1,0,1,0
31509,59473,445,0,0,70,70,0,1,0,1,0
31510,59472,445,0,0,70,70,0,1,0,1,0
31511,17760,50584,0,0,146,146,0,1,0,1,0
31512,59725,445,0,0,66,66,0,1,0,1,0
31513,59731,445,0,0,66,66,0,1,0,1,0
31514,59733,445,0,0,66,66,0,1,0,1,0
31515,59734,445,0,0,66,66,0,1,0,1,0
31516,59728,445,0,0,66,66,0,1,0,1,0
31517,59724,445,0,0,66,66,0,1,0,1,0
31518,59722,445,0,0,66,66,0,1,0,1,0
31519,59468,445,0,0,70,70,0,1,0,1,0
31520,61639,37965,0,0,66,66,0,1,0,1,0
31521,55616,56205,0,0,66,66,0,1,0,1,0
31522,443,60496,0,0,320,320,0,1,0,1,0
31523,44411,37965,0,0,62,62,0,1,0,1,0
31524,64314,445,0,0,70,70,0,1,0,1,0
31525,54016,42707,0,0,62,62,0,1,0,1,0
31526,64313,445,0,0,70,70,0,1,0,1,0
31527,64312,445,0,0,70,70,0,1,0,1,0
31528,64309,445,0,0,70,70,0,1,0,1,0
31529,28367,23,0,0,60,60,0,1,0,1,0
31530,26713,64147,0,0,62,62,0,1,0,1,0
31531,28040,64147,0,0,66,66,0,1,0,1,0
31532,65419,26467,0,0,62,62,0,1,0,1,0
31533,45941,23386,0,0,60,60,0,1,0,1,0
31534,45941,23386,0,0,60,60,0,1,0,1,0
31535,16387,8455,0,0,60,60,0,1,0,1,0
31536,16387,49252,0,0,60,60,0,1,0,1,0
31537,16387,35244,0,0,60,60,0,1,0,1,0
31538,59462,445,0,0,70,70,0,1,0,1,0
31539,32770,51505,0,0,62,62,0,1,0,1,0
31540,26642,57470,0,0,62,62,0,1,0,1,0
31541,64307,445,0,0,70,70,0,1,0,1,0
31542,64306,445,0,0,70,70,0,1,0,1,0
31543,64305,445,0,0,70,70,0,1,0,1,0
31544,56442,11392,0,0,66,66,0,1,0,1,0
31545,59718,445,0,0,66,66,0,1,0,1,0
31546,32520,47993,0,0,66,66,0,1,0,1,0
31547,6338,23117,0,0,66,66,0,1,0,1,0
31548,64300,445,0,0,70,70,0,1,0,1,0
31549,60786,51505,0,0,66,66,0,1,0,1,0
31550,2432,11392,0,0,62,62,0,1,0,1,0
31551,60374,57470,0,0,62,62,0,1,0,1,0
31552,59455,445,0,0,70,70,0,1,0,1,0
31553,56367,44847,0,0,62,62,0,1,0,1,0
31554,59714,445,0,0,66,66,0,1,0,1,0
31555,40571,26467,0,0,62,62,0,1,0,1,0
31556,59453,445,0,0,70,70,0,1,0,1,0
31557,65081,26467,0,0,66,66,0,1,0,1,0
31558,59712,445,0,0,66,66,0,1,0,1,0
31559,59710,445,0,0,66,66,0,1,0,1,0
31560,59709,445,0,0,66,66,0,1,0,1,0
31561,3978,35440,0,0,62,62,0,1,0,1,0
31562,16387,34137,0,0,60,60,0,1,0,1,0
31563,16387,61049,0,0,60,60,0,1,0,1,0
31564,16387,23177,0,0,60,60,0,1,0,1,0
31565,59449,445,0,0,70,70,0,1,0,1,0
31566,59447,445,0,0,70,70,0,1,0,1,0
31567,57034,44847,0,0,66,66,0,1,0,1,0
31568,64292,445,0,0,70,70,0,1,0,1,0
31569,33886,39127,0,0,162,162,0,1,0,1,0
31570,51743,64147,0,0,62,62,0,1,0,1,0
31571,55421,57470,0,0,74,74,0,1,0,1,0
31572,64284,445,0,0,70,70,0,1,0,1,0
31573,64282,445,0,0,70,70,0,1,0,1,0
31574,59443,445,0,0,70,70,0,1,0,1,0
31575,13423,56205,0,0,62,62,0,1,0,1,0
31576,13408,44847,0,0,62,62,0,1,0,1,0
31577,59697,445,0,0,66,66,0,1,0,1,0
31578,59441,445,0,0,70,70,0,1,0,1,0
31579,13090,36237,0,0,66,66,0,1,0,1,0
31580,59690,445,0,0,66,66,0,1,0,1,0
31581,64274,445,0,0,70,70,0,1,0,1,0
31582,59437,445,0,0,70,70,0,1,0,1,0
31583,58858,15503,0,0,66,66,0,1,0,1,0
31584,61030,21247,0,0,66,66,0,1,0,1,0
31585,59688,445,0,0,66,66,0,1,0,1,0
31586,10416,64147,0,0,62,62,0,1,0,1,0
31587,45042,48817,0,0,109,109,0,1,0,1,0
31588,30129,37965,0,0,72,72,0,1,0,1,0
31589,0,0,0,0,320,320,0,5,0,5,0
31590,0,0,0,0,2000,1020,980,20,0,10,10
31591,35229,32468,0,0,62,62,0,1,0,1,0
31592,59680,445,0,0,66,66,0,1,0,1,0
31593,55835,62413,0,0,62,62,0,1,0,1,0
31594,59673,445,0,0,66,66,0,1,0,1,0
31595,8403,46824,0,0,62,62,0,1,0,1,0
31596,443,42788,0,0,74,74,0,1,0,1,0
31597,18904,57470,0,0,62,62,0,1,0,1,0
31598,59424,445,0,0,70,70,0,1,0,1,0
31599,51581,22114,0,0,66,66,0,1,0,1,0
31600,58972,57866,0,0,66,66,0,1,0,1,0
31601,59421,445,0,0,70,70,0,1,0,1,0
31602,64263,445,0,0,70,70,0,1,0,1,0
31603,64261,445,0,0,70,70,0,1,0,1,0
31604,64260,445,0,0,70,70,0,1,0,1,0
31605,59662,445,0,0,66,66,0,1,0,1,0
31606,59664,445,0,0,66,66,0,1,0,1,0
31607,59665,445,0,0,66,66,0,1,0,1,0
31608,59658,445,0,0,66,66,0,1,0,1,0
31609,59663,445,0,0,66,66,0,1,0,1,0
31610,59660,445,0,0,66,66,0,1,0,1,0
31611,59661,445,0,0,66,66,0,1,0,1,0
31612,59659,445,0,0,66,66,0,1,0,1,0
31613,16327,55442,0,0,66,66,0,1,0,1,0
31614,42223,67,0,0,60,60,0,1,0,1,0
31615,59694,50584,0,0,62,62,0,1,0,1,0
31616,13963,50584,0,0,62,62,0,1,0,1,0
31617,47013,44512,0,0,62,62,0,1,0,1,0
31618,59416,445,0,0,70,70,0,1,0,1,0
31619,1187,64147,0,0,66,66,0,1,0,1,0
31620,27947,26467,0,0,62,62,0,1,0,1,0
31621,59415,445,0,0,70,70,0,1,0,1,0
31622,49915,35440,0,0,146,146,0,1,0,1,0
31623,50927,44847,0,0,62,62,0,1,0,1,0
31624,59413,445,0,0,70,70,0,1,0,1,0
31625,50424,55777,0,0,62,62,0,1,0,1,0
31626,64249,445,0,0,70,70,0,1,0,1,0
31627,64247,445,0,0,70,70,0,1,0,1,0
31628,64245,445,0,0,70,70,0,1,0,1,0
31629,64242,445,0,0,70,70,0,1,0,1,0
31630,27617,51505,0,0,146,146,0,1,0,1,0
31631,49323,53,45688,53,192,98,94,2,30,1,1
31632,53144,58987,43141,58987,70,70,0,2,8,2,0
31633,58115,3389,58115,3389,4166,2141,2025,18,17,9,9
31634,64627,53,17603,53,198,101,97,2,30,1,1
31635,64244,53,29357,53,198,101,97,2,30,1,1
31636,55938,53,49190,53,780,93,687,2,30,1,1
31637,50012,53,54567,53,208,106,102,2,30,1,1
31638,57189,53,57433,53,174,89,85,2,30,1,1
31639,57187,53,15982,53,782,105,677,2,30,1,1
31640,56991,53,36997,53,748,106,642,2,30,1,1
31641,57204,53,58502,53,182,93,89,2,30,1,1
31642,54467,80,25502,80,17572,1518,16054,30,255,16,14
31643,58725,443,21181,443,26960,13206,13754,53,17,28,25
31644,63934,55027,48051,55027,66,66,0,2,8,2,0
31645,53140,64128,33195,64128,698,320,378,10,17,6,4
31646,54472,80,34355,80,13695,1377,12318,26,255,14,12
31647,61518,22,61518,22,7306,2583,4723,36,25,19,17
31648,56381,53,44431,53,192,98,94,2,31,1,1
31649,56341,3389,56341,3389,3424,1710,1714,16,33,8,8
31650,35980,443,35980,443,4398,1491,2907,19,26,11,8
31651,58723,443,11514,443,24079,11282,12797,44,17,22,22
31652,60443,50284,54263,50284,164,70,94,2,5,1,1
31653,36026,443,14720,443,7050,984,6066,18,39,12,6
31654,54473,80,28386,80,14035,1381,12654,26,255,14,12
31655,56411,53,42159,53,184,94,90,2,31,1,1
31656,55641,53,45216,53,184,94,90,2,31,1,1
31657,55593,53,41754,53,749,89,660,2,30,1,1
31658,55596,53,37319,53,188,96,92,2,31,1,1
31659,33878,443,33484,443,2279,1637,642,15,25,9,6
31660,64534,53,43156,53,212,108,104,2,31,1,1
31661,45259,53,45259,53,176,78,98,2,30,1,1
31662,58744,443,27181,443,2576,1549,1027,15,15,7,8
31663,65176,53,2902,53,186,95,91,2,30,1,1
31664,55670,31056,18384,31056,70,70,0,2,8,2,0
31665,55006,53,44866,53,789,110,679,2,30,1,1
31666,5231,30114,20445,30114,832,832,0,14,96,14,0
31667,58724,443,37298,443,21610,9250,12360,40,17,19,21
31668,8971,80,8971,80,326,186,140,6,29,4,2
31669,53738,25760,39657,25760,2031,1019,1012,11,16,6,5
31670,58719,443,6983,443,18880,7831,11049,37,18,19,18
31671,54470,80,58006,80,16896,1514,15382,30,255,16,14
31672,55514,53,31515,53,747,93,654,2,30,1,1
31673,65294,53,15570,53,710,89,621,2,30,1,1
31674,56489,53,16732,53,208,106,102,2,31,1,1
31675,64911,53,61645,53,202,103,99,2,31,1,1
31676,56643,53,22354,53,190,97,93,2,31,1,1
31677,36542,3142,36542,3142,138,78,60,2,6,1,1
31678,50544,443,14371,443,11083,4570,6513,24,35,13,11
31679,56661,53,9185,53,297,102,195,4,34,2,2
31680,64837,53,3342,53,190,97,93,2,31,1,1
31681,51956,36995,25588,36995,70,70,0,2,8,2,0
31682,6722,80,6722,80,326,186,140,6,29,4,2
31683,45641,443,12763,443,99276,88410,10866,143,333,78,65
31684,37616,443,22145,443,6506,1356,5150,24,16,14,10
31685,34697,443,10528,443,15997,3015,12982,31,18,16,15
31686,51898,443,2125,443,7866,1549,6317,21,321,10,11
31687,34698,443,50104,443,16164,3053,13111,31,18,16,15
31688,51753,7000,51753,7000,3638,2087,1551,17,15,10,7
31689,56171,53,61869,53,756,95,661,2,30,1,1
31690,34600,80,41483,80,3089,775,2314,15,16,9,6
31691,48015,443,45822,443,19394,2961,16433,51,196,24,27
31692,64987,53,19027,53,196,100,96,2,30,1,1
31693,50551,80,50551,80,4780,1925,2855,16,22,8,8
31694,56690,53,19054,53,802,104,698,2,30,1,1
31695,56142,53,12873,53,188,96,92,2,30,1,1
31696,55828,53,3503,53,178,91,87,2,30,1,1
31697,56415,53,58262,53,174,89,85,2,31,1,1
31698,56094,53,60857,53,764,99,665,2,31,1,1
31699,64588,53,37209,53,186,95,91,2,31,1,1
31700,6881,41872,4010,41872,509,150,359,2,1200,1,1
31701,65246,53,33087,53,174,89,85,2,31,1,1
31702,63473,443,25564,443,4490,1234,3256,20,122,9,11
31703,45590,53,0,0,82,82,0,1,31,1,0
31704,65042,53,25956,53,182,93,89,2,31,1,1
31705,56627,53,42658,53,186,95,91,2,31,1,1
31706,57181,53,65198,53,733,93,640,2,31,1,1
31707,65512,53,60205,53,744,95,649,2,31,1,1
31708,30960,45738,57653,45738,396,396,0,7,3615,7,0
31709,56649,443,48324,443,3469,1006,2463,15,121,7,8
31710,57127,53,59492,53,186,95,91,2,31,1,1
31711,64174,53,49823,53,176,90,86,2,31,1,1
31712,65042,53,41893,53,182,93,89,2,31,1,1
31713,55344,53,18078,53,208,106,102,2,31,1,1
31714,63960,53,41492,53,172,88,84,2,31,1,1
31715,64555,53,55433,53,166,85,81,2,31,1,1
31716,53980,443,7192,443,4957,1627,3330,17,120,8,9
31717,56673,53,13818,53,186,95,91,2,31,1,1
31718,62102,443,56889,443,3466,821,2645,11,121,5,6
31719,64619,53,54626,53,174,89,85,2,31,1,1
31720,57470,45561,33811,45561,792,792,0,13,1201,13,0
31721,55130,53,9076,53,216,110,106,2,31,1,1
31722,56785,53,64900,53,186,95,91,2,31,1,1
31723,55126,53,24901,53,186,95,91,2,31,1,1
31724,56889,53,27625,53,206,105,101,2,31,1,1
31725,55533,53,56018,53,182,93,89,2,31,1,1
31726,56387,53,9036,53,182,93,89,2,31,1,1
31727,49216,53,25748,53,178,91,87,2,31,1,1
31728,56387,53,7178,53,182,93,89,2,31,1,1
31729,53979,443,21511,443,3566,871,2695,11,120,5,6
31730,49864,53,25609,53,186,95,91,2,31,1,1
31731,48817,8677,48817,8677,490,149,341,2,1200,1,1
31732,49160,51839,39818,51839,868,150,718,4,1200,2,2
31733,31974,51505,0,0,66,66,0,1,0,1,0
31734,59644,445,0,0,66,66,0,1,0,1,0
31735,59642,445,0,0,66,66,0,1,0,1,0
31736,59641,445,0,0,66,66,0,1,0,1,0
31737,57131,31061,0,0,145,145,0,1,0,1,0
31738,61000,15503,0,0,146,146,0,1,0,1,0
31739,32704,46824,0,0,66,66,0,1,0,1,0
31740,59406,445,0,0,70,70,0,1,0,1,0
31741,57538,30188,0,0,66,66,0,1,0,1,0
31742,443,23133,0,0,97,97,0,1,0,1,0
31743,61000,57587,0,0,146,146,0,1,0,1,0
31744,64240,445,0,0,70,70,0,1,0,1,0
31745,35925,443,8324,443,1092248,9101,1083147,860,195,111,749
31746,65410,53,23769,53,216,94,122,2,30,1,1
31747,7166,64147,0,0,62,62,0,1,0,1,0
31748,59404,445,0,0,70,70,0,1,0,1,0
31749,38306,51221,0,0,62,62,0,1,0,1,0
31750,64237,445,0,0,70,70,0,1,0,1,0
31751,64231,445,0,0,70,70,0,1,0,1,0
31752,64230,445,0,0,70,70,0,1,0,1,0
31753,39063,5900,0,0,60,60,0,1,0,1,0
31754,63343,53,0,0,74,74,0,1,0,1,0
31755,12969,55777,0,0,66,66,0,1,0,1,0
31756,7226,50584,0,0,62,62,0,1,0,1,0
31757,59403,445,0,0,70,70,0,1,0,1,0
31758,59402,445,0,0,70,70,0,1,0,1,0
31759,59401,445,0,0,70,70,0,1,0,1,0
31760,8313,51505,0,0,66,66,0,1,0,1,0
31761,59397,445,0,0,70,70,0,1,0,1,0
31762,59395,445,0,0,70,70,0,1,0,1,0
31763,25090,9192,0,0,145,145,0,1,0,1,0
31764,51346,51221,0,0,74,74,0,1,0,1,0
31765,52925,3389,0,0,60,60,0,1,0,1,0
31766,13485,43708,0,0,554,554,0,1,0,1,0
31767,45941,23386,0,0,60,60,0,1,0,1,0
31768,45941,23386,0,0,60,60,0,1,0,1,0
31769,9448,57866,0,0,62,62,0,1,0,1,0
31770,24145,35440,0,0,62,62,0,1,0,1,0
31771,6999,11119,0,0,143,143,0,1,0,1,0
31772,59383,445,0,0,70,70,0,1,0,1,0
31773,59382,445,0,0,70,70,0,1,0,1,0
31774,27402,37628,0,0,62,62,0,1,0,1,0
31775,59378,445,0,0,70,70,0,1,0,1,0
31776,54305,39004,0,0,62,62,0,1,0,1,0
31777,59373,445,0,0,70,70,0,1,0,1,0
31778,64221,445,0,0,70,70,0,1,0,1,0
31779,64222,445,0,0,70,70,0,1,0,1,0
31780,64217,445,0,0,70,70,0,1,0,1,0
31781,34470,57470,0,0,66,66,0,1,0,1,0
31782,8868,50584,0,0,146,146,0,1,0,1,0
31783,59630,445,0,0,66,66,0,1,0,1,0
31784,37203,443,4528,443,466,392,74,4,0,3,1
31785,14148,1,0,0,66,66,0,1,0,1,0
31786,56092,56205,0,0,146,146,0,1,0,1,0
31787,52003,44512,0,0,66,66,0,1,0,1,0
31788,51426,47563,0,0,100,100,0,1,0,1,0
31789,10797,50584,0,0,62,62,0,1,0,1,0
31790,34932,38608,0,0,62,62,0,1,0,1,0
31791,59361,445,0,0,70,70,0,1,0,1,0
31792,54276,37628,0,0,66,66,0,1,0,1,0
31793,64215,445,0,0,70,70,0,1,0,1,0
31794,64213,445,0,0,70,70,0,1,0,1,0
31795,50261,64147,0,0,66,66,0,1,0,1,0
31796,54593,51505,0,0,66,66,0,1,0,1,0
31797,61798,35440,0,0,66,66,0,1,0,1,0
31798,51426,12447,0,0,100,100,0,1,0,1,0
31799,61000,1,0,0,146,146,0,1,0,1,0
31800,18423,51505,0,0,62,62,0,1,0,1,0
31801,65322,53,28599,53,395,102,293,2,30,1,1
31802,64987,53,43588,53,198,102,96,2,30,1,1
31803,50575,53,21343,53,184,94,90,2,30,1,1
31804,49663,53,58279,53,195,102,93,2,30,1,1
31805,56269,53,36395,53,102,102,0,1,30,1,0
31806,50000,53,33265,53,216,110,106,2,30,1,1
31807,49420,53,61159,53,183,94,89,2,30,1,1
31808,51632,443,13714,443,5021,2884,2137,14,135,7,7
31809,50156,53,6756,53,186,102,84,2,30,1,1
31810,55218,443,17111,443,17915,7421,10494,39,61,21,18
31811,63914,32805,13245,32805,70,70,0,1,4,1,0
31812,50208,80,63761,80,1277,460,817,16,77,5,11
31813,49189,443,23027,443,9734,1613,8121,24,17,12,12
31814,51111,80,8917,80,366,240,126,7,21,5,2
31815,64976,53,53844,53,193,102,91,2,29,1,1
31816,64421,53,32983,53,178,94,84,2,29,1,1
31817,49490,443,14327,443,9109,1943,7166,32,270,16,16
31818,51853,443,32598,443,7415,1550,5865,28,37,15,13
31819,53746,7546,50898,7546,70,70,0,1,4,1,0
31820,53760,45682,34507,45682,70,70,0,2,7,2,0
31821,34325,443,18256,443,2450,1451,999,19,315,10,9
31822,56661,53,3079,53,297,102,195,4,34,2,2
31823,55912,53,45004,53,199,102,97,2,29,1,1
31824,57371,53,14687,53,321,108,213,4,33,2,2
31825,55350,53,27984,53,177,94,83,2,29,1,1
31826,51958,51322,52514,51322,70,70,0,2,7,2,0
31827,53762,9587,1266,9587,70,70,0,2,7,2,0
31828,56594,53,50396,53,165,86,79,2,29,1,1
31829,64507,53,28479,53,382,102,280,2,29,1,1
31830,57096,53,49643,53,443,182,261,6,29,3,3
31831,56611,53,17951,53,177,94,83,2,29,1,1
31832,64898,53,46183,53,209,94,115,2,29,1,1
31833,50440,53,52778,53,458,188,270,6,29,3,3
31834,55350,53,12521,53,185,102,83,2,29,1,1
31835,49312,53,33674,53,306,94,212,2,29,1,1
31836,49561,53,39252,53,754,94,660,2,30,1,1
31837,56611,53,12492,53,177,94,83,2,29,1,1
31838,55649,53,24364,53,216,110,106,2,30,1,1
31839,58741,443,39394,443,5168,700,4468,16,15,7,9
31840,50552,80,50552,80,2887,1776,1111,14,22,8,6
31841,56806,443,47180,443,403093,31796,371297,497,151,185,312
31842,54469,80,59842,80,1466,831,635,10,255,6,4
31843,50341,5222,19733,5222,9254,3356,5898,74,444,30,44
31844,58742,443,35475,443,5166,700,4466,16,15,7,9
31845,57189,53,16894,53,179,94,85,2,30,1,1
31846,55495,53,17025,53,210,110,100,2,30,1,1
31847,49746,53,8872,53,290,102,188,2,30,1,1
31848,49786,53,59022,53,752,110,642,2,30,1,1
31849,63943,53,44134,53,196,94,102,2,30,1,1
31850,50012,53,27557,53,212,110,102,2,30,1,1
31851,55641,53,38684,53,184,94,90,2,30,1,1
31852,55911,53,35640,53,211,110,101,2,30,1,1
31853,56489,53,43327,53,212,110,102,2,30,1,1
31854,56009,53,53982,53,178,94,84,2,30,1,1
31855,27005,33051,48719,33051,887,126,761,2,31,1,1
31856,56381,53,54551,53,196,102,94,2,30,1,1
31857,57204,53,58516,53,183,94,89,2,30,1,1
31858,55533,53,40009,53,183,94,89,2,30,1,1
31859,54461,80,46042,80,2544,900,1644,12,255,7,5
31860,38517,53,38517,53,214,82,132,2,32,1,1
31861,6455,80,6455,80,326,186,140,6,29,4,2
31862,51485,443,20455,443,828,390,438,11,40,4,7
31863,42654,443,18143,443,3650,2162,1488,25,80,13,12
31864,5571,80,5571,80,326,186,140,6,29,4,2
31865,49456,443,8615,443,10956,1757,9199,21,37,10,11
31866,56562,443,49879,443,8821,3228,5593,25,60,15,10
31867,58743,443,4487,443,5167,700,4467,16,15,7,9
31868,49404,53,23314,53,200,94,106,2,30,1,1
31869,52324,443,60831,443,295493,16052,279441,394,68,186,208
31870,50287,443,51254,443,14559,2721,11838,31,16,17,14
31871,50209,53,30899,53,749,94,655,2,30,1,1
31872,65024,53,47698,53,179,94,85,2,30,1,1
31873,44938,443,27497,443,46323,1563,44760,49,30,15,34
31874,63929,53,15311,53,195,94,101,2,30,1,1
31875,57204,53,35848,53,183,94,89,2,30,1,1
31876,50575,53,41966,53,184,94,90,2,30,1,1
31877,57126,53,50266,53,183,94,89,2,30,1,1
31878,55621,53,47829,53,453,186,267,6,30,3,3
31879,49372,53,37424,53,216,110,106,2,30,1,1
31880,49254,53,55219,53,265,110,155,2,30,1,1
31881,49797,53,5232,53,787,110,677,2,30,1,1
31882,56269,53,62645,53,816,102,714,2,30,1,1
31883,56643,53,48653,53,195,102,93,2,30,1,1
31884,56415,53,51829,53,179,94,85,2,30,1,1
31885,49323,53,61963,53,196,102,94,2,30,1,1
31886,57127,53,64638,53,193,102,91,2,30,1,1
31887,47662,80,15716,80,1067,697,370,8,63,5,3
31888,6590,80,6590,80,326,186,140,6,29,4,2
31889,5686,80,5686,80,326,186,140,6,29,4,2
31890,50598,80,63854,80,17837,3830,14007,27,24,12,15
31891,35217,443,21700,443,2388,1628,760,18,294,11,7
31892,56692,443,45896,443,7914,1925,5989,20,15,11,9
31893,64896,53,50820,53,195,94,101,2,30,1,1
31894,55495,53,27673,53,210,110,100,2,30,1,1
31895,36851,53,31171,53,86,86,0,1,30,1,0
31896,55828,53,17599,53,181,94,87,2,30,1,1
31897,64707,53,47683,53,258,102,156,2,30,1,1
31898,64607,53,1706,53,211,110,101,2,30,1,1
31899,56415,53,6950,53,179,94,85,2,30,1,1
31900,50604,80,39550,80,1658,1247,411,8,15,5,3
31901,51955,39871,23023,39871,70,70,0,2,8,2,0
31902,55464,53,43920,53,216,94,122,2,30,1,1
31903,64457,53,27221,53,261,102,159,2,30,1,1
31904,65146,53,65321,53,335,102,233,2,30,1,1
31905,56009,53,46044,53,178,94,84,2,30,1,1
31906,49420,53,47944,53,183,94,89,2,30,1,1
31907,64964,53,38711,53,197,102,95,2,30,1,1
31908,57071,53,6792,53,166,86,80,2,30,1,1
31909,56411,53,39978,53,184,94,90,2,30,1,1
31910,27005,32028,16656,32028,900,126,774,2,31,1,1
31911,50079,443,27272,443,20880,7976,12904,41,47,22,19
31912,55017,443,32512,443,7627,2734,4893,26,16,15,11
31913,55020,443,26568,443,7239,2934,4305,26,16,15,11
31914,50603,443,37566,443,2928,1448,1480,17,20,10,7
31915,56645,80,11255,80,234,234,0,4,12,4,0
31916,53743,23915,44968,23915,70,70,0,1,4,1,0
31917,58746,443,54765,443,5107,700,4407,15,15,7,8
31918,53808,443,50826,443,10785,2147,8638,22,30,10,12
31919,55018,443,29845,443,7232,2925,4307,27,16,16,11
31920,56661,53,53473,53,297,102,195,4,34,2,2
31921,54067,443,60829,443,113020,6140,106880,149,202,66,83
31922,49323,53,40976,53,196,102,94,2,31,1,1
31923,34530,80,15851,80,1056,682,374,10,15,6,4
31924,63916,56318,63492,56318,70,70,0,1,4,1,0
31925,56691,443,29213,443,7862,1873,5989,20,15,11,9
31926,5233,22683,23073,22683,832,832,0,14,95,14,0
31927,56142,53,19071,53,194,102,92,2,29,1,1
31928,63937,43443,33286,43443,246,66,180,4,7,2,2
31929,63938,26204,5698,26204,66,66,0,2,7,2,0
31930,57071,53,20542,53,166,86,80,2,29,1,1
31931,55031,443,21855,443,134,60,74,3,5,2,1
31932,52080,443,29531,443,3052,2014,1038,16,15,9,7
31933,56185,53,12663,53,183,102,81,2,29,1,1
31934,54076,443,7008,443,55394,4535,50859,91,170,47,44
31935,64987,53,27930,53,198,102,96,2,29,1,1
31936,49384,53,28867,53,305,93,212,4,48,2,2
31937,64976,53,29065,53,193,102,91,2,29,1,1
31938,56979,53,50155,53,180,94,86,2,29,1,1
31939,64628,53,58574,53,199,102,97,2,29,1,1
31940,49671,53,15823,53,166,86,80,2,29,1,1
31941,64586,53,51199,53,183,94,89,2,29,1,1
31942,49811,53,52504,53,300,118,182,2,29,1,1
31943,50272,53,52496,53,210,110,100,2,29,1,1
31944,55728,53,18036,53,195,102,93,2,29,1,1
31945,50272,53,35628,53,210,110,100,2,29,1,1
31946,57147,53,63811,53,166,86,80,2,29,1,1
31947,57204,53,13761,53,183,94,89,2,30,1,1
31948,57131,53,26066,53,168,78,90,2,30,1,1
31949,55596,53,31644,53,194,102,92,2,30,1,1
31950,49783,53,25868,53,179,94,85,2,30,1,1
31951,64496,53,57419,53,196,94,102,2,30,1,1
31952,56889,53,27210,53,211,110,101,2,30,1,1
31953,56009,53,38515,53,178,94,84,2,30,1,1
31954,64619,53,25912,53,179,94,85,2,31,1,1
31955,57470,64108,16646,64108,330,330,0,6,1199,6,0
31956,55649,53,62328,53,216,110,106,2,30,1,1
31957,55728,53,52425,53,195,102,93,2,30,1,1
31958,64555,53,59391,53,167,86,81,2,30,1,1
31959,50037,53,65320,53,195,102,93,2,31,1,1
31960,32012,500,63361,500,879,462,417,2,600,1,1
31961,64321,53,56788,53,195,102,93,2,31,1,1
31962,27005,33060,38657,33060,928,126,802,2,31,1,1
31963,51931,19416,18686,19416,70,70,0,1,5,1,0
31964,64321,53,14158,53,296,97,199,4,53,2,2
31965,65240,53,20571,53,453,186,267,6,30,3,3
31966,52323,443,4848,443,454059,23387,430672,602,76,275,327
31967,64986,53,34295,53,183,94,89,2,30,1,1
31968,64837,53,36950,53,195,102,93,2,30,1,1
31969,56085,53,34233,53,167,86,81,2,30,1,1
31970,55155,53,1843,53,183,94,89,2,30,1,1
31971,54194,443,38493,443,195229,13204,182025,270,124,102,168
31972,63933,443,50085,443,6822,3370,3452,21,135,10,11
31973,64872,53,21895,53,166,86,80,2,31,1,1
31974,56142,53,56422,53,194,102,92,2,31,1,1
31975,53759,80,20494,80,997,582,415,11,315,6,5
31976,65489,53,57940,53,531,97,434,4,35,2,2
31977,51932,36498,40161,36498,70,70,0,1,5,1,0
31978,54066,443,63244,443,307208,13249,293959,367,202,153,214
31979,54073,443,61123,443,90387,4941,85446,123,170,54,69
31980,57117,80,29144,80,1049,679,370,8,16,5,3
31981,45019,443,10530,443,33865,6559,27306,67,67,34,33
31982,64273,53,19409,53,256,102,154,2,30,1,1
31983,49931,53,2557,53,195,102,93,2,30,1,1
31984,56104,53,55768,53,210,110,100,2,30,1,1
31985,55830,53,41012,53,184,94,90,2,30,1,1
31986,55237,53,14253,53,193,102,91,2,30,1,1
31987,59692,443,65414,443,6129,3123,3006,12,120,7,5
31988,55159,53,57486,53,168,86,82,2,30,1,1
31989,40709,443,57804,443,256802,11839,244963,329,173,136,193
31990,55039,443,37835,443,19775,1890,17885,40,80,17,23
31991,56611,53,45220,53,177,94,83,2,30,1,1
31992,43176,53,34266,53,168,78,90,2,30,1,1
31993,56166,53,15271,53,193,102,91,2,30,1,1
31994,49730,53,58094,53,767,102,665,2,30,1,1
31995,64534,53,37006,53,214,110,104,2,30,1,1
31996,55237,53,28991,53,193,102,91,2,30,1,1
31997,33884,53,0,0,86,86,0,1,30,1,0
31998,57914,443,40977,443,17285,4005,13280,26,120,11,15
31999,55644,53,20547,53,184,94,90,2,30,1,1
32000,55808,53,26919,53,179,94,85,2,30,1,1
32001,55911,53,54432,53,211,110,101,2,30,1,1
32002,49845,53,42421,53,168,86,82,2,30,1,1
32003,56627,53,14624,53,193,102,91,2,30,1,1
32004,55130,53,35650,53,216,110,106,2,30,1,1
32005,49162,53,33354,53,183,94,89,2,30,1,1
32006,49563,53,27987,53,200,102,98,2,31,1,1
32007,55644,53,33807,53,184,94,90,2,31,1,1
32008,27005,32055,20958,32055,878,126,752,2,31,1,1
32009,56104,53,51847,53,210,110,100,2,31,1,1
32010,56627,53,7670,53,193,102,91,2,31,1,1
32011,64174,53,11186,53,180,94,86,2,31,1,1
32012,65176,53,48862,53,193,102,91,2,31,1,1
32013,64244,53,1570,53,199,102,97,2,31,1,1
32014,64627,53,39841,53,199,102,97,2,31,1,1
32015,59693,443,23790,443,1867,250,1617,8,120,4,4
32016,60433,443,40567,443,7113,3977,3136,23,136,12,11
32017,36712,53,0,0,139,70,69,2,30,1,1
32018,27005,26258,3792,26258,886,126,760,2,31,1,1
32019,55344,53,62039,53,212,110,102,2,30,1,1
32020,27005,33070,6671,33070,883,126,757,2,31,1,1
32021,56643,53,25715,53,195,102,93,2,31,1,1
32022,55596,53,30266,53,194,102,92,2,31,1,1
32023,64911,53,46196,53,209,110,99,2,31,1,1
32024,56166,53,32897,53,193,102,91,2,31,1,1
32025,56411,53,48736,53,184,94,90,2,31,1,1
32026,57127,53,17390,53,193,102,91,2,31,1,1
32027,64837,53,35241,53,195,102,93,2,31,1,1
32028,51147,443,61160,443,7124,2457,4667,23,120,10,13
32029,60565,443,42590,443,6483,3687,2796,18,135,9,9
32030,61286,443,11751,443,8970,5359,3611,22,121,11,11
32031,27005,32066,15067,32066,881,126,755,2,31,1,1
32032,27005,33055,20199,33055,888,126,762,2,31,1,1
32033,56426,53,37263,53,184,94,90,2,31,1,1
32034,57038,53,5859,53,186,102,84,2,31,1,1
32035,56041,53,17868,53,179,94,85,2,31,1,1
32036,49235,53,6024,53,164,86,78,2,31,1,1
32037,56381,53,46735,53,196,102,94,2,31,1,1
32038,56648,443,4719,443,7080,2136,4944,18,121,8,10
32039,50262,443,49732,443,7608,2413,5195,19,120,9,10
32040,58848,443,16146,443,2109,420,1689,11,121,6,5
32041,50265,44843,10747,44843,70,70,0,1,1200,1,0
32042,55877,12187,8942,12187,150,150,0,1,1200,1,0
32043,55641,53,35786,53,184,94,90,2,31,1,1
32044,64428,53,26819,53,299,97,202,4,44,2,2
32045,63929,443,53771,443,14647,2365,12282,22,136,10,12
32046,53741,43800,30138,43800,70,70,0,1,5,1,0
32047,59617,445,0,0,66,66,0,1,0,1,0
32048,59616,445,0,0,66,66,0,1,0,1,0
32049,59357,445,0,0,70,70,0,1,0,1,0
32050,64203,445,0,0,70,70,0,1,0,1,0
32051,49855,36180,0,0,62,62,0,1,0,1,0
32052,64198,445,0,0,70,70,0,1,0,1,0
32053,64194,445,0,0,70,70,0,1,0,1,0
32054,64193,445,0,0,70,70,0,1,0,1,0
32055,59347,445,0,0,70,70,0,1,0,1,0
32056,59346,445,0,0,70,70,0,1,0,1,0
32057,59345,445,0,0,70,70,0,1,0,1,0
32058,59609,445,0,0,66,66,0,1,0,1,0
32059,59342,445,0,0,70,70,0,1,0,1,0
32060,59340,445,0,0,70,70,0,1,0,1,0
32061,50086,57470,0,0,66,66,0,1,0,1,0
32062,60610,58414,0,0,62,62,0,1,0,1,0
32063,26606,40108,0,0,145,145,0,1,0,1,0
32064,59594,445,0,0,66,66,0,1,0,1,0
32065,59593,445,0,0,66,66,0,1,0,1,0
32066,59605,445,0,0,66,66,0,1,0,1,0
32067,59599,445,0,0,66,66,0,1,0,1,0
32068,59601,445,0,0,66,66,0,1,0,1,0
32069,59600,445,0,0,66,66,0,1,0,1,0
32070,59597,445,0,0,66,66,0,1,0,1,0
32071,62819,56205,0,0,62,62,0,1,0,1,0
32072,50245,44847,0,0,66,66,0,1,0,1,0
32073,64190,445,0,0,70,70,0,1,0,1,0
32074,24285,26467,0,0,62,62,0,1,0,1,0
32075,55111,39004,0,0,66,66,0,1,0,1,0
32076,28413,64147,0,0,66,66,0,1,0,1,0
32077,64185,445,0,0,70,70,0,1,0,1,0
32078,64183,445,0,0,70,70,0,1,0,1,0
32079,64181,445,0,0,70,70,0,1,0,1,0
32080,57173,44847,0,0,62,62,0,1,0,1,0
32081,1024,57470,0,0,72,72,0,1,0,1,0
32082,51812,1433,0,0,60,60,0,1,0,1,0
32083,59334,445,0,0,70,70,0,1,0,1,0
32084,24949,47563,0,0,145,145,0,1,0,1,0
32085,3074,64147,0,0,62,62,0,1,0,1,0
32086,24910,64147,0,0,66,66,0,1,0,1,0
32087,22125,23,0,0,60,60,0,1,0,1,0
32088,49514,39127,0,0,162,162,0,1,0,1,0
32089,17378,44847,0,0,66,66,0,1,0,1,0
32090,59327,445,0,0,70,70,0,1,0,1,0
32091,64180,445,0,0,70,70,0,1,0,1,0
32092,64177,445,0,0,70,70,0,1,0,1,0
32093,64173,445,0,0,70,70,0,1,0,1,0
32094,59326,445,0,0,70,70,0,1,0,1,0
32095,59587,445,0,0,66,66,0,1,0,1,0
32096,443,43775,0,0,97,97,0,1,0,1,0
32097,64172,445,0,0,70,70,0,1,0,1,0
32098,63988,50584,0,0,66,66,0,1,0,1,0
32099,60141,62413,0,0,66,66,0,1,0,1,0
32100,2180,63710,0,0,62,62,0,1,0,1,0
32101,59585,445,0,0,66,66,0,1,0,1,0
32102,1057,57470,0,0,62,62,0,1,0,1,0
32103,59583,445,0,0,66,66,0,1,0,1,0
32104,59582,445,0,0,66,66,0,1,0,1,0
32105,59579,445,0,0,66,66,0,1,0,1,0
32106,59321,445,0,0,70,70,0,1,0,1,0
32107,60351,50584,0,0,62,62,0,1,0,1,0
32108,59319,445,0,0,70,70,0,1,0,1,0
32109,21750,39004,0,0,66,66,0,1,0,1,0
32110,59486,50584,0,0,62,62,0,1,0,1,0
32111,12737,35440,0,0,62,62,0,1,0,1,0
32112,14042,22114,0,0,62,62,0,1,0,1,0
32113,14042,22114,0,0,146,146,0,1,0,1,0
32114,3023,40108,0,0,148,148,0,1,0,1,0
32115,3068,36237,0,0,62,62,0,1,0,1,0
32116,64164,445,0,0,70,70,0,1,0,1,0
32117,56035,1310,0,0,66,66,0,1,0,1,0
32118,37028,51505,0,0,62,62,0,1,0,1,0
32119,58791,15503,0,0,66,66,0,1,0,1,0
32120,12644,11392,0,0,62,62,0,1,0,1,0
32121,59315,445,0,0,70,70,0,1,0,1,0
32122,64159,445,0,0,70,70,0,1,0,1,0
32123,64156,445,0,0,70,70,0,1,0,1,0
32124,39287,57470,0,0,62,62,0,1,0,1,0
32125,50806,51505,0,0,66,66,0,1,0,1,0
32126,55854,54369,0,0,74,74,0,1,0,1,0
32127,51996,57470,0,0,66,66,0,1,0,1,0
32128,59313,445,0,0,70,70,0,1,0,1,0
32129,1143,25198,0,0,148,148,0,1,0,1,0
32130,59569,445,0,0,66,66,0,1,0,1,0
32131,13285,29892,0,0,145,145,0,1,0,1,0
32132,42964,5900,0,0,60,60,0,1,0,1,0
32133,59309,445,0,0,70,70,0,1,0,1,0
32134,59561,445,0,0,66,66,0,1,0,1,0
32135,5087,22114,0,0,66,66,0,1,0,1,0
32136,64144,445,0,0,70,70,0,1,0,1,0
32137,25267,2323,0,0,60,60,0,1,0,1,0
32138,65166,62413,0,0,66,66,0,1,0,1,0
32139,59915,42707,0,0,145,145,0,1,0,1,0
32140,59559,445,0,0,66,66,0,1,0,1,0
32141,12260,51505,0,0,62,62,0,1,0,1,0
32142,57468,57470,0,0,66,66,0,1,0,1,0
32143,53766,51505,0,0,62,62,0,1,0,1,0
32144,59552,445,0,0,66,66,0,1,0,1,0
32145,45941,23386,0,0,60,60,0,1,0,1,0
32146,45238,44847,0,0,66,66,0,1,0,1,0
32147,19875,30170,0,0,145,145,0,1,0,1,0
32148,59543,445,0,0,66,66,0,1,0,1,0
32149,59296,445,0,0,70,70,0,1,0,1,0
32150,14967,24855,0,0,62,62,0,1,0,1,0
32151,59293,445,0,0,70,70,0,1,0,1,0
32152,51413,57470,0,0,72,72,0,1,0,1,0
32153,57302,62413,0,0,66,66,0,1,0,1,0
32154,58076,21247,0,0,62,62,0,1,0,1,0
32155,64134,445,0,0,70,70,0,1,0,1,0
32156,64133,445,0,0,70,70,0,1,0,1,0
32157,64132,445,0,0,70,70,0,1,0,1,0
32158,35408,56205,0,0,62,62,0,1,0,1,0
32159,59530,445,0,0,66,66,0,1,0,1,0
32160,55644,53,49999,53,184,94,90,2,30,1,1
32161,56104,53,14895,53,204,104,100,2,30,1,1
32162,56751,53,17361,53,752,93,659,2,30,1,1
32163,49563,53,8253,53,200,102,98,2,30,1,1
32164,56879,53,15562,53,744,95,649,2,30,1,1
32165,59904,443,14583,443,694,370,324,12,34,7,5
32166,63900,42641,18797,42641,504,382,122,8,16,6,2
32167,53141,8595,16874,8595,70,70,0,1,5,1,0
32168,51950,17499,15514,17499,70,70,0,2,8,2,0
32169,46861,15000,42443,15000,130,70,60,2,5,1,1
32170,50286,443,3120,443,8773,1538,7235,25,15,14,11
32171,65262,53,47231,53,216,110,106,2,30,1,1
32172,36738,80,36738,80,416,198,218,7,121,4,3
32173,63935,51413,5308,51413,312,132,180,6,7,3,3
32174,50392,8080,50392,8080,8962,4731,4231,26,75,14,12
32175,64862,53,32776,53,206,105,101,2,30,1,1
32176,64872,53,35777,53,164,84,80,2,30,1,1
32177,49251,443,56131,443,15567,1944,13623,40,81,17,23
32178,49247,53,6509,53,478,196,282,6,64,3,3
32179,55016,1113,36871,1113,6723,1881,4842,25,16,15,10
32180,57364,53,57364,53,213,79,134,2,32,1,1
32181,51700,7000,51700,7000,2163,676,1487,14,15,7,7
32182,38848,80,21726,80,288702,9850,278852,312,105,123,189
32183,55808,53,62686,53,174,89,85,2,30,1,1
32184,55184,53,64437,53,182,93,89,2,31,1,1
32185,57629,80,39284,80,1115,534,581,12,16,7,5
32186,49245,53,3951,53,190,97,93,2,31,1,1
32187,56943,80,45580,80,2817,2024,793,12,75,7,5
32188,50406,8080,50406,8080,47078,2874,44204,66,51,32,34
32189,60979,443,13590,443,49981,8331,41650,75,48,36,39
32190,64200,53,60467,53,186,95,91,2,30,1,1
32191,51107,80,61498,80,366,240,126,7,21,5,2
32192,41061,5222,19047,5222,107717,16808,90909,301,618,148,153
32193,59000,443,41990,443,9876,5325,4551,25,131,14,11
32194,49692,53,19952,53,208,106,102,2,30,1,1
32195,56998,443,56998,443,4577,1670,2907,19,26,11,8
32196,49845,53,59006,53,168,86,82,2,30,1,1
32197,56166,53,15904,53,186,95,91,2,30,1,1
32198,56730,53,51057,53,733,86,647,2,30,1,1
32199,65451,53,6208,53,188,96,92,2,31,1,1
32200,56426,53,19941,53,184,94,90,2,31,1,1
32201,60792,443,60792,443,16401,8712,7689,53,297,25,28
32202,50972,3544,28007,3544,258,107,151,2,31,1,1
32203,3819,80,3819,80,9399,632,8767,15,15,7,8
32204,64460,53,62568,53,192,98,94,2,31,1,1
32205,56041,53,27459,53,174,89,85,2,31,1,1
32206,49480,53,49480,53,213,79,134,2,32,1,1
32207,55000,443,17337,443,134,60,74,3,10,2,1
32208,48885,53,48885,53,215,80,135,2,32,1,1
32209,36307,80,3965,80,1368,920,448,12,20,7,5
32210,59001,443,42456,443,9860,5309,4551,25,131,14,11
32211,57071,443,54499,443,20873,8800,12073,68,19,37,31
32212,5588,5588,0,0,3354,1792,1562,46,194,23,23
32213,61503,443,25661,443,182448,3931,178517,161,26,36,125
32214,49162,53,42033,53,182,93,89,2,30,1,1
32215,55159,53,17196,53,168,86,82,2,30,1,1
32216,49825,53,42990,53,168,86,82,2,30,1,1
32217,49621,53,22875,53,182,93,89,2,31,1,1
32218,38567,80,39974,80,1571,877,694,11,181,6,5
32219,15503,14130,48221,14130,480,149,331,2,1200,1,1
32220,56216,5228,61293,5228,2495,1477,1018,17,3600,8,9
32221,55630,53,58025,53,194,99,95,2,31,1,1
32222,58972,443,21151,443,5979,3487,2492,21,168,10,11
32223,50049,443,7528,443,27889,1445,26444,37,121,14,23
32224,40098,443,58425,443,4564,3204,1360,19,348,10,9
32225,64473,53,45182,53,184,94,90,2,31,1,1
32226,50037,53,57358,53,190,97,93,2,30,1,1
32227,57416,53,52623,53,186,95,91,2,30,1,1
32228,65107,53,21629,53,186,95,91,2,31,1,1
32229,64036,53,10774,53,182,93,89,2,31,1,1
32230,64475,53,56794,53,184,94,90,2,31,1,1
32231,51957,53,51957,53,825,99,726,2,31,1,1
32232,27005,30009,16373,30009,889,126,763,2,31,1,1
32233,15755,53,15755,53,241,95,146,2,31,1,1
32234,65144,53,52237,53,204,104,100,2,31,1,1
32235,62275,443,20241,443,18482489,568378,17914111,19386,214,6466,12920
32236,49188,53,21489,53,777,87,690,2,31,1,1
32237,57397,53,25863,53,182,93,89,2,31,1,1
32238,56144,53,58343,53,176,90,86,2,31,1,1
32239,65049,53,59454,53,184,94,90,2,31,1,1
32240,51221,10476,15636,10476,528,528,0,9,1201,9,0
32241,62062,443,17723,443,13499,2333,11166,24,137,10,14
32242,59534,445,0,0,66,66,0,1,0,1,0
32243,59532,445,0,0,66,66,0,1,0,1,0
32244,59527,445,0,0,66,66,0,1,0,1,0
32245,59535,445,0,0,66,66,0,1,0,1,0
32246,59528,445,0,0,66,66,0,1,0,1,0
32247,59531,445,0,0,66,66,0,1,0,1,0
32248,59529,445,0,0,66,66,0,1,0,1,0
32249,17548,36829,0,0,62,62,0,1,0,1,0
32250,9687,57470,0,0,78,78,0,1,0,1,0
32251,1091,37965,0,0,62,62,0,1,0,1,0
32252,59288,445,0,0,70,70,0,1,0,1,0
32253,54866,37965,0,0,62,62,0,1,0,1,0
32254,23415,11392,0,0,66,66,0,1,0,1,0
32255,48857,50584,0,0,66,66,0,1,0,1,0
32256,11256,47967,0,0,143,143,0,1,0,1,0
32257,59287,445,0,0,70,70,0,1,0,1,0
32258,8592,35993,0,0,66,66,0,1,0,1,0
32259,51382,56205,0,0,66,66,0,1,0,1,0
32260,24301,6881,0,0,146,146,0,1,0,1,0
32261,10447,30317,0,0,146,146,0,1,0,1,0
32262,59285,445,0,0,70,70,0,1,0,1,0
32263,10480,26467,0,0,62,62,0,1,0,1,0
32264,26323,50584,0,0,146,146,0,1,0,1,0
32265,10477,44847,0,0,62,62,0,1,0,1,0
32266,55644,53,55094,53,184,94,90,2,30,1,1
32267,34154,443,26354,443,45554,1695,43859,50,30,15,35
32268,1024,44847,0,0,62,62,0,1,0,1,0
32269,13917,18033,0,0,62,62,0,1,0,1,0
32270,55444,23,0,0,60,60,0,1,0,1,0
32271,64131,445,0,0,70,70,0,1,0,1,0
32272,64122,445,0,0,70,70,0,1,0,1,0
32273,64123,445,0,0,70,70,0,1,0,1,0
32274,64121,445,0,0,70,70,0,1,0,1,0
32275,41734,57470,0,0,62,62,0,1,0,1,0
32276,2464,50584,0,0,66,66,0,1,0,1,0
32277,22409,55442,0,0,74,74,0,1,0,1,0
32278,59514,445,0,0,66,66,0,1,0,1,0
32279,59513,445,0,0,66,66,0,1,0,1,0
32280,59512,445,0,0,66,66,0,1,0,1,0
32281,56098,55442,0,0,66,66,0,1,0,1,0
32282,59278,445,0,0,70,70,0,1,0,1,0
32283,14336,64147,0,0,62,62,0,1,0,1,0
32284,26601,22114,0,0,66,66,0,1,0,1,0
32285,56218,43890,0,0,66,66,0,1,0,1,0
32286,59276,445,0,0,70,70,0,1,0,1,0
32287,9445,56205,0,0,66,66,0,1,0,1,0
32288,20724,19750,0,0,78,78,0,1,0,1,0
32289,64112,445,0,0,70,70,0,1,0,1,0
32290,51429,22114,0,0,66,66,0,1,0,1,0
32291,59275,445,0,0,70,70,0,1,0,1,0
32292,56413,53,33044,53,338,110,228,2,30,1,1
32293,56785,53,32079,53,193,102,91,2,30,1,1
32294,57416,53,15222,53,193,102,91,2,30,1,1
32295,64862,53,5762,53,211,110,101,2,30,1,1
32296,39890,443,25429,443,18127,8010,10117,41,116,24,17
32297,49552,80,31507,80,1963,1067,896,11,15,6,5
32298,56690,443,7139,443,7914,1925,5989,20,15,11,9
32299,58740,443,9858,443,5228,700,4528,17,14,7,10
32300,60778,40010,59381,40010,316,136,180,6,6,3,3
32301,57069,443,33403,443,15125,2482,12643,53,38,27,26
32302,49663,53,4720,53,195,102,93,2,29,1,1
32303,55828,53,62076,53,181,94,87,2,29,1,1
32304,55344,53,42459,53,212,110,102,2,29,1,1
32305,64534,53,57803,53,214,110,104,2,30,1,1
32306,56824,443,13725,443,18356,13354,5002,47,34,29,18
32307,49554,443,18292,443,7540,1840,5700,18,15,10,8
32308,56317,53,56317,53,216,82,134,2,32,1,1
32309,39326,53,39326,53,233,90,143,2,32,1,1
32310,27005,32063,51455,32063,889,126,763,3,31,2,1
32311,54677,443,22432,443,10029,4115,5914,31,61,17,14
32312,50010,80,40489,80,5058,4299,759,11,27,6,5
32313,46851,443,41590,443,3998,1986,2012,20,255,10,10
32314,51962,1024,18199,1024,316,136,180,6,5,3,3
32315,36821,443,10604,443,5948,1553,4395,16,15,10,6
32316,65189,53,21618,53,734,94,640,2,29,1,1
32317,49162,53,39735,53,183,94,89,2,29,1,1
32318,58997,443,10081,443,70,70,0,1,4,1,0
32319,64588,53,11970,53,193,102,91,2,29,1,1
32320,42847,443,14614,443,162,102,60,2,4,1,1
32321,65246,53,9355,53,179,94,85,2,29,1,1
32322,46660,443,53403,443,13699,2575,11124,30,135,15,15
32323,27691,53,27691,53,235,90,145,2,32,1,1
32324,56444,53,36861,53,730,102,628,2,29,1,1
32325,63960,53,45995,53,178,94,84,2,30,1,1
32326,55830,53,49103,53,184,94,90,2,29,1,1
32327,56415,53,18388,53,179,94,85,2,29,1,1
32328,55155,53,2864,53,183,94,89,2,29,1,1
32329,50156,53,35377,53,178,94,84,2,29,1,1
32330,55533,53,54545,53,183,94,89,2,29,1,1
32331,64244,53,64721,53,199,102,97,2,29,1,1
32332,55155,53,64785,53,183,94,89,2,29,1,1
32333,55130,53,39778,53,216,110,106,2,29,1,1
32334,65042,53,26467,53,183,94,89,2,29,1,1
32335,55822,53,10353,53,324,126,198,2,30,1,1
32336,64837,53,39780,53,195,102,93,2,30,1,1
32337,56687,443,42301,443,7889,1900,5989,20,15,11,9
32338,49421,443,23073,443,301494,6917,294577,306,48,101,205
32339,53853,53,0,0,139,70,69,2,30,1,1
32340,65262,53,31670,53,216,110,106,2,30,1,1
32341,56426,53,49161,53,184,94,90,2,30,1,1
32342,64818,53,61380,53,260,102,158,2,30,1,1
32343,64473,53,9936,53,184,94,90,2,30,1,1
32344,64862,53,39051,53,211,110,101,2,30,1,1
32345,49563,53,27885,53,200,102,98,2,30,1,1
32346,51923,80,55461,80,60441,6260,54181,79,29,35,44
32347,39910,80,12870,80,1658,1344,314,10,15,5,5
32348,64460,53,29713,53,196,102,94,2,30,1,1
32349,50553,443,23117,443,1632,1023,609,16,133,9,7
32350,51927,63309,60569,63309,70,70,0,1,5,1,0
32351,51920,80,17031,80,5069,4443,626,11,30,6,5
32352,37611,443,45731,443,11038,3875,7163,33,16,18,15
32353,57986,80,14489,80,1898,1524,374,14,15,8,6
32354,64416,53,56387,53,291,110,181,2,30,1,1
32355,2874,53,2874,53,216,82,134,2,31,1,1
32356,37608,443,50721,443,7866,2680,5186,26,16,14,12
32357,56889,53,22522,53,211,110,101,2,30,1,1
32358,56358,53,65243,53,210,110,100,2,33,1,1
32359,50664,443,33919,443,9666,1682,7984,25,16,13,12
32360,49310,53,37425,53,239,102,137,2,30,1,1
32361,51928,52520,11257,52520,70,70,0,1,5,1,0
32362,58058,80,25761,80,318,192,126,6,21,4,2
32363,56689,443,16946,443,7890,1901,5989,20,15,11,9
32364,65246,53,26370,53,179,94,85,2,30,1,1
32365,56688,443,60189,443,7942,1953,5989,20,15,11,9
32366,56673,53,10759,53,193,102,91,2,30,1,1
32367,64534,53,35373,53,214,110,104,2,30,1,1
32368,64795,53,2622,53,338,110,228,2,30,1,1
32369,65451,53,62075,53,194,102,92,2,30,1,1
32370,64897,53,54215,53,312,94,218,2,30,1,1
32371,49245,53,24840,53,195,102,93,2,30,1,1
32372,49419,53,29016,53,252,102,150,2,30,1,1
32373,65512,53,38019,53,265,102,163,2,30,1,1
32374,55533,53,2426,53,183,94,89,2,30,1,1
32375,56673,53,26407,53,193,102,91,2,30,1,1
32376,37965,48477,53954,48477,7097,4720,2377,89,3163,55,34
32377,49692,53,65365,53,212,110,102,2,30,1,1
32378,64666,53,52653,53,226,102,124,2,30,1,1
32379,51929,53371,28667,53371,70,70,0,1,5,1,0
32380,51109,80,7098,80,366,240,126,7,20,5,2
32381,39687,443,29168,443,10412,5123,5289,36,236,19,17
32382,64200,53,27722,53,193,102,91,2,30,1,1
32383,64200,53,25588,53,193,102,91,2,30,1,1
32384,65107,53,27622,53,193,102,91,2,30,1,1
32385,49692,53,33543,53,212,110,102,2,30,1,1
32386,54453,443,34094,443,257837,37453,220384,446,952,175,271
32387,59945,443,18013,443,10477,3435,7042,34,20,18,16
32388,57336,443,14468,443,6956,2856,4100,28,16,16,12
32389,35196,5222,52205,5222,3376,1509,1867,32,83,16,16
32390,59754,80,41353,80,1352,848,504,13,83,8,5
32391,64041,53,42434,53,198,94,104,2,30,1,1
32392,49692,53,30173,53,212,110,102,2,30,1,1
32393,63960,53,27823,53,178,94,84,2,30,1,1
32394,56532,53,37108,53,164,86,78,2,30,1,1
32395,49671,53,34167,53,242,110,132,2,30,1,1
32396,27005,30006,1523,30006,888,126,762,2,31,1,1
32397,6881,6881,14892,6881,502,150,352,2,1200,1,1
32398,37877,80,30834,80,991,483,508,9,181,5,4
32399,27005,33038,15973,33038,892,126,766,2,31,1,1
32400,49327,443,33965,443,54335,2550,51785,74,42,29,45
32401,54075,443,31475,443,76388,4341,72047,107,169,48,59
32402,49551,80,48076,80,1769,873,896,11,15,6,5
32403,54074,443,19199,443,72465,3991,68474,98,169,43,55
32404,49553,443,65490,443,6074,865,5209,16,15,9,7
32405,51952,50967,36786,50967,70,70,0,2,7,2,0
32406,57436,66,13833,66,70,70,0,2,7,2,0
32407,51325,443,47264,443,2019,1219,800,15,17,8,7
32408,51954,12380,62025,12380,70,70,0,2,7,2,0
32409,53739,27290,28914,27290,70,70,0,1,4,1,0
32410,56661,53,7946,53,297,102,195,4,33,2,2
32411,53720,443,39047,443,11338,7078,4260,19,16,12,7
32412,64627,53,53750,53,305,101,204,4,44,2,2
32413,50554,443,37415,443,7343,1707,5636,26,134,14,12
32414,49828,53,44800,53,733,86,647,2,29,1,1
32415,58999,443,40792,443,9569,2606,6963,22,135,11,11
32416,56166,53,54206,53,193,102,91,2,29,1,1
32417,41764,53,7946,53,168,78,90,2,29,1,1
32418,64872,53,24466,53,730,102,628,2,29,1,1
32419,51110,80,59490,80,1524,1028,496,10,20,7,3
32420,57177,53,20677,53,179,94,85,2,29,1,1
32421,63902,22928,21119,22928,504,382,122,8,15,6,2
32422,49372,53,4796,53,527,208,319,6,64,3,3
32423,56627,53,58271,53,193,102,91,2,29,1,1
32424,55867,53,51725,53,184,94,90,2,29,1,1
32425,49216,53,14364,53,181,94,87,2,30,1,1
32426,49162,53,33526,53,183,94,89,2,30,1,1
32427,49940,53,16387,53,257,110,147,2,29,1,1
32428,55126,53,61612,53,193,102,91,2,29,1,1
32429,55184,53,59449,53,183,94,89,2,30,1,1
32430,56889,53,49457,53,211,110,101,2,30,1,1
32431,49372,53,58789,53,216,110,106,2,30,1,1
32432,56104,53,19874,53,210,110,100,2,30,1,1
32433,65262,53,52236,53,216,110,106,2,30,1,1
32434,49864,53,63965,53,193,102,91,2,30,1,1
32435,27005,33059,8397,33059,900,126,774,2,31,1,1
32436,64460,53,42311,53,196,102,94,2,31,1,1
32437,49825,53,56726,53,168,86,82,2,30,1,1
32438,64036,53,20328,53,183,94,89,2,30,1,1
32439,32675,53,58212,53,218,78,140,2,30,1,1
32440,65144,53,10538,53,210,110,100,2,30,1,1
32441,49669,53,30235,53,197,94,103,2,30,1,1
32442,27005,32078,44538,32078,871,126,745,2,31,1,1
32443,56170,443,45296,443,9201,4926,4275,19,120,10,9
32444,51539,443,52838,443,94949,5974,88975,118,148,45,73
32445,55035,443,8425,443,5653,2347,3306,33,361,18,15
32446,49435,53,45474,53,720,94,626,2,30,1,1
32447,42846,443,19024,443,162,102,60,2,5,1,1
32448,49247,53,7662,53,478,196,282,6,63,3,3
32449,36483,80,36483,80,1015966,37923,978043,1167,205,468,699
32450,39689,443,12729,443,7259,3893,3366,34,236,18,16
32451,56673,53,29686,53,193,102,91,2,30,1,1
32452,56041,53,26244,53,179,94,85,2,30,1,1
32453,57416,53,53787,53,193,102,91,2,30,1,1
32454,64417,53,10923,53,231,102,129,2,30,1,1
32455,64555,53,55605,53,167,86,81,2,30,1,1
32456,65262,53,62763,53,216,110,106,2,30,1,1
32457,49216,53,15355,53,181,94,87,2,30,1,1
32458,65176,53,39241,53,193,102,91,2,30,1,1
32459,64862,53,53283,53,211,110,101,2,30,1,1
32460,53262,443,28483,443,4385,2869,1516,32,19,18,14
32461,49770,80,9129,80,254,128,126,5,15,3,2
32462,52297,443,5562,443,3055,1931,1124,16,16,9,7
32463,65246,53,35369,53,179,94,85,2,30,1,1
32464,34153,443,49528,443,7037,1282,5755,21,30,11,10
32465,55126,53,18152,53,193,102,91,2,30,1,1
32466,64911,53,45523,53,209,110,99,2,30,1,1
32467,65523,53,26977,53,228,94,134,2,30,1,1
32468,64200,53,53095,53,193,102,91,2,30,1,1
32469,57052,443,57052,443,4616,1709,2907,19,28,11,8
32470,53261,443,49163,443,12912,4288,8624,43,20,22,21
32471,50405,8080,50405,8080,3985,2010,1975,17,51,10,7
32472,63939,24867,28601,24867,312,132,180,6,6,3,3
32473,51951,65387,56923,65387,70,70,0,2,8,2,0
32474,44158,443,51060,443,232,172,60,3,5,2,1
32475,55130,53,20364,53,216,110,106,2,30,1,1
32476,55344,53,59156,53,212,110,102,2,30,1,1
32477,57038,53,2434,53,186,102,84,2,30,1,1
32478,56387,53,17582,53,183,94,89,2,30,1,1
32479,49235,53,22418,53,172,94,78,2,30,1,1
32480,63960,53,31296,53,178,94,84,2,30,1,1
32481,64514,53,1734,53,209,102,107,2,30,1,1
32482,55630,53,39473,53,197,102,95,2,30,1,1
32483,49864,53,57559,53,193,102,91,2,30,1,1
32484,56041,53,56903,53,179,94,85,2,30,1,1
32485,27005,33035,15064,33035,864,126,738,2,31,1,1
32486,64473,53,39348,53,184,94,90,2,31,1,1
32487,55184,53,63377,53,183,94,89,2,30,1,1
32488,65025,53,23591,53,347,94,253,2,30,1,1
32489,27005,33076,50946,33076,889,126,763,2,31,1,1
32490,53829,53,12567,53,258,86,172,2,31,1,1
32491,27005,50003,14417,50003,887,126,761,2,31,1,1
32492,65451,53,9650,53,194,102,92,2,31,1,1
32493,65107,53,31681,53,193,102,91,2,31,1,1
32494,64319,53,34050,53,193,102,91,2,31,1,1
32495,65251,53,39893,53,179,94,85,2,31,1,1
32496,64619,53,39601,53,179,94,85,2,31,1,1
32497,64872,53,64528,53,166,86,80,2,31,1,1
32498,50037,53,63751,53,195,102,93,2,31,1,1
32499,49501,53,63385,53,193,102,91,2,31,1,1
32500,63035,443,64744,443,1864,250,1614,8,120,4,4
32501,34319,443,65277,443,15358,11148,4210,93,423,51,42
32502,58847,443,11614,443,7014,1630,5384,20,120,10,10
32503,57603,80,12542,80,886,886,0,1,120,1,0
32504,37484,443,55128,443,59233,7514,51719,70,122,27,43
32505,6881,6889,64062,6889,228,118,110,2,1199,1,1
32506,57470,52215,48091,52215,528,528,0,9,1200,9,0
32507,52839,443,27104,443,11808,5409,6399,73,123,33,40
32508,50037,53,12005,53,195,102,93,2,30,1,1
32509,55630,53,11814,53,197,102,95,2,30,1,1
32510,27005,33052,60950,33052,873,126,747,2,31,1,1
32511,50972,3544,56182,3544,409,107,302,4,31,2,2
32512,64070,53,32128,53,243,94,149,2,31,1,1
32513,55184,53,41873,53,183,94,89,2,31,1,1
32514,55456,443,5231,443,7409,2302,5107,19,135,9,10
32515,56686,443,39990,443,7941,1952,5989,20,16,11,9
32516,49216,53,46478,53,316,91,225,4,32,2,2
32517,55669,62781,37625,62781,320,140,180,6,7,3,3
32518,51949,5484,1068,5484,70,70,0,2,8,2,0
32519,53734,22051,14778,22051,70,70,0,1,5,1,0
32520,51052,80,32804,80,5678,1692,3986,13,17,8,5
32521,39333,443,52867,443,7832,1895,5937,24,83,14,10
32522,51957,56737,56106,56737,316,136,180,6,6,3,3
32523,38346,80,22623,80,1818,1504,314,13,16,8,5
32524,42317,443,11761,443,416,210,206,7,27,4,3
32525,51504,443,9734,443,6656,769,5887,14,16,9,5
32526,62514,37807,0,0,66,66,0,1,0,1,0
32527,64104,445,0,0,70,70,0,1,0,1,0
32528,64103,445,0,0,70,70,0,1,0,1,0
32529,64102,445,0,0,70,70,0,1,0,1,0
32530,47201,44847,0,0,66,66,0,1,0,1,0
32531,59274,445,0,0,70,70,0,1,0,1,0
32532,59273,445,0,0,70,70,0,1,0,1,0
32533,10145,21247,0,0,62,62,0,1,0,1,0
32534,59271,445,0,0,70,70,0,1,0,1,0
32535,59267,445,0,0,70,70,0,1,0,1,0
32536,44459,37807,0,0,62,62,0,1,0,1,0
32537,11061,4229,0,0,145,145,0,1,0,1,0
32538,59255,445,0,0,70,70,0,1,0,1,0
32539,59254,445,0,0,70,70,0,1,0,1,0
32540,1560,51505,0,0,62,62,0,1,0,1,0
32541,59251,445,0,0,70,70,0,1,0,1,0
32542,59244,445,0,0,70,70,0,1,0,1,0
32543,59245,445,0,0,70,70,0,1,0,1,0
32544,49522,21247,0,0,66,66,0,1,0,1,0
32545,18224,23,0,0,60,60,0,1,0,1,0
32546,64094,445,0,0,70,70,0,1,0,1,0
32547,64093,445,0,0,70,70,0,1,0,1,0
32548,64092,445,0,0,70,70,0,1,0,1,0
32549,11907,57470,0,0,66,66,0,1,0,1,0
32550,62257,2767,0,0,66,66,0,1,0,1,0
32551,46837,57470,0,0,62,62,0,1,0,1,0
32552,27309,6881,0,0,146,146,0,1,0,1,0
32553,59503,445,0,0,66,66,0,1,0,1,0
32554,37837,37965,0,0,62,62,0,1,0,1,0
32555,55027,48051,0,0,62,62,0,1,0,1,0
32556,52459,33890,0,0,60,60,0,1,0,1,0
32557,52252,46314,0,0,62,62,0,1,0,1,0
32558,56101,57470,0,0,66,66,0,1,0,1,0
32559,62143,23,0,0,60,60,0,1,0,1,0
32560,59233,445,0,0,70,70,0,1,0,1,0
32561,64087,445,0,0,70,70,0,1,0,1,0
32562,64084,445,0,0,70,70,0,1,0,1,0
32563,61392,50584,0,0,62,62,0,1,0,1,0
32564,59487,445,0,0,66,66,0,1,0,1,0
32565,59486,445,0,0,66,66,0,1,0,1,0
32566,59228,445,0,0,70,70,0,1,0,1,0
32567,49113,50584,0,0,66,66,0,1,0,1,0
32568,65398,7129,0,0,66,66,0,1,0,1,0
32569,6404,64147,0,0,145,145,0,1,0,1,0
32570,59220,445,0,0,70,70,0,1,0,1,0
32571,59219,445,0,0,70,70,0,1,0,1,0
32572,59218,445,0,0,70,70,0,1,0,1,0
32573,31745,2323,0,0,60,60,0,1,0,1,0
32574,64073,445,0,0,70,70,0,1,0,1,0
32575,60557,23117,0,0,66,66,0,1,0,1,0
32576,59215,445,0,0,70,70,0,1,0,1,0
32577,59213,445,0,0,70,70,0,1,0,1,0
32578,64070,445,0,0,70,70,0,1,0,1,0
32579,64068,445,0,0,70,70,0,1,0,1,0
32580,64067,445,0,0,70,70,0,1,0,1,0
32581,443,45940,0,0,85,85,0,1,0,1,0
32582,59481,445,0,0,66,66,0,1,0,1,0
32583,50920,60182,0,0,66,66,0,1,0,1,0
32584,59476,445,0,0,66,66,0,1,0,1,0
32585,59475,445,0,0,66,66,0,1,0,1,0
32586,59474,445,0,0,66,66,0,1,0,1,0
32587,59466,445,0,0,66,66,0,1,0,1,0
32588,59470,445,0,0,66,66,0,1,0,1,0
32589,59467,445,0,0,66,66,0,1,0,1,0
32590,59465,445,0,0,66,66,0,1,0,1,0
32591,64824,36829,0,0,66,66,0,1,0,1,0
32592,52914,37965,0,0,66,66,0,1,0,1,0
32593,64059,445,0,0,70,70,0,1,0,1,0
32594,16387,8455,0,0,60,60,0,1,0,1,0
32595,16387,49252,0,0,60,60,0,1,0,1,0
32596,16387,35244,0,0,60,60,0,1,0,1,0
32597,50675,56205,0,0,66,66,0,1,0,1,0
32598,64057,445,0,0,70,70,0,1,0,1,0
32599,64056,445,0,0,70,70,0,1,0,1,0
32600,64053,445,0,0,70,70,0,1,0,1,0
32601,4110,35440,0,0,66,66,0,1,0,1,0
32602,6666,5000,0,0,60,60,0,1,0,1,0
32603,59206,445,0,0,70,70,0,1,0,1,0
32604,59413,51505,0,0,66,66,0,1,0,1,0
32605,63956,38211,0,0,62,62,0,1,0,1,0
32606,41756,56205,0,0,62,62,0,1,0,1,0
32607,59199,445,0,0,70,70,0,1,0,1,0
32608,59197,445,0,0,70,70,0,1,0,1,0
32609,39324,64147,0,0,62,62,0,1,0,1,0
32610,64052,445,0,0,70,70,0,1,0,1,0
32611,64049,445,0,0,70,70,0,1,0,1,0
32612,64045,445,0,0,70,70,0,1,0,1,0
32613,59458,445,0,0,66,66,0,1,0,1,0
32614,57765,2767,0,0,146,146,0,1,0,1,0
32615,64044,445,0,0,70,70,0,1,0,1,0
32616,59456,445,0,0,66,66,0,1,0,1,0
32617,59193,445,0,0,70,70,0,1,0,1,0
32618,59454,445,0,0,66,66,0,1,0,1,0
32619,59452,445,0,0,66,66,0,1,0,1,0
32620,59191,445,0,0,70,70,0,1,0,1,0
32621,16477,37807,0,0,66,66,0,1,0,1,0
32622,59450,445,0,0,66,66,0,1,0,1,0
32623,12031,36237,0,0,66,66,0,1,0,1,0
32624,33003,28543,0,0,62,62,0,1,0,1,0
32625,5132,23,0,0,60,60,0,1,0,1,0
32626,54389,28543,0,0,66,66,0,1,0,1,0
32627,36893,67,0,0,60,60,0,1,0,1,0
32628,10445,46824,0,0,62,62,0,1,0,1,0
32629,53725,64147,0,0,66,66,0,1,0,1,0
32630,59187,445,0,0,70,70,0,1,0,1,0
32631,65344,46824,0,0,66,66,0,1,0,1,0
32632,50,38211,0,0,66,66,0,1,0,1,0
32633,64037,445,0,0,70,70,0,1,0,1,0
32634,64030,445,0,0,70,70,0,1,0,1,0
32635,64029,445,0,0,70,70,0,1,0,1,0
32636,59186,445,0,0,70,70,0,1,0,1,0
32637,1054,57470,0,0,62,62,0,1,0,1,0
32638,57368,7302,0,0,66,66,0,1,0,1,0
32639,57170,38303,0,0,66,66,0,1,0,1,0
32640,59440,445,0,0,66,66,0,1,0,1,0
32641,59181,445,0,0,70,70,0,1,0,1,0
32642,63527,50584,0,0,62,62,0,1,0,1,0
32643,51320,37965,0,0,62,62,0,1,0,1,0
32644,59432,445,0,0,66,66,0,1,0,1,0
32645,64017,445,0,0,70,70,0,1,0,1,0
32646,58745,30188,0,0,66,66,0,1,0,1,0
32647,19841,50584,0,0,62,62,0,1,0,1,0
32648,59429,445,0,0,66,66,0,1,0,1,0
32649,26448,9192,0,0,145,145,0,1,0,1,0
32650,39098,51505,0,0,62,62,0,1,0,1,0
32651,13413,44847,0,0,66,66,0,1,0,1,0
32652,16382,17500,0,0,62,62,0,1,0,1,0
32653,59168,445,0,0,70,70,0,1,0,1,0
32654,59422,445,0,0,66,66,0,1,0,1,0
32655,51503,443,40605,443,4801,702,4099,13,16,8,5
32656,38234,443,15725,443,9807,2542,7265,47,19,24,23
32657,26929,443,8333,443,7487,2728,4759,25,19,13,12
32658,50272,443,27135,443,772,432,340,12,18,7,5
32659,42277,443,42277,443,2200,1253,947,23,76,12,11
32660,49041,443,30685,443,5144,847,4297,16,132,9,7
32661,59778,443,59778,443,4580,1673,2907,19,28,11,8
32662,43311,80,24777,80,811,671,140,6,31,4,2
32663,56572,53,56572,53,253,99,154,2,32,1,1
32664,54319,53,54319,53,253,99,154,2,32,1,1
32665,53732,22704,15296,22704,70,70,0,1,5,1,0
32666,42282,443,42282,443,2052,1187,865,21,76,11,10
32667,42280,443,42280,443,2052,1187,865,21,76,11,10
32668,56722,80,63327,80,41658,23230,18428,114,798,66,48
32669,64912,53,12678,53,182,93,89,2,31,1,1
32670,56468,53,8242,53,176,90,86,2,30,1,1
32671,47819,443,19809,443,6258,956,5302,20,16,11,9
32672,60380,443,29465,443,70,70,0,1,5,1,0
32673,53737,51456,42714,51456,70,70,0,1,5,1,0
32674,47326,443,40388,443,6318,1025,5293,17,33,9,8
32675,34141,53,34141,53,217,87,130,2,30,1,1
32676,64319,53,16100,53,186,95,91,2,30,1,1
32677,49501,53,44593,53,186,95,91,2,31,1,1
32678,62439,443,62439,443,4507,1600,2907,19,26,11,8
32679,39232,53,39232,53,215,80,135,2,32,1,1
32680,11919,53,11919,53,213,79,134,2,32,1,1
32681,54012,443,7741,443,4318,726,3592,14,16,7,7
32682,54182,443,54182,443,4581,1674,2907,19,29,11,8
32683,36548,443,36548,443,4621,1714,2907,19,30,11,8
32684,5180,80,5180,80,33443,797,32646,33,16,9,24
32685,50494,443,62791,443,5331564,43954,5287610,4171,80,672,3499
32686,49837,53,8590,53,176,90,86,2,30,1,1
32687,6881,6881,38378,6881,231,111,120,2,1200,1,1
32688,51221,50861,60298,50861,490,149,341,2,1200,1,1
32689,64357,53,4119,53,182,93,89,2,31,1,1
32690,58467,53,16449,53,235,95,140,2,31,1,1
32691,47744,80,34323,80,1571,877,694,11,180,6,5
32692,49274,53,46367,53,194,99,95,2,31,1,1
32693,49312,53,34351,53,767,102,665,2,31,1,1
32694,32912,53,0,0,82,82,0,1,31,1,0
32695,56395,53,20688,53,170,87,83,2,31,1,1
32696,49385,31652,0,0,66,66,0,1,91,1,0
32697,65524,53,51364,53,182,93,89,2,31,1,1
32698,30960,45740,3924,45740,330,330,0,6,3609,6,0
32699,59414,445,0,0,66,66,0,1,0,1,0
32700,59165,445,0,0,70,70,0,1,0,1,0
32701,28875,51505,0,0,146,146,0,1,0,1,0
32702,43578,15503,0,0,74,74,0,1,0,1,0
32703,57706,64147,0,0,62,62,0,1,0,1,0
32704,64006,445,0,0,70,70,0,1,0,1,0
32705,63459,443,62292,443,7782,1280,6502,22,79,10,12
32706,64005,445,0,0,70,70,0,1,0,1,0
32707,64004,445,0,0,70,70,0,1,0,1,0
32708,59161,445,0,0,70,70,0,1,0,1,0
32709,59402,445,0,0,66,66,0,1,0,1,0
32710,59403,445,0,0,66,66,0,1,0,1,0
32711,59404,445,0,0,66,66,0,1,0,1,0
32712,59401,445,0,0,66,66,0,1,0,1,0
32713,59405,445,0,0,66,66,0,1,0,1,0
32714,59398,445,0,0,66,66,0,1,0,1,0
32715,59399,445,0,0,66,66,0,1,0,1,0
32716,59400,445,0,0,66,66,0,1,0,1,0
32717,30135,37965,0,0,62,62,0,1,0,1,0
32718,59876,44847,0,0,66,66,0,1,0,1,0
32719,64104,22114,0,0,66,66,0,1,0,1,0
32720,59159,445,0,0,70,70,0,1,0,1,0
32721,64449,30188,0,0,66,66,0,1,0,1,0
32722,54825,444,0,0,60,60,0,1,0,1,0
32723,44922,57470,0,0,74,74,0,1,0,1,0
32724,51926,58664,64074,58664,70,70,0,1,5,1,0
32725,51502,443,41545,443,7211,823,6388,16,15,10,6
32726,65322,443,20624,443,8429792,268889,8160903,8985,135,2983,6002
32727,49245,53,23757,53,195,102,93,2,30,1,1
32728,65107,53,53716,53,193,102,91,2,30,1,1
32729,64619,53,61367,53,438,89,349,4,44,2,2
32730,36699,443,33647,443,11086707,166045,10920662,9176,172,1285,7891
32731,62348,443,31303,443,1592,965,627,15,20,7,8
32732,55662,36445,15210,36445,504,318,186,8,17,5,3
32733,49621,53,6731,53,501,188,313,6,33,3,3
32734,53735,58869,24687,58869,70,70,0,1,4,1,0
32735,53704,443,40944,443,5743,1339,4404,18,180,8,10
32736,18743,53,18743,53,235,90,145,2,31,1,1
32737,56919,443,47014,443,54568,32686,21882,69,161,40,29
32738,48608,443,46175,443,6371,848,5523,20,16,11,9
32739,44559,443,29969,443,6903,1185,5718,26,255,12,14
32740,38689,443,13215,443,1264333,25315,1239018,1197,16,355,842
32741,63930,44330,64385,44330,66,66,0,2,7,2,0
32742,53736,37168,63835,37168,70,70,0,1,4,1,0
32743,36166,80,26343,80,1614,1300,314,10,15,5,5
32744,49621,53,59180,53,287,93,194,4,56,2,2
32745,49864,53,49733,53,193,102,91,2,29,1,1
32746,13826,443,17437,443,7356,1014,6342,20,75,10,10
32747,57397,53,11845,53,183,94,89,2,29,1,1
32748,64172,53,13713,53,197,102,95,2,29,1,1
32749,5588,5588,0,0,3354,1792,1562,46,193,23,23
32750,49621,53,9845,53,183,94,89,2,29,1,1
32751,49825,53,31559,53,168,86,82,2,29,1,1
32752,59402,53,59402,53,216,90,126,2,29,1,1
32753,65332,53,1654,53,226,86,140,2,29,1,1
32754,49563,53,41117,53,200,102,98,2,29,1,1
32755,49837,53,4839,53,180,94,86,2,29,1,1
32756,57397,53,24712,53,183,94,89,2,30,1,1
32757,56426,53,8485,53,184,94,90,2,30,1,1
32758,51925,29587,19217,29587,70,70,0,1,5,1,0
32759,56936,80,5916,80,1490,886,604,10,75,6,4
32760,63896,80,57609,80,314,192,122,6,15,4,2
32761,64319,53,2772,53,193,102,91,2,30,1,1
32762,49164,53,54796,53,226,102,124,2,30,1,1
32763,64912,53,47656,53,183,94,89,2,30,1,1
32764,51890,80,53517,80,7097,3553,3544,15,31,8,7
32765,56685,443,20018,443,7855,1866,5989,20,15,11,9
32766,58729,443,41982,443,5167,700,4467,16,15,7,9
32767,15503,6881,43362,6881,2310,2310,0,36,3136,36,0
32768,55229,53,60362,53,720,94,626,2,30,1,1
32769,57397,53,3449,53,183,94,89,2,30,1,1
32770,49337,53,51649,53,258,126,132,2,30,1,1
32771,51675,443,51675,443,4539,1632,2907,19,27,11,8
32772,64365,53,55898,53,196,94,102,2,30,1,1
32773,50635,443,12337,443,8252,1702,6550,26,72,13,13
32774,65049,53,51039,53,184,94,90,2,30,1,1
32775,64460,53,1617,53,196,102,94,2,30,1,1
32776,56497,443,18628,443,1343,763,580,14,26,8,6
32777,56468,53,30389,53,180,94,86,2,30,1,1
32778,50270,443,3425,443,868,514,354,13,18,8,5
32779,55630,53,24833,53,197,102,95,2,30,1,1
32780,56144,53,26768,53,180,94,86,2,30,1,1
32781,51947,16935,29468,16935,70,70,0,2,8,2,0
32782,64592,53,20935,53,177,94,83,2,30,1,1
32783,65007,53,25080,53,180,86,94,2,30,1,1
32784,56935,80,54520,80,1482,878,604,10,75,6,4
32785,65144,53,24637,53,210,110,100,2,30,1,1
32786,17282,7000,17282,7000,2163,676,1487,14,15,7,7
32787,50349,80,24554,80,3909,888,3021,12,15,6,6
32788,64678,53,43744,53,289,102,187,2,30,1,1
32789,38688,443,23677,443,90166,3481,86685,96,16,31,65
32790,56937,80,7429,80,2567,1586,981,13,75,8,5
32791,49180,53,37264,53,314,97,217,4,34,2,2
32792,56644,80,27121,80,234,234,0,4,12,4,0
32793,56498,443,11650,443,1343,763,580,14,26,8,6
32794,49193,80,37184,80,6158,654,5504,15,16,8,7
32795,64036,53,28611,53,360,93,267,4,57,2,2
32796,49876,53,42623,53,211,102,109,2,30,1,1
32797,56468,53,1634,53,180,94,86,2,30,1,1
32798,42316,443,23676,443,6397,2103,4294,17,26,9,8
32799,49654,22,49654,22,7791,3373,4418,54,36,26,28
32800,58040,80,24098,80,9984,5333,4651,21,25,10,11
32801,51925,80,55386,80,51645,3868,47777,67,28,30,37
32802,54468,443,26749,443,2402,1444,958,18,81,10,8
32803,63929,48477,10688,48477,66,66,0,2,7,2,0
32804,58038,80,30379,80,5029,2608,2421,15,25,9,6
32805,44960,443,32145,443,306066,33556,272510,414,196,162,252
32806,56938,80,50995,80,1403,841,562,10,75,6,4
32807,53455,53,0,0,82,82,0,2,40,2,0
32808,53757,1,21144,1,70,70,0,2,8,2,0
32809,53722,6881,24173,6881,552,306,246,9,15,5,4
32810,49192,80,39568,80,2807,587,2220,13,16,7,6
32811,39032,443,17584,443,5819,1571,4248,26,58,14,12
32812,50282,443,64648,443,15775,3795,11980,48,18,32,16
32813,53733,40599,48603,40599,70,70,0,1,4,1,0
32814,49247,53,56867,53,478,196,282,6,63,3,3
32815,57862,443,61289,443,448344,11729,436615,474,157,128,346
32816,36386,443,8343,443,1209,709,500,14,28,8,6
32817,56684,443,53117,443,7907,1918,5989,20,15,11,9
32818,57871,443,42705,443,7716,3991,3725,50,125,25,25
32819,57416,53,53137,53,193,102,91,2,29,1,1
32820,49323,53,47360,53,196,102,94,2,29,1,1
32821,64872,53,61410,53,166,86,80,2,29,1,1
32822,49510,53,6465,53,329,118,211,2,29,1,1
32823,49355,53,58716,53,193,102,91,2,29,1,1
32824,49825,53,18724,53,168,86,82,2,29,1,1
32825,56532,53,65053,53,164,86,78,2,29,1,1
32826,64319,53,63281,53,193,102,91,2,29,1,1
32827,64475,53,62342,53,184,94,90,2,29,1,1
32828,64095,53,51473,53,269,110,159,2,30,1,1
32829,64105,53,29112,53,300,102,198,2,30,1,1
32830,64473,53,45476,53,184,94,90,2,30,1,1
32831,43628,443,48034,443,13974,3774,10200,29,120,12,17
32832,52458,443,42668,443,4550,1777,2773,17,135,8,9
32833,53750,27352,21637,27352,70,70,0,2,8,2,0
32834,53754,25306,12188,25306,70,70,0,2,8,2,0
32835,51924,28016,53313,28016,70,70,0,1,5,1,0
32836,43702,443,33020,443,1201,707,494,12,26,7,5
32837,39677,443,47798,443,7123,1331,5792,22,81,11,11
32838,49191,80,25150,80,2807,587,2220,13,16,7,6
32839,57870,443,40542,443,1373,734,639,17,125,10,7
32840,48347,443,29830,443,8415,883,7532,23,54,8,15
32841,50541,80,22542,80,4296,3281,1015,12,33,7,5
32842,37604,443,53490,443,8493,2314,6179,33,16,18,15
32843,58050,80,17128,80,318,192,126,6,20,4,2
32844,49197,53,3341,53,249,94,155,2,30,1,1
32845,13825,443,28678,443,8844,949,7895,19,75,9,10
32846,58056,80,49652,80,3518,1780,1738,12,20,7,5
32847,50275,443,24781,443,708,362,346,11,18,6,5
32848,55668,80,2182,80,70,70,0,2,8,2,0
32849,43027,80,42429,80,1506,1446,60,2,5,1,1
32850,50633,443,56668,443,6673,1791,4882,22,72,12,10
32851,58728,443,26266,443,5167,700,4467,16,15,7,9
32852,60995,443,4422,443,1351,846,505,12,19,7,5
32853,64592,53,18733,53,177,94,83,2,30,1,1
32854,64026,53,2303,53,244,94,150,2,31,1,1
32855,38125,443,63227,443,497663,22937,474726,585,38,245,340
32856,50021,80,33696,80,10026538,185017,9841521,9515,195,2989,6526
32857,43701,443,61661,443,1201,707,494,12,26,7,5
32858,50279,443,26201,443,1128,654,474,17,18,10,7
32859,44861,443,14296,443,1625,1038,587,14,27,8,6
32860,50634,443,27378,443,8220,1670,6550,26,71,13,13
32861,49355,53,27262,53,193,102,91,2,30,1,1
32862,64475,53,56537,53,184,94,90,2,30,1,1
32863,56771,53,12754,53,261,94,167,2,30,1,1
32864,55432,443,59316,443,256189,15094,241095,316,122,120,196
32865,56675,53,13397,53,254,94,160,2,30,1,1
32866,65251,53,45927,53,183,98,85,3,31,2,1
32867,38001,443,11115,443,1652,817,835,17,186,9,8
32868,56534,443,31456,443,3055,993,2062,10,120,5,5
32869,35165,443,20390,443,7174,4658,2516,18,121,10,8
32870,54425,443,49600,443,1648,813,835,17,186,9,8
32871,57179,53,11960,53,325,94,231,2,30,1,1
32872,64912,53,33217,53,183,94,89,2,31,1,1
32873,49654,53,58880,53,214,110,104,2,31,1,1
32874,63976,443,11736,443,1270998,514773,756225,3073,2384,1413,1660
32875,37999,443,54290,443,1650,815,835,17,186,9,8
32876,56400,80,42500,80,1281,398,883,16,392,4,12
32877,33017,443,62492,443,11008,4624,6384,36,322,19,17
32878,36438,5223,19564,5223,5243,1898,3345,34,3005,18,16
32879,43381,443,3948,443,9551,2173,7378,33,25,17,16
32880,48452,443,56539,443,9553,2175,7378,33,27,17,16
32881,31653,53,31653,53,235,90,145,2,34,1,1
32882,52788,53,56727,53,196,94,102,2,30,1,1
32883,64357,53,36127,53,183,94,89,2,30,1,1
32884,49274,53,14620,53,197,102,95,2,30,1,1
32885,50562,53,50562,53,216,82,134,2,32,1,1
32886,31096,53,31096,53,216,82,134,2,32,1,1
32887,54894,443,28940,443,9829,2313,7516,37,25,19,18
32888,33774,443,40240,443,9551,2173,7378,33,27,17,16
32889,53651,443,17075,443,9485,2173,7312,32,27,17,15
32890,64381,443,33769,443,4838,1059,3779,16,54,8,8
32891,64813,53,4341,53,180,94,86,2,30,1,1
32892,49569,53,17630,53,213,94,119,2,30,1,1
32893,49654,53,53040,53,214,110,104,2,30,1,1
32894,49501,53,46075,53,343,92,251,4,32,2,2
32895,58436,443,57353,443,18290,3012,15278,46,136,24,22
32896,49355,53,60733,53,193,102,91,2,30,1,1
32897,56468,53,3693,53,180,94,86,2,30,1,1
32898,56920,23117,0,0,146,146,0,1,0,1,0
32899,54826,444,0,0,60,60,0,1,0,1,0
32900,59155,445,0,0,70,70,0,1,0,1,0
32901,46516,57470,0,0,62,62,0,1,0,1,0
32902,64824,37965,0,0,62,62,0,1,0,1,0
32903,3181,53567,0,0,66,66,0,1,0,1,0
32904,62493,50584,0,0,146,146,0,1,0,1,0
32905,60425,15503,0,0,145,145,0,1,0,1,0
32906,60786,51505,0,0,66,66,0,1,0,1,0
32907,51148,9571,0,0,66,66,0,1,0,1,0
32908,22784,9571,0,0,62,62,0,1,0,1,0
32909,53500,1,0,0,66,66,0,1,0,1,0
32910,64000,445,0,0,70,70,0,1,0,1,0
32911,64001,445,0,0,70,70,0,1,0,1,0
32912,63997,445,0,0,70,70,0,1,0,1,0
32913,63987,445,0,0,70,70,0,1,0,1,0
32914,43323,1,0,0,62,62,0,1,0,1,0
32915,26889,50265,0,0,62,62,0,1,0,1,0
32916,59191,35440,0,0,66,66,0,1,0,1,0
32917,61451,17500,0,0,62,62,0,1,0,1,0
32918,59148,445,0,0,70,70,0,1,0,1,0
32919,20724,19750,0,0,78,78,0,1,0,1,0
32920,59383,445,0,0,66,66,0,1,0,1,0
32921,59384,445,0,0,66,66,0,1,0,1,0
32922,59386,445,0,0,66,66,0,1,0,1,0
32923,59146,445,0,0,70,70,0,1,0,1,0
32924,39681,37965,0,0,66,66,0,1,0,1,0
32925,23553,37965,0,0,62,62,0,1,0,1,0
32926,38909,57470,0,0,62,62,0,1,0,1,0
32927,53447,22114,0,0,146,146,0,1,0,1,0
32928,59145,445,0,0,70,70,0,1,0,1,0
32929,16319,44847,0,0,62,62,0,1,0,1,0
32930,59144,445,0,0,70,70,0,1,0,1,0
32931,63984,445,0,0,70,70,0,1,0,1,0
32932,59143,445,0,0,70,70,0,1,0,1,0
32933,1818,22114,0,0,62,62,0,1,0,1,0
32934,50624,50584,0,0,66,66,0,1,0,1,0
32935,59139,445,0,0,70,70,0,1,0,1,0
32936,59141,445,0,0,70,70,0,1,0,1,0
32937,63983,445,0,0,70,70,0,1,0,1,0
32938,63981,445,0,0,70,70,0,1,0,1,0
32939,63980,445,0,0,70,70,0,1,0,1,0
32940,6881,26296,0,0,143,143,0,1,0,1,0
32941,40512,57470,0,0,74,74,0,1,0,1,0
32942,59125,445,0,0,70,70,0,1,0,1,0
32943,59124,445,0,0,70,70,0,1,0,1,0
32944,59119,445,0,0,70,70,0,1,0,1,0
32945,51368,1900,0,0,139,139,0,1,0,1,0
32946,13559,57866,0,0,62,62,0,1,0,1,0
32947,59114,445,0,0,70,70,0,1,0,1,0
32948,59115,445,0,0,70,70,0,1,0,1,0
32949,2432,11392,0,0,62,62,0,1,0,1,0
32950,50063,35776,0,0,148,148,0,1,0,1,0
32951,63966,445,0,0,70,70,0,1,0,1,0
32952,63964,445,0,0,70,70,0,1,0,1,0
32953,63963,445,0,0,70,70,0,1,0,1,0
32954,26835,47993,0,0,62,62,0,1,0,1,0
32955,22987,15503,0,0,146,146,0,1,0,1,0
32956,59373,445,0,0,66,66,0,1,0,1,0
32957,32520,47993,0,0,66,66,0,1,0,1,0
32958,54242,443,22470,443,499,425,74,4,0,3,1
32959,54241,443,12202,443,499,425,74,4,0,3,1
32960,64815,37965,0,0,62,62,0,1,0,1,0
32961,59103,445,0,0,70,70,0,1,0,1,0
32962,65081,26467,0,0,66,66,0,1,0,1,0
32963,40571,26467,0,0,62,62,0,1,0,1,0
32964,25237,57470,0,0,62,62,0,1,0,1,0
32965,16693,36237,0,0,66,66,0,1,0,1,0
32966,49168,57470,0,0,66,66,0,1,0,1,0
32967,6666,5984,0,0,60,60,0,1,0,1,0
32968,53024,57866,0,0,146,146,0,1,0,1,0
32969,63958,445,0,0,70,70,0,1,0,1,0
32970,63957,445,0,0,70,70,0,1,0,1,0
32971,57034,44847,0,0,66,66,0,1,0,1,0
32972,59099,445,0,0,70,70,0,1,0,1,0
32973,59357,445,0,0,66,66,0,1,0,1,0
32974,59355,445,0,0,66,66,0,1,0,1,0
32975,13423,56205,0,0,62,62,0,1,0,1,0
32976,12986,64147,0,0,145,145,0,1,0,1,0
32977,59090,445,0,0,70,70,0,1,0,1,0
32978,59089,445,0,0,70,70,0,1,0,1,0
32979,59087,445,0,0,70,70,0,1,0,1,0
32980,59084,445,0,0,70,70,0,1,0,1,0
32981,1043,48817,0,0,136,136,0,1,0,1,0
32982,59082,445,0,0,70,70,0,1,0,1,0
32983,63945,445,0,0,70,70,0,1,0,1,0
32984,63939,445,0,0,70,70,0,1,0,1,0
32985,63942,445,0,0,70,70,0,1,0,1,0
32986,63940,445,0,0,70,70,0,1,0,1,0
32987,51743,64147,0,0,62,62,0,1,0,1,0
32988,59350,445,0,0,66,66,0,1,0,1,0
32989,44491,50584,0,0,62,62,0,1,0,1,0
32990,13090,36237,0,0,66,66,0,1,0,1,0
32991,3667,56205,0,0,62,62,0,1,0,1,0
32992,59335,445,0,0,66,66,0,1,0,1,0
32993,59336,445,0,0,66,66,0,1,0,1,0
32994,59341,445,0,0,66,66,0,1,0,1,0
32995,59343,445,0,0,66,66,0,1,0,1,0
32996,59339,445,0,0,66,66,0,1,0,1,0
32997,59338,445,0,0,66,66,0,1,0,1,0
32998,59345,445,0,0,66,66,0,1,0,1,0
32999,58858,15503,0,0,66,66,0,1,0,1,0
33000,55854,54369,0,0,74,74,0,1,0,1,0
33001,63931,445,0,0,70,70,0,1,0,1,0
33002,58901,443,24407,443,17071,1532,15539,17,27,3,14
33003,59077,445,0,0,70,70,0,1,0,1,0
33004,49958,36829,0,0,66,66,0,1,0,1,0
33005,63929,445,0,0,70,70,0,1,0,1,0
33006,63928,445,0,0,70,70,0,1,0,1,0
33007,63925,445,0,0,70,70,0,1,0,1,0
33008,42640,11119,0,0,148,148,0,1,0,1,0
33009,12951,50584,0,0,66,66,0,1,0,1,0
33010,30129,37965,0,0,72,72,0,1,0,1,0
33011,55966,35440,0,0,62,62,0,1,0,1,0
33012,59069,445,0,0,70,70,0,1,0,1,0
33013,59067,445,0,0,70,70,0,1,0,1,0
33014,36579,30188,0,0,66,66,0,1,0,1,0
33015,58582,50584,0,0,62,62,0,1,0,1,0
33016,63924,445,0,0,70,70,0,1,0,1,0
33017,63921,445,0,0,70,70,0,1,0,1,0
33018,63919,445,0,0,70,70,0,1,0,1,0
33019,51581,22114,0,0,66,66,0,1,0,1,0
33020,59328,445,0,0,66,66,0,1,0,1,0
33021,58972,57866,0,0,66,66,0,1,0,1,0
33022,59062,445,0,0,70,70,0,1,0,1,0
33023,63916,445,0,0,70,70,0,1,0,1,0
33024,59061,445,0,0,70,70,0,1,0,1,0
33025,59326,445,0,0,66,66,0,1,0,1,0
33026,49286,23,0,0,60,60,0,1,0,1,0
33027,32648,55108,0,0,145,145,0,1,0,1,0
33028,59325,445,0,0,66,66,0,1,0,1,0
33029,59324,445,0,0,66,66,0,1,0,1,0
33030,59321,445,0,0,66,66,0,1,0,1,0
33031,32137,44512,0,0,62,62,0,1,0,1,0
33032,59057,445,0,0,70,70,0,1,0,1,0
33033,7881,48817,0,0,133,133,0,1,0,1,0
33034,59055,445,0,0,70,70,0,1,0,1,0
33035,63909,445,0,0,70,70,0,1,0,1,0
33036,63902,445,0,0,70,70,0,1,0,1,0
33037,63898,445,0,0,70,70,0,1,0,1,0
33038,27844,52700,0,0,70,70,0,1,0,1,0
33039,26254,56205,0,0,62,62,0,1,0,1,0
33040,59310,445,0,0,66,66,0,1,0,1,0
33041,59051,445,0,0,70,70,0,1,0,1,0
33042,12969,55777,0,0,66,66,0,1,0,1,0
33043,54986,53,11167,53,212,108,104,2,31,1,1
33044,51917,80,25082,80,43399,5061,38338,55,29,24,31
33045,65417,443,43584,443,2494,1643,851,17,25,9,8
33046,54648,443,56134,443,9215,3253,5962,51,22,25,26
33047,54379,80,23086,80,1466,729,737,12,16,7,5
33048,34471,53,34471,53,253,99,154,2,32,1,1
33049,51508,4545,51508,4545,156,156,0,3,8,3,0
33050,48728,443,2946,443,2437,1321,1116,15,83,9,6
33051,64383,443,47790,443,4017,978,3039,14,53,8,6
33052,34522,80,31284,80,1420,715,705,12,16,7,5
33053,56594,53,29926,53,788,108,680,2,30,1,1
33054,23127,53,23127,53,233,91,142,2,30,1,1
33055,54008,443,44994,443,4249,724,3525,13,15,7,6
33056,54005,443,23305,443,4253,726,3527,13,15,7,6
33057,54782,443,13415,443,9487,2103,7384,32,24,16,16
33058,64382,443,26649,443,4017,978,3039,14,53,8,6
33059,49756,80,38066,80,20926,3231,17695,37,51,17,20
33060,58890,80,50368,80,23867,3316,20551,38,135,20,18
33061,49667,80,52853,80,1165,468,697,8,125,5,3
33062,52714,443,48732,443,26399,2076,24323,37,319,15,22
33063,50237,443,44543,443,2994,1521,1473,15,83,9,6
33064,64813,53,27372,53,176,90,86,2,30,1,1
33065,12776,53,12776,53,239,94,145,2,30,1,1
33066,52715,443,11256,443,26901,2286,24615,46,319,18,28
33067,55254,443,18680,443,13275,3587,9688,38,27,20,18
33068,49117,443,48924,443,9551,2173,7378,33,27,17,16
33069,42642,443,22756,443,10548,2689,7859,38,24,19,19
33070,37346,443,8413,443,7814,2339,5475,26,316,12,14
33071,51945,1587,22122,1587,70,70,0,2,8,2,0
33072,5588,5588,0,0,3354,1792,1562,46,193,23,23
33073,31976,53,31976,53,241,95,146,2,30,1,1
33074,65238,53,13271,53,86,86,0,1,30,1,0
33075,41577,53,15196,53,168,78,90,2,30,1,1
33076,54550,443,54550,443,13490,2525,10965,30,18,17,13
33077,57354,53,55769,53,767,102,665,2,30,1,1
33078,52460,53,0,0,82,82,0,1,30,1,0
33079,33008,53,33008,53,263,104,159,2,30,1,1
33080,54486,443,15577,443,3170,1036,2134,13,135,6,7
33081,51876,443,3089,443,1852,1103,749,16,32,9,7
33082,51931,443,20564,443,2328,1677,651,17,23,9,8
33083,51855,443,29819,443,11894,2661,9233,32,32,18,14
33084,56413,53,30670,53,224,94,130,2,30,1,1
33085,64297,443,21726,443,56432,4371,52061,72,135,29,43
33086,56574,443,27778,443,75732,15030,60702,137,138,56,81
33087,49201,53,5443,53,200,102,98,2,31,1,1
33088,36767,53,36767,53,237,93,144,2,31,1,1
33089,30960,45739,64773,45739,330,330,0,6,3609,6,0
33090,48360,443,45618,443,8400,2088,6312,33,20,18,15
33091,47000,53,0,0,82,82,0,1,31,1,0
33092,42190,53,42190,53,639,86,553,2,31,1,1
33093,37598,443,64510,443,8102,2685,5417,24,17,15,9
33094,65428,53,7407,53,731,85,646,2,31,1,1
33095,22131,53,22131,53,172,76,96,2,31,1,1
33096,49621,53,49621,53,231,90,141,2,31,1,1
33097,62449,443,11939,443,9977,4364,5613,19,121,9,10
33098,46585,443,60959,443,9439,3223,6216,27,137,13,14
33099,54380,60038,0,0,66,66,0,1,90,1,0
33100,30960,45736,51969,45736,396,396,0,7,3616,7,0
33101,51221,57274,16024,57274,528,528,0,9,1201,9,0
33102,50424,55777,0,0,62,62,0,1,0,1,0
33103,8403,46824,0,0,62,62,0,1,0,1,0
33104,3978,35440,0,0,62,62,0,1,0,1,0
33105,32704,46824,0,0,66,66,0,1,0,1,0
33106,51188,64147,0,0,62,62,0,1,0,1,0
33107,56521,32480,0,0,62,62,0,1,0,1,0
33108,59303,445,0,0,66,66,0,1,0,1,0
33109,63888,445,0,0,70,70,0,1,0,1,0
33110,7226,50584,0,0,62,62,0,1,0,1,0
33111,59301,445,0,0,66,66,0,1,0,1,0
33112,8313,51505,0,0,66,66,0,1,0,1,0
33113,38306,51221,0,0,62,62,0,1,0,1,0
33114,64606,53,40619,53,278,118,160,2,30,1,1
33115,54986,53,26600,53,214,110,104,2,30,1,1
33116,37603,443,12094,443,8493,2314,6179,33,15,18,15
33117,59053,53,2855,53,227,86,141,2,30,1,1
33118,65524,53,59878,53,183,94,89,2,30,1,1
33119,43523,53,26419,53,168,78,90,2,30,1,1
33120,35579,443,65088,443,13136,3596,9540,40,26,21,19
33121,58712,80,8787,80,4176,3453,723,14,15,7,7
33122,51946,9407,10036,9407,70,70,0,2,7,2,0
33123,53730,37096,48081,37096,70,70,0,1,4,1,0
33124,63898,13205,50081,13205,70,70,0,1,4,1,0
33125,64036,53,62200,53,183,94,89,2,29,1,1
33126,65049,53,41682,53,184,94,90,2,29,1,1
33127,56221,53,31091,53,177,94,83,2,29,1,1
33128,64334,53,61866,53,311,94,217,2,30,1,1
33129,64093,53,55556,53,213,94,119,2,30,1,1
33130,48689,443,50166,443,9681,2243,7438,35,24,18,17
33131,60270,443,42458,443,9551,2173,7378,33,26,17,16
33132,57376,443,40721,443,7211,823,6388,16,15,10,6
33133,56522,80,49102,80,798,401,397,7,17,5,2
33134,48348,443,49861,443,20838,2211,18627,40,14,20,20
33135,51943,55464,31100,55464,70,70,0,2,8,2,0
33136,49520,80,52279,80,2011,975,1036,13,70,7,6
33137,51922,18413,51851,18413,70,70,0,1,5,1,0
33138,58533,443,53373,443,17356,5096,12260,46,26,24,22
33139,51920,32678,28612,32678,70,70,0,1,5,1,0
33140,60442,49556,41273,49556,624,318,306,10,15,5,5
33141,49540,80,39259,80,374,192,182,7,42,4,3
33142,48349,443,46666,443,42932,2883,40049,63,14,31,32
33143,49516,80,21754,80,1256,746,510,11,70,6,5
33144,21276,53,21276,53,244,98,146,2,33,1,1
33145,49993,80,30030,80,21812,900,20912,27,26,9,18
33146,52642,6881,49230,6881,1106,800,306,10,14,5,5
33147,51966,443,65076,443,9249,4498,4751,39,15,22,17
33148,63904,18268,33783,18268,70,70,0,1,4,1,0
33149,49690,53,14782,53,790,110,680,2,29,1,1
33150,55091,443,55091,443,21122,2591,18531,36,17,18,18
33151,51914,5222,1180,5222,5141,2331,2810,41,144,24,17
33152,63317,53,0,0,181,86,95,2,30,1,1
33153,56395,53,28310,53,177,94,83,2,30,1,1
33154,65049,53,38762,53,184,94,90,2,30,1,1
33155,49245,53,64738,53,195,102,93,2,30,1,1
33156,20641,53,20641,53,240,98,142,2,29,1,1
33157,56221,53,42617,53,177,94,83,2,29,1,1
33158,50345,80,27840,80,736,670,66,6,15,5,1
33159,49178,80,4471,80,2807,587,2220,13,16,7,6
33160,49179,80,7093,80,2807,587,2220,13,16,7,6
33161,2348,3389,2348,3389,4145,1976,2169,22,19,13,9
33162,51915,5222,45227,5222,11827,5467,6360,100,144,54,46
33163,55559,53,14649,53,1026,292,734,8,50,4,4
33164,55464,53,8236,53,214,110,104,2,30,1,1
33165,54986,53,42487,53,214,110,104,2,30,1,1
33166,37597,443,2780,443,10497,3476,7021,34,17,18,16
33167,55695,53,46724,53,209,102,107,2,30,1,1
33168,38720,5222,21758,5222,6262,2015,4247,35,48,17,18
33169,58709,443,26417,443,7924,702,7222,17,16,7,10
33170,55663,19994,59885,19994,70,70,0,2,8,2,0
33171,64554,53,57103,53,498,204,294,6,30,3,3
33172,55479,53,49461,53,232,94,138,2,30,1,1
33173,41246,443,27215,443,234,234,0,4,12,4,0
33174,51834,80,36073,80,366,240,126,7,32,5,2
33175,49188,8108,9022,8108,1788,1016,772,15,15,8,7
33176,60297,53,6955,53,227,86,141,2,30,1,1
33177,51923,11542,51093,11542,70,70,0,1,5,1,0
33178,41750,443,14251,443,4636,792,3844,16,15,8,8
33179,56120,53,36940,53,212,102,110,2,30,1,1
33180,49666,80,7693,80,2356,499,1857,10,125,6,4
33181,55396,443,55396,443,63319,6716,56603,91,19,45,46
33182,40050,53,42804,53,168,78,90,2,30,1,1
33183,48966,53,48747,53,168,78,90,2,30,1,1
33184,49181,80,37044,80,6158,654,5504,15,16,8,7
33185,63135,443,47015,443,7127,1737,5390,18,16,10,8
33186,49274,53,26954,53,560,199,361,6,82,3,3
33187,64357,53,13293,53,183,94,89,2,30,1,1
33188,55495,53,24897,53,305,94,211,2,30,1,1
33189,65236,53,60243,53,247,118,129,2,30,1,1
33190,51941,19333,28791,19333,70,70,0,2,8,2,0
33191,49733,80,1914,80,4198,2450,1748,20,148,15,5
33192,56252,53,46494,53,531,90,441,4,41,2,2
33193,51090,80,46921,80,10434,1041,9393,20,45,11,9
33194,54449,443,54449,443,7974,2926,5048,25,17,15,10
33195,65377,53,55727,53,207,86,121,2,30,1,1
33196,49793,53,56349,53,271,102,169,2,30,1,1
33197,56470,53,27427,53,168,78,90,2,30,1,1
33198,50266,443,13343,443,6344,2063,4281,26,21,12,14
33199,36430,443,7560,443,9423,2105,7318,31,26,16,15
33200,44710,443,12033,443,13320,3575,9745,38,26,19,19
33201,43499,443,52568,443,9685,2330,7355,23,15,12,11
33202,63906,36909,1381,36909,70,70,0,1,4,1,0
33203,51274,24399,41980,24399,70,70,0,1,5,1,0
33204,56337,443,18375,443,9683,2173,7510,35,26,17,18
33205,65194,53,9315,53,265,91,174,4,36,2,2
33206,39854,443,9295,443,7903,3497,4406,38,72,22,16
33207,65491,443,49902,443,452013,13200,438813,465,16,163,302
33208,37790,443,42788,443,448,78,370,6,25,1,5
33209,53306,443,56801,443,11114,3066,8048,41,119,22,19
33210,50347,80,44018,80,1671,862,809,10,15,5,5
33211,58583,443,61583,443,8605,3169,5436,19,17,12,7
33212,46492,80,56877,80,1967,1133,834,12,45,7,5
33213,51953,62964,9503,62964,316,136,180,6,5,3,3
33214,49190,80,2197,80,6158,654,5504,15,15,8,7
33215,49539,80,49460,80,378,192,186,7,42,4,3
33216,51891,80,21420,80,7434,3830,3604,17,30,9,8
33217,55667,19667,52444,19667,70,70,0,2,8,2,0
33218,51942,22272,51406,22272,210,70,140,4,8,2,2
33219,53729,40721,47011,40721,70,70,0,1,4,1,0
33220,41748,443,37689,443,4570,792,3778,15,15,8,7
33221,63899,62015,51023,62015,70,70,0,1,4,1,0
33222,56433,80,35239,80,17188,1559,15629,25,25,10,15
33223,37653,5223,25600,5223,142,142,0,1,5,1,0
33224,51922,80,2848,80,52962,3994,48968,71,27,32,39
33225,49911,53,26669,53,258,110,148,2,30,1,1
33226,50127,443,64951,443,31982,9936,22046,61,16,33,28
33227,65238,53,22542,53,168,86,82,2,29,1,1
33228,49582,443,23714,443,29241,2457,26784,48,171,24,24
33229,64813,53,44563,53,180,94,86,2,30,1,1
33230,56181,53,2631,53,784,94,690,2,29,1,1
33231,50940,443,10678,443,6888,1774,5114,25,210,14,11
33232,53812,443,40871,443,2966,801,2165,13,135,6,7
33233,65144,53,2841,53,210,110,100,2,29,1,1
33234,49762,53,15647,53,195,94,101,2,30,1,1
33235,49703,53,48424,53,198,86,112,2,30,1,1
33236,44847,15315,12919,15315,150,150,0,1,1200,1,0
33237,55158,53,38311,53,212,102,110,2,30,1,1
33238,64357,53,57507,53,271,85,186,4,30,2,2
33239,49574,53,12004,53,337,110,227,2,30,1,1
33240,55756,53,23922,53,311,94,217,2,30,1,1
33241,27515,53,18456,53,224,78,146,2,30,1,1
33242,63379,443,51286,443,2649,330,2319,12,134,5,7
33243,53254,443,47275,443,9949,4623,5326,45,150,23,22
33244,41815,5228,54746,5228,7701,2155,5546,30,611,17,13
33245,51906,443,34093,443,5685,1179,4506,18,29,10,8
33246,60150,443,32146,443,7741,2692,5049,24,16,13,11
33247,48014,80,51000,80,4006,3572,434,14,15,7,7
33248,55666,36653,26608,36653,70,70,0,2,8,2,0
33249,41047,443,9579,443,6423,744,5679,16,16,9,7
33250,51451,80,37614,80,214,140,74,4,15,3,1
33251,49665,80,5154,80,2237,508,1729,10,125,6,4
33252,65463,53,27388,53,210,102,108,2,30,1,1
33253,59627,53,32997,53,290,102,188,2,30,1,1
33254,49935,53,2977,53,370,94,276,2,30,1,1
33255,55464,53,12452,53,214,110,104,2,30,1,1
33256,35556,53,63282,53,168,78,90,2,30,1,1
33257,60936,443,12668,443,1864,250,1614,8,120,4,4
33258,49925,443,37960,443,19134,7361,11773,40,148,19,21
33259,56263,53,57350,53,385,134,251,2,31,1,1
33260,63466,443,61707,443,5828,1439,4389,16,75,9,7
33261,57625,443,18316,443,4751,909,3842,15,16,9,6
33262,41751,443,36135,443,4570,792,3778,15,15,8,7
33263,65492,443,42698,443,92573,4519,88054,105,16,39,66
33264,64374,53,45440,53,239,102,137,2,30,1,1
33265,64912,53,24794,53,183,94,89,2,30,1,1
33266,64384,53,2219,53,333,94,239,2,30,1,1
33267,56680,53,8517,53,211,102,109,2,30,1,1
33268,51194,443,35674,443,1561,768,793,17,185,9,8
33269,38112,443,61056,443,1053962,45604,1008358,1190,69,456,734
33270,50048,443,29440,443,6887,2473,4414,20,15,11,9
33271,64813,53,11826,53,335,90,245,4,35,2,2
33272,51921,37744,34923,37744,70,70,0,1,5,1,0
33273,56492,443,36078,443,3715,1659,2056,35,188,18,17
33274,64298,53,48284,53,311,118,193,2,30,1,1
33275,44577,443,43261,443,30773,9123,21650,90,104,48,42
33276,56395,53,7674,53,177,94,83,2,30,1,1
33277,55204,53,12205,53,263,94,169,2,30,1,1
33278,55654,443,49899,443,186406,10415,175991,218,123,79,139
33279,56451,53,25472,53,322,102,220,2,30,1,1
33280,64588,53,18701,53,211,102,109,2,30,1,1
33281,25108,53,24919,53,222,78,144,2,30,1,1
33282,65146,53,35272,53,763,102,661,2,31,1,1
33283,49936,53,28353,53,211,102,109,2,31,1,1
33284,16230,53,64249,53,223,78,145,2,30,1,1
33285,49501,53,50847,53,193,102,91,2,31,1,1
33286,64791,443,34950,443,4725,1727,2998,11,121,6,5
33287,61887,443,28383,443,81136,7785,73351,109,131,40,69
33288,6882,4443,56989,4443,600,600,0,5,1200,5,0
33289,19473,35726,44271,35726,481,150,331,2,1200,1,1
33290,44037,443,25209,443,5839,3664,2175,13,120,8,5
33291,56035,53,29824,53,337,94,243,2,30,1,1
33292,55242,53,7339,53,373,126,247,2,30,1,1
33293,55333,123,5768,123,184,94,90,2,30,1,1
33294,55634,53,46753,53,308,102,206,2,30,1,1
33295,54986,53,61995,53,214,110,104,2,30,1,1
33296,64789,443,4787,443,1786,172,1614,7,121,3,4
33297,50724,443,63657,443,3171,1369,1802,9,120,5,4
33298,30188,63853,28721,63853,502,150,352,2,1200,1,1
33299,55034,443,13403,443,7969,4870,3099,36,360,20,16
33300,51948,34853,60337,34853,316,136,180,6,6,3,3
33301,63925,18912,65425,18912,66,66,0,2,8,2,0
33302,51918,80,52022,80,426,240,186,8,29,5,3
33303,49180,80,59682,80,6158,654,5504,15,16,8,7
33304,57165,53,7622,53,498,204,294,6,30,3,3
33305,56125,53,56568,53,311,118,193,2,30,1,1
33306,65524,53,37598,53,183,94,89,2,30,1,1
33307,56684,53,21413,53,301,94,207,2,31,1,1
33308,64281,53,45768,53,214,110,104,2,31,1,1
33309,50266,443,41683,443,49981,15486,34495,269,138,136,133
33310,50271,443,3937,443,10103,2342,7761,39,121,22,17
33311,53723,51501,24523,51501,70,70,0,1,5,1,0
33312,53501,443,53501,443,960,539,421,9,36,5,4
33313,51900,80,40398,80,366,240,126,7,29,5,2
33314,50276,443,53649,443,9984,2917,7067,49,102,28,21
33315,50270,443,45158,443,9998,2237,7761,38,121,21,17
33316,50285,443,58128,443,7210,2382,4828,33,100,19,14
33317,63924,26328,57332,26328,66,66,0,2,8,2,0
33318,50337,80,47050,80,1083,653,430,8,16,5,3
33319,51913,80,58997,80,366,240,126,7,29,5,2
33320,51841,443,41534,443,1686,984,702,15,32,8,7
33321,56853,443,46609,443,7092,1795,5297,25,32,14,11
33322,49675,53,62009,53,78,78,0,1,30,1,0
33323,65252,53,49878,53,249,102,147,2,30,1,1
33324,51346,51221,0,0,74,74,0,1,0,1,0
33325,59038,445,0,0,70,70,0,1,0,1,0
33326,48676,53393,0,0,60,60,0,1,0,1,0
33327,22409,55442,0,0,74,74,0,1,0,1,0
33328,53746,36237,0,0,66,66,0,1,0,1,0
33329,59293,445,0,0,66,66,0,1,0,1,0
33330,59035,445,0,0,70,70,0,1,0,1,0
33331,60204,2767,0,0,62,62,0,1,0,1,0
33332,9448,57866,0,0,62,62,0,1,0,1,0
33333,59290,445,0,0,66,66,0,1,0,1,0
33334,55320,22114,0,0,146,146,0,1,0,1,0
33335,45682,47993,0,0,62,62,0,1,0,1,0
33336,36400,51505,0,0,62,62,0,1,0,1,0
33337,18011,44847,0,0,62,62,0,1,0,1,0
33338,21759,51505,0,0,66,66,0,1,0,1,0
33339,25653,26296,0,0,148,148,0,1,0,1,0
33340,56157,50584,0,0,62,62,0,1,0,1,0
33341,59030,445,0,0,70,70,0,1,0,1,0
33342,58981,50584,0,0,146,146,0,1,0,1,0
33343,59029,445,0,0,70,70,0,1,0,1,0
33344,63878,445,0,0,70,70,0,1,0,1,0
33345,63877,445,0,0,70,70,0,1,0,1,0
33346,63876,445,0,0,70,70,0,1,0,1,0
33347,35229,32468,0,0,62,62,0,1,0,1,0
33348,59271,445,0,0,66,66,0,1,0,1,0
33349,59275,445,0,0,66,66,0,1,0,1,0
33350,59277,445,0,0,66,66,0,1,0,1,0
33351,59276,445,0,0,66,66,0,1,0,1,0
33352,59272,445,0,0,66,66,0,1,0,1,0
33353,59270,445,0,0,66,66,0,1,0,1,0
33354,59274,445,0,0,66,66,0,1,0,1,0
33355,59269,445,0,0,66,66,0,1,0,1,0
33356,59027,445,0,0,70,70,0,1,0,1,0
33357,62731,21247,0,0,66,66,0,1,0,1,0
33358,20724,19750,0,0,78,78,0,1,0,1,0
33359,55386,32480,0,0,62,62,0,1,0,1,0
33360,5859,11392,0,0,66,66,0,1,0,1,0
33361,27402,37628,0,0,62,62,0,1,0,1,0
33362,54276,37628,0,0,66,66,0,1,0,1,0
33363,59020,445,0,0,70,70,0,1,0,1,0
33364,63872,445,0,0,70,70,0,1,0,1,0
33365,63868,445,0,0,70,70,0,1,0,1,0
33366,63871,445,0,0,70,70,0,1,0,1,0
33367,63860,445,0,0,70,70,0,1,0,1,0
33368,59018,445,0,0,70,70,0,1,0,1,0
33369,59257,445,0,0,66,66,0,1,0,1,0
33370,59254,445,0,0,66,66,0,1,0,1,0
33371,59255,445,0,0,66,66,0,1,0,1,0
33372,34932,38608,0,0,62,62,0,1,0,1,0
33373,59017,445,0,0,70,70,0,1,0,1,0
33374,59016,445,0,0,70,70,0,1,0,1,0
33375,59015,445,0,0,70,70,0,1,0,1,0
33376,59013,445,0,0,70,70,0,1,0,1,0
33377,59009,445,0,0,70,70,0,1,0,1,0
33378,48527,7302,0,0,146,146,0,1,0,1,0
33379,50245,44847,0,0,66,66,0,1,0,1,0
33380,41249,50584,0,0,66,66,0,1,0,1,0
33381,63857,445,0,0,70,70,0,1,0,1,0
33382,63851,445,0,0,70,70,0,1,0,1,0
33383,63852,445,0,0,70,70,0,1,0,1,0
33384,63849,445,0,0,70,70,0,1,0,1,0
33385,56833,23117,0,0,62,62,0,1,0,1,0
33386,1024,57470,0,0,72,72,0,1,0,1,0
33387,55111,39004,0,0,66,66,0,1,0,1,0
33388,58997,445,0,0,70,70,0,1,0,1,0
33389,58996,445,0,0,70,70,0,1,0,1,0
33390,54240,443,62221,443,499,425,74,4,0,3,1
33391,54239,443,8377,443,499,425,74,4,0,3,1
33392,54238,443,21116,443,499,425,74,4,0,3,1
33393,54236,443,22668,443,499,425,74,4,0,3,1
33394,54237,443,5337,443,499,425,74,4,0,3,1
33395,58993,445,0,0,70,70,0,1,0,1,0
33396,28413,64147,0,0,66,66,0,1,0,1,0
33397,54305,39004,0,0,62,62,0,1,0,1,0
33398,54305,39004,0,0,145,145,0,1,0,1,0
33399,57173,44847,0,0,62,62,0,1,0,1,0
33400,19617,39004,0,0,62,62,0,1,0,1,0
33401,58986,445,0,0,70,70,0,1,0,1,0
33402,58987,445,0,0,70,70,0,1,0,1,0
33403,62912,26467,0,0,62,62,0,1,0,1,0
33404,11541,40108,0,0,148,148,0,1,0,1,0
33405,54779,50584,0,0,66,66,0,1,0,1,0
33406,27947,26467,0,0,66,66,0,1,0,1,0
33407,60514,39004,0,0,66,66,0,1,0,1,0
33408,63839,445,0,0,70,70,0,1,0,1,0
33409,63838,445,0,0,70,70,0,1,0,1,0
33410,63836,445,0,0,70,70,0,1,0,1,0
33411,43100,22114,0,0,146,146,0,1,0,1,0
33412,59245,445,0,0,66,66,0,1,0,1,0
33413,58975,445,0,0,70,70,0,1,0,1,0
33414,45964,55559,0,0,60,60,0,1,0,1,0
33415,29734,23,0,0,60,60,0,1,0,1,0
33416,57233,50934,0,0,66,66,0,1,0,1,0
33417,48323,35253,0,0,146,146,0,1,0,1,0
33418,51015,64147,0,0,62,62,0,1,0,1,0
33419,14923,51505,0,0,62,62,0,1,0,1,0
33420,3068,36237,0,0,62,62,0,1,0,1,0
33421,21750,39004,0,0,66,66,0,1,0,1,0
33422,62388,39004,0,0,145,145,0,1,0,1,0
33423,39920,22114,0,0,62,62,0,1,0,1,0
33424,36665,23,0,0,60,60,0,1,0,1,0
33425,24145,35440,0,0,62,62,0,1,0,1,0
33426,63831,445,0,0,70,70,0,1,0,1,0
33427,63830,445,0,0,70,70,0,1,0,1,0
33428,58971,445,0,0,70,70,0,1,0,1,0
33429,56035,1310,0,0,66,66,0,1,0,1,0
33430,59647,47993,0,0,62,62,0,1,0,1,0
33431,55854,54369,0,0,74,74,0,1,0,1,0
33432,58961,445,0,0,70,70,0,1,0,1,0
33433,58960,445,0,0,70,70,0,1,0,1,0
33434,58959,445,0,0,70,70,0,1,0,1,0
33435,59230,445,0,0,66,66,0,1,0,1,0
33436,59228,445,0,0,66,66,0,1,0,1,0
33437,58958,445,0,0,70,70,0,1,0,1,0
33438,10797,50584,0,0,62,62,0,1,0,1,0
33439,58955,445,0,0,70,70,0,1,0,1,0
33440,35864,44847,0,0,78,78,0,1,0,1,0
33441,62109,44847,0,0,62,62,0,1,0,1,0
33442,51096,63710,0,0,62,62,0,1,0,1,0
33443,0,0,0,0,156,156,0,2,0,2,0
33444,0,0,0,0,244,244,0,2,0,2,0
33445,63817,445,0,0,70,70,0,1,0,1,0
33446,59796,23,0,0,60,60,0,1,0,1,0
33447,63815,445,0,0,70,70,0,1,0,1,0
33448,63812,445,0,0,70,70,0,1,0,1,0
33449,63811,445,0,0,70,70,0,1,0,1,0
33450,16387,8455,0,0,60,60,0,1,0,1,0
33451,16387,49252,0,0,60,60,0,1,0,1,0
33452,16387,35244,0,0,60,60,0,1,0,1,0
33453,59222,445,0,0,66,66,0,1,0,1,0
33454,59211,445,0,0,66,66,0,1,0,1,0
33455,59214,445,0,0,66,66,0,1,0,1,0
33456,59215,445,0,0,66,66,0,1,0,1,0
33457,59213,445,0,0,66,66,0,1,0,1,0
33458,59210,445,0,0,66,66,0,1,0,1,0
33459,59216,445,0,0,66,66,0,1,0,1,0
33460,59208,445,0,0,66,66,0,1,0,1,0
33461,58949,445,0,0,70,70,0,1,0,1,0
33462,54134,64147,0,0,66,66,0,1,0,1,0
33463,63804,445,0,0,70,70,0,1,0,1,0
33464,65166,62413,0,0,66,66,0,1,0,1,0
33465,63801,445,0,0,70,70,0,1,0,1,0
33466,63797,445,0,0,70,70,0,1,0,1,0
33467,63799,445,0,0,70,70,0,1,0,1,0
33468,58941,445,0,0,70,70,0,1,0,1,0
33469,58938,445,0,0,70,70,0,1,0,1,0
33470,13484,37965,0,0,62,62,0,1,0,1,0
33471,49855,36180,0,0,62,62,0,1,0,1,0
33472,60022,10387,0,0,159,159,0,1,0,1,0
33473,45238,44847,0,0,66,66,0,1,0,1,0
33474,28580,64147,0,0,62,62,0,1,0,1,0
33475,11450,57470,0,0,66,66,0,1,0,1,0
33476,41755,48817,0,0,145,145,0,1,0,1,0
33477,50486,56205,0,0,62,62,0,1,0,1,0
33478,7275,9524,0,0,66,66,0,1,0,1,0
33479,15180,26467,0,0,62,62,0,1,0,1,0
33480,60610,58414,0,0,62,62,0,1,0,1,0
33481,58934,445,0,0,70,70,0,1,0,1,0
33482,61766,44847,0,0,66,66,0,1,0,1,0
33483,7286,44847,0,0,66,66,0,1,0,1,0
33484,63795,445,0,0,70,70,0,1,0,1,0
33485,63792,445,0,0,70,70,0,1,0,1,0
33486,63790,445,0,0,70,70,0,1,0,1,0
33487,58933,445,0,0,70,70,0,1,0,1,0
33488,59200,445,0,0,66,66,0,1,0,1,0
33489,63788,445,0,0,70,70,0,1,0,1,0
33490,50095,50584,0,0,62,62,0,1,0,1,0
33491,55600,22,0,0,60,60,0,1,0,1,0
33492,59198,445,0,0,66,66,0,1,0,1,0
33493,10480,26467,0,0,62,62,0,1,0,1,0
33494,57302,62413,0,0,66,66,0,1,0,1,0
33495,26872,44847,0,0,62,62,0,1,0,1,0
33496,59195,445,0,0,66,66,0,1,0,1,0
33497,59194,445,0,0,66,66,0,1,0,1,0
33498,55706,443,29687,443,5259,1203,4056,19,41,10,9
33499,49360,443,11814,443,5782,1008,4774,17,16,8,9
33500,49223,80,54325,80,1793,1030,763,11,15,6,5
33501,58051,443,3762,443,8930,1529,7401,21,19,9,12
33502,56559,53,15416,53,731,85,646,2,30,1,1
33503,50282,443,7706,443,24856,2858,21998,57,100,30,27
33504,51882,443,57503,443,366,180,186,7,30,4,3
33505,51849,80,48623,80,366,240,126,7,31,5,2
33506,51881,443,23769,443,4418,1116,3302,17,30,10,7
33507,51869,443,60062,443,4435,1290,3145,17,31,9,8
33508,27480,443,15079,443,11716,1007,10709,42,383,11,31
33509,51848,80,47789,80,12009,5364,6645,23,31,12,11
33510,51842,443,3576,443,1503,984,519,13,31,8,5
33511,43101,443,55812,443,20846,11163,9683,55,318,30,25
33512,16647,53,16647,53,233,91,142,2,30,1,1
33513,64281,53,18314,53,212,108,104,2,30,1,1
33514,51880,443,34522,443,4358,1056,3302,16,30,9,7
33515,51846,80,21384,80,366,240,126,7,31,5,2
33516,50268,443,33459,443,35251,25181,10070,121,123,63,58
33517,50272,443,15445,443,8456,2502,5954,32,120,19,13
33518,7331,53,7331,53,213,79,134,2,32,1,1
33519,60776,4156,9252,4156,70,70,0,2,8,2,0
33520,53726,26083,31165,26083,70,70,0,1,5,1,0
33521,58049,80,61142,80,378,192,186,7,19,4,3
33522,2588,53,2588,53,197,76,121,2,30,1,1
33523,44368,53,44368,53,233,91,142,2,30,1,1
33524,52265,53,0,0,233,89,144,2,30,1,1
33525,65353,53,60832,53,170,87,83,2,30,1,1
33526,51847,80,28250,80,366,240,126,7,31,5,2
33527,51874,443,24684,443,1852,1103,749,16,31,9,7
33528,51840,443,42990,443,246,120,126,5,32,3,2
33529,53500,443,53500,443,960,539,421,9,35,5,4
33530,55046,53,59080,53,300,102,198,4,40,2,2
33531,51879,443,43940,443,4418,1116,3302,17,30,10,7
33532,50283,443,2548,443,49752,4187,45565,87,100,45,42
33533,51348,7000,51348,7000,2163,676,1487,14,15,7,7
33534,50326,80,17692,80,7979,802,7177,17,47,8,9
33535,30859,53,30859,53,213,79,134,2,32,1,1
33536,57328,53,13021,53,1427,101,1326,4,48,2,2
33537,55886,443,32004,443,161,101,60,2,5,1,1
33538,51866,443,8681,443,2449,1794,655,17,31,10,7
33539,51221,33295,49216,33295,528,528,0,9,1200,9,0
33540,51877,443,15246,443,1852,1103,749,16,31,9,7
33541,49541,443,61178,443,8464,2891,5573,20,30,10,10
33542,51861,80,40570,80,366,240,126,7,31,5,2
33543,51875,443,48033,443,1852,1103,749,16,31,9,7
33544,53724,64923,63918,64923,70,70,0,1,5,1,0
33545,51845,80,46640,80,502,310,192,9,31,6,3
33546,51940,26399,39116,26399,70,70,0,2,8,2,0
33547,60184,443,60184,443,4574,1667,2907,19,26,11,8
33548,60445,20555,43690,20555,70,70,0,2,8,2,0
33549,63854,53,30633,53,578,286,292,9,15,5,4
33550,60437,30889,62883,30889,1729,1125,604,14,16,8,6
33551,52713,443,22767,443,26235,2216,24019,39,318,17,22
33552,55004,80,20099,80,2394,630,1764,9,16,6,3
33553,44684,443,12133,443,4728,3417,1311,23,35,12,11
33554,50327,80,7970,80,366,180,186,7,47,4,3
33555,57013,80,43644,80,5696,703,4993,14,75,8,6
33556,49322,443,12551,443,166663,77974,88689,368,2310,123,245
33557,46746,443,46746,443,4427,1520,2907,19,30,11,8
33558,55694,53,54062,53,166,85,81,2,31,1,1
33559,62861,443,20935,443,4777,2262,2515,10,122,5,5
33560,50265,26650,50101,26650,480,149,331,2,1201,1,1
33561,50535,80,30581,80,62768,25796,36972,75,34,33,42
33562,54195,443,39081,443,1786,172,1614,7,120,3,4
33563,50538,80,28093,80,4314,3518,796,15,32,8,7
33564,49740,53,20655,53,793,101,692,2,31,1,1
33565,137,137,54849,137,96,96,0,2,31,2,0
33566,65507,53,3795,53,166,85,81,2,31,1,1
33567,55203,443,52613,443,12947,4309,8638,29,152,15,14
33568,62860,443,23047,443,4954,2554,2400,11,122,6,5
33569,12929,41864,0,0,145,145,0,1,0,1,0
33570,58929,445,0,0,70,70,0,1,0,1,0
33571,59192,445,0,0,66,66,0,1,0,1,0
33572,53656,11119,0,0,148,148,0,1,0,1,0
33573,58928,445,0,0,70,70,0,1,0,1,0
33574,25589,23,0,0,60,60,0,1,0,1,0
33575,1025,51221,0,0,62,62,0,1,0,1,0
33576,51382,56205,0,0,66,66,0,1,0,1,0
33577,51413,57470,0,0,72,72,0,1,0,1,0
33578,60720,23718,0,0,62,62,0,1,0,1,0
33579,63780,445,0,0,70,70,0,1,0,1,0
33580,54866,37965,0,0,62,62,0,1,0,1,0
33581,51862,80,9823,80,6106,5420,686,13,30,7,6
33582,49953,80,9395,80,11209,819,10390,19,15,9,10
33583,60436,56687,61011,56687,564,318,246,9,16,5,4
33584,51960,443,7003,443,8830,1950,6880,27,25,14,13
33585,49959,80,5453,80,9763,749,9014,17,15,8,9
33586,47200,443,56772,443,11003,3821,7182,35,257,14,21
33587,50523,53,31491,53,199,102,97,2,30,1,1
33588,55715,443,4116,443,1648,114,1534,5,120,2,3
33589,51871,443,4793,443,554,310,244,10,30,6,4
33590,51837,80,11115,80,242,120,122,5,31,3,2
33591,52039,80,22816,80,4185,3462,723,14,15,7,7
33592,49769,80,36678,80,254,128,126,5,15,3,2
33593,58047,80,5646,80,7453,2953,4500,19,21,10,9
33594,56138,53,30181,53,284,94,190,2,29,1,1
33595,65353,53,4050,53,177,94,83,2,29,1,1
33596,56311,53,2296,53,311,94,217,2,30,1,1
33597,50047,80,4097,80,1455,349,1106,10,15,5,5
33598,51836,443,36494,443,4927,986,3941,21,31,12,9
33599,51908,80,63314,80,4542,2962,1580,13,28,8,5
33600,51815,80,14356,80,3910,2158,1752,15,32,10,5
33601,51830,80,53910,80,486,300,186,9,31,6,3
33602,57914,443,43452,443,4322,2383,1939,29,124,17,12
33603,50290,443,49413,443,26064,2233,23831,44,97,23,21
33604,51826,443,55412,443,682,370,312,12,32,7,5
33605,49455,443,62985,443,12386,1821,10565,23,33,11,12
33606,53502,443,53502,443,960,539,421,9,35,5,4
33607,53259,443,54002,443,6250,1774,4476,27,17,14,13
33608,50284,443,42928,443,13168,2875,10293,48,99,27,21
33609,63923,59177,7249,59177,66,66,0,2,7,2,0
33610,51915,443,2041,443,362,180,182,7,28,4,3
33611,53748,51413,38549,51413,70,70,0,2,7,2,0
33612,63895,43729,7105,43729,70,70,0,1,4,1,0
33613,56203,53,18895,53,283,102,181,2,29,1,1
33614,56395,53,26847,53,177,94,83,2,29,1,1
33615,49274,53,51381,53,197,102,95,2,29,1,1
33616,56907,53,38903,53,293,102,191,2,29,1,1
33617,50332,80,8939,80,5517,2843,2674,19,47,10,9
33618,50056,27018,50062,27018,546,390,156,6,30,4,2
33619,18125,53,18125,53,235,90,145,2,33,1,1
33620,51917,26077,25405,26077,70,70,0,1,5,1,0
33621,49358,443,2362,443,9482,4710,4772,19,16,11,8
33622,55446,443,18400,443,165191,6141,159050,184,30,67,117
33623,50085,80,41165,80,5514,2362,3152,37,469,19,18
33624,37983,443,26799,443,15668921,169545,15499376,12539,161,1284,11255
33625,49243,53,19778,53,212,102,110,2,30,1,1
33626,29616,53,29616,53,241,98,143,2,30,1,1
33627,56569,53,35579,53,199,102,97,2,30,1,1
33628,56513,53,43170,53,184,86,98,2,30,1,1
33629,57453,443,43967,443,2233,1347,886,23,135,13,10
33630,39455,80,39455,80,14349,1038,13311,26,20,13,13
33631,60438,17148,35885,17148,70,70,0,1,5,1,0
33632,51918,41488,58958,41488,70,70,0,1,5,1,0
33633,51889,80,18568,80,15867,8841,7026,29,29,16,13
33634,51962,443,60648,443,8600,1735,6865,27,25,14,13
33635,65115,53,32763,53,167,86,81,2,30,1,1
33636,59653,80,58858,80,1139,609,530,10,34,6,4
33637,33924,80,28051,80,1139,609,530,10,61,6,4
33638,46298,443,58260,443,52438,4244,48194,77,23,37,40
33639,46288,443,54873,443,28173,21385,6788,100,41,51,49
33640,56681,443,56377,443,8654,2150,6504,20,15,11,9
33641,49957,80,62910,80,6389,690,5699,16,15,8,8
33642,49961,80,19985,80,8315,820,7495,18,15,9,9
33643,46731,443,46731,443,4603,1696,2907,19,30,11,8
33644,51919,10298,57387,10298,70,70,0,1,5,1,0
33645,60336,5222,43827,5222,32653,15160,17493,307,506,160,147
33646,49955,80,63565,80,9810,819,8991,19,15,9,10
33647,59617,443,31345,443,5682,1565,4117,23,66,13,10
33648,49207,443,63518,443,19566,12185,7381,89,176,42,47
33649,64028,53,51007,53,293,134,159,2,30,1,1
33650,63133,80,57043,80,18055,904,17151,22,15,7,15
33651,64651,53,19265,53,196,94,102,2,30,1,1
33652,49201,53,3474,53,200,102,98,2,30,1,1
33653,64028,53,50736,53,263,134,129,2,30,1,1
33654,50523,53,17417,53,199,102,97,2,30,1,1
33655,64281,53,42063,53,214,110,104,2,30,1,1
33656,56526,53,57484,53,210,102,108,2,30,1,1
33657,63092,443,8576,443,4771341,155341,4616000,5024,147,1667,3357
33658,45063,80,24999,80,1892,1014,878,10,21,6,4
33659,51733,5228,35376,5228,6967,1929,5038,25,128,14,11
33660,63132,80,36171,80,19934,920,19014,23,15,7,16
33661,46285,443,47233,443,40877,5947,34930,81,56,39,42
33662,50325,80,35970,80,2535,783,1752,13,48,7,6
33663,50302,80,5947,80,5100,1620,3480,17,114,10,7
33664,50329,80,27783,80,1550,728,822,13,47,7,6
33665,49960,80,58313,80,9718,819,8899,19,15,9,10
33666,49954,80,59970,80,10841,821,10020,19,15,9,10
33667,48838,8080,7294,8080,533,327,206,8,33,5,3
33668,51017,80,29159,80,2654,796,1858,12,18,7,5
33669,65237,53,3519,53,225,94,131,2,30,1,1
33670,49201,53,35149,53,200,102,98,2,30,1,1
33671,63893,443,26379,443,3071,804,2267,15,135,7,8
33672,49763,443,47715,443,12767,8343,4424,31,122,17,14
33673,49890,443,49782,443,2513598,90400,2423198,2658,280,896,1762
33674,49280,80,50074,80,200808,6612,194196,217,3669,83,134
33675,51831,80,34274,80,486,300,186,9,31,6,3
33676,21133,41620,37961,41620,150,150,0,1,1199,1,0
33677,35221,443,12640,443,146299,21774,124525,246,141,98,148
33678,51907,80,10230,80,9189,3144,6045,19,28,11,8
33679,49224,80,15279,80,2999,2271,728,11,15,6,5
33680,51914,80,46843,80,366,240,126,7,28,5,2
33681,51835,443,47905,443,546,300,246,10,31,6,4
33682,51825,443,16261,443,4943,936,4007,21,32,11,10
33683,51898,80,53700,80,366,240,126,7,28,5,2
33684,63134,80,1605,80,18032,904,17128,22,15,7,15
33685,51928,80,8868,80,1357,963,394,10,26,7,3
33686,50264,443,26394,443,25435,5293,20142,104,138,54,50
33687,50269,80,46714,80,1606,823,783,12,121,7,5
33688,60447,36396,16095,36396,70,70,0,2,8,2,0
33689,50281,443,10698,443,25811,4278,21533,73,100,38,35
33690,53138,15048,65155,15048,70,70,0,1,4,1,0
33691,50287,443,3897,443,8247,2761,5486,36,99,19,17
33692,51872,443,26165,443,442,250,192,8,30,5,3
33693,50257,443,7570,443,249660,21361,228299,416,141,191,225
33694,60439,47783,39683,47783,70,70,0,1,5,1,0
33695,56860,49991,48987,49991,70,70,0,1,5,1,0
33696,63892,8080,57373,8080,1269,548,721,10,15,6,4
33697,53725,57418,10921,57418,70,70,0,1,4,1,0
33698,60853,443,17952,443,126,60,66,3,4,2,1
33699,50263,443,33451,443,35817,18303,17514,160,138,85,75
33700,6977,53,6977,53,235,90,145,2,32,1,1
33701,55046,53,5301,53,300,102,198,4,40,2,2
33702,51275,10924,61359,10924,70,70,0,2,8,2,0
33703,58186,443,61282,443,5086,3296,1790,36,56,18,18
33704,55046,53,27327,53,300,102,198,4,39,2,2
33705,55046,53,20538,53,300,102,198,4,40,2,2
33706,55444,443,59927,443,1455177,56285,1398892,1600,31,632,968
33707,55198,80,49692,80,41822,2038,39784,56,15,27,29
33708,51982,80,47547,80,14487990,289826,14198164,13259,54,3839,9420
33709,50323,80,57798,80,2074,793,1281,11,48,6,5
33710,49958,80,11985,80,11173,821,10352,19,15,9,10
33711,41576,443,6870,443,5954,1607,4347,27,215,14,13
33712,49956,80,11904,80,10819,819,10000,19,15,9,10
33713,49651,53,30768,53,312,94,218,2,29,1,1
33714,55100,53,52662,53,438,94,344,2,29,1,1
33715,64320,53,39088,53,197,94,103,2,29,1,1
33716,65353,53,24740,53,177,94,83,2,30,1,1
33717,55549,53,55549,53,228,90,138,2,30,1,1
33718,58982,443,29770,443,6400453,202937,6197516,6806,226,2259,4547
33719,43827,443,38851,443,677212,30094,647118,785,136,282,503
33720,59920,443,55787,443,3063,1068,1995,12,134,6,6
33721,6881,58293,28909,58293,228,118,110,2,1200,1,1
33722,37851,443,26132,443,14283,12630,1653,29,126,17,12
33723,56682,443,61779,443,8654,2150,6504,20,15,11,9
33724,60908,443,62015,443,10043,4993,5050,45,15,27,18
33725,49800,53,49800,53,235,90,145,2,33,1,1
33726,9755,53,9755,53,244,98,146,2,33,1,1
33727,55449,443,46191,443,480989,16896,464093,507,22,178,329
33728,58013,80,34784,80,3877,2069,1808,15,26,9,6
33729,54889,443,57896,443,5541,3309,2232,19,61,11,8
33730,43863,80,21010,80,2025,805,1220,12,46,7,5
33731,64471,53,53728,53,264,110,154,2,30,1,1
33732,64998,53,50318,53,214,94,120,2,30,1,1
33733,64281,53,44626,53,214,110,104,2,30,1,1
33734,49591,53,31886,53,198,94,104,2,30,1,1
33735,39995,443,64142,443,6812,2910,3902,31,282,8,23
33736,58886,443,31172,443,3404,2124,1280,18,135,10,8
33737,49547,443,10107,443,6180,1249,4931,14,20,8,6
33738,49549,443,60727,443,5903,1270,4633,14,17,8,6
33739,56007,53,28468,53,197,102,95,2,33,1,1
33740,51939,34393,42807,34393,70,70,0,2,8,2,0
33741,60441,64337,24616,64337,70,70,0,1,5,1,0
33742,51916,24596,60319,24596,70,70,0,1,5,1,0
33743,58575,443,10441,443,6453,1742,4711,20,17,10,10
33744,50333,80,53972,80,442,250,192,8,47,5,3
33745,49359,443,29384,443,6261,1362,4899,22,15,12,10
33746,57355,53,57355,53,242,98,144,2,30,1,1
33747,46002,53,40286,53,168,78,90,2,30,1,1
33748,56569,53,62895,53,199,102,97,2,30,1,1
33749,60769,443,35964,443,3758,1691,2067,12,135,6,6
33750,51944,12470,26336,12470,316,136,180,6,6,3,3
33751,51938,11218,50761,11218,70,70,0,2,8,2,0
33752,60446,6882,2486,6882,70,70,0,2,8,2,0
33753,55445,443,10778,443,1373295,46189,1327106,1448,31,527,921
33754,50334,80,53374,80,442,250,192,8,47,5,3
33755,57454,443,10249,443,4881,1817,3064,30,135,16,14
33756,60971,443,28807,443,396507,14667,381840,458,21,171,287
33757,60142,443,18976,443,2998,1997,1001,16,16,8,8
33758,8836,53,8836,53,203,82,121,2,30,1,1
33759,65115,53,14088,53,167,86,81,2,30,1,1
33760,49401,53,41126,53,258,102,156,2,30,1,1
33761,59930,443,17395,443,58431,5847,52584,55,120,10,45
33762,57470,41013,23995,41013,2128,875,1253,26,1980,13,13
33763,50022,80,11593,80,10023148,180272,9842876,9438,193,2907,6531
33764,49201,53,51989,53,200,102,98,2,30,1,1
33765,57470,1052,29632,1052,132,132,0,3,1199,3,0
33766,57368,53,40892,53,167,86,81,2,30,1,1
33767,64073,53,23568,53,199,102,97,2,30,1,1
33768,55694,53,60951,53,167,86,81,2,30,1,1
33769,64951,53,46883,53,224,86,138,2,30,1,1
33770,54891,443,48520,443,10035,2160,7875,35,120,18,17
33771,52838,443,36112,443,14518,10453,4065,43,120,21,22
33772,50779,443,64325,443,3247,1630,1617,8,120,4,4
33773,47337,443,13338,443,14281,2906,11375,15,122,4,11
33774,44402,443,62685,443,196732,11940,184792,257,139,103,154
33775,53755,45416,43327,45416,320,140,180,6,6,3,3
33776,56642,80,4720,80,234,234,0,4,12,4,0
33777,50665,443,30090,443,22544,1481,21063,31,16,9,22
33778,58326,80,34084,80,804,449,355,9,256,5,4
33779,47238,443,16760,443,16131,4542,11589,45,139,21,24
33780,64073,53,37819,53,520,211,309,6,39,3,3
33781,60777,40010,8810,40010,316,136,180,6,6,3,3
33782,49187,2710,53094,2710,70,70,0,1,5,1,0
33783,27348,80,31901,80,1550,850,700,10,18,5,5
33784,9193,443,3894,443,5043,432,4611,12,16,6,6
33785,123,123,52430,123,184,94,90,2,30,1,1
33786,64669,53,24998,53,198,94,104,2,30,1,1
33787,55694,53,12759,53,167,86,81,2,30,1,1
33788,1091,37965,0,0,62,62,0,1,0,1,0
33789,63775,445,0,0,70,70,0,1,0,1,0
33790,63770,445,0,0,70,70,0,1,0,1,0
33791,58923,445,0,0,70,70,0,1,0,1,0
33792,28124,37965,0,0,145,145,0,1,0,1,0
33793,59180,445,0,0,66,66,0,1,0,1,0
33794,54280,3398,0,0,60,60,0,1,0,1,0
33795,54280,3398,0,0,60,60,0,1,0,1,0
33796,62088,56205,0,0,62,62,0,1,0,1,0
33797,2464,50584,0,0,66,66,0,1,0,1,0
33798,22409,55442,0,0,74,74,0,1,0,1,0
33799,443,60496,0,0,320,320,0,1,0,1,0
33800,44922,57470,0,0,74,74,0,1,0,1,0
33801,51429,22114,0,0,66,66,0,1,0,1,0
33802,45308,22114,0,0,146,146,0,1,0,1,0
33803,59173,445,0,0,66,66,0,1,0,1,0
33804,63760,445,0,0,70,70,0,1,0,1,0
33805,7249,30349,0,0,143,143,0,1,0,1,0
33806,51313,33669,0,0,100,100,0,1,0,1,0
33807,51313,40573,0,0,100,100,0,1,0,1,0
33808,47201,44847,0,0,66,66,0,1,0,1,0
33809,57260,51221,0,0,66,66,0,1,0,1,0
33810,58910,445,0,0,70,70,0,1,0,1,0
33811,45908,33330,0,0,60,60,0,1,0,1,0
33812,59171,445,0,0,66,66,0,1,0,1,0
33813,14036,48817,0,0,66,66,0,1,0,1,0
33814,58907,445,0,0,70,70,0,1,0,1,0
33815,53044,36237,0,0,66,66,0,1,0,1,0
33816,59162,445,0,0,66,66,0,1,0,1,0
33817,52836,36829,0,0,62,62,0,1,0,1,0
33818,60855,35440,0,0,66,66,0,1,0,1,0
33819,16522,26467,0,0,62,62,0,1,0,1,0
33820,59155,445,0,0,66,66,0,1,0,1,0
33821,3549,64147,0,0,62,62,0,1,0,1,0
33822,15465,64147,0,0,66,66,0,1,0,1,0
33823,24212,21247,0,0,146,146,0,1,0,1,0
33824,58345,24748,0,0,148,148,0,1,0,1,0
33825,62257,2767,0,0,66,66,0,1,0,1,0
33826,58902,445,0,0,70,70,0,1,0,1,0
33827,5683,50584,0,0,66,66,0,1,0,1,0
33828,56883,22114,0,0,62,62,0,1,0,1,0
33829,58901,445,0,0,70,70,0,1,0,1,0
33830,49001,48983,0,0,161,161,0,1,0,1,0
33831,13287,16933,0,0,62,62,0,1,0,1,0
33832,58899,445,0,0,70,70,0,1,0,1,0
33833,42361,23,0,0,60,60,0,1,0,1,0
33834,63751,445,0,0,70,70,0,1,0,1,0
33835,63750,445,0,0,70,70,0,1,0,1,0
33836,63748,445,0,0,70,70,0,1,0,1,0
33837,59148,445,0,0,66,66,0,1,0,1,0
33838,59147,445,0,0,66,66,0,1,0,1,0
33839,59146,445,0,0,66,66,0,1,0,1,0
33840,59142,445,0,0,66,66,0,1,0,1,0
33841,59140,445,0,0,66,66,0,1,0,1,0
33842,59145,445,0,0,66,66,0,1,0,1,0
33843,59143,445,0,0,66,66,0,1,0,1,0
33844,59141,445,0,0,66,66,0,1,0,1,0
33845,52018,57866,0,0,62,62,0,1,0,1,0
33846,10145,21247,0,0,62,62,0,1,0,1,0
33847,58892,445,0,0,70,70,0,1,0,1,0
33848,32051,37965,0,0,62,62,0,1,0,1,0
33849,58890,445,0,0,70,70,0,1,0,1,0
33850,63742,445,0,0,70,70,0,1,0,1,0
33851,63740,445,0,0,70,70,0,1,0,1,0
33852,63732,445,0,0,70,70,0,1,0,1,0
33853,63730,445,0,0,70,70,0,1,0,1,0
33854,54234,443,2984,443,499,425,74,4,0,3,1
33855,54233,443,10183,443,499,425,74,4,0,3,1
33856,57499,80,57499,80,343853,13570,330283,445,3,223,222
33857,58889,445,0,0,70,70,0,1,0,1,0
33858,59128,445,0,0,66,66,0,1,0,1,0
33859,59127,445,0,0,66,66,0,1,0,1,0
33860,59125,445,0,0,66,66,0,1,0,1,0
33861,58888,445,0,0,70,70,0,1,0,1,0
33862,58887,445,0,0,70,70,0,1,0,1,0
33863,39730,17372,0,0,66,66,0,1,0,1,0
33864,58884,445,0,0,70,70,0,1,0,1,0
33865,58881,445,0,0,70,70,0,1,0,1,0
33866,10218,2323,0,0,60,60,0,1,0,1,0
33867,47910,7454,0,0,60,60,0,1,0,1,0
33868,63728,445,0,0,70,70,0,1,0,1,0
33869,50106,31573,0,0,66,66,0,1,0,1,0
33870,63723,445,0,0,70,70,0,1,0,1,0
33871,63719,445,0,0,70,70,0,1,0,1,0
33872,63717,445,0,0,70,70,0,1,0,1,0
33873,58869,445,0,0,70,70,0,1,0,1,0
33874,58862,445,0,0,70,70,0,1,0,1,0
33875,50920,60182,0,0,66,66,0,1,0,1,0
33876,58858,445,0,0,70,70,0,1,0,1,0
33877,58859,445,0,0,70,70,0,1,0,1,0
33878,62765,16933,0,0,66,66,0,1,0,1,0
33879,64824,36829,0,0,66,66,0,1,0,1,0
33880,4110,35440,0,0,66,66,0,1,0,1,0
33881,24731,51505,0,0,62,62,0,1,0,1,0
33882,48840,50584,0,0,62,62,0,1,0,1,0
33883,49113,50584,0,0,66,66,0,1,0,1,0
33884,7968,2767,0,0,62,62,0,1,0,1,0
33885,52740,51505,0,0,66,66,0,1,0,1,0
33886,63710,445,0,0,70,70,0,1,0,1,0
33887,50330,53,50330,53,237,93,144,2,0,1,1
33888,49355,53,16925,53,186,95,91,2,0,1,1
33889,63708,445,0,0,70,70,0,1,0,1,0
33890,63709,445,0,0,70,70,0,1,0,1,0
33891,58847,445,0,0,70,70,0,1,0,1,0
33892,59116,445,0,0,66,66,0,1,0,1,0
33893,13285,29892,0,0,145,145,0,1,0,1,0
33894,53218,56205,0,0,62,62,0,1,0,1,0
33895,16477,37807,0,0,66,66,0,1,0,1,0
33896,58842,445,0,0,70,70,0,1,0,1,0
33897,52650,44847,0,0,66,66,0,1,0,1,0
33898,63703,445,0,0,70,70,0,1,0,1,0
33899,63702,445,0,0,70,70,0,1,0,1,0
33900,58686,18375,0,0,66,66,0,1,0,1,0
33901,58834,445,0,0,70,70,0,1,0,1,0
33902,58833,445,0,0,70,70,0,1,0,1,0
33903,58832,445,0,0,70,70,0,1,0,1,0
33904,26758,50584,0,0,62,62,0,1,0,1,0
33905,58830,445,0,0,70,70,0,1,0,1,0
33906,58826,445,0,0,70,70,0,1,0,1,0
33907,50,38211,0,0,66,66,0,1,0,1,0
33908,63956,38211,0,0,62,62,0,1,0,1,0
33909,59099,445,0,0,66,66,0,1,0,1,0
33910,59101,445,0,0,66,66,0,1,0,1,0
33911,31727,57470,0,0,62,62,0,1,0,1,0
33912,64237,51505,0,0,66,66,0,1,0,1,0
33913,63691,445,0,0,70,70,0,1,0,1,0
33914,63686,445,0,0,70,70,0,1,0,1,0
33915,63685,445,0,0,70,70,0,1,0,1,0
33916,63684,445,0,0,70,70,0,1,0,1,0
33917,61278,56205,0,0,62,62,0,1,0,1,0
33918,59094,445,0,0,66,66,0,1,0,1,0
33919,58821,445,0,0,70,70,0,1,0,1,0
33920,65012,2767,0,0,66,66,0,1,0,1,0
33921,19875,30170,0,0,145,145,0,1,0,1,0
33922,59078,445,0,0,66,66,0,1,0,1,0
33923,59083,445,0,0,66,66,0,1,0,1,0
33924,59082,445,0,0,66,66,0,1,0,1,0
33925,59088,445,0,0,66,66,0,1,0,1,0
33926,59086,445,0,0,66,66,0,1,0,1,0
33927,59079,445,0,0,66,66,0,1,0,1,0
33928,59077,445,0,0,66,66,0,1,0,1,0
33929,13445,44847,0,0,66,66,0,1,0,1,0
33930,63676,445,0,0,70,70,0,1,0,1,0
33931,1024,44847,0,0,62,62,0,1,0,1,0
33932,63673,445,0,0,70,70,0,1,0,1,0
33933,63672,445,0,0,70,70,0,1,0,1,0
33934,63669,445,0,0,70,70,0,1,0,1,0
33935,58813,445,0,0,70,70,0,1,0,1,0
33936,58812,445,0,0,70,70,0,1,0,1,0
33937,59898,443,21573,443,5429,2835,2594,19,140,9,10
33938,54599,443,16547,443,6410,2001,4409,27,28,16,11
33939,26782,443,49572,443,7407,2650,4757,24,20,12,12
33940,63921,23758,6337,23758,312,132,180,6,7,3,3
33941,57585,443,55906,443,9273,2712,6561,50,615,25,25
33942,14341,80,14341,80,3360,2260,1100,19,61,11,8
33943,57227,443,51779,443,9322,2994,6328,26,22,16,10
33944,51868,443,55642,443,4375,1230,3145,16,30,8,8
33945,56858,32330,59933,32330,66,66,0,1,5,1,0
33946,37920,53,0,0,82,82,0,1,30,1,0
33947,52786,443,34018,443,8160,2216,5944,22,38,14,8
33948,23216,53,23216,53,235,90,145,2,33,1,1
33949,5239,6064,8462,6064,217199,128,217071,316,37,3,313
33950,32820,443,45406,443,11455,5836,5619,40,317,20,20
33951,49459,443,9422,443,39932,34025,5907,52,21,34,18
33952,32955,80,30230,80,14961,937,14024,25,16,11,14
33953,52788,443,17904,443,21915,3929,17986,40,31,23,17
33954,47422,80,55452,80,1614,1300,314,10,18,5,5
33955,50575,443,8721,443,149414,8612,140802,208,25,107,101
33956,58744,443,37896,443,42954,12409,30545,154,319,67,87
33957,50980,443,34954,443,7959,3288,4671,19,97,11,8
33958,51937,38056,36648,38056,70,70,0,2,8,2,0
33959,54610,443,65041,443,9948,2463,7485,41,27,22,19
33960,14692,443,14692,443,95958,6670,89288,139,80,68,71
33961,54792,443,48996,443,9515,2231,7284,25,22,14,11
33962,60381,80,60381,80,448865,6437,442428,380,151,67,313
33963,5588,5588,0,0,3498,1872,1626,48,201,24,24
33964,51913,52188,58050,52188,66,66,0,1,5,1,0
33965,50537,80,34758,80,4186,3559,627,15,31,8,7
33966,64073,53,57961,53,304,101,203,4,38,2,2
33967,15503,62336,46736,62336,127653507,122661116,4992391,161030,2162,82907,78123
33968,57226,443,27047,443,7924,2027,5897,23,22,14,9
33969,55252,443,43197,443,16179,1763,14416,38,46,17,21
33970,49680,443,50049,443,63100,10145,52955,87,147,37,50
33971,49929,443,35482,443,2484,330,2154,12,136,5,7
33972,44971,443,53632,443,6861,2809,4052,33,407,11,22
33973,59018,443,37679,443,1786,172,1614,7,120,3,4
33974,65194,53,10314,53,178,91,87,2,31,1,1
33975,57964,44847,0,0,62,62,0,1,0,1,0
33976,42108,23,0,0,60,60,0,1,0,1,0
33977,58338,3353,0,0,60,60,0,1,0,1,0
33978,35154,42707,0,0,62,62,0,1,0,1,0
33979,22300,51505,0,0,62,62,0,1,0,1,0
33980,58806,445,0,0,70,70,0,1,0,1,0
33981,58805,445,0,0,70,70,0,1,0,1,0
33982,63668,445,0,0,70,70,0,1,0,1,0
33983,63662,445,0,0,70,70,0,1,0,1,0
33984,63665,445,0,0,70,70,0,1,0,1,0
33985,33627,36237,0,0,62,62,0,1,0,1,0
33986,49001,48983,0,0,161,161,0,1,0,1,0
33987,47102,123,23383,123,184,94,90,2,30,1,1
33988,55824,80,14752,80,1281,398,883,16,393,4,12
33989,50871,443,47245,443,9241,2001,7240,24,28,14,10
33990,53017,80,55649,80,1658,1344,314,10,15,5,5
33991,53715,62348,45392,62348,672,306,366,11,14,5,6
33992,57003,443,38569,443,8592,3700,4892,39,108,21,18
33993,49545,443,43829,443,6606,936,5670,17,23,9,8
33994,50481,443,48883,443,7653,1188,6465,21,15,12,9
33995,57892,80,46739,80,6519,1210,5309,15,17,8,7
33996,57077,443,42602,443,7159,1851,5308,22,31,13,9
33997,55664,45682,37882,45682,320,140,180,6,6,3,3
33998,49186,443,54954,443,508520,13734,494786,527,18,192,335
33999,61661,53,61661,53,235,90,145,2,33,1,1
34000,44052,80,38453,80,282,60,222,5,12,2,3
34001,45537,80,48297,80,1638,1324,314,10,15,5,5
34002,51926,80,62359,80,36720,3404,33316,51,25,22,29
34003,65222,53,8527,53,212,102,110,2,30,1,1
34004,49542,80,57907,80,1012,531,481,8,25,5,3
34005,60945,443,30602,443,7771,2691,5080,34,28,19,15
34006,55107,443,57254,443,12000,3846,8154,29,28,17,12
34007,55659,37787,37419,37787,70,70,0,1,5,1,0
34008,14417,443,14417,443,15556,2973,12583,41,80,22,19
34009,50539,80,55226,80,5912,3532,2380,15,31,8,7
34010,56504,53,9210,53,195,94,101,2,30,1,1
34011,49160,3800,35343,3800,854,150,704,4,1200,2,2
34012,64940,53,23084,53,250,94,156,2,30,1,1
34013,53320,443,39301,443,30796,3050,27746,60,30,32,28
34014,64673,53,43122,53,213,94,119,2,30,1,1
34015,54035,443,43754,443,7724,2555,5169,26,47,15,11
34016,55694,53,17874,53,274,85,189,4,35,2,2
34017,60978,443,39156,443,1004246,35992,968254,1127,90,451,676
34018,56339,443,15948,443,8991,1756,7235,28,26,15,13
34019,63237,443,45268,443,1369,670,699,17,141,9,8
34020,41632,443,12669,443,7670,2131,5539,30,27,15,15
34021,50730,443,12545,443,3514,1609,1905,30,51,16,14
34022,36776,443,7923,443,2866,1674,1192,14,15,8,6
34023,37567,443,42814,443,214,140,74,4,15,3,1
34024,49972,80,64274,80,95065,52092,42973,148,259,77,71
34025,49589,443,40471,443,327575,8400,319175,334,316,113,221
34026,43382,443,40551,443,9624,2231,7393,24,22,14,10
34027,65507,53,47508,53,167,86,81,2,30,1,1
34028,41636,123,47665,123,184,94,90,2,30,1,1
34029,17750,50321,45531,50321,491,150,341,2,1200,1,1
34030,50276,5223,4771,5223,552,280,272,9,16,5,4
34031,64410,53,32197,53,286,98,188,4,40,2,2
34032,45196,443,61474,443,6357,1546,4811,26,17,14,12
34033,65445,53,12722,53,254,102,152,2,30,1,1
34034,37568,443,50535,443,214,140,74,4,15,3,1
34035,40254,443,35283,443,7646,1024,6622,19,15,11,8
34036,55661,49671,27582,49671,70,70,0,1,5,1,0
34037,64073,53,53984,53,304,101,203,4,37,2,2
34038,43479,443,6073,443,6990,2019,4971,29,20,16,13
34039,52247,53,24197,53,216,86,130,2,30,1,1
34040,65507,53,3700,53,167,86,81,2,30,1,1
34041,63973,53,57018,53,346,98,248,4,31,2,2
34042,38115,443,13490,443,281978,16098,265880,405,67,204,201
34043,52146,443,52659,443,774806,25835,748971,772,52,253,519
34044,51935,38639,4270,38639,70,70,0,2,8,2,0
34045,51936,17650,3009,17650,70,70,0,2,8,2,0
34046,9172,443,4913,443,89362,3092,86270,100,21,37,63
34047,39265,443,4436,443,46879,2864,44015,74,179,34,40
34048,14137,443,14137,443,155070,7155,147915,186,81,74,112
34049,50482,443,60480,443,7653,1188,6465,21,15,12,9
34050,52793,443,12880,443,130,70,60,2,14,1,1
34051,60812,80,61213,80,1658,1344,314,10,14,5,5
34052,35217,443,22630,443,4113,2625,1488,25,79,13,12
34053,40217,443,1676,443,14944,7430,7514,32,25,19,13
34054,55813,443,20333,443,15097,2888,12209,40,28,20,20
34055,49742,443,14299,443,16041,1805,14236,30,20,14,16
34056,44890,443,50264,443,232,172,60,3,4,2,1
34057,63922,32305,41561,32305,312,132,180,6,6,3,3
34058,60773,20010,46646,20010,70,70,0,1,5,1,0
34059,63236,443,2158,443,4945,2798,2147,27,141,14,13
34060,9108,443,64667,443,5510,901,4609,15,26,8,7
34061,53652,443,55573,443,11041,3217,7824,26,24,15,11
34062,52425,443,26865,443,6527,1142,5385,23,32,13,10
34063,32967,443,43142,443,5327,963,4364,19,15,11,8
34064,64704,53,49716,53,213,102,111,2,29,1,1
34065,57368,53,45045,53,167,86,81,2,29,1,1
34066,57600,443,30518,443,2614,1689,925,18,21,10,8
34067,52435,53,3973,53,216,78,138,2,29,1,1
34068,50871,53,48869,53,86,86,0,1,30,1,0
34069,65295,53,10641,53,212,102,110,2,29,1,1
34070,46704,80,21758,80,1193,451,742,10,15,6,4
34071,59792,80,7891,80,1453540,37280,1416260,1552,96,507,1045
34072,42868,443,8590,443,10049,2289,7760,35,27,19,16
34073,56338,443,8628,443,11148,3099,8049,26,24,15,11
34074,49448,443,41135,443,186882,17018,169864,206,29,84,122
34075,65168,53,15649,53,230,110,120,2,30,1,1
34076,56265,53,56216,53,213,94,119,2,30,1,1
34077,60138,443,19544,443,2993,1992,1001,16,15,8,8
34078,37569,443,62678,443,214,140,74,4,15,3,1
34079,53113,443,2940,443,11030,4292,6738,32,61,17,15
34080,49967,53,55984,53,303,100,203,4,40,2,2
34081,28479,53,28479,53,235,90,145,2,33,1,1
34082,26385,53,26385,53,235,90,145,2,33,1,1
34083,53660,443,43128,443,350,210,140,6,24,4,2
34084,56370,443,11997,443,26040,2148,23892,44,22,21,23
34085,43654,443,39718,443,8761,2571,6190,24,17,14,10
34086,39118,443,64547,443,206769,6309,200460,215,27,77,138
34087,51892,443,20369,443,5671,1556,4115,23,274,13,10
34088,39447,443,60525,443,7878,1909,5969,31,28,16,15
34089,37566,443,56010,443,214,140,74,4,15,3,1
34090,63962,53,22978,53,274,93,181,4,64,2,2
34091,15016,443,15016,443,21083,3108,17975,45,80,24,21
34092,56698,443,19362,443,106055,8460,97595,168,26,79,89
34093,60265,443,40784,443,11048,3161,7887,26,24,15,11
34094,48690,443,27547,443,19402,10414,8988,35,22,21,14
34095,49546,443,3244,443,5519,945,4574,15,23,8,7
34096,65491,53,6276,53,889,404,485,10,30,5,5
34097,65044,443,31714,443,4446,2496,1950,9,120,5,4
34098,65045,443,13703,443,4305,2217,2088,11,120,5,6
34099,64876,53,13922,53,718,94,624,2,31,1,1
34100,65046,53,1859,53,211,94,117,2,31,1,1
34101,40404,443,18265,443,280,140,140,5,130,3,2
34102,57392,443,58743,443,12347,6378,5969,39,208,20,19
34103,49332,443,12336,443,4425,1910,2515,36,3656,12,24
34104,63914,32805,62469,32805,66,66,0,2,8,2,0
34105,51418,443,34735,443,7653,1188,6465,21,17,12,9
34106,58230,443,58230,443,4465,1558,2907,19,27,11,8
34107,5588,5588,0,0,3354,1792,1562,46,194,23,23
34108,55618,53,36676,53,199,94,105,2,30,1,1
34109,46919,443,8853,443,7094,1672,5422,21,361,10,11
34110,57470,6881,10823,6881,132,132,0,3,1200,3,0
34111,60241,443,3002,443,92975,3289,89686,107,316,40,67
34112,53745,18569,48041,18569,70,70,0,2,8,2,0
34113,43608,53,16507,53,199,94,105,2,30,1,1
34114,50549,53,21467,53,199,94,105,2,30,1,1
34115,50479,443,65060,443,25979,7217,18762,36,16,19,17
34116,45896,443,44655,443,211720,46699,165021,332,109,152,180
34117,63951,53,53032,53,345,106,239,4,38,2,2
34118,53743,23915,28798,23915,70,70,0,2,8,2,0
34119,62232,80,62232,80,2158,1419,739,11,150,6,5
34120,57994,443,31591,443,10027,2130,7897,27,27,16,11
34121,59072,445,0,0,66,66,0,1,0,1,0
34122,63660,445,0,0,70,70,0,1,0,1,0
34123,59068,445,0,0,66,66,0,1,0,1,0
34124,27160,64147,0,0,66,66,0,1,0,1,0
34125,58801,445,0,0,70,70,0,1,0,1,0
34126,44922,57470,0,0,74,74,0,1,0,1,0
34127,59066,445,0,0,66,66,0,1,0,1,0
34128,59064,445,0,0,66,66,0,1,0,1,0
34129,61419,57470,0,0,66,66,0,1,0,1,0
34130,4760,44847,0,0,62,62,0,1,0,1,0
34131,26229,21247,0,0,62,62,0,1,0,1,0
34132,56869,17637,0,0,66,66,0,1,0,1,0
34133,59063,445,0,0,66,66,0,1,0,1,0
34134,58799,445,0,0,70,70,0,1,0,1,0
34135,28009,36237,0,0,62,62,0,1,0,1,0
34136,53906,37965,0,0,62,62,0,1,0,1,0
34137,64449,30188,0,0,66,66,0,1,0,1,0
34138,63652,445,0,0,70,70,0,1,0,1,0
34139,63651,445,0,0,70,70,0,1,0,1,0
34140,63643,445,0,0,70,70,0,1,0,1,0
34141,58795,445,0,0,70,70,0,1,0,1,0
34142,59191,35440,0,0,66,66,0,1,0,1,0
34143,59051,445,0,0,66,66,0,1,0,1,0
34144,12550,37807,0,0,146,146,0,1,0,1,0
34145,59044,445,0,0,66,66,0,1,0,1,0
34146,63633,445,0,0,70,70,0,1,0,1,0
34147,50624,50584,0,0,66,66,0,1,0,1,0
34148,35619,12883,0,0,159,159,0,1,0,1,0
34149,58782,445,0,0,70,70,0,1,0,1,0
34150,1530,62413,0,0,62,62,0,1,0,1,0
34151,54016,42707,0,0,66,66,0,1,0,1,0
34152,59042,445,0,0,66,66,0,1,0,1,0
34153,58779,445,0,0,70,70,0,1,0,1,0
34154,1036,64147,0,0,145,145,0,1,0,1,0
34155,59035,445,0,0,66,66,0,1,0,1,0
34156,5462,21247,0,0,62,62,0,1,0,1,0
34157,11362,64147,0,0,145,145,0,1,0,1,0
34158,59027,445,0,0,66,66,0,1,0,1,0
34159,30365,45991,0,0,60,60,0,1,0,1,0
34160,14844,37965,0,0,62,62,0,1,0,1,0
34161,48388,44847,0,0,62,62,0,1,0,1,0
34162,58774,445,0,0,70,70,0,1,0,1,0
34163,58773,445,0,0,70,70,0,1,0,1,0
34164,1484,22114,0,0,146,146,0,1,0,1,0
34165,58771,445,0,0,70,70,0,1,0,1,0
34166,58338,3369,0,0,60,60,0,1,0,1,0
34167,48676,53399,0,0,60,60,0,1,0,1,0
34168,6338,23117,0,0,66,66,0,1,0,1,0
34169,56367,44847,0,0,66,66,0,1,0,1,0
34170,53835,62413,0,0,62,62,0,1,0,1,0
34171,26642,57470,0,0,62,62,0,1,0,1,0
34172,63622,445,0,0,70,70,0,1,0,1,0
34173,63621,445,0,0,70,70,0,1,0,1,0
34174,63620,445,0,0,70,70,0,1,0,1,0
34175,59018,445,0,0,66,66,0,1,0,1,0
34176,59019,445,0,0,66,66,0,1,0,1,0
34177,59016,445,0,0,66,66,0,1,0,1,0
34178,59013,445,0,0,66,66,0,1,0,1,0
34179,59014,445,0,0,66,66,0,1,0,1,0
34180,59017,445,0,0,66,66,0,1,0,1,0
34181,59011,445,0,0,66,66,0,1,0,1,0
34182,59015,445,0,0,66,66,0,1,0,1,0
34183,25237,57470,0,0,62,62,0,1,0,1,0
34184,16319,44847,0,0,62,62,0,1,0,1,0
34185,59626,22114,0,0,62,62,0,1,0,1,0
34186,49168,57470,0,0,66,66,0,1,0,1,0
34187,58764,445,0,0,70,70,0,1,0,1,0
34188,54298,48983,0,0,159,159,0,1,0,1,0
34189,1026,64147,0,0,62,62,0,1,0,1,0
34190,16693,36237,0,0,66,66,0,1,0,1,0
34191,28999,37807,0,0,146,146,0,1,0,1,0
34192,58762,445,0,0,70,70,0,1,0,1,0
34193,58761,445,0,0,70,70,0,1,0,1,0
34194,63617,445,0,0,70,70,0,1,0,1,0
34195,63618,445,0,0,70,70,0,1,0,1,0
34196,63610,445,0,0,70,70,0,1,0,1,0
34197,63602,445,0,0,70,70,0,1,0,1,0
34198,58760,445,0,0,70,70,0,1,0,1,0
34199,58759,445,0,0,70,70,0,1,0,1,0
34200,58757,445,0,0,70,70,0,1,0,1,0
34201,58754,445,0,0,70,70,0,1,0,1,0
34202,13408,44847,0,0,66,66,0,1,0,1,0
34203,27147,22114,0,0,146,146,0,1,0,1,0
34204,58999,445,0,0,66,66,0,1,0,1,0
34205,58998,445,0,0,66,66,0,1,0,1,0
34206,58996,445,0,0,66,66,0,1,0,1,0
34207,3047,50584,0,0,62,62,0,1,0,1,0
34208,36096,51505,0,0,146,146,0,1,0,1,0
34209,61477,57470,0,0,66,66,0,1,0,1,0
34210,3667,56205,0,0,62,62,0,1,0,1,0
34211,58741,445,0,0,70,70,0,1,0,1,0
34212,58740,445,0,0,70,70,0,1,0,1,0
34213,58736,445,0,0,70,70,0,1,0,1,0
34214,63600,445,0,0,70,70,0,1,0,1,0
34215,53362,23,0,0,60,60,0,1,0,1,0
34216,58730,445,0,0,70,70,0,1,0,1,0
34217,58731,445,0,0,70,70,0,1,0,1,0
34218,63599,445,0,0,70,70,0,1,0,1,0
34219,63595,445,0,0,70,70,0,1,0,1,0
34220,63594,445,0,0,70,70,0,1,0,1,0
34221,28385,26467,0,0,66,66,0,1,0,1,0
34222,11951,45026,0,0,60,60,0,1,0,1,0
34223,0,0,0,0,320,320,0,5,0,5,0
34224,51592,51505,0,0,62,62,0,1,0,1,0
34225,20743,23,0,0,60,60,0,1,0,1,0
34226,58719,445,0,0,70,70,0,1,0,1,0
34227,55835,62413,0,0,66,66,0,1,0,1,0
34228,65085,22114,0,0,62,62,0,1,0,1,0
34229,63581,445,0,0,70,70,0,1,0,1,0
34230,63582,445,0,0,70,70,0,1,0,1,0
34231,63580,445,0,0,70,70,0,1,0,1,0
34232,1818,22114,0,0,62,62,0,1,0,1,0
34233,1818,22114,0,0,146,146,0,1,0,1,0
34234,58986,445,0,0,66,66,0,1,0,1,0
34235,18904,57470,0,0,62,62,0,1,0,1,0
34236,56202,15503,0,0,146,146,0,1,0,1,0
34237,58715,445,0,0,70,70,0,1,0,1,0
34238,54219,443,4628,443,499,425,74,4,0,3,1
34239,54227,443,59982,443,499,425,74,4,0,3,1
34240,54221,443,30528,443,499,425,74,4,0,3,1
34241,54229,443,56153,443,499,425,74,4,0,3,1
34242,54225,443,6300,443,499,425,74,4,0,3,1
34243,54226,443,4295,443,499,425,74,4,0,3,1
34244,54224,443,19866,443,499,425,74,4,0,3,1
34245,54228,443,39518,443,499,425,74,4,0,3,1
34246,54223,443,38222,443,499,425,74,4,0,3,1
34247,54218,443,2874,443,499,425,74,4,0,3,1
34248,54222,443,54407,443,499,425,74,4,0,3,1
34249,54220,443,37468,443,499,425,74,4,0,3,1
34250,13963,50584,0,0,66,66,0,1,0,1,0
34251,58706,445,0,0,70,70,0,1,0,1,0
34252,58703,445,0,0,70,70,0,1,0,1,0
34253,63573,445,0,0,70,70,0,1,0,1,0
34254,63574,445,0,0,70,70,0,1,0,1,0
34255,59694,50584,0,0,66,66,0,1,0,1,0
34256,58701,445,0,0,70,70,0,1,0,1,0
34257,58699,445,0,0,70,70,0,1,0,1,0
34258,47013,44512,0,0,62,62,0,1,0,1,0
34259,58971,445,0,0,66,66,0,1,0,1,0
34260,58968,445,0,0,66,66,0,1,0,1,0
34261,1187,64147,0,0,66,66,0,1,0,1,0
34262,51387,443,47138,443,9584,1871,7713,28,106,14,14
34263,41462,443,21403,443,10331,2157,8174,37,137,18,19
34264,40367,80,26121,80,2119,808,1311,12,16,7,5
34265,56336,53,36932,53,198,93,105,2,30,1,1
34266,60894,443,14726,443,3507,900,2607,13,135,6,7
34267,49331,443,20933,443,4889,763,4126,18,30,8,10
34268,57949,443,49783,443,19190,13041,6149,64,389,33,31
34269,59896,443,22952,443,1537,934,603,14,32,7,7
34270,38115,80,9146,80,6442,1404,5038,23,30,12,11
34271,58077,36653,14563,36653,204,64,140,4,10,2,2
34272,50018,3389,50018,3389,3413,1458,1955,16,18,8,8
34273,54717,443,54717,443,4608,1701,2907,19,27,11,8
34274,51916,80,61338,80,182,60,122,4,26,2,2
34275,56546,443,13186,443,19236,2292,16944,45,55,23,22
34276,9474,53,9474,53,237,91,146,2,33,1,1
34277,47677,80,49789,80,1304,850,454,11,31,6,5
34278,55553,53,10197,53,711,87,624,2,30,1,1
34279,60118,53,0,0,216,84,132,2,30,1,1
34280,50604,443,50604,443,4401,1494,2907,19,28,11,8
34281,50128,80,27649,80,20575,11455,9120,92,966,47,45
34282,59895,443,59498,443,1537,934,603,14,32,7,7
34283,49859,443,46970,443,18811,1868,16943,22,142,7,15
34284,59894,443,37643,443,1537,934,603,14,33,7,7
34285,47595,33441,0,0,106,106,0,1,60,1,0
34286,10850,53,10850,53,237,91,146,2,34,1,1
34287,56560,443,46506,443,84111,3300,80811,104,54,41,63
34288,53719,49306,15851,49306,70,70,0,1,5,1,0
34289,60443,50284,16097,50284,258,70,188,4,8,2,2
34290,56857,43237,51679,43237,66,66,0,1,5,1,0
34291,55052,443,42502,443,4425,876,3549,15,29,8,7
34292,38612,443,17131,443,20651533,655694,19995839,24885,362,8746,16139
34293,38608,443,19892,443,17473899,604274,16869625,22165,408,7731,14434
34294,38610,443,57889,443,19092095,654744,18437351,24079,407,8531,15548
34295,51864,38544,39396,38544,1345,679,666,9,30,5,4
34296,59897,443,7806,443,1743,934,809,15,32,7,8
34297,50020,3389,50020,3389,3347,1458,1889,15,18,8,7
34298,56611,80,8801,80,1114,534,580,12,16,7,5
34299,59899,443,64399,443,1401,864,537,12,30,6,6
34300,60410,443,3323,443,3683,1899,1784,20,20,10,10
34301,45119,443,35597,443,2227,1018,1209,17,16,8,9
34302,58039,80,32642,80,318,192,126,6,21,4,2
34303,50697,80,53956,80,2525,1403,1122,22,272,12,10
34304,51910,60443,42638,60443,66,66,0,1,5,1,0
34305,18964,443,18964,443,5157,2180,2977,21,16,12,9
34306,57339,53,43284,53,184,80,104,2,30,1,1
34307,48371,53,57320,53,198,93,105,2,30,1,1
34308,62875,53,0,0,205,80,125,2,30,1,1
34309,53007,443,38198,443,25010,3519,21491,42,135,17,25
34310,6881,12999,32088,12999,622,356,266,4,1201,2,2
34311,41799,443,41969,443,10518,3356,7162,24,121,11,13
34312,51594,53,61639,53,172,80,92,2,31,1,1
34313,46285,443,49897,443,36209,28887,7322,65,364,34,31
34314,6889,47807,0,0,143,143,0,1,0,1,0
34315,32342,62413,0,0,62,62,0,1,0,1,0
34316,63563,445,0,0,70,70,0,1,0,1,0
34317,31974,51505,0,0,66,66,0,1,0,1,0
34318,58692,445,0,0,70,70,0,1,0,1,0
34319,63558,445,0,0,70,70,0,1,0,1,0
34320,63557,445,0,0,70,70,0,1,0,1,0
34321,63554,445,0,0,70,70,0,1,0,1,0
34322,58963,445,0,0,66,66,0,1,0,1,0
34323,57131,31061,0,0,145,145,0,1,0,1,0
34324,26799,6881,0,0,62,62,0,1,0,1,0
34325,25234,1,0,0,62,62,0,1,0,1,0
34326,30389,53,30389,53,235,90,145,2,33,1,1
34327,58959,445,0,0,66,66,0,1,0,1,0
34328,58956,445,0,0,66,66,0,1,0,1,0
34329,58958,445,0,0,66,66,0,1,0,1,0
34330,58955,445,0,0,66,66,0,1,0,1,0
34331,58952,445,0,0,66,66,0,1,0,1,0
34332,58949,445,0,0,66,66,0,1,0,1,0
34333,58948,445,0,0,66,66,0,1,0,1,0
34334,5223,13602,0,0,66,66,0,1,0,1,0
34335,58685,445,0,0,70,70,0,1,0,1,0
34336,63547,445,0,0,70,70,0,1,0,1,0
34337,58683,445,0,0,70,70,0,1,0,1,0
34338,63545,445,0,0,70,70,0,1,0,1,0
34339,63544,445,0,0,70,70,0,1,0,1,0
34340,63542,445,0,0,70,70,0,1,0,1,0
34341,7166,64147,0,0,66,66,0,1,0,1,0
34342,58678,445,0,0,70,70,0,1,0,1,0
34343,58677,445,0,0,70,70,0,1,0,1,0
34344,10416,64147,0,0,62,62,0,1,0,1,0
34345,50663,443,7277,443,7136,1421,5715,18,15,8,10
34346,56543,443,33644,443,8659,1687,6972,30,55,16,14
34347,49253,53,0,0,218,78,140,2,30,1,1
34348,60771,80,37890,80,254,128,126,5,15,3,2
34349,50670,443,29531,443,11940,3585,8355,43,16,24,19
34350,50477,443,6875,443,25979,7217,18762,36,15,19,17
34351,53716,6881,32283,6881,70,70,0,1,4,1,0
34352,50210,80,7597,80,1277,460,817,16,71,5,11
34353,49558,53,61665,53,423,104,319,4,39,2,2
34354,65507,53,22060,53,167,86,81,2,29,1,1
34355,64096,53,55413,53,197,94,103,2,29,1,1
34356,57470,18560,34437,18560,150,150,0,1,1199,1,0
34357,65265,3389,65265,3389,4213,2429,1784,18,31,9,9
34358,49484,443,58905,443,407843,11895,395948,436,271,157,279
34359,50708,80,15427,80,3114,1695,1419,15,196,11,4
34360,57070,443,3388,443,18227,6731,11496,63,18,34,29
34361,50713,80,55082,80,708,384,324,12,195,7,5
34362,8802,80,39611,80,4999,1313,3686,36,667,8,28
34363,57993,443,27022,443,8647,1990,6657,23,26,14,9
34364,54997,443,59177,443,10817,4402,6415,31,23,17,14
34365,64768,53,30558,53,394,102,292,2,29,1,1
34366,58025,80,19163,80,708,384,324,12,23,7,5
34367,53746,7546,3408,7546,70,70,0,2,7,2,0
34368,57431,80,59179,80,11357,5000,6357,22,30,11,11
34369,64656,53,17241,53,387,102,285,2,29,1,1
34370,57012,53,13483,53,230,86,144,2,29,1,1
34371,55131,53,55323,53,244,94,150,2,30,1,1
34372,39666,443,38106,443,7522,2433,5089,16,120,8,8
34373,50662,443,10724,443,6518,1200,5318,17,16,8,9
34374,51932,36498,31404,36498,70,70,0,2,8,2,0
34375,64410,53,3799,53,196,102,94,2,35,1,1
34376,55062,80,41792,80,486,240,246,9,28,5,4
34377,58044,80,31147,80,2742,1116,1626,11,20,6,5
34378,58042,80,52870,80,318,192,126,6,20,4,2
34379,54352,443,38196,443,12594,5098,7496,32,34,17,15
34380,51418,53,32808,53,168,78,90,2,30,1,1
34381,64215,53,28280,53,196,94,102,2,30,1,1
34382,43197,80,55210,80,3605,1700,1905,16,186,9,7
34383,57239,5228,64844,5228,16135,7514,8621,173,9115,72,101
34384,49593,53,25320,53,253,102,151,2,30,1,1
34385,50710,80,11292,80,708,384,324,12,195,7,5
34386,50712,80,10227,80,708,384,324,12,195,7,5
34387,60287,80,11423,80,130,70,60,2,15,1,1
34388,51931,19416,65025,19416,70,70,0,2,8,2,0
34389,65115,53,63102,53,301,95,206,4,36,2,2
34390,65090,53,43740,53,209,102,107,2,30,1,1
34391,50400,53,28411,53,177,94,83,2,30,1,1
34392,50400,53,9416,53,177,94,83,2,30,1,1
34393,46567,443,46567,443,4398,1491,2907,19,29,11,8
34394,64025,53,10807,53,199,94,105,2,30,1,1
34395,34092,53,13668,53,168,78,90,2,30,1,1
34396,41739,53,41739,53,235,90,145,2,32,1,1
34397,57850,3389,57850,3389,3347,1458,1889,15,18,8,7
34398,43817,53,43817,53,203,82,121,2,30,1,1
34399,62724,443,24098,443,11195,2218,8977,36,80,18,18
34400,55933,53,17036,53,212,102,110,2,30,1,1
34401,55653,443,8699,443,7267,2312,4955,16,120,7,9
34402,53522,8765,27669,8765,199,75,124,4,59,2,2
34403,55271,53,16538,53,268,102,166,2,30,1,1
34404,43195,80,21562,80,3477,1572,1905,16,186,9,7
34405,57169,53,0,0,208,86,122,2,30,1,1
34406,48931,53,2346,53,168,78,90,2,30,1,1
34407,64425,53,47922,53,216,94,122,2,30,1,1
34408,64579,443,6221,443,24686,1935,22751,36,20,17,19
34409,53083,80,12541,80,5259,1904,3355,30,15,23,7
34410,46999,53,31962,53,168,78,90,2,30,1,1
34411,55699,443,1921,443,4170,1901,2269,14,120,7,7
34412,56214,53,47113,53,200,102,98,2,33,1,1
34413,55075,53,41245,53,181,94,87,2,33,1,1
34414,42890,80,22504,80,2030,586,1444,10,30,6,4
34415,57689,443,27070,443,10855,1786,9069,32,180,15,17
34416,50050,53,17602,53,253,87,166,4,52,2,2
34417,64050,53,59472,53,389,94,295,2,30,1,1
34418,64765,53,34365,53,195,94,101,2,30,1,1
34419,56214,53,47362,53,200,102,98,2,30,1,1
34420,57225,53,35274,53,177,94,83,2,30,1,1
34421,50265,59362,35253,59362,4228,2471,1757,55,2758,31,24
34422,49352,53,48466,53,214,94,120,2,30,1,1
34423,65453,53,27266,53,251,94,157,2,31,1,1
34424,44455,443,5697,443,6972,1375,5597,20,31,10,10
34425,57045,53,2181,53,177,94,83,2,30,1,1
34426,37208,443,37628,443,9621,7389,2232,33,256,14,19
34427,52220,22,52220,22,8248,3445,4803,57,38,26,31
34428,41320,443,41281,443,1743946,54876,1689070,1870,360,678,1192
34429,56812,443,43977,443,11568,9158,2410,42,80,23,19
34430,53425,443,1934,443,7208,2237,4971,26,32,16,10
34431,53020,443,6371,443,3183,2180,1003,16,15,8,8
34432,51893,80,59031,80,14289,7263,7026,27,27,14,13
34433,49355,443,38735,443,4960,896,4064,14,16,8,6
34434,63131,34880,2031,34880,316,190,126,5,15,3,2
34435,50478,443,59774,443,25979,7217,18762,36,15,19,17
34436,51420,443,42852,443,7653,1188,6465,21,16,12,9
34437,40956,443,7227,443,10836,1733,9103,34,180,15,19
34438,39926,443,4012,443,40820,4400,36420,81,81,42,39
34439,51421,443,61384,443,9345,3051,6294,22,15,13,9
34440,50664,443,64015,443,7767,1421,6346,20,15,8,12
34441,63916,56318,49851,56318,66,66,0,2,7,2,0
34442,49295,53,11197,53,280,96,184,4,36,2,2
34443,63917,57826,24551,57826,66,66,0,2,7,2,0
34444,33938,443,14561,443,6919,2112,4807,19,15,10,9
34445,50714,80,62410,80,708,384,324,12,195,7,5
34446,37562,443,51859,443,13836,6371,7465,34,23,20,14
34447,58043,80,57225,80,378,192,186,7,20,4,3
34448,50210,1688,10212,1688,70,70,0,1,5,1,0
34449,53650,53,49968,53,199,94,105,2,29,1,1
34450,42749,443,12087,443,6172,1310,4862,28,468,10,18
34451,49753,80,62550,80,32910,18450,14460,143,1647,75,68
34452,55384,53,19331,53,94,94,0,1,30,1,0
34453,49683,53,44598,53,262,94,168,2,29,1,1
34454,64283,53,39891,53,337,110,227,2,29,1,1
34455,48292,80,5673,80,14038,3554,10484,45,1142,16,29
34456,52817,443,5709,443,2658,1126,1532,25,120,12,13
34457,64052,443,61598,443,4395,1673,2722,14,119,7,7
34458,49308,53,5550,53,195,94,101,2,29,1,1
34459,65097,53,14229,53,718,94,624,2,30,1,1
34460,59116,443,24457,443,48923,5417,43506,61,122,25,36
34461,53087,443,59846,443,408922,10621,398301,421,121,145,276
34462,6881,6889,14083,6889,228,118,110,2,1199,1,1
34463,51910,80,31121,80,4994,3658,1336,11,26,6,5
34464,64420,53,48861,53,294,95,199,4,42,2,2
34465,55049,443,41973,443,5587,3950,1637,26,55,15,11
34466,50709,80,20258,80,708,384,324,12,195,7,5
34467,49686,53,9507,53,343,94,249,2,30,1,1
34468,49805,53,26905,53,296,102,194,2,30,1,1
34469,57349,53,0,0,222,86,136,2,30,1,1
34470,49305,53,42044,53,177,94,83,2,30,1,1
34471,64743,53,57022,53,210,102,108,2,30,1,1
34472,43196,80,6981,80,3494,1589,1905,16,186,9,7
34473,6881,6881,57384,6881,238,118,120,2,1200,1,1
34474,47661,80,24519,80,2865,2000,865,12,15,7,5
34475,43440,80,5073,80,2093,825,1268,12,45,7,5
34476,54485,80,18876,80,130,70,60,2,15,1,1
34477,55061,80,17010,80,486,240,246,9,28,5,4
34478,53260,443,64697,443,6136,1916,4220,28,15,16,12
34479,57075,53,9642,53,199,94,105,2,30,1,1
34480,55077,53,49404,53,394,94,300,2,30,1,1
34481,55075,53,35995,53,181,94,87,2,30,1,1
34482,49914,53,9646,53,718,94,624,2,30,1,1
34483,44454,443,1457,443,7092,1495,5597,22,31,12,10
34484,50602,80,38980,80,1658,1247,411,8,15,5,3
34485,51682,80,11682,80,59786,3488,56298,119,55,45,74
34486,51852,80,36581,80,182,60,122,4,29,2,2
34487,51909,33509,56937,33509,70,70,0,1,5,1,0
34488,51911,14543,20500,14543,70,70,0,1,5,1,0
34489,50711,80,56692,80,708,384,324,12,195,7,5
34490,50661,443,13443,443,298067,6719,291348,307,17,98,209
34491,51450,80,49507,80,214,140,74,4,15,3,1
34492,50050,53,12626,53,253,87,166,4,51,2,2
34493,49901,53,32175,53,231,102,129,2,30,1,1
34494,64517,53,41461,53,211,102,109,2,30,1,1
34495,57225,53,63764,53,177,94,83,2,30,1,1
34496,49281,53,63913,53,251,102,149,2,30,1,1
34497,55144,443,5039,443,3522,869,2653,13,121,6,7
34498,51221,1338,12971,1338,132,132,0,3,1200,3,0
34499,49347,443,51852,443,611644,29314,582330,793,132,333,460
34500,61358,3389,61358,3389,3488,1774,1714,17,33,9,8
34501,37042,53,37042,53,237,98,139,2,30,1,1
34502,54093,5228,31167,5228,7608,1824,5784,34,171,19,15
34503,60343,443,27332,443,36547,3840,32707,88,241,43,45
34504,56641,80,60111,80,234,234,0,4,12,4,0
34505,55474,80,42098,80,25970,2371,23599,52,17,26,26
34506,63597,443,64564,443,19821,11622,8199,77,135,39,38
34507,63588,443,6782,443,11301,2292,9009,37,165,20,17
34508,63592,443,55191,443,6485,1871,4614,27,140,14,13
34509,64664,53,45386,53,250,86,164,4,33,2,2
34510,36413,443,33262,443,2064683,47545,2017138,1994,33,657,1337
34511,63583,443,3577,443,7339,2638,4701,33,167,18,15
34512,63584,443,2301,443,7146,2010,5136,34,167,18,16
34513,49001,55108,0,0,160,160,0,1,0,1,0
34514,58338,3375,0,0,60,60,0,1,0,1,0
34515,21419,23,0,0,60,60,0,1,0,1,0
34516,57538,30188,0,0,66,66,0,1,0,1,0
34517,63539,445,0,0,70,70,0,1,0,1,0
34518,63537,445,0,0,70,70,0,1,0,1,0
34519,63533,445,0,0,70,70,0,1,0,1,0
34520,58944,445,0,0,66,66,0,1,0,1,0
34521,24062,51505,0,0,146,146,0,1,0,1,0
34522,63532,445,0,0,70,70,0,1,0,1,0
34523,58939,445,0,0,66,66,0,1,0,1,0
34524,33543,44847,0,0,62,62,0,1,0,1,0
34525,53746,36237,0,0,66,66,0,1,0,1,0
34526,58671,445,0,0,70,70,0,1,0,1,0
34527,21759,51505,0,0,66,66,0,1,0,1,0
34528,9017,6881,0,0,62,62,0,1,0,1,0
34529,58936,445,0,0,66,66,0,1,0,1,0
34530,58935,445,0,0,66,66,0,1,0,1,0
34531,49001,48983,0,0,161,161,0,1,0,1,0
34532,58076,21247,0,0,66,66,0,1,0,1,0
34533,58933,445,0,0,66,66,0,1,0,1,0
34534,43578,15503,0,0,74,74,0,1,0,1,0
34535,52003,44512,0,0,66,66,0,1,0,1,0
34536,34470,57470,0,0,66,66,0,1,0,1,0
34537,62731,21247,0,0,66,66,0,1,0,1,0
34538,36400,51505,0,0,62,62,0,1,0,1,0
34539,58667,445,0,0,70,70,0,1,0,1,0
34540,61798,35440,0,0,66,66,0,1,0,1,0
34541,63529,445,0,0,70,70,0,1,0,1,0
34542,63513,445,0,0,70,70,0,1,0,1,0
34543,18423,51505,0,0,66,66,0,1,0,1,0
34544,5859,11392,0,0,66,66,0,1,0,1,0
34545,58923,445,0,0,66,66,0,1,0,1,0
34546,5894,44847,0,0,62,62,0,1,0,1,0
34547,54300,22114,0,0,62,62,0,1,0,1,0
34548,54458,64147,0,0,62,62,0,1,0,1,0
34549,40512,57470,0,0,74,74,0,1,0,1,0
34550,55874,64147,0,0,66,66,0,1,0,1,0
34551,39230,23,0,0,60,60,0,1,0,1,0
34552,39742,62413,0,0,62,62,0,1,0,1,0
34553,51262,35440,0,0,62,62,0,1,0,1,0
34554,62388,39004,0,0,62,62,0,1,0,1,0
34555,58654,445,0,0,70,70,0,1,0,1,0
34556,50086,57470,0,0,66,66,0,1,0,1,0
34557,41249,50584,0,0,66,66,0,1,0,1,0
34558,58915,445,0,0,66,66,0,1,0,1,0
34559,63504,445,0,0,70,70,0,1,0,1,0
34560,50283,49169,0,0,62,62,0,1,0,1,0
34561,41815,50265,0,0,146,146,0,1,0,1,0
34562,58651,445,0,0,70,70,0,1,0,1,0
34563,58913,445,0,0,66,66,0,1,0,1,0
34564,58085,57470,0,0,62,62,0,1,0,1,0
34565,45941,23386,0,0,60,60,0,1,0,1,0
34566,58904,445,0,0,66,66,0,1,0,1,0
34567,54779,50584,0,0,66,66,0,1,0,1,0
34568,58646,445,0,0,70,70,0,1,0,1,0
34569,58895,445,0,0,66,66,0,1,0,1,0
34570,58645,445,0,0,70,70,0,1,0,1,0
34571,60514,39004,0,0,66,66,0,1,0,1,0
34572,19617,39004,0,0,62,62,0,1,0,1,0
34573,58643,445,0,0,70,70,0,1,0,1,0
34574,443,60496,0,0,320,320,0,1,0,1,0
34575,62912,26467,0,0,62,62,0,1,0,1,0
34576,65317,51221,0,0,78,78,0,1,0,1,0
34577,2180,63710,0,0,66,66,0,1,0,1,0
34578,63494,445,0,0,70,70,0,1,0,1,0
34579,63493,445,0,0,70,70,0,1,0,1,0
34580,63492,445,0,0,70,70,0,1,0,1,0
34581,27038,63836,0,0,145,145,0,1,0,1,0
34582,58884,445,0,0,66,66,0,1,0,1,0
34583,58889,445,0,0,66,66,0,1,0,1,0
34584,58885,445,0,0,66,66,0,1,0,1,0
34585,58890,445,0,0,66,66,0,1,0,1,0
34586,58883,445,0,0,66,66,0,1,0,1,0
34587,58887,445,0,0,66,66,0,1,0,1,0
34588,58886,445,0,0,66,66,0,1,0,1,0
34589,58882,445,0,0,66,66,0,1,0,1,0
34590,62051,11392,0,0,62,62,0,1,0,1,0
34591,60351,50584,0,0,66,66,0,1,0,1,0
34592,58636,445,0,0,70,70,0,1,0,1,0
34593,43700,30188,0,0,62,62,0,1,0,1,0
34594,1057,57470,0,0,62,62,0,1,0,1,0
34595,58634,445,0,0,70,70,0,1,0,1,0
34596,58791,15503,0,0,66,66,0,1,0,1,0
34597,12644,11392,0,0,66,66,0,1,0,1,0
34598,58633,445,0,0,70,70,0,1,0,1,0
34599,58632,445,0,0,70,70,0,1,0,1,0
34600,58631,445,0,0,70,70,0,1,0,1,0
34601,51996,57470,0,0,66,66,0,1,0,1,0
34602,5222,7493,0,0,66,66,0,1,0,1,0
34603,58628,445,0,0,70,70,0,1,0,1,0
34604,58626,445,0,0,70,70,0,1,0,1,0
34605,63488,445,0,0,70,70,0,1,0,1,0
34606,63482,445,0,0,70,70,0,1,0,1,0
34607,63480,445,0,0,70,70,0,1,0,1,0
34608,63476,445,0,0,70,70,0,1,0,1,0
34609,443,48120,0,0,97,97,0,1,0,1,0
34610,35864,44847,0,0,78,78,0,1,0,1,0
34611,50674,35440,0,0,62,62,0,1,0,1,0
34612,58868,445,0,0,66,66,0,1,0,1,0
34613,58869,445,0,0,66,66,0,1,0,1,0
34614,58867,445,0,0,66,66,0,1,0,1,0
34615,80,7597,0,0,66,66,0,1,0,1,0
34616,27337,51505,0,0,66,66,0,1,0,1,0
34617,50135,50584,0,0,146,146,0,1,0,1,0
34618,58613,445,0,0,70,70,0,1,0,1,0
34619,58612,445,0,0,70,70,0,1,0,1,0
34620,58610,445,0,0,70,70,0,1,0,1,0
34621,58602,445,0,0,70,70,0,1,0,1,0
34622,58603,445,0,0,70,70,0,1,0,1,0
34623,63472,445,0,0,70,70,0,1,0,1,0
34624,63469,445,0,0,70,70,0,1,0,1,0
34625,63467,445,0,0,70,70,0,1,0,1,0
34626,63463,445,0,0,70,70,0,1,0,1,0
34627,54976,2273,0,0,60,60,0,1,0,1,0
34628,51374,30317,0,0,62,62,0,1,0,1,0
34629,53766,51505,0,0,66,66,0,1,0,1,0
34630,58591,445,0,0,70,70,0,1,0,1,0
34631,63455,445,0,0,70,70,0,1,0,1,0
34632,63453,445,0,0,70,70,0,1,0,1,0
34633,63448,445,0,0,70,70,0,1,0,1,0
34634,61766,44847,0,0,66,66,0,1,0,1,0
34635,11450,57470,0,0,66,66,0,1,0,1,0
34636,7286,44847,0,0,66,66,0,1,0,1,0
34637,9394,51505,0,0,62,62,0,1,0,1,0
34638,58858,445,0,0,66,66,0,1,0,1,0
34639,56876,30188,0,0,62,62,0,1,0,1,0
34640,58587,445,0,0,70,70,0,1,0,1,0
34641,26872,44847,0,0,62,62,0,1,0,1,0
34642,28429,23,0,0,60,60,0,1,0,1,0
34643,54984,80,56260,80,2487,680,1807,9,17,6,3
34644,53747,21698,30276,21698,320,140,180,6,7,3,3
34645,63572,443,58406,443,125798,40014,85784,276,171,125,151
34646,63059,443,42784,443,5772,3849,1923,27,270,14,13
34647,48022,5228,46270,5228,10096,2251,7845,41,3747,16,25
34648,50908,443,7886,443,124,64,60,2,15,1,1
34649,54977,80,22361,80,4259,1114,3145,12,18,8,4
34650,51430,443,37453,443,7318,1585,5733,24,50,14,10
34651,55754,53,32469,53,170,87,83,2,31,1,1
34652,21975,3389,21975,3389,3910,1805,2105,20,19,12,8
34653,53141,8595,63363,8595,70,70,0,2,8,2,0
34654,59902,443,47216,443,6196,746,5450,17,28,8,9
34655,49341,443,40823,443,484,210,274,8,135,4,4
34656,51429,443,6993,443,8804,1597,7207,25,50,14,11
34657,55304,53,64050,53,711,87,624,2,30,1,1
34658,49348,80,58488,80,2695,601,2094,14,17,7,7
34659,60339,7010,60339,7010,3322,2027,1295,16,16,9,7
34660,51905,65253,44295,65253,66,66,0,1,5,1,0
34661,54716,443,54716,443,4728,1821,2907,19,29,11,8
34662,54985,80,44594,80,2452,680,1772,9,17,6,3
34663,40599,443,4488,443,7338,2419,4919,19,23,12,7
34664,50469,80,50469,80,350722,14506,336216,459,26,231,228
34665,49350,80,17216,80,2485,529,1956,12,17,6,6
34666,58325,53,35330,53,251,79,172,2,30,1,1
34667,56358,53,16023,53,104,104,0,1,30,1,0
34668,63594,443,17345,443,7673,2645,5028,31,137,17,14
34669,50907,443,12062,443,124,64,60,2,15,1,1
34670,56856,47715,25916,47715,66,66,0,1,5,1,0
34671,49632,7000,49632,7000,1236,676,560,13,15,7,6
34672,9098,443,52183,443,6177,969,5208,17,26,9,8
34673,58888,443,13119,443,274616,12640,261976,352,28,167,185
34674,57045,53,27906,53,170,87,83,2,30,1,1
34675,30960,45737,31575,45737,330,330,0,6,3609,6,0
34676,43918,5228,35546,5228,2276,1356,920,15,3601,7,8
34677,58124,80,58124,80,125299,3364,121935,129,19,44,85
34678,63591,443,24703,443,11746,3874,7872,44,141,22,22
34679,35085,443,56294,443,1617,1062,555,13,45,8,5
34680,49012,443,59626,443,44584,2838,41746,66,31,31,35
34681,52054,80,49202,80,1682,642,1040,13,54,4,9
34682,52708,443,22649,443,10748,1634,9114,22,316,10,12
34683,55822,80,1122,80,1052,612,440,10,16,5,5
34684,56206,53,48081,53,711,87,624,2,30,1,1
34685,61581,443,25669,443,5103,2363,2740,11,120,6,5
34686,65444,3389,65444,3389,4305,2521,1784,19,34,10,9
34687,62343,443,28448,443,13709,1675,12034,25,31,11,14
34688,38576,443,42458,443,10853,8227,2626,30,360,15,15
34689,48817,47719,48817,47719,1837,852,985,8,1200,4,4
34690,32609,64097,0,0,62,62,0,1,0,1,0
34691,58578,445,0,0,70,70,0,1,0,1,0
34692,58577,445,0,0,70,70,0,1,0,1,0
34693,58576,445,0,0,70,70,0,1,0,1,0
34694,35408,56205,0,0,66,66,0,1,0,1,0
34695,58574,445,0,0,70,70,0,1,0,1,0
34696,39098,51505,0,0,146,146,0,1,0,1,0
34697,58570,445,0,0,70,70,0,1,0,1,0
34698,48857,50584,0,0,66,66,0,1,0,1,0
34699,63446,445,0,0,70,70,0,1,0,1,0
34700,63443,445,0,0,70,70,0,1,0,1,0
34701,58869,57470,0,0,145,145,0,1,0,1,0
34702,53321,443,65410,443,416,210,206,7,28,4,3
34703,35775,443,51834,443,6665,3913,2752,33,98,19,14
34704,63599,443,32617,443,10050,1802,8248,30,39,16,14
34705,58976,43890,0,0,62,62,0,1,0,1,0
34706,58843,445,0,0,66,66,0,1,0,1,0
34707,58839,445,0,0,66,66,0,1,0,1,0
34708,10477,44847,0,0,66,66,0,1,0,1,0
34709,13917,18033,0,0,62,62,0,1,0,1,0
34710,58565,445,0,0,70,70,0,1,0,1,0
34711,63433,445,0,0,70,70,0,1,0,1,0
34712,2691,64147,0,0,62,62,0,1,0,1,0
34713,63427,445,0,0,70,70,0,1,0,1,0
34714,63425,445,0,0,70,70,0,1,0,1,0
34715,63424,445,0,0,70,70,0,1,0,1,0
34716,54552,64147,0,0,62,62,0,1,0,1,0
34717,39920,22114,0,0,62,62,0,1,0,1,0
34718,58835,445,0,0,66,66,0,1,0,1,0
34719,10243,36237,0,0,62,62,0,1,0,1,0
34720,58555,445,0,0,70,70,0,1,0,1,0
34721,53656,31573,0,0,62,62,0,1,0,1,0
34722,48420,31755,0,0,146,146,0,1,0,1,0
34723,58827,445,0,0,66,66,0,1,0,1,0
34724,58825,445,0,0,66,66,0,1,0,1,0
34725,58818,445,0,0,66,66,0,1,0,1,0
34726,58830,445,0,0,66,66,0,1,0,1,0
34727,58826,445,0,0,66,66,0,1,0,1,0
34728,58819,445,0,0,66,66,0,1,0,1,0
34729,58829,445,0,0,66,66,0,1,0,1,0
34730,58553,445,0,0,70,70,0,1,0,1,0
34731,62514,37807,0,0,66,66,0,1,0,1,0
34732,1025,51221,0,0,62,62,0,1,0,1,0
34733,57260,51221,0,0,66,66,0,1,0,1,0
34734,63419,445,0,0,70,70,0,1,0,1,0
34735,63417,445,0,0,70,70,0,1,0,1,0
34736,63416,445,0,0,70,70,0,1,0,1,0
34737,63413,445,0,0,70,70,0,1,0,1,0
34738,43350,58414,0,0,62,62,0,1,0,1,0
34739,58549,445,0,0,70,70,0,1,0,1,0
34740,41734,57470,0,0,62,62,0,1,0,1,0
34741,58547,445,0,0,70,70,0,1,0,1,0
34742,14036,48817,0,0,66,66,0,1,0,1,0
34743,15465,64147,0,0,66,66,0,1,0,1,0
34744,6881,6881,0,0,146,146,0,1,0,1,0
34745,53044,36237,0,0,66,66,0,1,0,1,0
34746,3549,64147,0,0,62,62,0,1,0,1,0
34747,62131,50584,0,0,66,66,0,1,0,1,0
34748,48420,26672,0,0,146,146,0,1,0,1,0
34749,58543,445,0,0,70,70,0,1,0,1,0
34750,63411,445,0,0,70,70,0,1,0,1,0
34751,63409,445,0,0,70,70,0,1,0,1,0
34752,63405,445,0,0,70,70,0,1,0,1,0
34753,63598,443,20938,443,164604,5676,158928,188,39,70,118
34754,59898,443,27640,443,1265,684,581,13,30,6,7
34755,60121,443,30083,443,6351,1857,4494,20,16,11,9
34756,49343,443,10308,443,1556,769,787,17,134,9,8
34757,55675,53,34777,53,287,91,196,4,60,2,2
34758,37965,29299,52257,29299,858,858,0,14,1199,14,0
34759,58883,443,6061,443,5476,3102,2374,42,132,23,19
34760,53258,443,34531,443,5916,1774,4142,25,15,14,11
34761,49885,7000,49885,7000,3132,815,2317,14,15,7,7
34762,50470,80,50470,80,2144,900,1244,11,26,7,4
34763,57556,443,56704,443,162,102,60,2,5,1,1
34764,49346,443,21624,443,4312,2524,1788,34,132,19,15
34765,61802,443,61802,443,4521,1614,2907,19,26,11,8
34766,64274,53,5372,53,197,102,95,2,32,1,1
34767,51928,52520,20049,52520,258,70,188,4,8,2,2
34768,38446,443,2799,443,46008,3750,42258,77,48,39,38
34769,49305,53,59053,53,177,94,83,2,29,1,1
34770,65126,443,41319,443,958,384,574,14,34,7,7
34771,60911,53,23878,53,335,78,257,2,29,1,1
34772,57045,53,5353,53,177,94,83,2,29,1,1
34773,65250,53,12810,53,900,110,790,2,30,1,1
34774,49817,53,29101,53,401,91,310,4,29,2,2
34775,63596,443,27876,443,8104,2201,5903,28,135,15,13
34776,58870,443,14754,443,7415,2363,5052,17,120,9,8
34777,56301,53,2529,53,177,94,83,2,30,1,1
34778,50245,443,54814,443,6866,1958,4908,21,20,13,8
34779,60444,47094,7095,47094,320,140,180,6,7,3,3
34780,38427,443,30130,443,12591,2902,9689,40,55,19,21
34781,49383,53,44225,53,94,94,0,1,30,1,0
34782,34489,443,45344,443,8363,1573,6790,24,49,14,10
34783,60791,443,31785,443,15013,10159,4854,34,46,19,15
34784,63887,80,15748,80,314,192,122,6,15,4,2
34785,60126,443,24609,443,3015,2086,929,16,15,9,7
34786,60775,40010,2313,40010,316,136,180,6,6,3,3
34787,46764,443,46764,443,4401,1494,2907,19,29,11,8
34788,30201,53,30201,53,235,90,145,2,33,1,1
34789,42615,443,10393,443,117381,60398,56983,518,4126,256,262
34790,51929,53371,7224,53371,70,70,0,2,8,2,0
34791,9099,443,46908,443,6677,1097,5580,21,25,11,10
34792,56358,53,42887,53,210,110,100,2,33,1,1
34793,59464,443,49741,443,7333,1933,5400,27,16,15,12
34794,56913,53,62016,53,247,94,153,2,30,1,1
34795,49438,443,56148,443,180,60,120,4,15,2,2
34796,58037,80,32783,80,2339,1122,1217,11,20,6,5
34797,57045,53,16294,53,177,94,83,2,30,1,1
34798,34424,53,34424,53,235,90,145,2,33,1,1
34799,38445,443,60732,443,23571,4700,18871,60,48,30,30
34800,64814,53,63374,53,212,102,110,2,30,1,1
34801,44009,443,15754,443,1392,731,661,14,80,8,6
34802,57243,53,28936,53,168,78,90,2,30,1,1
34803,38425,443,45581,443,103112,8212,94900,165,55,80,85
34804,9152,443,16352,443,15550,1508,14042,28,19,13,15
34805,42727,53,0,0,82,82,0,2,40,2,0
34806,60476,80,59400,80,613,539,74,7,15,6,1
34807,47504,443,4278,443,6496,3631,2865,71,606,39,32
34808,50873,443,51953,443,350,210,140,6,26,4,2
34809,56283,53,17978,53,315,102,213,2,30,1,1
34810,64809,53,47769,53,312,78,234,2,30,1,1
34811,50662,443,44987,443,3306,1714,1592,17,16,9,8
34812,51927,63309,55046,63309,70,70,0,2,8,2,0
34813,52539,80,47321,80,1152,712,440,10,15,5,5
34814,50061,80,3362,80,405,285,120,5,15,3,2
34815,54350,443,24025,443,10318,2117,8201,38,371,19,19
34816,49839,53,21176,53,315,102,213,2,30,1,1
34817,56222,53,43289,53,168,78,90,2,30,1,1
34818,65409,53,62247,53,200,94,106,2,30,1,1
34819,51595,443,19980,443,632,158,474,2,30,1,1
34820,58362,53,30634,53,167,78,89,2,30,1,1
34821,40994,443,58076,443,1396,735,661,14,80,8,6
34822,49348,443,47501,443,2879984,113967,2766017,3396,129,1423,1973
34823,51417,443,60924,443,25865,7151,18714,36,15,19,17
34824,56706,80,18045,80,214,140,74,4,25,3,1
34825,14436,443,7159,443,2601,1455,1146,18,15,8,10
34826,51906,17491,7245,17491,70,70,0,1,5,1,0
34827,46812,80,23325,80,1137,679,458,10,15,6,4
34828,51892,80,28935,80,15867,8841,7026,29,26,16,13
34829,53739,27290,11218,27290,70,70,0,2,7,2,0
34830,53741,43800,53441,43800,70,70,0,2,7,2,0
34831,34487,443,45811,443,8363,1573,6790,24,49,14,10
34832,53256,443,33815,443,6185,1994,4191,27,16,16,11
34833,38448,443,13312,443,18512,3109,15403,45,48,22,23
34834,43094,443,34606,443,6443,1973,4470,19,16,11,8
34835,48340,443,49643,443,18198,13269,4929,47,324,20,27
34836,58052,80,61267,80,1550,853,697,9,15,5,4
34837,56478,53,6625,53,177,94,83,2,29,1,1
34838,56007,53,24693,53,197,102,95,2,35,1,1
34839,56478,53,29572,53,177,94,83,2,29,1,1
34840,34488,443,33891,443,8363,1573,6790,24,49,14,10
34841,55754,53,35474,53,177,94,83,2,30,1,1
34842,53678,443,40421,443,6697,1606,5091,23,24,13,10
34843,64082,53,61850,53,329,102,227,2,30,1,1
34844,53708,23280,6417,23280,1903,968,935,16,16,9,7
34845,49266,53,8623,53,86,86,0,1,30,1,0
34846,57546,443,50936,443,34428,22220,12208,84,122,41,43
34847,63595,443,51163,443,8062,2186,5876,29,136,15,14
34848,53706,59208,42614,59208,164,70,94,2,8,1,1
34849,60792,443,58920,443,5037,1343,3694,18,45,11,7
34850,51538,443,28169,443,6384,1899,4485,16,75,9,7
34851,51894,80,51074,80,7434,3830,3604,17,26,9,8
34852,60367,443,5802,443,12979,6398,6581,39,115,22,17
34853,55754,53,39478,53,177,94,83,2,30,1,1
34854,60166,443,54772,443,7639,2673,4966,36,255,17,19
34855,38447,443,18020,443,9824,2902,6922,38,48,19,19
34856,56833,28571,3493,28571,5436,3022,2414,17,32,11,6
34857,58364,53,50367,53,167,78,89,2,30,1,1
34858,58363,53,45299,53,167,78,89,2,30,1,1
34859,56852,443,47368,443,8215,2882,5333,32,90,16,16
34860,53707,44209,9971,44209,1513,989,524,17,16,10,7
34861,42204,443,21062,443,6197,942,5255,19,361,10,9
34862,60864,5223,16379,5223,194,134,60,2,5,1,1
34863,38685,443,17432,443,749731,23099,726632,823,16,326,497
34864,39851,443,44930,443,9355,3422,5933,56,16,28,28
34865,64731,53,43372,53,241,110,131,2,30,1,1
34866,64723,53,15149,53,229,110,119,2,30,1,1
34867,52720,443,21173,443,11732,4753,6979,41,397,17,24
34868,42203,443,25522,443,6345,1024,5321,21,361,11,10
34869,42202,443,2028,443,6610,1106,5504,23,361,12,11
34870,53460,443,49234,443,6118,5698,420,12,124,6,6
34871,55704,53,8827,53,177,94,83,2,31,1,1
34872,60123,443,13855,443,6485,1957,4528,22,16,11,11
34873,50566,443,28525,443,7367,1149,6218,18,27,9,9
34874,49477,53,44035,53,168,78,90,2,30,1,1
34875,65350,53,62383,53,168,86,82,2,30,1,1
34876,65350,53,48988,53,168,86,82,2,30,1,1
34877,38684,443,33741,443,90449,3289,87160,93,16,28,65
34878,56388,53,23027,53,186,95,91,3,34,2,1
34879,45726,443,40256,443,130,70,60,3,6,2,1
34880,50284,443,28484,443,208,60,148,4,12,2,2
34881,38687,443,37401,443,13923,1728,12195,24,16,10,14
34882,37264,443,41734,443,130,70,60,3,5,2,1
34883,63888,6881,45286,6881,70,70,0,1,5,1,0
34884,50565,443,52646,443,1313,876,437,11,27,6,5
34885,50562,443,27211,443,1313,876,437,11,27,6,5
34886,55761,53,38695,53,168,78,90,2,30,1,1
34887,58665,53,16877,53,260,86,174,2,30,1,1
34888,55704,53,43154,53,177,94,83,2,30,1,1
34889,64179,53,19210,53,212,102,110,2,30,1,1
34890,65350,53,48602,53,168,86,82,2,31,1,1
34891,58813,445,0,0,66,66,0,1,0,1,0
34892,58542,445,0,0,70,70,0,1,0,1,0
34893,56883,22114,0,0,62,62,0,1,0,1,0
34894,63404,445,0,0,70,70,0,1,0,1,0
34895,58809,445,0,0,66,66,0,1,0,1,0
34896,63342,53,0,0,72,72,0,1,0,1,0
34897,58808,445,0,0,66,66,0,1,0,1,0
34898,58807,445,0,0,66,66,0,1,0,1,0
34899,37837,37965,0,0,62,62,0,1,0,1,0
34900,58805,445,0,0,66,66,0,1,0,1,0
34901,1038,37965,0,0,62,62,0,1,0,1,0
34902,26085,10387,0,0,148,148,0,1,0,1,0
34903,41840,50584,0,0,66,66,0,1,0,1,0
34904,56101,57470,0,0,66,66,0,1,0,1,0
34905,58537,445,0,0,70,70,0,1,0,1,0
34906,4438,23,0,0,60,60,0,1,0,1,0
34907,63399,445,0,0,70,70,0,1,0,1,0
34908,5688,44847,0,0,62,62,0,1,0,1,0
34909,63390,445,0,0,70,70,0,1,0,1,0
34910,63391,445,0,0,70,70,0,1,0,1,0
34911,52711,37965,0,0,62,62,0,1,0,1,0
34912,52925,3389,0,0,60,60,0,1,0,1,0
34913,58793,445,0,0,66,66,0,1,0,1,0
34914,51646,37965,0,0,62,62,0,1,0,1,0
34915,39730,17372,0,0,66,66,0,1,0,1,0
34916,58524,445,0,0,70,70,0,1,0,1,0
34917,58786,445,0,0,66,66,0,1,0,1,0
34918,63376,445,0,0,70,70,0,1,0,1,0
34919,50106,31573,0,0,66,66,0,1,0,1,0
34920,58521,445,0,0,70,70,0,1,0,1,0
34921,25453,35776,0,0,145,145,0,1,0,1,0
34922,58784,445,0,0,66,66,0,1,0,1,0
34923,50675,56205,0,0,66,66,0,1,0,1,0
34924,56494,15503,0,0,146,146,0,1,0,1,0
34925,52914,37965,0,0,66,66,0,1,0,1,0
34926,24731,51505,0,0,62,62,0,1,0,1,0
34927,58516,445,0,0,70,70,0,1,0,1,0
34928,52537,37965,0,0,62,62,0,1,0,1,0
34929,9506,2323,0,0,60,60,0,1,0,1,0
34930,58515,445,0,0,70,70,0,1,0,1,0
34931,58775,445,0,0,66,66,0,1,0,1,0
34932,41756,56205,0,0,62,62,0,1,0,1,0
34933,58773,445,0,0,66,66,0,1,0,1,0
34934,58513,445,0,0,70,70,0,1,0,1,0
34935,64438,23,0,0,60,60,0,1,0,1,0
34936,39324,64147,0,0,62,62,0,1,0,1,0
34937,63027,35440,0,0,62,62,0,1,0,1,0
34938,63367,445,0,0,70,70,0,1,0,1,0
34939,63365,445,0,0,70,70,0,1,0,1,0
34940,63364,445,0,0,70,70,0,1,0,1,0
34941,58506,445,0,0,70,70,0,1,0,1,0
34942,58758,445,0,0,66,66,0,1,0,1,0
34943,58760,445,0,0,66,66,0,1,0,1,0
34944,58755,445,0,0,66,66,0,1,0,1,0
34945,58761,445,0,0,66,66,0,1,0,1,0
34946,58756,445,0,0,66,66,0,1,0,1,0
34947,58759,445,0,0,66,66,0,1,0,1,0
34948,58754,445,0,0,66,66,0,1,0,1,0
34949,58753,445,0,0,66,66,0,1,0,1,0
34950,43724,35440,0,0,146,146,0,1,0,1,0
34951,443,60496,0,0,320,320,0,1,0,1,0
34952,59147,51505,0,0,62,62,0,1,0,1,0
34953,58504,445,0,0,70,70,0,1,0,1,0
34954,12031,36237,0,0,66,66,0,1,0,1,0
34955,52650,44847,0,0,66,66,0,1,0,1,0
34956,16377,21247,0,0,62,62,0,1,0,1,0
34957,58686,18375,0,0,66,66,0,1,0,1,0
34958,40005,36237,0,0,62,62,0,1,0,1,0
34959,58503,445,0,0,70,70,0,1,0,1,0
34960,58502,445,0,0,70,70,0,1,0,1,0
34961,58501,445,0,0,70,70,0,1,0,1,0
34962,58497,445,0,0,70,70,0,1,0,1,0
34963,58499,445,0,0,70,70,0,1,0,1,0
34964,59095,57470,0,0,66,66,0,1,0,1,0
34965,43129,15503,0,0,62,62,0,1,0,1,0
34966,61008,5555,0,0,60,60,0,1,0,1,0
34967,61147,22114,0,0,62,62,0,1,0,1,0
34968,56186,57470,0,0,62,62,0,1,0,1,0
34969,23900,64147,0,0,62,62,0,1,0,1,0
34970,1054,57470,0,0,62,62,0,1,0,1,0
34971,63360,445,0,0,70,70,0,1,0,1,0
34972,63358,445,0,0,70,70,0,1,0,1,0
34973,63352,445,0,0,70,70,0,1,0,1,0
34974,63348,445,0,0,70,70,0,1,0,1,0
34975,57368,7302,0,0,66,66,0,1,0,1,0
34976,51300,64147,0,0,62,62,0,1,0,1,0
34977,61744,11392,0,0,66,66,0,1,0,1,0
34978,58483,445,0,0,70,70,0,1,0,1,0
34979,58741,445,0,0,66,66,0,1,0,1,0
34980,58739,445,0,0,66,66,0,1,0,1,0
34981,58738,445,0,0,66,66,0,1,0,1,0
34982,58482,445,0,0,70,70,0,1,0,1,0
34983,58476,445,0,0,70,70,0,1,0,1,0
34984,64237,51505,0,0,66,66,0,1,0,1,0
34985,58472,445,0,0,70,70,0,1,0,1,0
34986,58473,445,0,0,70,70,0,1,0,1,0
34987,51320,37965,0,0,62,62,0,1,0,1,0
34988,63527,50584,0,0,66,66,0,1,0,1,0
34989,51185,37965,0,0,62,62,0,1,0,1,0
34990,65012,2767,0,0,66,66,0,1,0,1,0
34991,14023,37965,0,0,62,62,0,1,0,1,0
34992,59985,57470,0,0,62,62,0,1,0,1,0
34993,63344,445,0,0,70,70,0,1,0,1,0
34994,64586,50584,0,0,62,62,0,1,0,1,0
34995,63343,445,0,0,70,70,0,1,0,1,0
34996,63339,445,0,0,70,70,0,1,0,1,0
34997,63334,445,0,0,70,70,0,1,0,1,0
34998,35261,15503,0,0,74,74,0,1,0,1,0
34999,13445,44847,0,0,66,66,0,1,0,1,0
35000,24281,23,0,0,60,60,0,1,0,1,0
35001,1024,44847,0,0,62,62,0,1,0,1,0
35002,10669,49756,0,0,60,60,0,1,0,1,0
35003,58461,445,0,0,70,70,0,1,0,1,0
35004,10669,49756,0,0,60,60,0,1,0,1,0
35005,10669,49756,0,0,60,60,0,1,0,1,0
35006,10669,49756,0,0,60,60,0,1,0,1,0
35007,10669,49756,0,0,60,60,0,1,0,1,0
35008,8889,9806,0,0,60,60,0,1,0,1,0
35009,57020,36237,0,0,62,62,0,1,0,1,0
35010,55009,1114,14128,1114,6562,1873,4689,25,16,15,10
35011,53737,51456,15956,51456,70,70,0,2,8,2,0
35012,443,6793,0,0,169,169,0,2,90,2,0
35013,55704,53,24414,53,170,87,83,2,30,1,1
35014,50561,80,19741,80,318,192,126,6,26,4,2
35015,50573,80,11289,80,318,192,126,6,26,4,2
35016,51231,443,6800,443,63550,10766,52784,98,131,43,55
35017,29011,7000,29011,7000,3756,2125,1631,18,17,10,8
35018,64274,53,57250,53,104,104,0,2,35,2,0
35019,50571,80,62731,80,318,192,126,6,26,4,2
35020,54034,443,22227,443,43491,8521,34970,69,50,34,35
35021,41390,443,29292,443,7240,2035,5205,25,316,12,13
35022,65350,53,19451,53,75,75,0,1,30,1,0
35023,8531,53,8531,53,213,87,126,2,30,1,1
35024,50559,80,62420,80,318,192,126,6,26,4,2
35025,29746,53,29746,53,235,90,145,2,32,1,1
35026,55517,443,55517,443,274414,45529,228885,359,170,186,173
35027,56810,53,59842,53,751,95,656,2,30,1,1
35028,37134,53,0,0,82,82,0,1,30,1,0
35029,52049,443,18143,443,7710,2476,5234,18,135,8,10
35030,6825,53,6825,53,217,87,130,2,30,1,1
35031,50254,53,7590,53,749,94,655,2,30,1,1
35032,64379,53,64379,53,235,90,145,2,33,1,1
35033,53732,22704,63994,22704,70,70,0,2,8,2,0
35034,57634,5228,55639,5228,165,105,60,2,5,1,1
35035,4083,443,26942,443,2227,1018,1209,17,16,8,9
35036,38674,80,36626,80,1114,534,580,12,16,7,5
35037,56721,53,12920,53,711,87,624,2,30,1,1
35038,47733,443,46776,443,556154,55291,500863,1146,559,440,706
35039,64603,34021,0,0,66,66,0,1,90,1,0
35040,55721,53,57546,53,170,87,83,2,31,1,1
35041,45499,443,58024,443,17031,8260,8771,39,128,19,20
35042,50572,80,10361,80,318,192,126,6,26,4,2
35043,60338,7000,60338,7000,3486,1983,1503,15,16,8,7
35044,60380,443,8139,443,70,70,0,2,8,2,0
35045,50570,80,64078,80,318,192,126,6,26,4,2
35046,40474,1488,40474,1488,156,156,0,3,8,3,0
35047,50568,80,17182,80,318,192,126,6,26,4,2
35048,50569,80,5164,80,318,192,126,6,26,4,2
35049,53137,35111,32550,35111,70,70,0,1,5,1,0
35050,50560,80,54497,80,318,192,126,6,26,4,2
35051,60930,443,60930,443,16379,2214,14165,39,18,20,19
35052,54455,443,54455,443,324001,46592,277409,409,177,203,206
35053,35061,80,46318,80,15651782,355118,15296664,15172,45,5065,10107
35054,57051,53,59033,53,711,87,624,2,30,1,1
35055,40204,40028,12239,40028,143,81,62,2,30,1,1
35056,38834,53,64506,53,168,78,90,2,30,1,1
35057,55094,53,26727,53,754,94,660,2,31,1,1
35058,56559,53,54246,53,711,87,624,2,31,1,1
35059,62293,53,18482,53,232,88,144,2,31,1,1
35060,47119,5228,18356,5228,3630,2427,1203,21,3601,11,10
35061,61938,443,24031,443,3663,1097,2566,13,136,6,7
35062,47564,5900,0,0,60,60,0,1,0,1,0
35063,10933,23,0,0,60,60,0,1,0,1,0
35064,39617,50584,0,0,62,62,0,1,0,1,0
35065,42044,60043,0,0,62,62,0,1,0,1,0
35066,16382,17500,0,0,62,62,0,1,0,1,0
35067,63325,445,0,0,70,70,0,1,0,1,0
35068,63324,445,0,0,70,70,0,1,0,1,0
35069,63322,445,0,0,70,70,0,1,0,1,0
35070,21502,44847,0,0,66,66,0,1,0,1,0
35071,58457,445,0,0,70,70,0,1,0,1,0
35072,58728,445,0,0,66,66,0,1,0,1,0
35073,47944,50584,0,0,146,146,0,1,0,1,0
35074,7226,50584,0,0,146,146,0,1,0,1,0
35075,27160,64147,0,0,66,66,0,1,0,1,0
35076,58447,445,0,0,70,70,0,1,0,1,0
35077,58446,445,0,0,70,70,0,1,0,1,0
35078,58444,445,0,0,70,70,0,1,0,1,0
35079,58443,445,0,0,70,70,0,1,0,1,0
35080,58439,445,0,0,70,70,0,1,0,1,0
35081,30135,37965,0,0,66,66,0,1,0,1,0
35082,31727,57470,0,0,62,62,0,1,0,1,0
35083,61419,57470,0,0,66,66,0,1,0,1,0
35084,59948,22114,0,0,146,146,0,1,0,1,0
35085,61451,17500,0,0,66,66,0,1,0,1,0
35086,26889,50265,0,0,66,66,0,1,0,1,0
35087,57706,64147,0,0,66,66,0,1,0,1,0
35088,61033,39004,0,0,66,66,0,1,0,1,0
35089,63318,445,0,0,70,70,0,1,0,1,0
35090,63316,445,0,0,70,70,0,1,0,1,0
35091,28009,36237,0,0,62,62,0,1,0,1,0
35092,61522,64147,0,0,62,62,0,1,0,1,0
35093,38637,22,0,0,60,60,0,1,0,1,0
35094,64824,37965,0,0,62,62,0,1,0,1,0
35095,37260,21247,0,0,66,66,0,1,0,1,0
35096,58713,445,0,0,66,66,0,1,0,1,0
35097,58710,445,0,0,66,66,0,1,0,1,0
35098,49128,18593,0,0,157,157,0,1,0,1,0
35099,58434,445,0,0,70,70,0,1,0,1,0
35100,61323,23117,0,0,146,146,0,1,0,1,0
35101,48706,23393,0,0,60,60,0,1,0,1,0
35102,63305,445,0,0,70,70,0,1,0,1,0
35103,63301,445,0,0,70,70,0,1,0,1,0
35104,49159,53,5839,53,195,86,109,2,30,1,1
35105,34642,53,34642,53,220,90,130,2,30,1,1
35106,56905,53,61024,53,239,110,129,2,30,1,1
35107,50600,80,53751,80,1658,1247,411,8,15,5,3
35108,49354,443,37956,443,22643,7456,15187,32,15,17,15
35109,56301,53,31707,53,177,94,83,2,29,1,1
35110,65171,53,52756,53,194,94,100,2,29,1,1
35111,42642,443,27903,443,6826,1804,5022,21,137,11,10
35112,50567,443,48889,443,7367,1149,6218,18,26,9,9
35113,50591,80,63944,80,318,192,126,6,25,4,2
35114,50563,443,65476,443,1313,876,437,11,26,6,5
35115,41033,443,54265,443,4974,2311,2663,29,79,15,14
35116,9137,80,35596,80,908,842,66,7,18,6,1
35117,52730,7000,52730,7000,2163,676,1487,14,15,7,7
35118,50564,443,57456,443,1313,876,437,11,26,6,5
35119,53744,10030,43880,10030,320,140,180,6,5,3,3
35120,42295,443,63348,443,9164,2473,6691,22,17,13,9
35121,53252,443,50911,443,6899,2368,4531,27,27,14,13
35122,53088,443,43774,443,161938,137946,23992,412,384,227,185
35123,57433,443,58515,443,11243,4236,7007,47,15,22,25
35124,53733,40599,57099,40599,70,70,0,2,7,2,0
35125,35292,8100,45355,8100,78,78,0,1,4,1,0
35126,50700,80,35384,80,142,142,0,1,4,1,0
35127,59470,53,45081,53,184,86,98,2,29,1,1
35128,49250,53,39996,53,225,110,115,2,29,1,1
35129,55704,53,10411,53,177,94,83,2,31,1,1
35130,40204,40002,65519,40002,148,86,62,2,30,1,1
35131,56356,53,26889,53,277,118,159,2,30,1,1
35132,57470,39113,45501,39113,14689,8867,5822,93,3051,67,26
35133,49715,53,39049,53,807,94,713,2,30,1,1
35134,50556,80,38454,80,378,192,186,7,26,4,3
35135,56854,17067,27330,17067,70,70,0,1,5,1,0
35136,47821,443,31829,443,71624,60795,10829,194,131,110,84
35137,42578,443,53109,443,3857,2757,1100,27,22,14,13
35138,58029,80,1723,80,374,192,182,7,21,4,3
35139,55457,53,12461,53,177,94,83,2,30,1,1
35140,65104,53,46686,53,311,94,217,2,30,1,1
35141,56726,53,58672,53,223,102,121,2,30,1,1
35142,55457,53,25879,53,177,94,83,2,30,1,1
35143,50557,80,9717,80,318,192,126,6,26,4,2
35144,64364,53,34718,53,323,110,213,2,30,1,1
35145,57270,53,35020,53,211,102,109,2,30,1,1
35146,51925,29587,42996,29587,70,70,0,2,8,2,0
35147,49487,53,45596,53,267,102,165,2,30,1,1
35148,50577,80,17204,80,2350,896,1454,13,25,7,6
35149,65489,443,61860,443,92240,4799,87441,107,16,43,64
35150,54985,53,45907,53,177,94,83,2,30,1,1
35151,55280,53,18692,53,258,110,148,2,30,1,1
35152,65490,443,45608,443,405489,12010,393479,416,16,146,270
35153,51195,123,46436,123,184,94,90,2,30,1,1
35154,52426,443,50838,443,782,428,354,12,28,7,5
35155,50575,80,13060,80,318,192,126,6,25,4,2
35156,50555,80,24136,80,318,192,126,6,26,4,2
35157,53648,31637,13598,31637,744,618,126,10,28,8,2
35158,43093,443,25301,443,7028,2558,4470,19,16,11,8
35159,62335,443,30924,443,73341,3336,70005,85,48,27,58
35160,41371,53,41371,53,220,90,130,2,30,1,1
35161,56613,53,57106,53,307,134,173,2,30,1,1
35162,54985,53,30088,53,177,94,83,2,30,1,1
35163,57195,53,47926,53,195,102,93,2,33,1,1
35164,41639,8080,18114,8080,78,78,0,2,8,2,0
35165,34782,443,56417,443,15321,1796,13525,26,326,11,15
35166,64838,53,23821,53,338,110,228,2,30,1,1
35167,57201,53,57201,53,220,90,130,2,30,1,1
35168,60186,53,47856,53,199,94,105,2,30,1,1
35169,50552,53,38940,53,164,78,86,2,30,1,1
35170,49195,53,13959,53,239,110,129,2,30,1,1
35171,55721,53,26269,53,177,94,83,2,30,1,1
35172,49606,53,17957,53,258,110,148,2,30,1,1
35173,57340,53,43547,53,370,94,276,2,30,1,1
35174,30188,39920,5702,39920,501,150,351,2,1200,1,1
35175,49272,53,30273,53,168,86,82,2,31,1,1
35176,53232,443,40771,443,69742,34581,35161,105,63,52,53
35177,57556,443,34647,443,7087,2587,4500,21,30,12,9
35178,33825,443,12586,443,15400,12233,3167,75,995,38,37
35179,47140,443,13289,443,7669,3355,4314,33,38,19,14
35180,50545,443,13694,443,10127,1872,8255,26,27,13,13
35181,55247,443,30780,443,9656,3460,6196,22,46,12,10
35182,50550,80,15717,80,374,192,182,7,26,4,3
35183,58512,5222,4015,5222,2834,1238,1596,26,34,13,13
35184,43837,443,18055,443,5733,1543,4190,24,28,13,11
35185,50551,80,44425,80,374,192,182,7,26,4,3
35186,49863,8100,10467,8100,78,78,0,1,4,1,0
35187,51924,28016,24796,28016,70,70,0,2,8,2,0
35188,53735,58869,2598,58869,70,70,0,2,7,2,0
35189,56724,443,8554,443,14956,2081,12875,30,20,16,14
35190,44062,443,39025,443,4614,853,3761,16,127,9,7
35191,53734,22051,59968,22051,70,70,0,2,7,2,0
35192,50261,443,64119,443,10320,3495,6825,45,136,25,20
35193,53736,37168,47120,37168,70,70,0,2,7,2,0
35194,51903,35904,40844,35904,70,70,0,1,5,1,0
35195,57436,53,11754,53,728,102,626,2,29,1,1
35196,64807,53,32139,53,246,118,128,2,29,1,1
35197,37936,443,26226,443,5463,1378,4085,16,145,10,6
35198,55754,53,48167,53,177,94,83,2,29,1,1
35199,58666,53,17306,53,167,78,89,2,29,1,1
35200,58026,80,26240,80,454,262,192,8,21,5,3
35201,59181,53,28620,53,260,86,174,2,29,1,1
35202,49962,53,32122,53,402,118,284,2,30,1,1
35203,52858,443,52858,443,313243,267937,45306,456,5925,210,246
35204,53986,443,26855,443,6734,2264,4470,19,16,11,8
35205,56682,53,9242,53,196,86,110,2,30,1,1
35206,58860,53,53609,53,209,102,107,2,29,1,1
35207,64510,53,63517,53,280,118,162,2,29,1,1
35208,60053,53,50009,53,199,94,105,2,30,1,1
35209,44921,53,22635,53,168,78,90,2,30,1,1
35210,56786,443,47874,443,36203,1763,34440,46,119,17,29
35211,52050,443,62804,443,9896,3586,6310,27,134,13,14
35212,56185,443,34268,443,5415,1730,3685,20,120,9,11
35213,3304,80,1558,80,2340,1419,921,10,15,5,5
35214,51926,58664,36241,58664,70,70,0,2,8,2,0
35215,49345,443,62638,443,26156,6762,19394,37,16,16,21
35216,50194,443,13497,443,50338,5239,45099,54,165,19,35
35217,56682,53,37640,53,168,86,82,2,30,1,1
35218,37840,53,37840,53,216,90,126,2,30,1,1
35219,38515,443,54100,443,12624,5203,7421,48,274,24,24
35220,40204,40027,54251,40027,245,182,63,2,30,1,1
35221,55721,53,41720,53,177,94,83,2,30,1,1
35222,57309,53,41723,53,316,110,206,2,30,1,1
35223,49715,53,16817,53,184,94,90,2,30,1,1
35224,6333,53,6333,53,216,90,126,2,30,1,1
35225,55475,443,50971,443,8714,1456,7258,25,32,13,12
35226,39154,80,25294,80,1504,926,578,15,36,9,6
35227,50540,80,53400,80,2175,1539,636,13,27,8,5
35228,50582,443,54824,443,7453,1467,5986,19,25,10,9
35229,50553,80,13843,80,378,192,186,7,26,4,3
35230,50554,80,7103,80,378,192,186,7,26,4,3
35231,50558,80,10581,80,318,192,126,6,26,4,2
35232,51904,51883,50262,51883,70,70,0,1,5,1,0
35233,65003,53,32396,53,94,94,0,1,30,1,0
35234,57195,53,17608,53,195,102,93,2,30,1,1
35235,53105,53,53105,53,216,90,126,2,30,1,1
35236,65509,53,55791,53,321,102,219,2,30,1,1
35237,47625,53,55385,53,168,78,90,2,30,1,1
35238,36194,443,29201,443,5674,1556,4118,23,271,13,10
35239,50574,80,28738,80,318,192,126,6,25,4,2
35240,64430,53,25685,53,245,118,127,2,30,1,1
35241,6929,53,6929,53,197,90,107,2,30,1,1
35242,64913,53,34114,53,211,102,109,2,30,1,1
35243,60873,443,46332,443,4265,1678,2587,21,142,10,11
35244,15503,63684,7728,63684,481,150,331,2,1200,1,1
35245,60355,443,30669,443,5341,2434,2907,19,135,9,10
35246,34912,443,42889,443,36366,2297,34069,51,139,21,30
35247,6882,9220,16555,9220,654,150,504,3,1200,1,2
35248,44847,30066,30079,30066,150,150,0,1,1200,1,0
35249,45423,80,20264,80,2259,1830,429,11,150,6,5
35250,61886,443,1075,443,8829,3335,5494,16,126,9,7
35251,55286,53,26564,53,268,87,181,4,35,2,2
35252,63899,62015,4677,62015,66,66,0,2,8,2,0
35253,56914,53,35890,53,100,100,0,2,35,2,0
35254,51457,443,49898,443,642,582,60,2,15,1,1
35255,53713,26085,40044,26085,70,70,0,1,5,1,0
35256,51976,443,51253,443,14912,9611,5301,36,57,21,15
35257,36756,443,3567,443,6112,1553,4559,18,16,10,8
35258,1100,27540,53473,27540,132,70,62,2,30,1,1
35259,37434,443,37114,443,11113,2993,8120,26,143,14,12
35260,52043,443,36100,443,7847,1904,5943,21,361,10,11
35261,53729,40721,59100,40721,70,70,0,2,8,2,0
35262,55740,8060,53740,8060,70,70,0,1,5,1,0
35263,55286,53,17426,53,268,87,181,4,35,2,2
35264,50052,53,23158,53,789,102,687,2,30,1,1
35265,64805,53,48699,53,278,102,176,2,31,1,1
35266,63297,445,0,0,70,70,0,1,0,1,0
35267,63296,445,0,0,70,70,0,1,0,1,0
35268,43578,15503,0,0,74,74,0,1,0,1,0
35269,58426,445,0,0,70,70,0,1,0,1,0
35270,58708,445,0,0,66,66,0,1,0,1,0
35271,23197,44847,0,0,146,146,0,1,0,1,0
35272,58425,445,0,0,70,70,0,1,0,1,0
35273,58700,445,0,0,66,66,0,1,0,1,0
35274,58692,445,0,0,66,66,0,1,0,1,0
35275,58698,445,0,0,66,66,0,1,0,1,0
35276,58690,445,0,0,66,66,0,1,0,1,0
35277,58702,445,0,0,66,66,0,1,0,1,0
35278,58691,445,0,0,66,66,0,1,0,1,0
35279,58701,445,0,0,66,66,0,1,0,1,0
35280,60361,57470,0,0,62,62,0,1,0,1,0
35281,1530,62413,0,0,62,62,0,1,0,1,0
35282,35154,42707,0,0,62,62,0,1,0,1,0
35283,62348,30349,0,0,148,148,0,1,0,1,0
35284,63291,445,0,0,70,70,0,1,0,1,0
35285,54016,42707,0,0,66,66,0,1,0,1,0
35286,58420,445,0,0,70,70,0,1,0,1,0
35287,63289,445,0,0,70,70,0,1,0,1,0
35288,63288,445,0,0,70,70,0,1,0,1,0
35289,63286,445,0,0,70,70,0,1,0,1,0
35290,58418,445,0,0,70,70,0,1,0,1,0
35291,443,60496,0,0,320,320,0,1,0,1,0
35292,27528,35440,0,0,62,62,0,1,0,1,0
35293,40512,57470,0,0,74,74,0,1,0,1,0
35294,61135,50265,0,0,62,62,0,1,0,1,0
35295,61150,11392,0,0,62,62,0,1,0,1,0
35296,51401,6881,0,0,62,62,0,1,0,1,0
35297,58414,445,0,0,70,70,0,1,0,1,0
35298,13559,57866,0,0,66,66,0,1,0,1,0
35299,58413,445,0,0,70,70,0,1,0,1,0
35300,63284,445,0,0,70,70,0,1,0,1,0
35301,63280,445,0,0,70,70,0,1,0,1,0
35302,63278,445,0,0,70,70,0,1,0,1,0
35303,21034,50265,0,0,66,66,0,1,0,1,0
35304,58685,445,0,0,66,66,0,1,0,1,0
35305,48388,44847,0,0,62,62,0,1,0,1,0
35306,51535,44847,0,0,62,62,0,1,0,1,0
35307,63276,445,0,0,70,70,0,1,0,1,0
35308,58682,445,0,0,66,66,0,1,0,1,0
35309,6338,23117,0,0,66,66,0,1,0,1,0
35310,64815,37965,0,0,66,66,0,1,0,1,0
35311,56367,44847,0,0,66,66,0,1,0,1,0
35312,58678,445,0,0,66,66,0,1,0,1,0
35313,58680,445,0,0,66,66,0,1,0,1,0
35314,53835,62413,0,0,62,62,0,1,0,1,0
35315,57964,44847,0,0,62,62,0,1,0,1,0
35316,58676,445,0,0,66,66,0,1,0,1,0
35317,58408,445,0,0,70,70,0,1,0,1,0
35318,26642,57470,0,0,62,62,0,1,0,1,0
35319,48676,53389,0,0,60,60,0,1,0,1,0
35320,58338,3369,0,0,60,60,0,1,0,1,0
35321,24874,55108,0,0,145,145,0,1,0,1,0
35322,56794,46824,0,0,66,66,0,1,0,1,0
35323,63272,445,0,0,70,70,0,1,0,1,0
35324,63266,445,0,0,70,70,0,1,0,1,0
35325,63265,445,0,0,70,70,0,1,0,1,0
35326,46516,57470,0,0,62,62,0,1,0,1,0
35327,58665,445,0,0,66,66,0,1,0,1,0
35328,58395,445,0,0,70,70,0,1,0,1,0
35329,13408,44847,0,0,66,66,0,1,0,1,0
35330,3047,50584,0,0,62,62,0,1,0,1,0
35331,45908,33330,0,0,60,60,0,1,0,1,0
35332,58392,445,0,0,70,70,0,1,0,1,0
35333,58658,445,0,0,66,66,0,1,0,1,0
35334,63248,445,0,0,70,70,0,1,0,1,0
35335,4935,3389,0,0,66,66,0,1,0,1,0
35336,56869,17637,0,0,66,66,0,1,0,1,0
35337,58655,445,0,0,66,66,0,1,0,1,0
35338,6889,7363,0,0,143,143,0,1,0,1,0
35339,58387,445,0,0,70,70,0,1,0,1,0
35340,443,60496,0,0,320,320,0,1,0,1,0
35341,49958,36829,0,0,66,66,0,1,0,1,0
35342,58386,445,0,0,70,70,0,1,0,1,0
35343,13285,29892,0,0,145,145,0,1,0,1,0
35344,0,0,0,0,480,244,236,4,0,2,2
35345,58384,445,0,0,70,70,0,1,0,1,0
35346,55966,35440,0,0,66,66,0,1,0,1,0
35347,58648,445,0,0,66,66,0,1,0,1,0
35348,12951,50584,0,0,66,66,0,1,0,1,0
35349,62089,8604,0,0,62,62,0,1,0,1,0
35350,58642,445,0,0,66,66,0,1,0,1,0
35351,47063,15503,0,0,146,146,0,1,0,1,0
35352,55835,62413,0,0,66,66,0,1,0,1,0
35353,8103,65473,0,0,157,157,0,1,0,1,0
35354,16330,50584,0,0,62,62,0,1,0,1,0
35355,58582,50584,0,0,66,66,0,1,0,1,0
35356,13160,7905,0,0,62,62,0,1,0,1,0
35357,25620,50432,0,0,146,146,0,1,0,1,0
35358,51581,17546,0,0,62,62,0,1,0,1,0
35359,36579,30188,0,0,66,66,0,1,0,1,0
35360,58377,445,0,0,70,70,0,1,0,1,0
35361,63239,445,0,0,70,70,0,1,0,1,0
35362,63237,445,0,0,70,70,0,1,0,1,0
35363,63236,445,0,0,70,70,0,1,0,1,0
35364,58375,445,0,0,70,70,0,1,0,1,0
35365,58629,445,0,0,66,66,0,1,0,1,0
35366,58633,445,0,0,66,66,0,1,0,1,0
35367,58628,445,0,0,66,66,0,1,0,1,0
35368,58632,445,0,0,66,66,0,1,0,1,0
35369,58631,445,0,0,66,66,0,1,0,1,0
35370,58630,445,0,0,66,66,0,1,0,1,0
35371,58627,445,0,0,66,66,0,1,0,1,0
35372,58625,445,0,0,66,66,0,1,0,1,0
35373,44821,64147,0,0,62,62,0,1,0,1,0
35374,6881,6881,0,0,146,146,0,1,0,1,0
35375,58374,445,0,0,70,70,0,1,0,1,0
35376,13963,50584,0,0,66,66,0,1,0,1,0
35377,58373,445,0,0,70,70,0,1,0,1,0
35378,58372,445,0,0,70,70,0,1,0,1,0
35379,59694,50584,0,0,66,66,0,1,0,1,0
35380,58367,445,0,0,70,70,0,1,0,1,0
35381,58366,445,0,0,70,70,0,1,0,1,0
35382,1026,64147,0,0,62,62,0,1,0,1,0
35383,19875,30170,0,0,145,145,0,1,0,1,0
35384,1187,64147,0,0,66,66,0,1,0,1,0
35385,27947,26467,0,0,66,66,0,1,0,1,0
35386,443,60496,0,0,187,187,0,1,0,1,0
35387,27844,52700,0,0,74,74,0,1,0,1,0
35388,60374,57470,0,0,62,62,0,1,0,1,0
35389,26254,56205,0,0,66,66,0,1,0,1,0
35390,60374,57470,0,0,145,145,0,1,0,1,0
35391,63234,445,0,0,70,70,0,1,0,1,0
35392,63228,445,0,0,70,70,0,1,0,1,0
35393,63226,445,0,0,70,70,0,1,0,1,0
35394,63220,445,0,0,70,70,0,1,0,1,0
35395,58353,445,0,0,70,70,0,1,0,1,0
35396,58352,445,0,0,70,70,0,1,0,1,0
35397,58349,445,0,0,70,70,0,1,0,1,0
35398,63589,44847,0,0,62,62,0,1,0,1,0
35399,12242,51221,0,0,62,62,0,1,0,1,0
35400,51114,443,50404,443,10301,4593,5708,21,121,10,11
35401,65114,53,6427,53,253,87,166,4,31,2,2
35402,56568,53,15733,53,711,87,624,2,30,1,1
35403,42279,443,42279,443,3414,1979,1435,22,69,11,11
35404,42278,443,42278,443,1916,1121,795,19,69,10,9
35405,56280,53,50135,53,1335,87,1248,4,59,2,2
35406,39672,443,58171,443,6540,5046,1494,19,115,12,7
35407,55286,53,19401,53,268,87,181,4,35,2,2
35408,49295,53,50273,53,280,96,184,4,34,2,2
35409,56007,53,3946,53,99,99,0,1,30,1,0
35410,56896,53,19605,53,256,87,169,2,30,1,1
35411,57470,62348,3608,62348,149,149,0,1,1200,1,0
35412,37035,443,37035,443,4510,1603,2907,19,28,11,8
35413,59530,53,58720,53,578,286,292,9,15,5,4
35414,54086,443,46250,443,4982,2205,2777,46,61,24,22
35415,58908,443,56510,443,6278402,111931,6166471,5306,1119,732,4574
35416,64303,53,50389,53,253,87,166,4,31,2,2
35417,51870,443,29475,443,4375,1230,3145,16,26,8,8
35418,18063,53,18063,53,219,87,132,2,30,1,1
35419,9084,53,9084,53,224,88,136,2,30,1,1
35420,56214,53,17373,53,200,102,98,2,30,1,1
35421,55075,53,29760,53,178,91,87,2,30,1,1
35422,37965,33738,46824,33738,1548,265,1283,4,1200,2,2
35423,55457,443,46084,443,8447,2129,6318,26,250,15,11
35424,9189,443,50417,443,4941,429,4512,12,15,6,6
35425,9188,443,11737,443,5955,728,5227,17,15,8,9
35426,38366,15000,19494,15000,130,70,60,2,6,1,1
35427,55060,80,45377,80,1289,724,565,11,26,6,5
35428,50283,443,36964,443,290,142,148,5,11,3,2
35429,45847,443,35477,443,1134,490,644,18,42,8,10
35430,5588,5588,0,0,3354,1792,1562,46,193,23,23
35431,51800,443,3294,443,36048,2364,33684,54,28,23,31
35432,38163,53,38163,53,216,89,127,2,30,1,1
35433,50460,53,9714,53,751,95,656,2,30,1,1
35434,58605,443,40025,443,3301,1240,2061,14,135,7,7
35435,55168,53,23617,53,816,97,719,2,31,1,1
35436,24985,443,23171,443,2227,1018,1209,17,15,8,9
35437,9190,443,45715,443,4943,429,4514,12,15,6,6
35438,56631,80,27363,80,61771,2713,59058,80,45,35,45
35439,48982,15000,10476,15000,130,70,60,2,5,1,1
35440,51899,47537,11729,47537,66,66,0,1,5,1,0
35441,64664,53,51475,53,168,86,82,2,34,1,1
35442,49569,53,48621,53,91,91,0,2,37,2,0
35443,60957,443,60957,443,70839,5466,65373,98,19,47,51
35444,40786,53,0,0,82,82,0,1,30,1,0
35445,65026,53,20362,53,188,96,92,2,30,1,1
35446,54653,53,54653,53,231,90,141,2,30,1,1
35447,49788,53,44900,53,196,100,96,2,30,1,1
35448,53727,53,60009,53,172,72,100,2,30,1,1
35449,35154,60038,0,0,66,66,0,1,91,1,0
35450,61939,443,12700,443,3698,1049,2649,13,135,6,7
35451,39473,443,53063,443,9590,3811,5779,20,122,10,10
35452,56835,53,37097,53,170,87,83,2,31,1,1
35453,27988,40002,58461,40002,144,82,62,2,31,1,1
35454,8881,443,2247,443,27459,19126,8333,67,402,30,37
35455,27988,40034,46189,40034,141,79,62,2,31,1,1
35456,27988,40023,43847,40023,143,81,62,2,31,1,1
35457,58342,445,0,0,70,70,0,1,0,1,0
35458,58343,445,0,0,70,70,0,1,0,1,0
35459,58612,445,0,0,66,66,0,1,0,1,0
35460,58611,445,0,0,66,66,0,1,0,1,0
35461,58610,445,0,0,66,66,0,1,0,1,0
35462,31974,51505,0,0,66,66,0,1,0,1,0
35463,53971,50265,0,0,62,62,0,1,0,1,0
35464,55733,51505,0,0,66,66,0,1,0,1,0
35465,10416,64147,0,0,62,62,0,1,0,1,0
35466,7166,64147,0,0,66,66,0,1,0,1,0
35467,5222,21212,0,0,66,66,0,1,0,1,0
35468,47365,10387,0,0,159,159,0,1,0,1,0
35469,443,60496,0,0,187,187,0,1,0,1,0
35470,2170,43227,0,0,62,62,0,1,0,1,0
35471,63217,445,0,0,70,70,0,1,0,1,0
35472,51918,27015,0,0,67,67,0,1,0,1,0
35473,63214,445,0,0,70,70,0,1,0,1,0
35474,63210,445,0,0,70,70,0,1,0,1,0
35475,56509,53,49839,53,1165,94,1071,2,30,1,1
35476,23338,53,23338,53,242,98,144,2,30,1,1
35477,64813,53,46374,53,177,94,83,2,30,1,1
35478,55872,123,4281,123,184,94,90,2,30,1,1
35479,56590,53,44528,53,305,94,211,2,30,1,1
35480,50653,80,33144,80,124643,7017,117626,163,21,75,88
35481,57062,80,49519,80,864,507,357,8,38,5,3
35482,56640,80,54626,80,234,234,0,4,11,4,0
35483,50412,80,11804,80,22200,11865,10335,38,86,24,14
35484,60473,443,60473,443,18018,4407,13611,36,100,19,17
35485,65479,53,45836,53,728,102,626,2,29,1,1
35486,65095,53,43220,53,718,94,624,2,30,1,1
35487,46763,443,11187,443,11876848,256539,11620309,11266,74,3584,7682
35488,33893,80,46490,80,1376,788,588,10,23,6,4
35489,51853,80,50403,80,4903,4061,842,11,26,6,5
35490,55022,80,15142,80,1080714,29230,1051484,1137,174,436,701
35491,63906,36909,30978,36909,66,66,0,2,7,2,0
35492,50576,80,30685,80,4189,1691,2498,16,24,9,7
35493,42281,443,42281,443,1530,817,713,17,68,9,8
35494,58021,80,10301,80,318,192,126,6,20,4,2
35495,51090,80,51090,80,19837,2061,17776,30,21,14,16
35496,56694,53,2840,53,427,88,339,4,55,2,2
35497,55249,443,62038,443,3056958,73055,2983903,3016,43,1023,1993
35498,53730,37096,47492,37096,70,70,0,2,7,2,0
35499,64559,53,32115,53,193,102,91,2,29,1,1
35500,55313,53,17189,53,198,94,104,2,29,1,1
35501,57086,53,59882,53,228,102,126,2,29,1,1
35502,55780,53,61304,53,322,134,188,2,29,1,1
35503,65327,53,49765,53,822,102,720,2,29,1,1
35504,50565,53,50708,53,707,94,613,2,30,1,1
35505,64413,53,4808,53,209,102,107,2,30,1,1
35506,65026,53,1071,53,194,102,92,2,30,1,1
35507,57330,53,57913,53,177,94,83,2,30,1,1
35508,51921,37744,59756,37744,70,70,0,2,8,2,0
35509,49538,53,59762,53,754,94,660,2,30,1,1
35510,49937,53,46761,53,718,94,624,2,30,1,1
35511,64361,53,3934,53,194,94,100,2,30,1,1
35512,48553,443,14731,443,49428,2702,46726,70,136,30,40
35513,50265,49083,4910,49083,132,132,0,3,1200,3,0
35514,64868,53,56069,53,216,102,114,2,30,1,1
35515,51920,32678,45180,32678,70,70,0,2,8,2,0
35516,56138,53,23162,53,177,94,83,2,30,1,1
35517,42853,443,44169,443,130,70,60,3,5,2,1
35518,63885,6969,58102,6969,70,70,0,1,5,1,0
35519,57377,53,26653,53,2235,93,2142,4,30,2,2
35520,58824,53,47620,53,358,96,262,4,50,2,2
35521,37297,443,46820,443,232,172,60,3,5,2,1
35522,56579,443,24024,443,23150,13858,9292,52,49,32,20
35523,50754,443,43460,443,10133,2663,7470,35,255,18,17
35524,56206,53,31271,53,211,102,109,2,30,1,1
35525,40001,53,40001,53,218,90,128,2,30,1,1
35526,35556,443,19765,443,2988,1649,1339,17,255,9,8
35527,55059,80,26318,80,306,180,126,6,26,4,2
35528,64647,53,15086,53,718,94,624,2,30,1,1
35529,50199,443,58943,443,8641,2459,6182,22,16,12,10
35530,58024,80,1081,80,318,192,126,6,20,4,2
35531,49461,53,60884,53,314,102,212,2,30,1,1
35532,20495,53,20495,53,217,90,127,2,30,1,1
35533,55007,443,50452,443,9726,4743,4983,41,15,24,17
35534,39057,53,39057,53,222,90,132,2,30,1,1
35535,55442,53,42681,53,177,94,83,2,30,1,1
35536,37614,53,37614,53,209,98,111,2,30,1,1
35537,55300,53,49492,53,308,94,214,2,30,1,1
35538,57377,53,64833,53,1165,94,1071,2,30,1,1
35539,49558,53,18984,53,177,94,83,2,30,1,1
35540,47213,443,42653,443,8166,2498,5668,16,120,8,8
35541,49857,443,44578,443,18811,1868,16943,22,139,7,15
35542,49558,53,29414,53,177,94,83,2,30,1,1
35543,55057,80,24701,80,306,180,126,6,26,4,2
35544,49448,80,49448,80,3193,2163,1030,17,79,10,7
35545,41738,53,43971,53,168,78,90,2,30,1,1
35546,49930,53,6830,53,361,94,267,2,30,1,1
35547,51274,24399,41569,24399,70,70,0,2,8,2,0
35548,51686,80,25444,80,45058,2444,42614,90,52,33,57
35549,49554,443,54292,443,10104,2646,7458,28,186,14,14
35550,63924,53,40615,53,214,102,112,2,30,1,1
35551,50265,45682,34420,45682,330,330,0,6,1200,6,0
35552,49509,443,14742,443,17660,7465,10195,44,201,23,21
35553,51459,443,47605,443,379,259,120,4,16,2,2
35554,44011,443,64228,443,1056,569,487,10,78,6,4
35555,47879,443,13971,443,37598,2397,35201,53,239,22,31
35556,49489,443,58403,443,3170,977,2193,13,135,6,7
35557,56580,443,8692,443,20897,11903,8994,52,49,30,22
35558,51500,443,60787,443,451,259,192,5,23,2,3
35559,59618,443,47989,443,5682,1562,4120,23,61,13,10
35560,55657,53,56154,53,101,101,0,2,34,2,0
35561,63898,13205,16525,13205,66,66,0,2,7,2,0
35562,53714,6882,41499,6882,70,70,0,1,4,1,0
35563,63904,18268,47003,18268,66,66,0,2,7,2,0
35564,42934,443,24809,443,232,172,60,3,5,2,1
35565,55075,53,54293,53,181,94,87,2,33,1,1
35566,55246,443,12271,443,6144,1810,4334,18,45,11,7
35567,56415,443,20835,443,6032,1722,4310,22,117,13,9
35568,49788,53,45773,53,198,102,96,2,33,1,1
35569,58016,80,61881,80,378,192,186,7,21,4,3
35570,53710,27935,34512,27935,70,70,0,1,4,1,0
35571,51802,443,43953,443,4976,1826,3150,19,151,9,10
35572,65317,53,60723,53,195,102,93,2,29,1,1
35573,64559,53,14656,53,816,102,714,2,29,1,1
35574,54833,443,46650,443,3894,969,2925,20,153,9,11
35575,42860,80,52081,80,1346,842,504,13,123,8,5
35576,56363,2710,2278,2710,1222,747,475,10,25,5,5
35577,55721,53,12194,53,177,94,83,2,29,1,1
35578,7954,53,7954,53,226,90,136,2,29,1,1
35579,61980,53,64563,53,374,104,270,4,50,2,2
35580,64969,53,18068,53,329,118,211,2,30,1,1
35581,64408,53,53381,53,199,94,105,2,29,1,1
35582,50207,53,4187,53,195,102,93,2,29,1,1
35583,65113,53,56187,53,232,102,130,2,29,1,1
35584,64813,53,49645,53,177,94,83,2,30,1,1
35585,26180,53,26180,53,245,98,147,2,30,1,1
35586,41093,53,34774,53,78,78,0,1,30,1,0
35587,48565,53,48565,53,197,90,107,2,30,1,1
35588,57330,53,61035,53,177,94,83,2,30,1,1
35589,10844,53,10844,53,222,90,132,2,30,1,1
35590,49272,53,51922,53,266,94,172,2,30,1,1
35591,49841,53,36944,53,227,110,117,2,30,1,1
35592,36476,5228,61709,5228,21282,7311,13971,96,1216,47,49
35593,55774,443,58031,443,6092,3093,2999,16,120,8,8
35594,43092,443,2375,443,7011,2541,4470,19,15,11,8
35595,49569,53,65331,53,181,94,87,2,32,1,1
35596,35623,443,1828,443,9685,2504,7181,26,153,11,15
35597,35441,5222,17710,5222,10854,4776,6078,80,119,41,39
35598,64670,53,9827,53,183,86,97,2,30,1,1
35599,49741,53,44929,53,177,94,83,2,30,1,1
35600,64449,53,62626,53,249,94,155,2,30,1,1
35601,38941,443,59649,443,13623,2693,10930,22,123,10,12
35602,50489,443,43121,443,8389,1077,7312,24,140,12,12
35603,44719,80,51210,80,1998,1422,576,10,15,6,4
35604,62843,53,62843,53,235,90,145,2,32,1,1
35605,56214,53,46867,53,200,102,98,2,33,1,1
35606,51503,443,56151,443,887,635,252,7,23,3,4
35607,54828,443,7869,443,150,150,0,1,5,1,0
35608,56515,995,45992,995,2901,1472,1429,27,17,12,15
35609,57506,443,36392,443,2696,1695,1001,24,105,13,11
35610,55045,53,21912,53,261,102,159,2,30,1,1
35611,50265,35344,29716,35344,1386,1386,0,22,2342,22,0
35612,51922,18413,55909,18413,70,70,0,2,8,2,0
35613,51923,11542,38262,11542,70,70,0,2,8,2,0
35614,55286,53,22881,53,268,87,181,4,35,2,2
35615,55056,80,26189,80,306,180,126,6,26,4,2
35616,55055,80,30882,80,306,180,126,6,26,4,2
35617,50579,80,48781,80,265114,13651,251463,346,76,161,185
35618,5588,5588,0,0,3498,1872,1626,48,197,24,24
35619,49741,53,17465,53,177,94,83,2,30,1,1
35620,50223,53,39269,53,165,86,79,2,30,1,1
35621,51388,443,52372,443,20351,3359,16992,52,103,27,25
35622,50223,53,61828,53,173,94,79,2,30,1,1
35623,55442,53,12898,53,177,94,83,2,30,1,1
35624,49998,53,44432,53,94,94,0,1,30,1,0
35625,10151,31964,38746,31964,481,150,331,2,1200,1,1
35626,37965,6881,16163,6881,452,248,204,4,1199,2,2
35627,58239,80,32964,80,2444,2444,0,3,191,3,0
35628,51974,443,51489,443,11486,5080,6406,24,121,12,12
35629,47509,443,17369,443,7769,2586,5183,18,121,9,9
35630,50265,11035,48783,11035,132,132,0,3,1200,3,0
35631,37965,16881,45844,16881,448,246,202,4,1199,2,2
35632,37965,6881,34922,6881,448,246,202,4,1199,2,2
35633,51221,6881,38542,6881,469,150,319,2,1200,1,1
35634,64055,53,9885,53,265,91,174,4,37,2,2
35635,50656,443,61533,443,3815,1772,2043,18,16,10,8
35636,56138,53,22955,53,177,94,83,2,30,1,1
35637,56518,53,3673,53,177,94,83,2,31,1,1
35638,53705,30600,18470,30600,492,306,186,8,15,5,3
35639,55256,53,58019,53,79,79,0,2,35,2,0
35640,49989,443,4666,443,300,168,132,4,6,2,2
35641,44354,80,44354,80,250076,10158,239918,315,24,146,169
35642,56307,53,64603,53,168,78,90,2,30,1,1
35643,55156,53,44381,53,194,102,92,2,30,1,1
35644,60293,53,33499,53,312,78,234,2,30,1,1
35645,59932,443,1750,443,333535,35190,298345,555,285,257,298
35646,53725,57418,1375,57418,70,70,0,2,8,2,0
35647,56611,80,46294,80,4296,2076,2220,31,128,15,16
35648,56298,53,17699,53,173,94,79,2,30,1,1
35649,51189,53,6847,53,312,78,234,2,30,1,1
35650,55156,53,26617,53,194,102,92,2,31,1,1
35651,62929,443,8515,443,46033,7524,38509,103,141,49,54
35652,63206,445,0,0,70,70,0,1,0,1,0
35653,58331,445,0,0,70,70,0,1,0,1,0
35654,48420,48637,0,0,146,146,0,1,0,1,0
35655,48420,35974,0,0,146,146,0,1,0,1,0
35656,28378,56205,0,0,62,62,0,1,0,1,0
35657,27869,51221,0,0,66,66,0,1,0,1,0
35658,50116,22,0,0,60,60,0,1,0,1,0
35659,45941,23388,0,0,60,60,0,1,0,1,0
35660,9687,57470,0,0,78,78,0,1,0,1,0
35661,11066,50584,0,0,62,62,0,1,0,1,0
35662,60204,2767,0,0,66,66,0,1,0,1,0
35663,58327,445,0,0,70,70,0,1,0,1,0
35664,32845,9797,0,0,60,60,0,1,0,1,0
35665,63197,445,0,0,70,70,0,1,0,1,0
35666,63194,445,0,0,70,70,0,1,0,1,0
35667,63192,445,0,0,70,70,0,1,0,1,0
35668,50292,22114,0,0,62,62,0,1,0,1,0
35669,57799,10387,0,0,145,145,0,1,0,1,0
35670,6546,37965,0,0,62,62,0,1,0,1,0
35671,58076,21247,0,0,66,66,0,1,0,1,0
35672,57538,30188,0,0,66,66,0,1,0,1,0
35673,58599,445,0,0,66,66,0,1,0,1,0
35674,18011,44847,0,0,66,66,0,1,0,1,0
35675,6889,8055,0,0,143,143,0,1,0,1,0
35676,56521,32480,0,0,62,62,0,1,0,1,0
35677,58318,445,0,0,70,70,0,1,0,1,0
35678,58317,445,0,0,70,70,0,1,0,1,0
35679,58316,445,0,0,70,70,0,1,0,1,0
35680,23537,35253,0,0,62,62,0,1,0,1,0
35681,48420,54532,0,0,146,146,0,1,0,1,0
35682,58314,445,0,0,70,70,0,1,0,1,0
35683,56157,50584,0,0,66,66,0,1,0,1,0
35684,58311,445,0,0,70,70,0,1,0,1,0
35685,65179,44847,0,0,62,62,0,1,0,1,0
35686,443,1785,0,0,97,97,0,1,0,1,0
35687,52003,44512,0,0,66,66,0,1,0,1,0
35688,47013,44512,0,0,62,62,0,1,0,1,0
35689,50052,65008,0,0,60,60,0,1,0,1,0
35690,45682,47993,0,0,62,62,0,1,0,1,0
35691,63190,445,0,0,70,70,0,1,0,1,0
35692,34772,15503,0,0,146,146,0,1,0,1,0
35693,27089,30627,0,0,146,146,0,1,0,1,0
35694,43578,15503,0,0,74,74,0,1,0,1,0
35695,55386,32480,0,0,66,66,0,1,0,1,0
35696,34470,57470,0,0,66,66,0,1,0,1,0
35697,18904,57470,0,0,62,62,0,1,0,1,0
35698,61798,35440,0,0,66,66,0,1,0,1,0
35699,58305,445,0,0,70,70,0,1,0,1,0
35700,53208,18375,0,0,62,62,0,1,0,1,0
35701,58583,445,0,0,66,66,0,1,0,1,0
35702,58582,445,0,0,66,66,0,1,0,1,0
35703,18423,51505,0,0,66,66,0,1,0,1,0
35704,64115,2767,0,0,62,62,0,1,0,1,0
35705,41916,53,0,0,60,60,0,1,0,1,0
35706,60962,64147,0,0,66,66,0,1,0,1,0
35707,39981,57470,0,0,62,62,0,1,0,1,0
35708,40512,57470,0,0,74,74,0,1,0,1,0
35709,8999,55783,0,0,146,146,0,1,0,1,0
35710,63179,445,0,0,70,70,0,1,0,1,0
35711,58297,445,0,0,70,70,0,1,0,1,0
35712,1262,23,0,0,60,60,0,1,0,1,0
35713,58295,445,0,0,70,70,0,1,0,1,0
35714,63174,445,0,0,70,70,0,1,0,1,0
35715,63170,445,0,0,70,70,0,1,0,1,0
35716,63172,445,0,0,70,70,0,1,0,1,0
35717,17008,35440,0,0,146,146,0,1,0,1,0
35718,58580,445,0,0,66,66,0,1,0,1,0
35719,50086,57470,0,0,66,66,0,1,0,1,0
35720,59227,11392,0,0,62,62,0,1,0,1,0
35721,58022,5601,0,0,60,60,0,1,0,1,0
35722,48079,43227,0,0,62,62,0,1,0,1,0
35723,58570,445,0,0,66,66,0,1,0,1,0
35724,58574,445,0,0,66,66,0,1,0,1,0
35725,58572,445,0,0,66,66,0,1,0,1,0
35726,58567,445,0,0,66,66,0,1,0,1,0
35727,58569,445,0,0,66,66,0,1,0,1,0
35728,58568,445,0,0,66,66,0,1,0,1,0
35729,58564,445,0,0,66,66,0,1,0,1,0
35730,58290,445,0,0,70,70,0,1,0,1,0
35731,40216,50265,0,0,62,62,0,1,0,1,0
35732,58289,445,0,0,70,70,0,1,0,1,0
35733,63165,445,0,0,70,70,0,1,0,1,0
35734,63161,445,0,0,70,70,0,1,0,1,0
35735,63160,445,0,0,70,70,0,1,0,1,0
35736,63157,445,0,0,70,70,0,1,0,1,0
35737,19068,37965,0,0,62,62,0,1,0,1,0
35738,57698,64147,0,0,62,62,0,1,0,1,0
35739,39531,19473,0,0,62,62,0,1,0,1,0
35740,58285,445,0,0,70,70,0,1,0,1,0
35741,49426,57470,0,0,62,62,0,1,0,1,0
35742,45908,33330,0,0,60,60,0,1,0,1,0
35743,57131,31061,0,0,145,145,0,1,0,1,0
35744,58284,445,0,0,70,70,0,1,0,1,0
35745,10860,55108,0,0,148,148,0,1,0,1,0
35746,63153,445,0,0,70,70,0,1,0,1,0
35747,63151,445,0,0,70,70,0,1,0,1,0
35748,63149,445,0,0,70,70,0,1,0,1,0
35749,33432,5900,0,0,60,60,0,1,0,1,0
35750,58556,445,0,0,66,66,0,1,0,1,0
35751,63148,445,0,0,70,70,0,1,0,1,0
35752,58553,445,0,0,66,66,0,1,0,1,0
35753,58279,445,0,0,70,70,0,1,0,1,0
35754,53465,57470,0,0,62,62,0,1,0,1,0
35755,58552,445,0,0,66,66,0,1,0,1,0
35756,58550,445,0,0,66,66,0,1,0,1,0
35757,5223,21557,0,0,91,91,0,1,0,1,0
35758,58549,445,0,0,66,66,0,1,0,1,0
35759,57233,50934,0,0,66,66,0,1,0,1,0
35760,14923,51505,0,0,66,66,0,1,0,1,0
35761,37927,50265,0,0,66,66,0,1,0,1,0
35762,2180,63710,0,0,66,66,0,1,0,1,0
35763,60351,50584,0,0,66,66,0,1,0,1,0
35764,63147,445,0,0,70,70,0,1,0,1,0
35765,50298,37965,0,0,62,62,0,1,0,1,0
35766,51015,64147,0,0,62,62,0,1,0,1,0
35767,63137,445,0,0,70,70,0,1,0,1,0
35768,63133,445,0,0,70,70,0,1,0,1,0
35769,58791,15503,0,0,66,66,0,1,0,1,0
35770,59647,47993,0,0,66,66,0,1,0,1,0
35771,10521,15503,0,0,146,146,0,1,0,1,0
35772,62109,44847,0,0,66,66,0,1,0,1,0
35773,51996,57470,0,0,66,66,0,1,0,1,0
35774,1057,57470,0,0,62,62,0,1,0,1,0
35775,58266,445,0,0,70,70,0,1,0,1,0
35776,58537,445,0,0,66,66,0,1,0,1,0
35777,15581,46713,0,0,66,66,0,1,0,1,0
35778,58263,445,0,0,70,70,0,1,0,1,0
35779,63196,445,0,0,62,62,0,1,0,1,0
35780,61137,40740,0,0,145,145,0,1,0,1,0
35781,46409,35440,0,0,62,62,0,1,0,1,0
35782,58530,445,0,0,66,66,0,1,0,1,0
35783,63122,445,0,0,70,70,0,1,0,1,0
35784,51505,17372,0,0,62,62,0,1,0,1,0
35785,443,39851,0,0,112,112,0,1,0,1,0
35786,58259,445,0,0,70,70,0,1,0,1,0
35787,54134,64147,0,0,66,66,0,1,0,1,0
35788,58257,445,0,0,70,70,0,1,0,1,0
35789,58528,445,0,0,66,66,0,1,0,1,0
35790,51096,63710,0,0,66,66,0,1,0,1,0
35791,22390,19473,0,0,62,62,0,1,0,1,0
35792,58255,445,0,0,70,70,0,1,0,1,0
35793,53766,51505,0,0,66,66,0,1,0,1,0
35794,13484,37965,0,0,66,66,0,1,0,1,0
35795,58519,445,0,0,66,66,0,1,0,1,0
35796,11337,15503,0,0,62,62,0,1,0,1,0
35797,58510,445,0,0,66,66,0,1,0,1,0
35798,50486,56205,0,0,66,66,0,1,0,1,0
35799,29159,39004,0,0,62,62,0,1,0,1,0
35800,53608,39004,0,0,66,66,0,1,0,1,0
35801,58248,445,0,0,70,70,0,1,0,1,0
35802,41207,5900,0,0,60,60,0,1,0,1,0
35803,48840,50584,0,0,62,62,0,1,0,1,0
35804,58246,445,0,0,70,70,0,1,0,1,0
35805,50095,50584,0,0,66,66,0,1,0,1,0
35806,49981,44847,0,0,62,62,0,1,0,1,0
35807,63113,445,0,0,70,70,0,1,0,1,0
35808,63109,445,0,0,70,70,0,1,0,1,0
35809,63108,445,0,0,70,70,0,1,0,1,0
35810,25222,37965,0,0,62,62,0,1,0,1,0
35811,35408,56205,0,0,66,66,0,1,0,1,0
35812,58500,445,0,0,66,66,0,1,0,1,0
35813,58504,445,0,0,66,66,0,1,0,1,0
35814,58505,445,0,0,66,66,0,1,0,1,0
35815,27988,40029,26130,40029,140,78,62,2,30,1,1
35816,57987,3478,22536,3478,312,140,172,4,30,2,2
35817,53724,64923,33470,64923,70,70,0,2,8,2,0
35818,52425,80,64946,80,1630,918,712,12,16,7,5
35819,49483,53,49626,53,172,88,84,2,30,1,1
35820,49907,53,29279,53,308,92,216,2,30,1,1
35821,57997,80,61005,80,318,192,126,6,21,4,2
35822,63908,33945,27378,33945,312,132,180,6,7,3,3
35823,56637,53,42734,53,711,87,624,2,30,1,1
35824,55340,53,32896,53,184,94,90,2,31,1,1
35825,64251,53,51222,53,170,87,83,2,31,1,1
35826,60337,7000,60337,7000,2163,676,1487,14,16,7,7
35827,63905,19899,5860,19899,312,132,180,6,7,3,3
35828,15503,58675,42815,58675,2227,1224,1003,20,1200,11,9
35829,55924,53,5985,53,711,87,624,2,31,1,1
35830,27988,40027,35628,40027,140,78,62,2,30,1,1
35831,57987,3478,8652,3478,312,140,172,4,30,2,2
35832,48625,443,29976,443,7605,2028,5577,23,159,11,12
35833,49701,53,52830,53,488,110,378,4,32,2,2
35834,63877,51413,26586,51413,564,382,182,9,18,6,3
35835,11962,53,11962,53,194,87,107,2,30,1,1
35836,56518,53,9053,53,170,87,83,2,30,1,1
35837,53498,3389,53498,3389,3549,1594,1955,18,18,10,8
35838,59046,443,4447,443,8279,2876,5403,22,155,9,13
35839,46640,9002,46640,9002,124,60,64,2,5,1,1
35840,51349,80,65226,80,1056,682,374,10,15,6,4
35841,62346,80,27241,80,2328,580,1748,12,16,6,6
35842,49629,53,32885,53,742,88,654,2,30,1,1
35843,55156,53,61392,53,188,96,92,2,30,1,1
35844,56775,53,28683,53,170,87,83,2,30,1,1
35845,49472,53,22827,53,751,95,656,2,31,1,1
35846,45099,443,21949,443,94099,5885,88214,140,104,69,71
35847,53726,26083,18088,26083,70,70,0,2,8,2,0
35848,49453,53,4294,53,763,101,662,2,31,1,1
35849,37247,443,37247,443,4401,1494,2907,19,25,11,8
35850,56567,53,47104,53,701,88,613,2,30,1,1
35851,32854,443,34612,443,9695,4412,5283,22,172,13,9
35852,31750,53,31750,53,200,90,110,2,30,1,1
35853,50615,443,36645,443,1577,949,628,16,71,9,7
35854,53728,19442,57763,19442,320,140,180,6,7,3,3
35855,58782,53,58782,53,310,94,216,2,30,1,1
35856,57998,80,49916,80,318,192,126,6,21,4,2
35857,58007,80,40862,80,318,192,126,6,21,4,2
35858,64958,53,27605,53,216,94,122,2,30,1,1
35859,56509,53,27088,53,1164,93,1071,2,30,1,1
35860,62912,53,42026,53,214,76,138,2,30,1,1
35861,49691,53,43996,53,378,127,251,2,30,1,1
35862,27988,40022,50196,40022,146,84,62,2,30,1,1
35863,27988,40031,63445,40031,140,78,62,2,30,1,1
35864,57411,53,38630,53,711,87,624,2,31,1,1
35865,37565,443,47595,443,8553,3392,5161,25,202,13,12
35866,57470,6881,26091,6881,330,330,0,6,1201,6,0
35867,65436,53,35308,53,332,98,234,3,58,2,1
35868,55471,53,40426,53,760,97,663,2,31,1,1
35869,57195,53,29138,53,190,97,93,2,31,1,1
35870,8884,443,38785,443,5307,3288,2019,25,397,8,17
35871,54159,443,24398,443,4723,2593,2130,16,137,8,8
35872,49771,53,11315,53,728,96,632,2,31,1,1
35873,61746,443,1496,443,251,69,182,3,120,1,2
35874,37965,61872,44512,61872,1548,265,1283,4,1201,2,2
35875,55649,5228,61882,5228,5378,2359,3019,35,3786,16,19
35876,58502,445,0,0,66,66,0,1,0,1,0
35877,58503,445,0,0,66,66,0,1,0,1,0
35878,58498,445,0,0,66,66,0,1,0,1,0
35879,58501,445,0,0,66,66,0,1,0,1,0
35880,64841,6881,0,0,62,62,0,1,0,1,0
35881,58497,445,0,0,66,66,0,1,0,1,0
35882,58245,445,0,0,70,70,0,1,0,1,0
35883,58244,445,0,0,70,70,0,1,0,1,0
35884,58243,445,0,0,70,70,0,1,0,1,0
35885,58238,445,0,0,70,70,0,1,0,1,0
35886,58239,445,0,0,70,70,0,1,0,1,0
35887,21588,52700,0,0,145,145,0,1,0,1,0
35888,64546,57470,0,0,66,66,0,1,0,1,0
35889,48857,50584,0,0,66,66,0,1,0,1,0
35890,28435,23,0,0,60,60,0,1,0,1,0
35891,42731,23,0,0,60,60,0,1,0,1,0
35892,19885,64147,0,0,62,62,0,1,0,1,0
35893,35494,22114,0,0,62,62,0,1,0,1,0
35894,60720,23718,0,0,66,66,0,1,0,1,0
35895,58225,445,0,0,70,70,0,1,0,1,0
35896,58223,445,0,0,70,70,0,1,0,1,0
35897,58221,445,0,0,70,70,0,1,0,1,0
35898,10477,44847,0,0,66,66,0,1,0,1,0
35899,33896,57470,0,0,74,74,0,1,0,1,0
35900,64870,53,1765,53,200,102,98,2,33,1,1
35901,49712,53,62216,53,178,94,84,2,30,1,1
35902,60438,17148,53794,17148,70,70,0,2,8,2,0
35903,59904,53,31184,53,312,78,234,2,29,1,1
35904,58215,445,0,0,70,70,0,1,0,1,0
35905,58214,445,0,0,70,70,0,1,0,1,0
35906,13917,18033,0,0,62,62,0,1,0,1,0
35907,63104,445,0,0,70,70,0,1,0,1,0
35908,63100,445,0,0,70,70,0,1,0,1,0
35909,63095,445,0,0,70,70,0,1,0,1,0
35910,63091,445,0,0,70,70,0,1,0,1,0
35911,58483,445,0,0,66,66,0,1,0,1,0
35912,58485,445,0,0,66,66,0,1,0,1,0
35913,58484,445,0,0,66,66,0,1,0,1,0
35914,15180,26467,0,0,62,62,0,1,0,1,0
35915,62088,56205,0,0,66,66,0,1,0,1,0
35916,43700,30188,0,0,62,62,0,1,0,1,0
35917,52714,64147,0,0,62,62,0,1,0,1,0
35918,63088,445,0,0,70,70,0,1,0,1,0
35919,59236,17,0,0,60,60,0,1,0,1,0
35920,58203,445,0,0,70,70,0,1,0,1,0
35921,63086,445,0,0,70,70,0,1,0,1,0
35922,63084,445,0,0,70,70,0,1,0,1,0
35923,63082,445,0,0,70,70,0,1,0,1,0
35924,5223,21557,0,0,60,60,0,1,0,1,0
35925,62514,37807,0,0,66,66,0,1,0,1,0
35926,50674,35440,0,0,62,62,0,1,0,1,0
35927,60136,56205,0,0,62,62,0,1,0,1,0
35928,58199,445,0,0,70,70,0,1,0,1,0
35929,60855,35440,0,0,66,66,0,1,0,1,0
35930,16522,26467,0,0,66,66,0,1,0,1,0
35931,63071,445,0,0,70,70,0,1,0,1,0
35932,63069,445,0,0,70,70,0,1,0,1,0
35933,63064,445,0,0,70,70,0,1,0,1,0
35934,54742,37965,0,0,66,66,0,1,0,1,0
35935,58189,445,0,0,70,70,0,1,0,1,0
35936,58190,445,0,0,70,70,0,1,0,1,0
35937,58188,445,0,0,70,70,0,1,0,1,0
35938,58185,445,0,0,70,70,0,1,0,1,0
35939,58472,445,0,0,66,66,0,1,0,1,0
35940,9997,53,9997,53,235,90,145,2,32,1,1
35941,45052,80,23641,80,1539,553,986,10,14,6,4
35942,64303,53,30875,53,298,87,211,4,34,2,2
35943,51914,20777,59494,20777,256,136,120,5,8,3,2
35944,49988,443,12921,443,214,82,132,4,5,2,2
35945,63895,43729,42252,43729,66,66,0,2,7,2,0
35946,53723,51501,50854,51501,70,70,0,2,7,2,0
35947,53318,56648,63034,56648,672,432,240,10,142,6,4
35948,26751,443,19482,443,11513,2842,8671,31,18,15,16
35949,58044,443,46397,443,24527,2438,22089,43,329,19,24
35950,65114,53,53193,53,177,94,83,2,29,1,1
35951,65333,53,15875,53,197,94,103,2,29,1,1
35952,65026,53,61151,53,194,102,92,2,29,1,1
35953,65194,53,43835,53,181,94,87,2,29,1,1
35954,56509,53,12733,53,1165,94,1071,2,29,1,1
35955,56775,53,64956,53,177,94,83,2,29,1,1
35956,56518,53,42205,53,177,94,83,2,29,1,1
35957,24202,53,24202,53,220,90,130,2,29,1,1
35958,56835,53,60962,53,177,94,83,2,29,1,1
35959,65114,53,14258,53,177,94,83,2,29,1,1
35960,58563,53,4425,53,312,78,234,2,29,1,1
35961,27005,1308,46544,1308,855,126,729,2,30,1,1
35962,56835,53,48670,53,177,94,83,2,30,1,1
35963,60439,47783,16622,47783,70,70,0,2,8,2,0
35964,27005,1105,38006,1105,855,126,729,2,30,1,1
35965,56518,53,9121,53,177,94,83,2,30,1,1
35966,55340,53,17205,53,184,94,90,2,30,1,1
35967,27988,40017,42811,40017,148,86,62,2,30,1,1
35968,9179,443,30869,443,5731,495,5236,14,15,7,7
35969,51918,41488,54208,41488,70,70,0,2,8,2,0
35970,51898,50677,8224,50677,70,70,0,1,5,1,0
35971,58309,53,16090,53,255,86,169,2,30,1,1
35972,50596,443,51132,443,9573,1963,7610,25,72,12,13
35973,64766,53,54775,53,195,102,93,2,30,1,1
35974,58006,80,48045,80,318,192,126,6,21,4,2
35975,27005,1306,39345,1306,858,126,732,2,30,1,1
35976,38011,443,43234,443,6900,4387,2513,37,98,19,18
35977,63962,53,52393,53,483,189,294,6,85,3,3
35978,59180,53,28928,53,260,86,174,2,30,1,1
35979,59986,53,15041,53,186,86,100,2,30,1,1
35980,57987,3478,44464,3478,312,140,172,4,30,2,2
35981,59341,53,56377,53,187,78,109,2,30,1,1
35982,64877,53,52528,53,94,94,0,1,30,1,0
35983,44007,123,12438,123,184,94,90,2,30,1,1
35984,56775,53,53871,53,177,94,83,2,30,1,1
35985,49483,53,48622,53,178,94,84,2,30,1,1
35986,27005,1104,16545,1104,870,126,744,2,30,1,1
35987,27005,1106,55769,1106,903,126,777,2,30,1,1
35988,27005,1103,38860,1103,822,126,696,2,30,1,1
35989,64251,53,6102,53,177,94,83,2,30,1,1
35990,62766,443,11804,443,3370,1226,2144,13,135,6,7
35991,46556,443,5923,443,9316,1720,7596,25,16,13,12
35992,50643,443,60929,443,1512,844,668,16,64,9,7
35993,59680,80,46564,80,5762500,128192,5634308,5613,134,1854,3759
35994,59199,53,18550,53,228,94,134,2,30,1,1
35995,27988,40013,46561,40013,148,86,62,2,30,1,1
35996,27988,40027,31364,40027,148,86,62,2,30,1,1
35997,27988,40001,35761,40001,148,86,62,2,30,1,1
35998,42479,80,8740,80,696,413,283,7,15,5,2
35999,63903,56016,63323,56016,312,132,180,6,6,3,3
36000,51916,24596,6622,24596,70,70,0,2,8,2,0
36001,56860,49991,37577,49991,70,70,0,2,8,2,0
36002,60441,64337,31545,64337,70,70,0,2,8,2,0
36003,53138,15048,61968,15048,70,70,0,2,7,2,0
36004,56596,53,10703,53,194,102,92,2,31,1,1
36005,57990,80,35454,80,42086,9535,32551,48,21,19,29
36006,50652,80,2519,80,97934,5018,92916,124,20,55,69
36007,50914,443,57800,443,22211,8661,13550,173,854,77,96
36008,62985,8920,45375,8920,823,577,246,9,15,5,4
36009,49184,443,9767,443,493152,13222,479930,509,19,184,325
36010,56651,80,31520,80,11855,7269,4586,28,115,15,13
36011,64524,53,20476,53,274,94,180,4,33,2,2
36012,64086,53,31835,53,241,94,147,2,29,1,1
36013,59516,443,21075,443,9943,1882,8061,32,33,15,17
36014,50281,5223,28986,5223,208,60,148,4,11,2,2
36015,65264,53,8238,53,256,88,168,4,35,2,2
36016,55631,53,42735,53,422,96,326,4,42,2,2
36017,36368,80,60128,80,78,78,0,1,5,1,0
36018,40006,80,2393,80,7086,1841,5245,15,92,8,7
36019,48092,443,48092,443,4398,1491,2907,19,27,11,8
36020,53240,443,24615,443,46348,20067,26281,75,60,37,38
36021,56298,53,16841,53,173,94,79,2,29,1,1
36022,55340,53,11264,53,184,94,90,2,30,1,1
36023,57319,53,57319,53,198,90,108,2,29,1,1
36024,39252,53,39252,53,197,90,107,2,29,1,1
36025,39583,53,11422,53,86,86,0,1,30,1,0
36026,64303,53,57962,53,177,94,83,2,29,1,1
36027,55547,53,1923,53,339,94,245,2,30,1,1
36028,56950,53,38998,53,183,86,97,2,29,1,1
36029,64251,53,24532,53,177,94,83,2,30,1,1
36030,56775,53,45440,53,177,94,83,2,30,1,1
36031,27005,1202,59034,1202,865,126,739,2,30,1,1
36032,56896,53,21578,53,177,94,83,2,30,1,1
36033,50263,53,58515,53,771,102,669,2,30,1,1
36034,56509,53,37473,53,1165,94,1071,2,30,1,1
36035,27005,1102,43095,1102,867,126,741,2,30,1,1
36036,48831,443,51436,443,10129,5016,5113,18,120,9,9
36037,60873,53,0,0,86,86,0,1,30,1,0
36038,56583,53,58946,53,177,94,83,2,31,1,1
36039,49701,53,39669,53,197,102,95,2,31,1,1
36040,6881,60026,38643,60026,509,150,359,2,1199,1,1
36041,27988,40005,9616,40005,148,86,62,2,30,1,1
36042,27988,40003,22369,40003,148,86,62,2,30,1,1
36043,37965,44056,39211,44056,158,158,0,1,1199,1,0
36044,53760,443,58528,443,13059,3730,9329,73,3729,32,41
36045,56563,53,56693,53,177,94,83,2,30,1,1
36046,58850,443,9120,443,18715,10778,7937,39,96,16,23
36047,39978,443,47110,443,8030,7064,966,22,30,13,9
36048,60913,80,45601,80,613,539,74,7,15,6,1
36049,42862,443,59113,443,10233,2198,8035,25,81,14,11
36050,38118,443,33958,443,574857,27894,546963,745,57,346,399
36051,57098,53,51101,53,229,94,135,2,30,1,1
36052,50255,53,26984,53,199,102,97,2,30,1,1
36053,50748,443,45400,443,12166,8765,3401,52,561,25,27
36054,51983,443,27301,443,23955,4211,19744,42,46,21,21
36055,9180,443,3139,443,5731,495,5236,14,15,7,7
36056,45458,443,14560,443,7144,4917,2227,36,561,18,18
36057,64251,53,65162,53,177,94,83,2,30,1,1
36058,56038,53,33876,53,177,94,83,2,30,1,1
36059,27988,40005,15276,40005,148,86,62,2,30,1,1
36060,27988,40002,6353,40002,140,78,62,2,30,1,1
36061,50379,53,12803,53,197,102,95,2,30,1,1
36062,62723,443,17496,443,126815,114702,12113,243,86,139,104
36063,50655,80,4984,80,91198,3990,87208,113,19,49,64
36064,51917,26077,8998,26077,70,70,0,2,8,2,0
36065,51919,10298,22024,10298,70,70,0,2,8,2,0
36066,49342,443,27856,443,6944,2404,4540,21,15,10,11
36067,9178,443,33091,443,5731,495,5236,14,15,7,7
36068,58009,80,11441,80,495,192,303,6,21,4,2
36069,56896,53,58642,53,177,94,83,2,30,1,1
36070,27005,1108,29177,1108,873,126,747,2,30,1,1
36071,27005,1305,52487,1305,855,126,729,2,30,1,1
36072,57987,3478,50170,3478,312,140,172,4,30,2,2
36073,64725,53,58713,53,757,102,655,2,30,1,1
36074,50493,443,55037,443,8164,1206,6958,24,139,12,12
36075,49160,38098,52628,38098,676,367,309,6,1200,3,3
36076,27988,40006,7041,40006,148,86,62,2,30,1,1
36077,55084,53,9496,53,177,94,83,2,31,1,1
36078,26081,53,34120,53,75510,75228,282,904,90,902,2
36079,26081,53,4535,53,243667,236247,7420,2897,90,2851,46
36080,19473,12430,61068,12430,491,150,341,2,1200,1,1
36081,48412,443,30459,443,47703,2616,45087,62,120,24,38
36082,62284,443,22217,443,3419,1275,2144,13,135,6,7
36083,37965,51413,62222,51413,158,158,0,1,1200,1,0
36084,21133,39263,6580,39263,323,150,173,2,1200,1,1
36085,57094,443,45074,443,8180,2643,5537,19,121,9,10
36086,64767,443,64767,443,4507,1600,2907,19,31,11,8
36087,50603,443,4652,443,3443,2189,1254,23,72,13,10
36088,60774,40010,46436,40010,316,136,180,6,7,3,3
36089,56639,80,24086,80,234,234,0,4,12,4,0
36090,49270,443,33027,443,10367,2273,8094,43,730,22,21
36091,53702,51413,55761,51413,70,70,0,1,5,1,0
36092,49640,443,18216,443,8607,3608,4999,25,256,14,11
36093,39359,443,36397,443,46113,6913,39200,86,34,41,45
36094,37715,53,37715,53,235,90,145,2,32,1,1
36095,53449,443,9843,443,12474,4810,7664,39,66,19,20
36096,54707,443,60614,443,5826,1199,4627,21,42,11,10
36097,51927,80,21213,80,1945,1002,943,11,20,7,4
36098,49310,53,42489,53,816,102,714,2,30,1,1
36099,50447,53,27142,53,765,102,663,2,30,1,1
36100,49230,53,1845,53,168,86,82,2,31,1,1
36101,55340,53,63068,53,184,94,90,2,31,1,1
36102,58183,445,0,0,70,70,0,1,0,1,0
36103,52018,57866,0,0,66,66,0,1,0,1,0
36104,56101,57470,0,0,66,66,0,1,0,1,0
36105,63060,445,0,0,70,70,0,1,0,1,0
36106,63059,445,0,0,70,70,0,1,0,1,0
36107,41734,57470,0,0,62,62,0,1,0,1,0
36108,58176,445,0,0,70,70,0,1,0,1,0
36109,46859,50584,0,0,62,62,0,1,0,1,0
36110,11821,64147,0,0,146,146,0,1,0,1,0
36111,58457,445,0,0,66,66,0,1,0,1,0
36112,58455,445,0,0,66,66,0,1,0,1,0
36113,6721,37965,0,0,66,66,0,1,0,1,0
36114,63097,44847,0,0,62,62,0,1,0,1,0
36115,1880,57470,0,0,146,146,0,1,0,1,0
36116,6828,64322,0,0,60,60,0,1,0,1,0
36117,53260,36237,0,0,146,146,0,1,0,1,0
36118,58169,445,0,0,70,70,0,1,0,1,0
36119,58168,445,0,0,70,70,0,1,0,1,0
36120,47910,7461,0,0,60,60,0,1,0,1,0
36121,5223,21557,0,0,60,60,0,1,0,1,0
36122,5223,21557,0,0,91,91,0,1,0,1,0
36123,13287,16933,0,0,62,62,0,1,0,1,0
36124,63052,445,0,0,70,70,0,1,0,1,0
36125,26889,50265,0,0,66,66,0,1,0,1,0
36126,7968,2767,0,0,66,66,0,1,0,1,0
36127,63046,445,0,0,70,70,0,1,0,1,0
36128,63043,445,0,0,70,70,0,1,0,1,0
36129,63042,445,0,0,70,70,0,1,0,1,0
36130,61595,50939,0,0,145,145,0,1,0,1,0
36131,58450,445,0,0,66,66,0,1,0,1,0
36132,58163,445,0,0,70,70,0,1,0,1,0
36133,58161,445,0,0,70,70,0,1,0,1,0
36134,62937,30975,0,0,185,185,0,1,0,1,0
36135,58446,445,0,0,66,66,0,1,0,1,0
36136,58442,445,0,0,66,66,0,1,0,1,0
36137,58445,445,0,0,66,66,0,1,0,1,0
36138,58436,445,0,0,66,66,0,1,0,1,0
36139,58439,445,0,0,66,66,0,1,0,1,0
36140,58435,445,0,0,66,66,0,1,0,1,0
36141,58440,445,0,0,66,66,0,1,0,1,0
36142,10243,36237,0,0,62,62,0,1,0,1,0
36143,1054,57470,0,0,62,62,0,1,0,1,0
36144,45941,23386,0,0,60,60,0,1,0,1,0
36145,63036,445,0,0,70,70,0,1,0,1,0
36146,63033,445,0,0,70,70,0,1,0,1,0
36147,63032,445,0,0,70,70,0,1,0,1,0
36148,63029,445,0,0,70,70,0,1,0,1,0
36149,58157,445,0,0,70,70,0,1,0,1,0
36150,50675,56205,0,0,66,66,0,1,0,1,0
36151,62765,16933,0,0,66,66,0,1,0,1,0
36152,52914,37965,0,0,66,66,0,1,0,1,0
36153,37837,37965,0,0,62,62,0,1,0,1,0
36154,993,16279,0,0,129,129,0,1,0,1,0
36155,58155,445,0,0,70,70,0,1,0,1,0
36156,58973,57470,0,0,62,62,0,1,0,1,0
36157,52740,51505,0,0,66,66,0,1,0,1,0
36158,41756,56205,0,0,62,62,0,1,0,1,0
36159,9494,23,0,0,60,60,0,1,0,1,0
36160,63765,51221,0,0,62,62,0,1,0,1,0
36161,63027,445,0,0,70,70,0,1,0,1,0
36162,63022,445,0,0,70,70,0,1,0,1,0
36163,63026,445,0,0,70,70,0,1,0,1,0
36164,58430,445,0,0,66,66,0,1,0,1,0
36165,58151,445,0,0,70,70,0,1,0,1,0
36166,63020,445,0,0,70,70,0,1,0,1,0
36167,58426,445,0,0,66,66,0,1,0,1,0
36168,58424,445,0,0,66,66,0,1,0,1,0
36169,58422,445,0,0,66,66,0,1,0,1,0
36170,53218,56205,0,0,66,66,0,1,0,1,0
36171,35722,30188,0,0,62,62,0,1,0,1,0
36172,58420,445,0,0,66,66,0,1,0,1,0
36173,32051,37965,0,0,62,62,0,1,0,1,0
36174,63015,445,0,0,70,70,0,1,0,1,0
36175,26758,50584,0,0,66,66,0,1,0,1,0
36176,12031,36237,0,0,66,66,0,1,0,1,0
36177,63008,445,0,0,70,70,0,1,0,1,0
36178,63007,445,0,0,70,70,0,1,0,1,0
36179,65529,35440,0,0,62,62,0,1,0,1,0
36180,58138,445,0,0,70,70,0,1,0,1,0
36181,52836,36829,0,0,66,66,0,1,0,1,0
36182,58409,445,0,0,66,66,0,1,0,1,0
36183,58135,445,0,0,70,70,0,1,0,1,0
36184,57368,7302,0,0,66,66,0,1,0,1,0
36185,59563,30188,0,0,66,66,0,1,0,1,0
36186,61278,56205,0,0,66,66,0,1,0,1,0
36187,63527,50584,0,0,66,66,0,1,0,1,0
36188,58402,445,0,0,66,66,0,1,0,1,0
36189,62992,445,0,0,70,70,0,1,0,1,0
36190,58131,445,0,0,70,70,0,1,0,1,0
36191,58129,445,0,0,70,70,0,1,0,1,0
36192,45941,23388,0,0,60,60,0,1,0,1,0
36193,40005,36237,0,0,62,62,0,1,0,1,0
36194,26448,9192,0,0,145,145,0,1,0,1,0
36195,58127,445,0,0,70,70,0,1,0,1,0
36196,58399,445,0,0,66,66,0,1,0,1,0
36197,51320,37965,0,0,62,62,0,1,0,1,0
36198,14997,57470,0,0,72,72,0,1,0,1,0
36199,58392,445,0,0,66,66,0,1,0,1,0
36200,48660,21622,0,0,143,143,0,1,0,1,0
36201,58387,445,0,0,66,66,0,1,0,1,0
36202,50264,443,29730,443,430,60,370,7,24,2,5
36203,43310,80,46970,80,811,671,140,6,32,4,2
36204,14102,80,14102,80,722,300,422,11,158,5,6
36205,45846,443,37447,443,4819,829,3990,15,40,8,7
36206,57987,80,45212,80,2803,1625,1178,16,21,9,7
36207,57031,53,13224,53,711,87,624,2,30,1,1
36208,34784,53,61391,53,168,78,90,2,30,1,1
36209,55655,63670,50631,63670,70,70,0,1,5,1,0
36210,61489,443,63810,443,4624,1191,3433,23,75,14,9
36211,51964,443,28760,443,54794,16744,38050,82,71,42,40
36212,64396,53,52154,53,349,91,258,2,30,1,1
36213,61091,443,61091,443,18924,5378,13546,33,18,19,14
36214,65486,53,11134,53,760,97,663,2,30,1,1
36215,55905,53,39225,53,754,94,660,2,30,1,1
36216,56583,53,53516,53,170,87,83,2,31,1,1
36217,55508,53,1825,53,814,110,704,2,30,1,1
36218,59892,443,22013,443,1813,1004,809,16,28,8,8
36219,49712,53,29972,53,172,88,84,2,30,1,1
36220,65361,53,33877,53,760,97,663,2,30,1,1
36221,59890,443,5968,443,1401,864,537,12,28,6,6
36222,50390,53,29650,53,772,103,669,2,30,1,1
36223,55466,53,2778,53,170,87,83,2,30,1,1
36224,59887,443,6975,443,1576,973,603,14,28,7,7
36225,59891,443,7306,443,1813,1004,809,16,28,8,8
36226,50601,443,53899,443,5035,3194,1841,23,72,12,11
36227,59881,443,61673,443,302,120,182,6,31,3,3
36228,57400,443,4312,443,10169,1957,8212,26,136,11,15
36229,40309,443,48693,443,51588,40242,11346,107,418,53,54
36230,51913,52188,11778,52188,70,70,0,2,8,2,0
36231,62344,80,50382,80,1892,583,1309,12,16,6,6
36232,57843,443,8894,443,130,70,60,2,15,1,1
36233,50277,443,65171,443,268,120,148,5,11,3,2
36234,49254,53,31955,53,814,110,704,2,30,1,1
36235,49690,53,24171,53,216,110,106,2,30,1,1
36236,47994,443,47994,443,4485,1578,2907,19,28,11,8
36237,60659,443,57729,443,8175,3047,5128,26,165,12,14
36238,56596,53,38999,53,188,96,92,2,31,1,1
36239,60899,7275,19563,7275,2875,449,2426,12,16,7,5
36240,49302,443,39111,443,454,262,192,8,27,5,3
36241,59888,443,28259,443,1401,864,537,12,28,6,6
36242,59884,443,34275,443,1401,864,537,12,28,6,6
36243,56858,32330,62382,32330,70,70,0,2,8,2,0
36244,45964,59999,45964,59999,60,60,0,1,5,1,0
36245,59889,443,31832,443,1576,973,603,14,28,7,7
36246,55658,45261,61900,45261,70,70,0,1,5,1,0
36247,59885,443,10109,443,1401,864,537,12,28,6,6
36248,60884,443,60884,443,4918,1626,3292,17,17,10,7
36249,41247,80,40368,80,78,78,0,1,5,1,0
36250,50493,443,36062,443,2147464,35144,2112320,1951,72,540,1411
36251,61273,443,61273,443,8480,2451,6029,21,17,12,9
36252,49901,53,7736,53,272,122,150,2,30,1,1
36253,64857,53,57218,53,332,104,228,2,30,1,1
36254,56038,53,40412,53,170,87,83,2,30,1,1
36255,49234,53,23533,53,206,97,109,2,30,1,1
36256,49989,53,26196,53,346,111,235,2,30,1,1
36257,49690,53,35001,53,216,110,106,2,30,1,1
36258,65111,443,62828,443,3255,1259,1996,13,135,7,6
36259,57366,53,36112,53,711,87,624,2,31,1,1
36260,54956,53,35292,53,711,87,624,2,31,1,1
36261,47595,33440,0,0,106,106,0,1,61,1,0
36262,57348,443,25316,443,13048,4976,8072,40,140,18,22
36263,52850,443,50911,443,4982,3414,1568,19,362,9,10
36264,57218,53,55252,53,789,110,679,2,31,1,1
36265,49414,53,16481,53,770,102,668,2,31,1,1
36266,49929,53,13431,53,260,124,136,2,31,1,1
36267,56464,53,12940,53,170,87,83,2,31,1,1
36268,49862,53,62626,53,744,89,655,2,31,1,1
36269,50178,53,23159,53,758,96,662,2,31,1,1
36270,56420,443,5096,443,9876,5607,4269,66,122,35,31
36271,42555,443,40081,443,14262,5874,8388,31,138,15,16
36272,49191,53,32868,53,186,95,91,2,31,1,1
36273,52838,443,32099,443,207289,9233,198056,234,136,83,151
36274,22300,51505,0,0,66,66,0,1,0,1,0
36275,58922,57470,0,0,66,66,0,1,0,1,0
36276,58120,445,0,0,70,70,0,1,0,1,0
36277,4760,44847,0,0,62,62,0,1,0,1,0
36278,33627,36237,0,0,66,66,0,1,0,1,0
36279,58118,445,0,0,70,70,0,1,0,1,0
36280,60754,53,60754,53,198,90,108,2,30,1,1
36281,49300,5228,46650,5228,12589,6479,6110,172,4146,86,86
36282,52853,443,45061,443,130,70,60,2,15,1,1
36283,60943,443,53022,443,4960,896,4064,14,18,8,6
36284,49690,53,62022,53,322,110,212,4,30,2,2
36285,49690,53,31414,53,216,110,106,2,30,1,1
36286,9160,443,28992,443,5727,491,5236,14,15,7,7
36287,43934,443,29568,443,2548,1257,1291,15,416,8,7
36288,55240,443,28397,443,6902,1936,4966,22,45,11,11
36289,52802,53,8957,53,350,210,140,6,14,4,2
36290,53139,50285,41730,50285,320,140,180,6,6,3,3
36291,53721,8999,32848,8999,320,140,180,6,6,3,3
36292,38261,443,49964,443,134,60,74,3,4,2,1
36293,9136,80,1532,80,908,842,66,7,15,6,1
36294,49178,53,11567,53,822,102,720,2,29,1,1
36295,50379,53,49959,53,197,102,95,2,29,1,1
36296,57610,443,60687,443,4327,674,3653,14,25,8,6
36297,49339,80,8376,80,1467,361,1106,10,15,5,5
36298,49839,443,39363,443,17843,13076,4767,27,134,17,10
36299,54819,443,51134,443,8093,1263,6830,25,39,13,12
36300,55241,443,32846,443,8080,2630,5450,24,45,12,12
36301,54708,443,18474,443,5702,1143,4559,21,41,12,9
36302,60513,443,43919,443,9047,2015,7032,25,39,13,12
36303,54709,443,26640,443,5493,933,4560,18,41,9,9
36304,53695,21965,20178,21965,2044,1143,901,19,16,9,10
36305,52801,443,38731,443,8308,3201,5107,36,1401,19,17
36306,53704,15000,63052,15000,70,70,0,1,4,1,0
36307,57210,8525,57210,8525,138,78,60,2,5,1,1
36308,9161,443,17981,443,5658,501,5157,14,15,7,7
36309,1558,80,1558,80,6377,703,5674,13,15,6,7
36310,50650,80,8138,80,129929,6216,123713,164,21,74,90
36311,54033,443,63656,443,190,70,120,4,15,2,2
36312,49187,2710,40478,2710,70,70,0,2,7,2,0
36313,34951,443,13510,443,3308,2109,1199,30,751,16,14
36314,51961,443,43999,443,6913,1658,5255,22,17,12,10
36315,57986,443,51773,443,124014,6270,117744,175,27,69,106
36316,48740,443,37273,443,7868,2194,5674,26,36,13,13
36317,42881,443,29777,443,134,60,74,3,4,2,1
36318,51820,80,11900,80,366,240,126,7,25,5,2
36319,53703,16426,38652,16426,70,70,0,1,4,1,0
36320,60706,443,17990,443,4974,836,4138,16,40,8,8
36321,50605,443,56643,443,1766,975,791,15,71,9,6
36322,49852,53,8412,53,94,94,0,1,29,1,0
36323,64766,53,31618,53,195,102,93,2,29,1,1
36324,56835,53,56114,53,177,94,83,2,29,1,1
36325,38264,443,28661,443,134,60,74,3,4,2,1
36326,65264,53,15709,53,178,94,84,2,29,1,1
36327,55084,53,64405,53,177,94,83,2,29,1,1
36328,49230,53,46684,53,168,86,82,2,30,1,1
36329,50255,53,25168,53,199,102,97,2,29,1,1
36330,53306,53,0,0,86,86,0,1,29,1,0
36331,55656,31165,38946,31165,70,70,0,1,5,1,0
36332,40701,5223,47765,5223,5723,1105,4618,27,473,10,17
36333,44583,443,45015,443,6834,3797,3037,48,97,23,25
36334,38114,443,10061,443,863998,37140,826858,1072,61,479,593
36335,57431,53,35038,53,392,134,258,2,30,1,1
36336,55466,53,45668,53,177,94,83,2,30,1,1
36337,59654,53,16319,53,199,94,105,2,30,1,1
36338,65200,53,5141,53,214,110,104,2,30,1,1
36339,64524,53,42733,53,184,94,90,2,31,1,1
36340,9156,443,14551,443,5734,498,5236,14,15,7,7
36341,65496,53,41450,53,280,96,184,4,34,2,2
36342,49874,443,49241,443,15358,8278,7080,47,19,24,23
36343,57195,53,19593,53,195,102,93,2,33,1,1
36344,53718,1053,4101,1053,320,140,180,6,8,3,3
36345,51896,43357,20029,43357,70,70,0,1,5,1,0
36346,35570,443,53736,443,3297,2327,970,22,37,11,11
36347,55239,443,1727,443,9352,2524,6828,27,46,14,13
36348,64908,53,50064,53,812,110,702,2,30,1,1
36349,57332,53,48938,53,168,86,82,2,30,1,1
36350,64888,53,19204,53,718,94,624,2,30,1,1
36351,55659,37787,47813,37787,70,70,0,2,8,2,0
36352,64274,53,64916,53,110,110,0,1,30,1,0
36353,56583,53,7154,53,177,94,83,2,30,1,1
36354,49742,53,51185,53,216,110,106,2,30,1,1
36355,6881,63963,28408,63963,207,118,89,2,1200,1,1
36356,63988,53,36168,53,195,102,93,2,30,1,1
36357,30188,17677,54608,17677,11116,4642,6474,64,1457,30,34
36358,65200,53,50135,53,214,110,104,2,30,1,1
36359,50713,53,50713,53,198,90,108,2,30,1,1
36360,49593,5228,25502,5228,9720,2717,7003,67,1019,34,33
36361,64576,443,6624,443,8503,1969,6534,24,32,13,11
36362,43835,443,28215,443,11422,2361,9061,26,505,10,16
36363,51893,63924,1367,63924,70,70,0,1,5,1,0
36364,9167,443,11467,443,4072,434,3638,12,15,6,6
36365,56954,80,1117,80,1469,970,499,9,65,6,3
36366,49386,443,47173,443,6250,1765,4485,22,15,12,10
36367,38119,53,41188,53,199,94,105,2,30,1,1
36368,49742,53,16673,53,216,110,106,2,30,1,1
36369,49257,53,6745,53,199,102,97,2,30,1,1
36370,56596,53,31650,53,194,102,92,2,30,1,1
36371,57201,53,54960,53,173,94,79,2,30,1,1
36372,7946,23,7946,23,130,66,64,2,5,1,1
36373,64274,53,21757,53,299,104,195,4,35,2,2
36374,39350,3389,39350,3389,3910,1805,2105,20,18,12,8
36375,53699,36887,39756,36887,492,306,186,8,15,5,3
36376,53254,443,33543,443,4498,916,3582,18,17,9,9
36377,9162,443,30671,443,5658,501,5157,14,15,7,7
36378,9155,443,45491,443,5734,498,5236,14,15,7,7
36379,49698,53,53512,53,184,102,82,2,30,1,1
36380,49742,53,36313,53,216,110,106,2,30,1,1
36381,60740,443,50087,443,12605,5558,7047,42,101,18,24
36382,57554,443,18344,443,7323,2654,4669,23,30,13,10
36383,48739,443,34033,443,7107,1636,5471,24,38,11,13
36384,52892,443,14885,443,130,70,60,2,14,1,1
36385,57885,80,59656,80,32460,9354,23106,67,71,40,27
36386,48736,443,16569,443,371295,17988,353307,571,40,233,338
36387,56493,443,6298,443,10532,6786,3746,55,81,28,27
36388,53727,8999,52156,8999,320,140,180,6,5,3,3
36389,49310,53,61139,53,186,95,91,3,33,2,1
36390,51818,80,64733,80,366,240,126,7,25,5,2
36391,50642,443,51887,443,10981,2295,8686,32,63,16,16
36392,42880,443,28151,443,134,60,74,3,4,2,1
36393,51894,26116,8093,26116,70,70,0,1,5,1,0
36394,37886,443,62818,443,134,60,74,3,5,2,1
36395,49561,80,28691,80,57215,680,56535,47,135,7,40
36396,9163,443,23024,443,5658,501,5157,14,15,7,7
36397,49429,443,22034,443,990201,31101,959100,1061,192,383,678
36398,49438,443,47897,443,135574,9426,126148,201,183,102,99
36399,56707,443,1984,443,5928,1558,4370,22,20,13,9
36400,49178,53,26968,53,199,102,97,2,29,1,1
36401,56563,53,35411,53,177,94,83,2,29,1,1
36402,9157,443,57140,443,5734,498,5236,14,15,7,7
36403,49698,53,38054,53,184,102,82,2,30,1,1
36404,51897,57057,43684,57057,70,70,0,1,5,1,0
36405,50255,53,55681,53,199,102,97,2,29,1,1
36406,49257,53,51437,53,199,102,97,2,30,1,1
36407,49712,53,30095,53,178,94,84,2,29,1,1
36408,49423,443,63927,443,4287346,130607,4156739,4409,282,1473,2936
36409,33418,443,42698,443,4764,1876,2888,22,81,10,12
36410,39661,7275,31233,7275,8822,1485,7337,26,15,13,13
36411,56038,53,20578,53,177,94,83,2,29,1,1
36412,55466,53,37366,53,177,94,83,2,30,1,1
36413,49712,53,3465,53,178,94,84,2,30,1,1
36414,57201,53,44480,53,165,86,79,2,30,1,1
36415,56038,53,24286,53,177,94,83,2,30,1,1
36416,49701,53,24977,53,197,102,95,2,30,1,1
36417,51120,53,11316,53,168,78,90,2,30,1,1
36418,49713,53,44635,53,177,94,83,2,30,1,1
36419,23283,53,47679,53,344,78,266,2,30,1,1
36420,33638,443,11926,443,1784,1010,774,16,185,9,7
36421,57470,56250,44821,56250,330,330,0,6,1199,6,0
36422,37965,54777,17164,54777,158,158,0,1,1200,1,0
36423,59879,443,12932,443,302,120,182,6,32,3,3
36424,51895,17172,22553,17172,70,70,0,1,5,1,0
36425,55657,37273,52099,37273,70,70,0,1,5,1,0
36426,39796,443,39796,443,4744,1837,2907,19,27,11,8
36427,49508,53,13388,53,199,102,97,2,30,1,1
36428,56953,80,31471,80,37311,3340,33971,52,65,26,26
36429,38269,443,44100,443,130,70,60,2,15,1,1
36430,54537,80,39580,80,4096,3455,641,13,15,8,5
36431,65040,53,27133,53,256,88,168,4,32,2,2
36432,55661,49671,9206,49671,70,70,0,2,8,2,0
36433,60773,20010,34411,20010,70,70,0,2,8,2,0
36434,51674,80,17494,80,533166,22786,510380,905,50,321,584
36435,53700,45682,9190,45682,492,306,186,8,15,5,3
36436,9158,443,59645,443,5727,491,5236,14,15,7,7
36437,49713,53,37729,53,177,94,83,2,30,1,1
36438,49359,53,8497,53,216,110,106,2,30,1,1
36439,65020,443,45828,443,5507,3397,2110,13,120,7,6
36440,50583,80,64336,80,630930,27504,603426,812,74,381,431
36441,9159,443,37775,443,5727,491,5236,14,15,7,7
36442,49535,53,29045,53,771,102,669,2,30,1,1
36443,42996,53,58544,53,168,78,90,2,30,1,1
36444,57332,53,59062,53,184,102,82,2,30,1,1
36445,57389,53,29962,53,193,102,91,2,30,1,1
36446,60546,443,51628,443,52666,33941,18725,95,139,49,46
36447,63567,443,49835,443,2467,1198,1269,22,186,11,11
36448,57470,51745,40205,51745,3214,1260,1954,33,1371,17,16
36449,64410,53,61695,53,196,102,94,2,30,1,1
36450,21054,53,21054,53,216,98,118,2,30,1,1
36451,50022,53,19595,53,182,94,88,2,30,1,1
36452,63988,53,51956,53,195,102,93,2,30,1,1
36453,55503,53,56462,53,216,110,106,2,30,1,1
36454,57333,53,18124,53,342,110,232,2,30,1,1
36455,56469,53,63453,53,177,94,83,2,31,1,1
36456,56939,53,41325,53,216,110,106,2,31,1,1
36457,59090,443,47184,443,1469,702,767,20,120,10,10
36458,52339,443,45302,443,4362,1266,3096,26,129,11,15
36459,62692,443,51155,443,14518,2409,12109,23,135,10,13
36460,58056,443,56911,443,866223,30135,836088,916,138,300,616
36461,55921,443,24781,443,4348,1536,2812,14,121,6,8
36462,37965,1025,42195,1025,158,158,0,1,1200,1,0
36463,37965,6881,15418,6881,1534,248,1286,4,1200,2,2
36464,65493,443,24258,443,7975,423,7552,15,120,6,9
36465,6881,7999,34044,7999,238,118,120,2,1199,1,1
36466,57389,53,9146,53,193,102,91,2,31,1,1
36467,33748,443,24979,443,70,70,0,2,5,2,0
36468,59607,53,65103,53,209,102,107,2,30,1,1
36469,49954,53,49870,53,216,110,106,2,30,1,1
36470,55513,53,1888,53,184,94,90,2,30,1,1
36471,50375,53,64896,53,211,110,101,2,30,1,1
36472,49359,53,18321,53,216,110,106,2,30,1,1
36473,56520,53,53336,53,177,94,83,2,31,1,1
36474,63566,443,27176,443,2537,1268,1269,23,186,12,11
36475,37965,32405,17637,32405,766,248,518,4,1200,2,2
36476,28021,443,4074,443,5578,1390,4188,19,16,9,10
36477,49508,53,17731,53,199,102,97,2,30,1,1
36478,55503,53,44075,53,216,110,106,2,30,1,1
36479,49701,53,55177,53,197,102,95,2,30,1,1
36480,56388,53,20771,53,816,102,714,2,30,1,1
36481,56484,53,42861,53,214,110,104,2,31,1,1
36482,57917,6789,34924,6789,8164,1336,6828,34,18,18,16
36483,55370,443,38504,443,3055,953,2102,23,50,10,13
36484,50473,80,50473,80,78355,11395,66960,122,27,62,60
36485,26847,443,30937,443,10585,3919,6666,33,80,16,17
36486,5588,5588,0,0,3498,1872,1626,48,199,24,24
36487,55740,53,13751,53,228,110,118,2,30,1,1
36488,56413,51221,0,0,62,62,0,1,0,1,0
36489,58117,445,0,0,70,70,0,1,0,1,0
36490,62983,445,0,0,70,70,0,1,0,1,0
36491,62982,445,0,0,70,70,0,1,0,1,0
36492,62980,445,0,0,70,70,0,1,0,1,0
36493,58115,445,0,0,70,70,0,1,0,1,0
36494,58480,57470,0,0,66,66,0,1,0,1,0
36495,58375,445,0,0,66,66,0,1,0,1,0
36496,58113,445,0,0,70,70,0,1,0,1,0
36497,58377,445,0,0,66,66,0,1,0,1,0
36498,58376,445,0,0,66,66,0,1,0,1,0
36499,58112,445,0,0,70,70,0,1,0,1,0
36500,58374,445,0,0,66,66,0,1,0,1,0
36501,58373,445,0,0,66,66,0,1,0,1,0
36502,58372,445,0,0,66,66,0,1,0,1,0
36503,58371,445,0,0,66,66,0,1,0,1,0
36504,58369,445,0,0,66,66,0,1,0,1,0
36505,4419,23,0,0,60,60,0,1,0,1,0
36506,26229,21247,0,0,66,66,0,1,0,1,0
36507,39324,64147,0,0,62,62,0,1,0,1,0
36508,57706,64147,0,0,66,66,0,1,0,1,0
36509,58097,445,0,0,70,70,0,1,0,1,0
36510,58096,445,0,0,70,70,0,1,0,1,0
36511,58091,445,0,0,70,70,0,1,0,1,0
36512,28809,50584,0,0,62,62,0,1,0,1,0
36513,58086,445,0,0,70,70,0,1,0,1,0
36514,58087,445,0,0,70,70,0,1,0,1,0
36515,12465,11392,0,0,62,62,0,1,0,1,0
36516,53906,37965,0,0,62,62,0,1,0,1,0
36517,62977,445,0,0,70,70,0,1,0,1,0
36518,62976,445,0,0,70,70,0,1,0,1,0
36519,62972,445,0,0,70,70,0,1,0,1,0
36520,62965,445,0,0,70,70,0,1,0,1,0
36521,9494,23,0,0,60,60,0,1,0,1,0
36522,58356,445,0,0,66,66,0,1,0,1,0
36523,58355,445,0,0,66,66,0,1,0,1,0
36524,58354,445,0,0,66,66,0,1,0,1,0
36525,61451,17500,0,0,66,66,0,1,0,1,0
36526,16382,17500,0,0,62,62,0,1,0,1,0
36527,44554,5900,0,0,60,60,0,1,0,1,0
36528,16377,21247,0,0,62,62,0,1,0,1,0
36529,51414,22,0,0,60,60,0,1,0,1,0
36530,58075,445,0,0,70,70,0,1,0,1,0
36531,62960,445,0,0,70,70,0,1,0,1,0
36532,52655,15503,0,0,146,146,0,1,0,1,0
36533,62956,445,0,0,70,70,0,1,0,1,0
36534,62954,445,0,0,70,70,0,1,0,1,0
36535,62953,445,0,0,70,70,0,1,0,1,0
36536,17344,62413,0,0,62,62,0,1,0,1,0
36537,46286,21247,0,0,62,62,0,1,0,1,0
36538,14925,57470,0,0,145,145,0,1,0,1,0
36539,58071,445,0,0,70,70,0,1,0,1,0
36540,5462,21247,0,0,66,66,0,1,0,1,0
36541,56381,51505,0,0,62,62,0,1,0,1,0
36542,25651,48817,0,0,140,140,0,1,0,1,0
36543,40369,57470,0,0,62,62,0,1,0,1,0
36544,1044,23,0,0,60,60,0,1,0,1,0
36545,58062,445,0,0,70,70,0,1,0,1,0
36546,58061,445,0,0,70,70,0,1,0,1,0
36547,58059,445,0,0,70,70,0,1,0,1,0
36548,13559,57866,0,0,66,66,0,1,0,1,0
36549,64586,50584,0,0,62,62,0,1,0,1,0
36550,39516,23,0,0,60,60,0,1,0,1,0
36551,58058,445,0,0,70,70,0,1,0,1,0
36552,62941,445,0,0,70,70,0,1,0,1,0
36553,62938,445,0,0,70,70,0,1,0,1,0
36554,62936,445,0,0,70,70,0,1,0,1,0
36555,58054,445,0,0,70,70,0,1,0,1,0
36556,21034,50265,0,0,66,66,0,1,0,1,0
36557,58344,445,0,0,66,66,0,1,0,1,0
36558,51535,44847,0,0,62,62,0,1,0,1,0
36559,8999,57470,0,0,146,146,0,1,0,1,0
36560,64824,37965,0,0,62,62,0,1,0,1,0
36561,64815,37965,0,0,66,66,0,1,0,1,0
36562,58048,445,0,0,70,70,0,1,0,1,0
36563,39617,50584,0,0,62,62,0,1,0,1,0
36564,62935,445,0,0,70,70,0,1,0,1,0
36565,62933,445,0,0,70,70,0,1,0,1,0
36566,59626,22114,0,0,66,66,0,1,0,1,0
36567,48488,50584,0,0,62,62,0,1,0,1,0
36568,16654,50265,0,0,62,62,0,1,0,1,0
36569,58327,445,0,0,66,66,0,1,0,1,0
36570,58326,445,0,0,66,66,0,1,0,1,0
36571,58041,445,0,0,70,70,0,1,0,1,0
36572,14844,37965,0,0,62,62,0,1,0,1,0
36573,58040,445,0,0,70,70,0,1,0,1,0
36574,62396,51050,0,0,146,146,0,1,0,1,0
36575,35833,23,0,0,60,60,0,1,0,1,0
36576,12074,10197,0,0,72,72,0,1,0,1,0
36577,28899,37965,0,0,62,62,0,1,0,1,0
36578,62923,445,0,0,70,70,0,1,0,1,0
36579,58034,445,0,0,70,70,0,1,0,1,0
36580,62916,445,0,0,70,70,0,1,0,1,0
36581,62914,445,0,0,70,70,0,1,0,1,0
36582,62913,445,0,0,70,70,0,1,0,1,0
36583,58033,445,0,0,70,70,0,1,0,1,0
36584,58321,445,0,0,66,66,0,1,0,1,0
36585,47134,37965,0,0,62,62,0,1,0,1,0
36586,15933,64147,0,0,62,62,0,1,0,1,0
36587,9494,23,0,0,60,60,0,1,0,1,0
36588,11574,51505,0,0,62,62,0,1,0,1,0
36589,58313,445,0,0,66,66,0,1,0,1,0
36590,58315,445,0,0,66,66,0,1,0,1,0
36591,58318,445,0,0,66,66,0,1,0,1,0
36592,58314,445,0,0,66,66,0,1,0,1,0
36593,58311,445,0,0,66,66,0,1,0,1,0
36594,58309,445,0,0,66,66,0,1,0,1,0
36595,58308,445,0,0,66,66,0,1,0,1,0
36596,48219,55442,0,0,62,62,0,1,0,1,0
36597,58029,445,0,0,70,70,0,1,0,1,0
36598,62907,445,0,0,70,70,0,1,0,1,0
36599,62905,445,0,0,70,70,0,1,0,1,0
36600,62903,445,0,0,70,70,0,1,0,1,0
36601,62902,445,0,0,70,70,0,1,0,1,0
36602,33359,443,23934,443,9818,2036,7782,28,31,12,16
36603,9494,23,0,0,60,60,0,1,0,1,0
36604,52432,50265,0,0,66,66,0,1,0,1,0
36605,58028,445,0,0,70,70,0,1,0,1,0
36606,49958,36829,0,0,66,66,0,1,0,1,0
36607,45833,13494,0,0,60,60,0,1,0,1,0
36608,19204,48817,0,0,148,148,0,1,0,1,0
36609,0,0,0,0,320,320,0,5,0,5,0
36610,50767,57470,0,0,62,62,0,1,0,1,0
36611,12951,50584,0,0,66,66,0,1,0,1,0
36612,51592,51505,0,0,66,66,0,1,0,1,0
36613,55966,35440,0,0,66,66,0,1,0,1,0
36614,16330,50584,0,0,62,62,0,1,0,1,0
36615,52614,44847,0,0,62,62,0,1,0,1,0
36616,57849,50584,0,0,66,66,0,1,0,1,0
36617,65085,22114,0,0,66,66,0,1,0,1,0
36618,58023,445,0,0,70,70,0,1,0,1,0
36619,62900,445,0,0,70,70,0,1,0,1,0
36620,62896,445,0,0,70,70,0,1,0,1,0
36621,62895,445,0,0,70,70,0,1,0,1,0
36622,18876,44847,0,0,66,66,0,1,0,1,0
36623,58582,50584,0,0,66,66,0,1,0,1,0
36624,58301,445,0,0,66,66,0,1,0,1,0
36625,36579,30188,0,0,66,66,0,1,0,1,0
36626,62892,445,0,0,70,70,0,1,0,1,0
36627,58298,445,0,0,66,66,0,1,0,1,0
36628,58296,445,0,0,66,66,0,1,0,1,0
36629,58294,445,0,0,66,66,0,1,0,1,0
36630,9018,23,0,0,60,60,0,1,0,1,0
36631,61408,30188,0,0,62,62,0,1,0,1,0
36632,58292,445,0,0,66,66,0,1,0,1,0
36633,1035,64147,0,0,145,145,0,1,0,1,0
36634,34301,21247,0,0,146,146,0,1,0,1,0
36635,55553,37965,0,0,66,66,0,1,0,1,0
36636,58010,445,0,0,70,70,0,1,0,1,0
36637,62887,445,0,0,70,70,0,1,0,1,0
36638,62883,445,0,0,70,70,0,1,0,1,0
36639,62880,445,0,0,70,70,0,1,0,1,0
36640,46516,57470,0,0,62,62,0,1,0,1,0
36641,27844,52700,0,0,74,74,0,1,0,1,0
36642,26254,56205,0,0,66,66,0,1,0,1,0
36643,58007,445,0,0,70,70,0,1,0,1,0
36644,58282,445,0,0,66,66,0,1,0,1,0
36645,41674,5900,0,0,60,60,0,1,0,1,0
36646,57747,15000,28219,15000,130,70,60,2,6,1,1
36647,57134,53,50387,53,1425,97,1328,4,53,2,2
36648,57438,53,17355,53,782,105,677,2,30,1,1
36649,64902,53,51695,53,414,106,308,2,30,1,1
36650,50669,80,58976,80,1485,806,679,13,15,7,6
36651,55803,53,50944,53,760,97,663,2,30,1,1
36652,57315,53,60318,53,748,95,653,2,30,1,1
36653,56661,443,26302,443,18375,7252,11123,47,40,24,23
36654,53589,3389,53589,3389,3407,1518,1889,16,16,9,7
36655,53719,49306,59032,49306,70,70,0,2,8,2,0
36656,57188,53,2618,53,744,89,655,2,30,1,1
36657,49359,53,18838,53,216,110,106,2,30,1,1
36658,50475,80,50475,80,26023,3118,22905,38,24,18,20
36659,63882,49163,63966,49163,66,66,0,1,5,1,0
36660,33387,80,58397,80,9105,1930,7175,18,16,9,9
36661,64971,53,64971,53,218,85,133,2,30,1,1
36662,49257,53,2534,53,198,101,97,2,30,1,1
36663,5612,53,5612,53,227,89,138,2,30,1,1
36664,56433,53,27409,53,170,87,83,2,31,1,1
36665,50418,53,2799,53,760,96,664,2,31,1,1
36666,65387,53,24725,53,272,122,150,2,30,1,1
36667,50253,53,9014,53,756,95,661,2,30,1,1
36668,55377,53,19699,53,1428,103,1325,4,32,2,2
36669,55083,53,35659,53,216,110,106,2,30,1,1
36670,55582,53,45316,53,170,87,83,2,30,1,1
36671,64332,53,24629,53,374,96,278,4,55,2,2
36672,55513,53,5223,53,184,94,90,2,30,1,1
36673,61499,443,53254,443,15584,2626,12958,34,37,18,16
36674,65055,53,55759,53,1426,98,1328,4,55,2,2
36675,57011,53,6103,53,770,101,669,2,30,1,1
36676,51910,60443,64340,60443,70,70,0,2,8,2,0
36677,38060,443,63699,443,27679,15839,11840,75,103,39,36
36678,50476,80,50476,80,28872,5086,23786,50,24,24,26
36679,49337,53,4969,53,303,97,206,4,56,2,2
36680,57284,53,3184,53,212,108,104,2,31,1,1
36681,65419,53,10153,53,198,101,97,2,31,1,1
36682,49619,53,50189,53,789,110,679,2,30,1,1
36683,61059,80,61059,80,16824,810,16014,22,15,8,14
36684,56601,443,39654,443,8978,3243,5735,22,45,13,9
36685,57215,53,55858,53,810,108,702,2,30,1,1
36686,56390,53,2004,53,701,88,613,2,30,1,1
36687,50478,80,50478,80,28032,3868,24164,47,24,23,24
36688,56857,43237,16433,43237,70,70,0,2,8,2,0
36689,64530,53,49179,53,782,105,677,2,30,1,1
36690,49757,80,22692,80,1396,864,532,9,15,5,4
36691,64993,53,50463,53,748,95,653,2,30,1,1
36692,50005,53,45437,53,295,101,194,4,30,2,2
36693,55102,53,40717,53,190,97,93,2,30,1,1
36694,63988,53,39055,53,190,97,93,2,30,1,1
36695,61651,123,29529,123,184,94,90,2,30,1,1
36696,57389,53,59363,53,186,95,91,2,30,1,1
36697,55110,53,57772,53,770,102,668,2,30,1,1
36698,56568,53,49055,53,206,105,101,2,30,1,1
36699,49845,53,18683,53,168,86,82,2,31,1,1
36700,49777,53,49271,53,168,78,90,2,31,1,1
36701,64055,53,63061,53,178,91,87,2,31,1,1
36702,44915,443,17055,443,23886,6994,16892,26,129,12,14
36703,64880,53,46886,53,164,84,80,2,30,1,1
36704,56275,53,15148,53,164,84,80,2,31,1,1
36705,56861,53,42758,53,756,95,661,2,31,1,1
36706,49961,53,46234,53,216,110,106,2,31,1,1
36707,56939,53,50675,53,216,110,106,2,31,1,1
36708,56156,53,34308,53,711,87,624,2,31,1,1
36709,64565,53,49218,53,802,104,698,2,31,1,1
36710,61810,443,52096,443,3109,812,2297,13,136,6,7
36711,55629,53,44695,53,168,86,82,2,31,1,1
36712,56356,53,2062,53,758,96,662,2,31,1,1
36713,55633,53,26791,53,793,101,692,2,31,1,1
36714,56621,53,7810,53,760,96,664,2,31,1,1
36715,55549,53,31074,53,202,103,99,2,31,1,1
36716,56429,53,7462,53,762,98,664,2,31,1,1
36717,65115,53,30947,53,170,87,83,2,31,1,1
36718,55181,53,51083,53,815,95,720,2,31,1,1
36719,56070,53,55660,53,186,95,91,2,31,1,1
36720,56969,53,8130,53,754,94,660,2,31,1,1
36721,55357,53,12869,53,754,94,660,2,31,1,1
36722,49152,53,51402,53,206,105,101,2,31,1,1
36723,64524,53,34078,53,184,94,90,2,31,1,1
36724,64675,53,55719,53,749,94,655,2,31,1,1
36725,55010,53,38368,53,190,97,93,2,31,1,1
36726,56668,53,31919,53,198,101,97,2,31,1,1
36727,49275,53,59894,53,190,97,93,2,31,1,1
36728,37965,16253,55858,16253,5892,3784,2108,81,3115,47,34
36729,60319,53,31437,53,316,80,236,2,31,1,1
36730,50265,26512,31440,26512,480,149,331,2,1200,1,1
36731,64870,53,47029,53,200,102,98,2,31,1,1
36732,64697,53,42927,53,198,101,97,2,31,1,1
36733,57896,46783,0,0,100,100,0,1,0,1,0
36734,53234,48817,0,0,148,148,0,1,0,1,0
36735,57896,49903,0,0,100,100,0,1,0,1,0
36736,32342,62413,0,0,66,66,0,1,0,1,0
36737,45941,23386,0,0,60,60,0,1,0,1,0
36738,45941,23386,0,0,60,60,0,1,0,1,0
36739,20012,8443,0,0,60,60,0,1,0,1,0
36740,58002,445,0,0,70,70,0,1,0,1,0
36741,53971,55442,0,0,62,62,0,1,0,1,0
36742,58001,445,0,0,70,70,0,1,0,1,0
36743,58274,445,0,0,66,66,0,1,0,1,0
36744,62864,445,0,0,70,70,0,1,0,1,0
36745,60204,2767,0,0,66,66,0,1,0,1,0
36746,57999,445,0,0,70,70,0,1,0,1,0
36747,58272,445,0,0,66,66,0,1,0,1,0
36748,32137,44512,0,0,62,62,0,1,0,1,0
36749,58263,445,0,0,66,66,0,1,0,1,0
36750,8999,15503,0,0,146,146,0,1,0,1,0
36751,42216,53,45740,53,199,94,105,2,30,1,1
36752,51909,33509,44942,33509,70,70,0,2,8,2,0
36753,56484,53,39719,53,214,110,104,2,30,1,1
36754,51940,53,28110,53,199,94,105,2,30,1,1
36755,61078,123,41282,123,184,94,90,2,30,1,1
36756,55382,53,35558,53,199,102,97,2,30,1,1
36757,56577,53,47746,53,198,110,88,2,30,1,1
36758,51585,443,25112,443,2840,330,2510,12,135,5,7
36759,59872,443,27152,443,6239,800,5439,18,32,8,10
36760,55809,443,47324,443,62,62,0,1,4,1,0
36761,49436,443,51591,443,784271,38715,745556,1017,183,465,552
36762,65200,53,41473,53,214,110,104,2,29,1,1
36763,49954,53,53212,53,216,110,106,2,29,1,1
36764,65386,53,46279,53,168,86,82,2,29,1,1
36765,53716,6881,40646,6881,70,70,0,2,7,2,0
36766,57553,443,21487,443,7075,2575,4500,21,30,12,9
36767,54080,443,18578,443,6673,1531,5142,22,341,10,12
36768,55115,53,50368,53,313,110,203,4,35,2,2
36769,58434,443,57588,443,170342,10231,160111,264,136,130,134
36770,38632,443,3130,443,9606,1228,8378,20,115,9,11
36771,49437,443,14429,443,586175,29694,556481,753,182,349,404
36772,56374,53,20604,53,177,94,83,2,29,1,1
36773,65059,53,56951,53,197,94,103,2,29,1,1
36774,55102,53,13108,53,195,102,93,2,29,1,1
36775,65496,53,16227,53,194,102,92,2,29,1,1
36776,55466,53,26661,53,177,94,83,2,29,1,1
36777,53588,3389,53588,3389,3489,1534,1955,17,16,9,8
36778,65386,53,22726,53,184,102,82,2,29,1,1
36779,59727,3389,59727,3389,8409,1841,6568,27,20,11,16
36780,56374,53,12810,53,177,94,83,2,29,1,1
36781,49315,53,15991,53,94,94,0,1,30,1,0
36782,64880,53,31529,53,166,86,80,2,30,1,1
36783,53458,443,20818,443,7584,7094,490,14,123,7,7
36784,56464,53,12026,53,177,94,83,2,30,1,1
36785,55608,53,12316,53,195,102,93,2,30,1,1
36786,47523,443,49117,443,429929,11379,418550,456,21,174,282
36787,51890,31122,11914,31122,70,70,0,1,5,1,0
36788,49434,443,8627,443,197635,12994,184641,287,183,143,144
36789,56728,443,61064,443,5367,725,4642,15,15,8,7
36790,63879,80,50871,80,314,192,122,6,15,4,2
36791,59763,443,10249,443,24828,8387,16441,80,111,44,36
36792,23157,53,23157,53,228,90,138,2,30,1,1
36793,64790,53,64538,53,779,86,693,2,30,1,1
36794,55292,53,15138,53,274,94,180,2,30,1,1
36795,65419,53,45268,53,199,102,97,2,30,1,1
36796,56433,53,26629,53,177,94,83,2,30,1,1
36797,56626,443,37778,443,45304,28614,16690,82,41,45,37
36798,51891,23238,29444,23238,70,70,0,1,5,1,0
36799,55115,53,46461,53,313,110,203,4,35,2,2
36800,56800,443,33972,443,7518,2862,4656,18,75,10,8
36801,55502,53,25311,53,193,102,91,2,30,1,1
36802,40600,53,40600,53,228,90,138,2,30,1,1
36803,42384,443,3442,443,101952,6925,95027,143,333,72,71
36804,54079,443,34399,443,6931,1974,4957,24,342,11,13
36805,60104,80,20513,80,18480,7940,10540,48,71,27,21
36806,49856,53,57011,53,168,78,90,2,30,1,1
36807,55516,123,34894,123,184,94,90,2,30,1,1
36808,23984,53,23984,53,216,98,118,2,30,1,1
36809,50005,53,14000,53,199,102,97,2,30,1,1
36810,56701,53,54684,53,211,110,101,2,30,1,1
36811,56433,53,3210,53,177,94,83,2,30,1,1
36812,48164,53,51985,53,199,94,105,2,30,1,1
36813,49936,53,12720,53,754,94,660,2,30,1,1
36814,65040,53,33364,53,178,94,84,2,30,1,1
36815,49226,53,53578,53,765,102,663,2,30,1,1
36816,51522,443,43510,443,190,70,120,4,15,2,2
36817,55504,53,20782,53,199,94,105,2,30,1,1
36818,64983,53,5979,53,181,94,87,2,30,1,1
36819,55614,53,42097,53,309,110,199,2,30,1,1
36820,65067,53,28760,53,86,86,0,1,30,1,0
36821,54224,53,18536,53,199,94,105,2,30,1,1
36822,55453,53,1077,53,730,102,628,2,30,1,1
36823,65139,53,54576,53,443,182,261,6,30,3,3
36824,56861,33412,8103,33412,70,70,0,1,5,1,0
36825,58035,80,7543,80,4168,2906,1262,11,15,6,5
36826,28020,443,11039,443,5576,1388,4188,19,15,9,10
36827,58980,123,62249,123,184,94,90,2,30,1,1
36828,55083,53,1182,53,216,110,106,2,30,1,1
36829,55582,53,5858,53,177,94,83,2,30,1,1
36830,49472,53,31228,53,772,102,670,2,30,1,1
36831,65056,53,13429,53,168,94,74,2,30,1,1
36832,65056,53,16740,53,168,94,74,2,30,1,1
36833,57284,53,19677,53,214,110,104,2,30,1,1
36834,51648,443,53191,443,30116,4336,25780,44,123,18,26
36835,17750,39318,52655,39318,481,150,331,2,1200,1,1
36836,48368,443,5888,443,9157,3805,5352,39,100,18,21
36837,10003,443,7102,443,7617,4161,3456,34,332,15,19
36838,42273,443,42273,443,4398,1491,2907,19,26,11,8
36839,51911,14543,57115,14543,70,70,0,2,8,2,0
36840,63962,53,21344,53,185,93,92,3,58,2,1
36841,35499,443,34865,443,2270,1303,967,20,102,11,9
36842,60440,53830,1700,53830,320,140,180,6,6,3,3
36843,55981,80,6270,80,130,70,60,2,15,1,1
36844,49174,53,31879,53,199,102,97,2,33,1,1
36845,38084,443,21809,443,2697,1520,1177,21,182,10,11
36846,60951,53,52563,53,164,78,86,2,29,1,1
36847,51892,46647,6843,46647,70,70,0,1,5,1,0
36848,33445,53,19899,53,168,78,90,2,29,1,1
36849,60287,53,28366,53,168,78,90,2,29,1,1
36850,58843,80,20341,80,1439485,27511,1411974,1308,108,369,939
36851,56520,53,9113,53,177,94,83,2,29,1,1
36852,40749,5222,28403,5222,3474,915,2559,34,685,10,24
36853,56577,53,39696,53,182,94,88,2,30,1,1
36854,50022,53,4784,53,198,110,88,2,29,1,1
36855,55503,53,6618,53,216,110,106,2,29,1,1
36856,46369,443,62410,443,12157,3583,8574,81,480,34,47
36857,50962,53,0,0,229,85,144,2,29,1,1
36858,50375,53,45862,53,211,110,101,2,30,1,1
36859,55513,53,13816,53,184,94,90,2,30,1,1
36860,56464,53,56163,53,177,94,83,2,30,1,1
36861,55382,53,48828,53,199,102,97,2,30,1,1
36862,64983,53,54706,53,181,94,87,2,30,1,1
36863,56610,443,5877,443,100002,5891,94111,138,44,60,78
36864,56583,53,33992,53,177,94,83,2,29,1,1
36865,50510,53,6283,53,734,94,640,2,30,1,1
36866,55582,53,57520,53,177,94,83,2,30,1,1
36867,65486,53,53853,53,193,102,91,2,30,1,1
36868,55102,53,6205,53,195,102,93,2,30,1,1
36869,50005,53,15477,53,199,102,97,2,30,1,1
36870,56469,53,24320,53,177,94,83,2,30,1,1
36871,57284,53,51341,53,214,110,104,2,30,1,1
36872,56701,53,21171,53,211,110,101,2,30,1,1
36873,50005,53,1672,53,199,102,97,2,30,1,1
36874,56523,53,49008,53,184,102,82,2,30,1,1
36875,49659,53,53164,53,730,102,628,2,30,1,1
36876,56568,53,16992,53,211,110,101,2,30,1,1
36877,58282,53,59362,53,215,102,113,2,30,1,1
36878,49713,53,20450,53,821,102,719,2,30,1,1
36879,50584,53,19282,53,738,86,652,2,30,1,1
36880,55778,53,54108,53,181,94,87,2,30,1,1
36881,56984,53,44033,53,209,102,107,2,30,1,1
36882,43604,53,41746,53,168,78,90,2,30,1,1
36883,39461,53,45858,53,168,78,90,2,30,1,1
36884,56275,53,46209,53,166,86,80,2,30,1,1
36885,55010,53,9213,53,195,102,93,2,31,1,1
36886,49161,53,58186,53,168,86,82,2,30,1,1
36887,43298,53,31678,53,199,94,105,2,30,1,1
36888,56803,53,10846,53,195,102,93,2,30,1,1
36889,56993,53,49057,53,168,86,82,2,30,1,1
36890,65348,53,57406,53,214,102,112,2,31,1,1
36891,56137,53,23667,53,199,102,97,2,31,1,1
36892,57180,53,28550,53,305,86,219,2,31,1,1
36893,37335,443,52361,443,4734755,152171,4582584,5334,405,2083,3251
36894,65147,53,63811,53,194,102,92,2,31,1,1
36895,57444,443,62310,443,7975,1742,6233,24,81,14,10
36896,51889,44348,37588,44348,70,70,0,1,5,1,0
36897,56523,53,57340,53,168,86,82,2,30,1,1
36898,56023,53,18673,53,195,102,93,2,30,1,1
36899,43563,53,1876,53,164,78,86,2,30,1,1
36900,56596,53,43071,53,194,102,92,2,30,1,1
36901,52926,443,36627,443,5458,1390,4068,17,15,9,8
36902,63130,55860,38620,55860,1426,964,462,7,15,4,3
36903,50210,1688,19159,1688,70,70,0,2,8,2,0
36904,51443,443,36286,443,70,70,0,1,5,1,0
36905,55083,53,24986,53,325,110,215,4,44,2,2
36906,52925,443,23150,443,5582,1388,4194,19,15,9,10
36907,56484,53,12661,53,214,110,104,2,30,1,1
36908,65486,53,8619,53,193,102,91,2,30,1,1
36909,56939,53,27310,53,216,110,106,2,30,1,1
36910,50368,53,63672,53,763,102,661,2,30,1,1
36911,38008,443,10885,443,11784,6760,5024,50,247,30,20
36912,51311,22,51311,22,5624,2099,3525,30,23,17,13
36913,60434,11339,17493,11339,70,70,0,1,5,1,0
36914,56464,53,58795,53,177,94,83,2,30,1,1
36915,56568,53,45144,53,211,110,101,2,30,1,1
36916,55083,53,56476,53,216,110,106,2,30,1,1
36917,49161,53,58630,53,184,102,82,2,30,1,1
36918,50040,53,5250,53,193,102,91,2,30,1,1
36919,49713,53,3397,53,198,102,96,2,30,1,1
36920,55413,53,7034,53,779,86,693,2,30,1,1
36921,55199,53,62068,53,152,78,74,2,30,1,1
36922,55032,443,19722,443,8965,3021,5944,39,360,22,17
36923,6881,34635,39166,34635,228,118,110,2,1200,1,1
36924,53530,53,6923,53,164,78,86,2,30,1,1
36925,48604,53,57366,53,164,78,86,2,30,1,1
36926,49125,53,10970,53,168,78,90,2,30,1,1
36927,45607,53,29195,53,168,78,90,2,30,1,1
36928,56433,53,56287,53,177,94,83,2,30,1,1
36929,55102,53,47869,53,195,102,93,2,30,1,1
36930,56070,53,23575,53,193,102,91,2,30,1,1
36931,65499,53,27912,53,182,102,80,2,30,1,1
36932,50237,53,53638,53,183,94,89,2,31,1,1
36933,56758,53,35324,53,173,94,79,2,31,1,1
36934,51847,53,49805,53,164,78,86,2,31,1,1
36935,49411,53,17691,53,195,102,93,2,31,1,1
36936,57284,53,21102,53,214,110,104,2,31,1,1
36937,49152,53,17272,53,307,105,202,4,31,2,2
36938,56137,53,37448,53,199,102,97,2,30,1,1
36939,65180,53,26372,53,165,86,79,2,30,1,1
36940,50622,53,57483,53,185,102,83,2,30,1,1
36941,55549,53,9583,53,209,110,99,2,30,1,1
36942,65115,53,30107,53,253,87,166,4,31,2,2
36943,37387,443,27821,443,64440,16508,47932,101,142,44,57
36944,49845,53,35831,53,168,86,82,2,30,1,1
36945,49152,53,49230,53,211,110,101,2,31,1,1
36946,64885,53,51711,53,212,102,110,2,31,1,1
36947,56512,53,52518,53,889,404,485,10,31,5,5
36948,57043,53,20251,53,166,86,80,2,31,1,1
36949,64885,53,54457,53,182,102,80,2,31,1,1
36950,56015,53,12325,53,195,102,93,2,31,1,1
36951,41575,443,49577,443,24256,1841,22415,41,131,18,23
36952,50622,53,8191,53,177,94,83,2,31,1,1
36953,56982,53,27888,53,177,94,83,2,31,1,1
36954,56803,53,20372,53,195,102,93,2,31,1,1
36955,37576,53,58836,53,168,78,90,2,30,1,1
36956,55000,53,36007,53,193,102,91,2,31,1,1
36957,64586,53,19634,53,252,94,158,2,31,1,1
36958,65350,53,14923,53,212,102,110,2,31,1,1
36959,56939,53,59190,53,216,110,106,2,31,1,1
36960,49275,53,35482,53,195,102,93,2,31,1,1
36961,55851,53,26107,53,167,86,81,2,31,1,1
36962,65218,53,5567,53,194,102,92,2,31,1,1
36963,55133,53,17544,53,443,182,261,6,31,3,3
36964,57389,53,16174,53,193,102,91,2,31,1,1
36965,64276,53,55136,53,197,102,95,2,31,1,1
36966,49961,53,61953,53,322,110,212,4,31,2,2
36967,33705,443,51177,443,4610,918,3692,15,135,7,8
36968,57470,60080,37928,60080,12668,8506,4162,117,3745,74,43
36969,60864,5223,21557,5223,6278,2408,3870,27,3600,15,12
36970,42718,443,45721,443,7341,2111,5230,18,135,8,10
36971,9058,443,18160,443,5655,934,4721,16,130,8,8
36972,65419,53,4348,53,295,101,194,4,31,2,2
36973,53720,50795,49301,50795,320,140,180,6,7,3,3
36974,33610,443,59796,443,9490,1158,8332,24,257,13,11
36975,55673,53,34311,53,179,94,85,2,31,1,1
36976,64751,53,23466,53,458,188,270,6,31,3,3
36977,51915,35068,4331,35068,316,136,180,6,6,3,3
36978,53698,8120,60768,8120,70,70,0,1,5,1,0
36979,39937,443,39937,443,4756,1849,2907,19,27,11,8
36980,56544,443,41897,443,39717,3740,35977,76,53,39,37
36981,49272,53,48276,53,168,86,82,2,33,1,1
36982,55233,443,14491,443,10226,3230,6996,28,47,16,12
36983,50442,37807,0,0,62,62,0,1,0,1,0
36984,58259,445,0,0,66,66,0,1,0,1,0
36985,57990,445,0,0,70,70,0,1,0,1,0
36986,60239,23,0,0,60,60,0,1,0,1,0
36987,42968,56205,0,0,62,62,0,1,0,1,0
36988,57988,445,0,0,70,70,0,1,0,1,0
36989,5450,23,0,0,60,60,0,1,0,1,0
36990,57987,445,0,0,70,70,0,1,0,1,0
36991,18011,44847,0,0,66,66,0,1,0,1,0
36992,57986,445,0,0,70,70,0,1,0,1,0
36993,57985,445,0,0,70,70,0,1,0,1,0
36994,56636,43890,0,0,66,66,0,1,0,1,0
36995,56157,50584,0,0,66,66,0,1,0,1,0
36996,57982,445,0,0,70,70,0,1,0,1,0
36997,57981,445,0,0,70,70,0,1,0,1,0
36998,62857,445,0,0,70,70,0,1,0,1,0
36999,62854,445,0,0,70,70,0,1,0,1,0
37000,62852,445,0,0,70,70,0,1,0,1,0
37001,58247,445,0,0,66,66,0,1,0,1,0
37002,22922,35440,0,0,62,62,0,1,0,1,0
37003,58246,445,0,0,66,66,0,1,0,1,0
37004,58249,445,0,0,66,66,0,1,0,1,0
37005,58248,445,0,0,66,66,0,1,0,1,0
37006,58244,445,0,0,66,66,0,1,0,1,0
37007,58242,445,0,0,66,66,0,1,0,1,0
37008,58245,445,0,0,66,66,0,1,0,1,0
37009,58241,445,0,0,66,66,0,1,0,1,0
37010,9017,6881,0,0,66,66,0,1,0,1,0
37011,48676,53395,0,0,60,60,0,1,0,1,0
37012,33543,44847,0,0,66,66,0,1,0,1,0
37013,10438,23,0,0,60,60,0,1,0,1,0
37014,27272,64147,0,0,62,62,0,1,0,1,0
37015,57967,445,0,0,70,70,0,1,0,1,0
37016,57966,445,0,0,70,70,0,1,0,1,0
37017,57964,445,0,0,70,70,0,1,0,1,0
37018,10669,49756,0,0,60,60,0,1,0,1,0
37019,10669,49756,0,0,60,60,0,1,0,1,0
37020,10669,49756,0,0,60,60,0,1,0,1,0
37021,10669,49756,0,0,60,60,0,1,0,1,0
37022,10669,49756,0,0,60,60,0,1,0,1,0
37023,57957,445,0,0,70,70,0,1,0,1,0
37024,57956,445,0,0,70,70,0,1,0,1,0
37025,50529,44847,0,0,66,66,0,1,0,1,0
37026,58501,44847,0,0,62,62,0,1,0,1,0
37027,52626,44847,0,0,62,62,0,1,0,1,0
37028,39742,62413,0,0,66,66,0,1,0,1,0
37029,38781,51505,0,0,62,62,0,1,0,1,0
37030,62844,445,0,0,70,70,0,1,0,1,0
37031,62846,445,0,0,70,70,0,1,0,1,0
37032,62840,445,0,0,70,70,0,1,0,1,0
37033,62835,445,0,0,70,70,0,1,0,1,0
37034,58229,445,0,0,66,66,0,1,0,1,0
37035,58228,445,0,0,66,66,0,1,0,1,0
37036,58227,445,0,0,66,66,0,1,0,1,0
37037,5894,44847,0,0,66,66,0,1,0,1,0
37038,55874,64147,0,0,66,66,0,1,0,1,0
37039,57945,445,0,0,70,70,0,1,0,1,0
37040,54300,22114,0,0,66,66,0,1,0,1,0
37041,54458,64147,0,0,62,62,0,1,0,1,0
37042,56521,32480,0,0,62,62,0,1,0,1,0
37043,55386,32480,0,0,66,66,0,1,0,1,0
37044,51262,35440,0,0,66,66,0,1,0,1,0
37045,61000,15503,0,0,146,146,0,1,0,1,0
37046,62832,445,0,0,70,70,0,1,0,1,0
37047,62392,15503,0,0,146,146,0,1,0,1,0
37048,50283,49169,0,0,66,66,0,1,0,1,0
37049,62831,445,0,0,70,70,0,1,0,1,0
37050,62825,445,0,0,70,70,0,1,0,1,0
37051,62821,445,0,0,70,70,0,1,0,1,0
37052,45964,2225,0,0,60,60,0,1,0,1,0
37053,57940,445,0,0,70,70,0,1,0,1,0
37054,62388,39004,0,0,62,62,0,1,0,1,0
37055,58085,57470,0,0,66,66,0,1,0,1,0
37056,57930,445,0,0,70,70,0,1,0,1,0
37057,57931,445,0,0,70,70,0,1,0,1,0
37058,57929,445,0,0,70,70,0,1,0,1,0
37059,57927,445,0,0,70,70,0,1,0,1,0
37060,57925,445,0,0,70,70,0,1,0,1,0
37061,46774,51050,0,0,146,146,0,1,0,1,0
37062,62810,445,0,0,70,70,0,1,0,1,0
37063,62812,445,0,0,70,70,0,1,0,1,0
37064,58206,445,0,0,66,66,0,1,0,1,0
37065,47325,2323,0,0,60,60,0,1,0,1,0
37066,14923,51505,0,0,66,66,0,1,0,1,0
37067,28378,56205,0,0,62,62,0,1,0,1,0
37068,57918,445,0,0,70,70,0,1,0,1,0
37069,57233,50934,0,0,66,66,0,1,0,1,0
37070,443,31367,0,0,74,74,0,1,0,1,0
37071,62051,11392,0,0,66,66,0,1,0,1,0
37072,62806,445,0,0,70,70,0,1,0,1,0
37073,62804,445,0,0,70,70,0,1,0,1,0
37074,59647,47993,0,0,66,66,0,1,0,1,0
37075,45682,47993,0,0,62,62,0,1,0,1,0
37076,51414,22,0,0,60,60,0,1,0,1,0
37077,49644,30188,0,0,62,62,0,1,0,1,0
37078,57911,445,0,0,70,70,0,1,0,1,0
37079,57909,445,0,0,70,70,0,1,0,1,0
37080,58201,445,0,0,66,66,0,1,0,1,0
37081,58199,445,0,0,66,66,0,1,0,1,0
37082,65285,50584,0,0,62,62,0,1,0,1,0
37083,61150,11392,0,0,66,66,0,1,0,1,0
37084,45941,23384,0,0,60,60,0,1,0,1,0
37085,64740,53,21372,53,204,96,108,2,0,1,1
37086,59611,56205,0,0,62,62,0,1,0,1,0
37087,62109,44847,0,0,66,66,0,1,0,1,0
37088,57905,445,0,0,70,70,0,1,0,1,0
37089,9522,51505,0,0,66,66,0,1,0,1,0
37090,62796,445,0,0,70,70,0,1,0,1,0
37091,57903,445,0,0,70,70,0,1,0,1,0
37092,0,0,0,0,156,156,0,2,0,2,0
37093,0,0,0,0,156,156,0,2,0,2,0
37094,0,0,0,0,156,156,0,2,0,2,0
37095,0,0,0,0,156,156,0,2,0,2,0
37096,62783,445,0,0,70,70,0,1,0,1,0
37097,62789,445,0,0,70,70,0,1,0,1,0
37098,62785,445,0,0,70,70,0,1,0,1,0
37099,63098,35440,0,0,62,62,0,1,0,1,0
37100,10427,32480,0,0,62,62,0,1,0,1,0
37101,58193,445,0,0,66,66,0,1,0,1,0
37102,57899,445,0,0,70,70,0,1,0,1,0
37103,58185,445,0,0,66,66,0,1,0,1,0
37104,58182,445,0,0,66,66,0,1,0,1,0
37105,58190,445,0,0,66,66,0,1,0,1,0
37106,58181,445,0,0,66,66,0,1,0,1,0
37107,58180,445,0,0,66,66,0,1,0,1,0
37108,58183,445,0,0,66,66,0,1,0,1,0
37109,53208,18375,0,0,62,62,0,1,0,1,0
37110,56863,5900,0,0,60,60,0,1,0,1,0
37111,54134,64147,0,0,66,66,0,1,0,1,0
37112,51015,64147,0,0,62,62,0,1,0,1,0
37113,62779,445,0,0,70,70,0,1,0,1,0
37114,57898,445,0,0,70,70,0,1,0,1,0
37115,51096,63710,0,0,66,66,0,1,0,1,0
37116,62775,445,0,0,70,70,0,1,0,1,0
37117,62776,445,0,0,70,70,0,1,0,1,0
37118,62774,445,0,0,70,70,0,1,0,1,0
37119,51374,30317,0,0,66,66,0,1,0,1,0
37120,13484,37965,0,0,66,66,0,1,0,1,0
37121,9393,51505,0,0,66,66,0,1,0,1,0
37122,58424,52700,0,0,66,66,0,1,0,1,0
37123,51320,44847,0,0,62,62,0,1,0,1,0
37124,57893,445,0,0,70,70,0,1,0,1,0
37125,8889,60961,0,0,60,60,0,1,0,1,0
37126,50486,56205,0,0,66,66,0,1,0,1,0
37127,40099,23,0,0,60,60,0,1,0,1,0
37128,19875,30170,0,0,145,145,0,1,0,1,0
37129,62768,445,0,0,70,70,0,1,0,1,0
37130,62767,445,0,0,70,70,0,1,0,1,0
37131,62766,445,0,0,70,70,0,1,0,1,0
37132,56876,30188,0,0,66,66,0,1,0,1,0
37133,58174,445,0,0,66,66,0,1,0,1,0
37134,62764,445,0,0,70,70,0,1,0,1,0
37135,58170,445,0,0,66,66,0,1,0,1,0
37136,50095,50584,0,0,66,66,0,1,0,1,0
37137,58168,445,0,0,66,66,0,1,0,1,0
37138,58166,445,0,0,66,66,0,1,0,1,0
37139,49981,44847,0,0,62,62,0,1,0,1,0
37140,58165,445,0,0,66,66,0,1,0,1,0
37141,32609,64097,0,0,66,66,0,1,0,1,0
37142,57880,445,0,0,70,70,0,1,0,1,0
37143,55745,53,2082,53,198,101,97,2,30,1,1
37144,56137,53,13627,53,198,101,97,2,30,1,1
37145,57320,53,17715,53,802,104,698,2,30,1,1
37146,56803,53,60073,53,190,97,93,2,30,1,1
37147,45973,80,60960,80,1114,534,580,12,16,7,5
37148,56848,19556,15601,19556,66,66,0,1,5,1,0
37149,40911,443,37854,443,11095,2599,8496,45,257,22,23
37150,58887,15000,7750,15000,138,78,60,2,6,1,1
37151,41627,15000,9881,15000,130,70,60,2,5,1,1
37152,58369,443,52510,443,12779517,343310,12436207,12837,162,4589,8248
37153,56726,443,54514,443,4221,666,3555,13,15,7,6
37154,56601,53,12996,53,170,87,83,2,30,1,1
37155,65357,53,31464,53,256,93,163,2,30,1,1
37156,49560,443,58104,443,13516,6981,6535,61,2149,34,27
37157,46985,443,26507,443,4957,3488,1469,25,51,15,10
37158,33505,80,10878,80,130,70,60,2,15,1,1
37159,51905,65253,13795,65253,70,70,0,2,8,2,0
37160,38598,80,50146,80,1114,534,580,12,16,7,5
37161,53694,8999,50905,8999,1179,606,573,12,17,7,5
37162,65416,443,30210,443,3219,2242,977,19,25,9,10
37163,49708,53,19029,53,186,95,91,2,31,1,1
37164,55238,443,54700,443,6165,1407,4758,21,45,12,9
37165,65340,53,24167,53,313,110,203,4,34,2,2
37166,55011,443,43208,443,134,60,74,3,10,2,1
37167,34154,443,26311,443,6107,2012,4095,18,25,10,8
37168,56015,53,32700,53,190,97,93,2,31,1,1
37169,56754,53,1275,53,751,95,656,2,30,1,1
37170,53096,443,46942,443,13599,5335,8264,35,171,18,17
37171,51616,15000,27735,15000,130,70,60,2,6,1,1
37172,40202,5222,32011,5222,5958,2420,3538,40,25,20,20
37173,56849,23745,9953,23745,66,66,0,1,5,1,0
37174,53247,443,23976,443,10542,1216,9326,26,44,10,16
37175,55223,443,26672,443,12583,2945,9638,31,47,16,15
37176,59900,3389,59900,3389,3489,1534,1955,17,18,9,8
37177,49544,80,16588,80,10192,3818,6374,20,16,9,11
37178,64617,53,32317,53,756,95,661,2,30,1,1
37179,55747,53,60258,53,186,95,91,2,30,1,1
37180,5588,5588,0,0,3498,1872,1626,48,201,24,24
37181,50130,53,57806,53,174,89,85,2,30,1,1
37182,60116,443,14734,443,9454,2307,7147,40,19,17,23
37183,58373,443,64061,443,78832,12408,66424,109,162,46,63
37184,45120,15000,54128,15000,130,70,60,2,6,1,1
37185,55678,53,40642,53,270,88,182,4,54,2,2
37186,56847,36370,51543,36370,624,318,306,10,15,5,5
37187,63891,51350,44570,51350,312,132,180,6,7,3,3
37188,56856,47715,33664,47715,70,70,0,2,8,2,0
37189,52099,443,31661,443,39798,12257,27541,68,97,27,41
37190,53836,15000,1937,15000,130,70,60,2,5,1,1
37191,55654,18251,36307,18251,70,70,0,1,5,1,0
37192,37483,443,13150,443,70,70,0,2,5,2,0
37193,48273,15000,43622,15000,130,70,60,2,5,1,1
37194,47166,15000,45851,15000,130,70,60,2,5,1,1
37195,48978,443,3498,443,10163,3585,6578,47,26,24,23
37196,51102,80,48661,80,254,128,126,5,16,3,2
37197,40204,5222,16908,5222,5097,2196,2901,36,25,18,18
37198,49973,53,28904,53,747,93,654,2,30,1,1
37199,65028,53,48786,53,182,93,89,2,31,1,1
37200,60261,53,9176,53,233,81,152,2,31,1,1
37201,56754,53,54310,53,182,93,89,2,31,1,1
37202,58452,5228,20449,5228,2855,1780,1075,20,3600,10,10
37203,57030,53,10715,53,749,94,655,2,30,1,1
37204,57043,53,11137,53,164,84,80,2,31,1,1
37205,52744,53,32462,53,218,81,137,2,31,1,1
37206,60205,53,4372,53,491,115,376,2,31,1,1
37207,64155,53,47794,53,182,93,89,2,31,1,1
37208,57432,53,52576,53,186,95,91,2,31,1,1
37209,55057,53,28590,53,188,80,108,2,31,1,1
37210,49411,53,5629,53,764,99,665,2,31,1,1
37211,49411,53,16636,53,190,97,93,2,31,1,1
37212,64502,53,19448,53,198,101,97,2,31,1,1
37213,44847,26356,3716,26356,501,150,351,2,1200,1,1
37214,56316,53,62474,53,733,93,640,2,31,1,1
37215,57403,53,33479,53,764,99,665,2,31,1,1
37216,49901,53,43057,53,752,93,659,2,31,1,1
37217,55165,53,33843,53,186,95,91,2,31,1,1
37218,55146,53,27596,53,178,91,87,2,31,1,1
37219,55989,53,34510,53,301,80,221,2,31,1,1
37220,55865,53,59187,53,192,98,94,2,31,1,1
37221,56754,53,26868,53,182,93,89,2,31,1,1
37222,56489,53,9715,53,172,88,84,2,31,1,1
37223,43616,5228,36276,5228,2322,1296,1026,15,3600,6,9
37224,61808,443,43689,443,4625,2292,2333,14,135,7,7
37225,30960,45732,62764,45732,330,330,0,6,3610,6,0
37226,52045,443,60420,443,51604,4684,46920,70,133,28,42
37227,63951,53,13752,53,186,95,91,2,31,1,1
37228,55673,53,33131,53,174,89,85,2,31,1,1
37229,55365,53,41996,53,184,94,90,2,31,1,1
37230,55379,53,30186,53,256,93,163,2,31,1,1
37231,56304,53,54200,53,184,94,90,2,31,1,1
37232,64275,53,47758,53,192,90,102,2,31,1,1
37233,54329,443,26217,443,5850,1617,4233,28,127,13,15
37234,54330,443,28162,443,7329,3011,4318,30,127,14,16
37235,64276,53,40042,53,194,99,95,2,31,1,1
37236,54992,53,12659,53,190,97,93,2,31,1,1
37237,32520,50265,0,0,145,145,0,1,0,1,0
37238,62758,445,0,0,70,70,0,1,0,1,0
37239,60720,23718,0,0,66,66,0,1,0,1,0
37240,58976,43890,0,0,66,66,0,1,0,1,0
37241,57877,445,0,0,70,70,0,1,0,1,0
37242,62747,445,0,0,70,70,0,1,0,1,0
37243,49611,53,44426,53,184,94,90,2,30,1,1
37244,57239,53,5025,53,193,102,91,2,30,1,1
37245,64155,53,2380,53,183,94,89,2,30,1,1
37246,49554,80,58941,80,1515,481,1034,11,15,6,5
37247,56914,53,24598,53,821,102,719,2,30,1,1
37248,49738,53,2728,53,215,102,113,2,30,1,1
37249,56070,53,12726,53,193,102,91,2,30,1,1
37250,55934,53,23725,53,182,102,80,2,30,1,1
37251,49502,53,5291,53,193,102,91,2,30,1,1
37252,49713,53,16907,53,184,94,90,2,30,1,1
37253,55019,443,52718,443,6484,1915,4569,26,131,14,12
37254,50580,443,17458,443,2723,1383,1340,29,37,16,13
37255,54983,80,49933,80,27816,7362,20454,69,240,41,28
37256,65250,53,37683,53,353,98,255,4,32,2,2
37257,27005,27126,47087,27126,636020,187240,448780,2701,104,1538,1163
37258,56568,53,6901,53,365,105,260,4,47,2,2
37259,49667,443,39894,443,8329,2188,6141,29,100,16,13
37260,49275,53,55214,53,283,97,186,4,30,2,2
37261,53696,50321,3484,50321,70,70,0,1,4,1,0
37262,60107,443,49027,443,9766,3290,6476,40,57,20,20
37263,55232,443,11743,443,9619,2504,7115,28,46,15,13
37264,55236,443,64536,443,10293,2881,7412,25,45,14,11
37265,58495,443,34760,443,1638,829,809,18,43,10,8
37266,49788,53,17656,53,198,102,96,2,32,1,1
37267,56638,80,7412,80,234,234,0,4,11,4,0
37268,59277,53,14948,53,164,78,86,2,29,1,1
37269,47636,53,0,0,86,86,0,1,29,1,0
37270,56070,53,26270,53,193,102,91,2,30,1,1
37271,55657,53,52636,53,822,102,720,2,30,1,1
37272,56993,53,24692,53,184,102,82,2,29,1,1
37273,64055,53,52345,53,181,94,87,2,29,1,1
37274,34317,53,53292,53,168,78,90,2,29,1,1
37275,55549,53,24179,53,209,110,99,2,29,1,1
37276,53552,53,3574,53,168,78,90,2,29,1,1
37277,55000,53,31472,53,193,102,91,2,29,1,1
37278,56982,53,54411,53,177,94,83,2,29,1,1
37279,65040,53,11010,53,178,94,84,2,29,1,1
37280,55199,53,24591,53,152,78,74,2,29,1,1
37281,41783,443,41782,443,23344,2097,21247,39,15,18,21
37282,50529,80,9935,80,12874,6770,6104,26,28,13,13
37283,50533,80,13873,80,3672,1976,1696,12,26,7,5
37284,44921,443,18740,443,5440,846,4594,15,15,9,6
37285,49890,443,3826,443,6370237,150385,6219852,6047,138,1688,4359
37286,64903,53,4073,53,210,110,100,2,30,1,1
37287,64415,53,15855,53,221,94,127,2,30,1,1
37288,50130,53,36317,53,179,94,85,2,30,1,1
37289,55629,53,22449,53,168,86,82,2,30,1,1
37290,49567,53,35834,53,168,86,82,2,30,1,1
37291,64583,53,34573,53,179,94,85,2,30,1,1
37292,55549,53,20623,53,209,110,99,2,30,1,1
37293,56304,53,19681,53,184,94,90,2,30,1,1
37294,49724,53,16397,53,183,94,89,2,30,1,1
37295,64870,53,42981,53,200,102,98,2,33,1,1
37296,54963,53,11032,53,210,110,100,2,30,1,1
37297,36677,443,38465,443,712,374,338,11,26,6,5
37298,49141,443,32844,443,2595,1230,1365,18,16,9,9
37299,59970,443,20638,443,7448,1347,6101,24,16,13,11
37300,50534,80,11143,80,318,192,126,6,25,4,2
37301,56432,80,52279,80,17128,1499,15629,24,25,9,15
37302,50463,80,63271,80,214,140,74,4,15,3,1
37303,49713,53,39823,53,184,94,90,2,30,1,1
37304,50549,80,64687,80,378,192,186,7,21,4,3
37305,50548,80,23213,80,378,192,186,7,21,4,3
37306,56560,53,11515,53,198,102,96,2,31,1,1
37307,64859,53,38916,53,385,134,251,2,30,1,1
37308,41776,443,58103,443,3196404,47816,3148588,2668,147,469,2199
37309,54936,80,14845,80,613,539,74,7,15,6,1
37310,55934,53,17194,53,182,102,80,2,30,1,1
37311,59932,443,3310,443,6065,1772,4293,27,1587,15,12
37312,65395,53,34335,53,754,94,660,2,30,1,1
37313,59962,443,64092,443,19201,1566,17635,34,16,16,18
37314,64903,53,57537,53,210,110,100,2,30,1,1
37315,49451,53,64804,53,211,102,109,2,30,1,1
37316,63982,53,27288,53,244,94,150,2,30,1,1
37317,44922,443,33552,443,5578,764,4814,14,15,8,6
37318,64903,53,16364,53,210,110,100,2,30,1,1
37319,64870,53,51566,53,200,102,98,2,30,1,1
37320,50536,80,24703,80,24166,3105,21061,31,24,12,19
37321,64718,53,52565,53,781,94,687,2,30,1,1
37322,57043,53,58233,53,166,86,80,2,30,1,1
37323,63951,53,11656,53,193,102,91,2,30,1,1
37324,64697,53,13382,53,199,102,97,2,30,1,1
37325,55678,53,49821,53,270,88,182,4,54,2,2
37326,56015,53,29304,53,195,102,93,2,30,1,1
37327,52145,443,2383,443,190,70,120,4,15,2,2
37328,65340,53,54833,53,313,110,203,4,33,2,2
37329,59958,443,39480,443,2303,1334,969,18,16,10,8
37330,59974,443,8585,443,7820,1344,6476,24,16,13,11
37331,42154,80,50458,80,73277,3302,69975,102,16,52,50
37332,59964,443,8853,443,166170,5611,160559,189,16,78,111
37333,50547,80,14282,80,378,192,186,7,21,4,3
37334,53691,11528,36171,11528,492,306,186,8,16,5,3
37335,56758,53,14411,53,165,86,79,2,30,1,1
37336,56601,53,17234,53,177,94,83,2,30,1,1
37337,64633,53,57902,53,231,110,121,2,30,1,1
37338,56779,53,27714,53,165,86,79,2,30,1,1
37339,49502,53,58398,53,193,102,91,2,30,1,1
37340,56601,53,46710,53,177,94,83,2,30,1,1
37341,49891,53,31414,53,243,94,149,2,30,1,1
37342,1930,80,62505,80,214,140,74,4,15,3,1
37343,64664,53,7997,53,168,86,82,2,32,1,1
37344,53136,41442,55511,41442,70,70,0,1,5,1,0
37345,5238,36298,39762,36298,179518,128,179390,173,37,3,170
37346,50532,80,48066,80,4561,2110,2451,15,26,9,6
37347,57335,53,58927,53,177,94,83,2,30,1,1
37348,57335,53,28128,53,185,102,83,2,30,1,1
37349,37479,53,37479,53,214,82,132,2,30,1,1
37350,55745,53,20797,53,199,102,97,2,30,1,1
37351,59454,53,0,0,86,86,0,1,30,1,0
37352,54963,53,23635,53,210,110,100,2,30,1,1
37353,52073,443,26285,443,22714,21388,1326,33,30,22,11
37354,14435,443,15912,443,2569,1470,1099,17,15,8,9
37355,55678,53,55305,53,270,88,182,4,54,2,2
37356,38680,443,52567,443,90091,3481,86610,95,15,31,64
37357,56115,53,38646,53,278,96,182,4,54,2,2
37358,33609,443,62063,443,9348,1018,8330,22,256,11,11
37359,49655,443,28580,443,50533,7291,43242,74,61,34,40
37360,38678,443,20008,443,380978,8857,372121,373,16,115,258
37361,53697,6224,22057,6224,70,70,0,1,4,1,0
37362,33611,443,49502,443,9490,1158,8332,24,256,13,11
37363,49295,53,60133,53,194,102,92,2,32,1,1
37364,50700,80,4259,80,417,417,0,4,9,4,0
37365,59960,443,41281,443,1953,1223,730,16,16,9,7
37366,43146,80,15239,80,1102,545,557,10,16,6,4
37367,45472,443,53386,443,1568,759,809,17,43,9,8
37368,35832,443,34150,443,9276,1884,7392,23,32,13,10
37369,45470,443,49980,443,1636,827,809,18,43,10,8
37370,59972,443,22705,443,7152,1299,5853,22,16,12,10
37371,46728,443,17105,443,7087,746,6341,16,15,9,7
37372,59956,443,50575,443,2162,1113,1049,18,16,10,8
37373,35810,443,45947,443,9276,1884,7392,23,94,13,10
37374,49127,53,16761,53,199,94,105,2,29,1,1
37375,41775,443,57658,443,7036547,93047,6943500,5816,186,995,4821
37376,65499,53,38166,53,166,86,80,2,29,1,1
37377,64533,53,56786,53,183,102,81,2,29,1,1
37378,65147,53,20335,53,194,102,92,2,29,1,1
37379,41781,443,5729,443,1820,1101,719,18,82,10,8
37380,55678,53,29354,53,270,88,182,4,53,2,2
37381,64533,53,56074,53,183,102,81,2,29,1,1
37382,55513,53,52238,53,184,94,90,2,29,1,1
37383,55010,53,42242,53,195,102,93,2,29,1,1
37384,47766,53,58844,53,164,78,86,2,29,1,1
37385,64885,53,4392,53,166,86,80,2,29,1,1
37386,65398,53,64087,53,811,94,717,2,29,1,1
37387,33794,53,45704,53,168,78,90,2,29,1,1
37388,55778,53,21245,53,189,102,87,2,29,1,1
37389,65180,53,3585,53,165,86,79,2,29,1,1
37390,56866,53,6471,53,194,102,92,2,30,1,1
37391,39684,80,40129,80,680,70,610,11,392,2,9
37392,50446,443,25780,443,5471,2089,3382,17,121,8,9
37393,50265,31101,44674,31101,150,150,0,1,1200,1,0
37394,64697,53,51206,53,199,102,97,2,30,1,1
37395,49708,53,46475,53,193,102,91,2,30,1,1
37396,65058,53,6038,53,249,94,155,2,30,1,1
37397,49933,53,6937,53,178,94,84,2,31,1,1
37398,55570,53,44028,53,168,86,82,2,31,1,1
37399,34630,443,65434,443,12120,5747,6373,22,120,10,12
37400,35601,443,47260,443,6419,995,5424,21,360,11,10
37401,30188,14991,3855,14991,501,150,351,2,1200,1,1
37402,57239,53,64762,53,193,102,91,2,31,1,1
37403,55146,53,42848,53,181,94,87,2,30,1,1
37404,59936,443,30573,443,10879,3057,7822,38,32,21,17
37405,35579,443,33211,443,130,70,60,2,15,1,1
37406,51906,17491,64843,17491,70,70,0,2,8,2,0
37407,65488,443,64323,443,92286,4799,87487,107,16,43,64
37408,56668,53,7163,53,199,102,97,2,30,1,1
37409,56668,53,30534,53,199,102,97,2,30,1,1
37410,49411,53,20667,53,195,102,93,2,30,1,1
37411,55673,53,41151,53,179,94,85,2,30,1,1
37412,49724,53,47705,53,183,94,89,2,30,1,1
37413,34744,443,31137,443,13175,2432,10743,52,3587,23,29
37414,50265,18417,40558,18417,7282,4118,3164,57,1696,35,22
37415,51967,443,12004,443,21063,13499,7564,47,68,25,22
37416,65340,53,38317,53,313,110,203,4,33,2,2
37417,64614,53,45879,53,616,188,428,6,35,3,3
37418,58497,443,60144,443,1640,831,809,18,43,10,8
37419,53714,443,14989,443,9842,4572,5270,22,76,12,10
37420,50587,80,51672,80,378,192,186,7,20,4,3
37421,58492,443,51321,443,5611,1560,4051,22,266,13,9
37422,51978,80,13488,80,24474,2101,22373,38,48,19,19
37423,41779,443,29003,443,618072,8505,609567,523,87,90,433
37424,56668,53,43075,53,199,102,97,2,30,1,1
37425,49564,53,57263,53,168,78,90,2,30,1,1
37426,55851,53,30574,53,183,102,81,2,30,1,1
37427,49436,53,51466,53,765,102,663,2,30,1,1
37428,56866,53,52471,53,194,102,92,2,30,1,1
37429,50015,53,0,0,234,86,148,2,30,1,1
37430,49708,53,49250,53,193,102,91,2,30,1,1
37431,65315,53,23256,53,178,94,84,2,30,1,1
37432,49708,53,50223,53,193,102,91,2,30,1,1
37433,49724,53,13142,53,183,94,89,2,30,1,1
37434,50810,443,16412,443,10682,4653,6029,28,33,15,13
37435,59966,443,53241,443,7165,1312,5853,22,16,12,10
37436,41784,443,54389,443,20365,2035,18330,36,15,17,19
37437,65487,443,56960,443,413465,12290,401175,427,16,150,277
37438,56859,32185,46564,32185,70,70,0,1,5,1,0
37439,54631,443,8589,443,130,70,60,3,5,2,1
37440,60474,53,36065,53,195,94,101,2,30,1,1
37441,56779,53,5601,53,173,94,79,2,30,1,1
37442,55745,53,56029,53,199,102,97,2,30,1,1
37443,50237,53,33615,53,183,94,89,2,30,1,1
37444,42041,443,41646,443,2351,1546,805,20,54,11,9
37445,64697,53,40381,53,199,102,97,2,30,1,1
37446,55146,53,47251,53,181,94,87,2,30,1,1
37447,55786,53,7570,53,193,102,91,2,30,1,1
37448,54963,53,30866,53,210,110,100,2,30,1,1
37449,49431,53,23067,53,353,94,259,2,30,1,1
37450,64155,53,25938,53,183,94,89,2,30,1,1
37451,37469,53,51680,53,168,78,90,2,30,1,1
37452,56304,53,49255,53,184,94,90,2,30,1,1
37453,48954,53,0,0,86,86,0,1,30,1,0
37454,60591,53,16493,53,218,78,140,2,31,1,1
37455,56601,53,1857,53,177,94,83,2,31,1,1
37456,49411,53,10560,53,195,102,93,2,31,1,1
37457,57043,53,5336,53,166,86,80,2,31,1,1
37458,56542,53,15813,53,183,94,89,2,30,1,1
37459,65028,53,59262,53,183,94,89,2,31,1,1
37460,49398,53,12765,53,226,86,140,2,31,1,1
37461,57432,53,10564,53,193,102,91,2,31,1,1
37462,49456,53,42586,53,199,102,97,2,31,1,1
37463,59906,443,52197,443,13657,5248,8409,33,171,17,16
37464,55673,53,34197,53,179,94,85,2,31,1,1
37465,55365,53,47603,53,184,94,90,2,31,1,1
37466,49952,53,65134,53,195,102,93,2,31,1,1
37467,56587,53,8172,53,184,94,90,2,31,1,1
37468,55748,53,53147,53,194,102,92,2,31,1,1
37469,54990,53,13608,53,168,86,82,2,31,1,1
37470,50458,443,34106,443,44532,3294,41238,56,128,21,35
37471,64302,53,55170,53,258,94,164,2,31,1,1
37472,6882,51508,23505,51508,238,118,120,2,1200,1,1
37473,55636,443,29047,443,13506,5979,7527,39,127,20,19
37474,58877,53,28014,53,426,118,308,2,31,1,1
37475,64884,53,27376,53,195,102,93,2,31,1,1
37476,56542,53,32612,53,183,94,89,2,31,1,1
37477,54681,443,46461,443,4417,2187,2230,16,135,8,8
37478,57470,15870,28583,15870,149,149,0,2,1199,2,0
37479,37965,27261,16872,27261,150,150,0,1,1199,1,0
37480,38679,443,29452,443,484912,17317,467595,550,16,229,321
37481,58210,443,60868,443,14898,12644,2254,32,316,18,14
37482,4567,80,4567,80,23456,1005,22451,32,16,13,19
37483,55652,443,58286,443,6672,2258,4414,19,16,10,9
37484,49532,53,59388,53,331,92,239,4,40,2,2
37485,49392,53,35647,53,398,93,305,4,45,2,2
37486,57810,80,62948,80,104397,8436,95961,122,21,49,73
37487,59697,80,58873,80,5326946,116544,5210402,5175,111,1695,3480
37488,50278,443,27147,443,259911,11421,248490,336,92,144,192
37489,56719,80,46763,80,1462,703,759,8,16,5,3
37490,63878,50829,35363,50829,70,70,0,1,5,1,0
37491,52146,80,22638,80,1868,1374,494,12,16,7,5
37492,62748,445,0,0,70,70,0,1,0,1,0
37493,48706,23393,0,0,60,60,0,1,0,1,0
37494,1441,51221,0,0,62,62,0,1,0,1,0
37495,58154,445,0,0,66,66,0,1,0,1,0
37496,62088,56205,0,0,66,66,0,1,0,1,0
37497,57873,445,0,0,70,70,0,1,0,1,0
37498,44923,23,0,0,60,60,0,1,0,1,0
37499,57871,445,0,0,70,70,0,1,0,1,0
37500,57869,445,0,0,70,70,0,1,0,1,0
37501,58146,445,0,0,66,66,0,1,0,1,0
37502,61242,35253,0,0,62,62,0,1,0,1,0
37503,62736,445,0,0,70,70,0,1,0,1,0
37504,59364,44847,0,0,62,62,0,1,0,1,0
37505,50798,36237,0,0,146,146,0,1,0,1,0
37506,53656,31573,0,0,66,66,0,1,0,1,0
37507,58143,445,0,0,66,66,0,1,0,1,0
37508,43350,58414,0,0,66,66,0,1,0,1,0
37509,49977,57470,0,0,62,62,0,1,0,1,0
37510,58255,50584,0,0,62,62,0,1,0,1,0
37511,9687,57470,0,0,78,78,0,1,0,1,0
37512,57862,445,0,0,70,70,0,1,0,1,0
37513,1629,64147,0,0,146,146,0,1,0,1,0
37514,58135,445,0,0,66,66,0,1,0,1,0
37515,57860,445,0,0,70,70,0,1,0,1,0
37516,57874,26467,0,0,62,62,0,1,0,1,0
37517,58127,445,0,0,66,66,0,1,0,1,0
37518,60855,35440,0,0,66,66,0,1,0,1,0
37519,16215,6881,0,0,146,146,0,1,0,1,0
37520,57859,445,0,0,70,70,0,1,0,1,0
37521,15180,26467,0,0,62,62,0,1,0,1,0
37522,16522,26467,0,0,66,66,0,1,0,1,0
37523,57858,445,0,0,70,70,0,1,0,1,0
37524,57857,445,0,0,70,70,0,1,0,1,0
37525,1024,60043,0,0,145,145,0,1,0,1,0
37526,57855,445,0,0,70,70,0,1,0,1,0
37527,57851,445,0,0,70,70,0,1,0,1,0
37528,33502,5529,0,0,143,143,0,1,0,1,0
37529,11478,51221,0,0,66,66,0,1,0,1,0
37530,62029,22114,0,0,66,66,0,1,0,1,0
37531,62728,445,0,0,70,70,0,1,0,1,0
37532,62725,445,0,0,70,70,0,1,0,1,0
37533,62724,445,0,0,70,70,0,1,0,1,0
37534,58121,445,0,0,66,66,0,1,0,1,0
37535,58120,445,0,0,66,66,0,1,0,1,0
37536,58117,445,0,0,66,66,0,1,0,1,0
37537,58116,445,0,0,66,66,0,1,0,1,0
37538,58118,445,0,0,66,66,0,1,0,1,0
37539,58119,445,0,0,66,66,0,1,0,1,0
37540,58114,445,0,0,66,66,0,1,0,1,0
37541,58113,445,0,0,66,66,0,1,0,1,0
37542,47910,7454,0,0,60,60,0,1,0,1,0
37543,57839,445,0,0,70,70,0,1,0,1,0
37544,1038,37965,0,0,62,62,0,1,0,1,0
37545,57838,445,0,0,70,70,0,1,0,1,0
37546,57834,445,0,0,70,70,0,1,0,1,0
37547,57829,445,0,0,70,70,0,1,0,1,0
37548,57828,445,0,0,70,70,0,1,0,1,0
37549,52018,57866,0,0,66,66,0,1,0,1,0
37550,41840,50584,0,0,66,66,0,1,0,1,0
37551,58672,43890,0,0,62,62,0,1,0,1,0
37552,65494,53,0,0,88,88,0,1,0,1,0
37553,5688,44847,0,0,66,66,0,1,0,1,0
37554,46859,50584,0,0,62,62,0,1,0,1,0
37555,18001,35440,0,0,146,146,0,1,0,1,0
37556,19245,64147,0,0,62,62,0,1,0,1,0
37557,53667,56205,0,0,62,62,0,1,0,1,0
37558,27898,52700,0,0,62,62,0,1,0,1,0
37559,62721,445,0,0,70,70,0,1,0,1,0
37560,62714,445,0,0,70,70,0,1,0,1,0
37561,62709,445,0,0,70,70,0,1,0,1,0
37562,62707,445,0,0,70,70,0,1,0,1,0
37563,52989,51505,0,0,66,66,0,1,0,1,0
37564,2691,64147,0,0,62,62,0,1,0,1,0
37565,65515,22114,0,0,62,62,0,1,0,1,0
37566,57817,445,0,0,70,70,0,1,0,1,0
37567,58101,445,0,0,66,66,0,1,0,1,0
37568,58099,445,0,0,66,66,0,1,0,1,0
37569,58098,445,0,0,66,66,0,1,0,1,0
37570,62704,445,0,0,70,70,0,1,0,1,0
37571,7968,2767,0,0,66,66,0,1,0,1,0
37572,62699,445,0,0,70,70,0,1,0,1,0
37573,62693,445,0,0,70,70,0,1,0,1,0
37574,62697,445,0,0,70,70,0,1,0,1,0
37575,57813,445,0,0,70,70,0,1,0,1,0
37576,54552,64147,0,0,62,62,0,1,0,1,0
37577,57802,445,0,0,70,70,0,1,0,1,0
37578,57803,445,0,0,70,70,0,1,0,1,0
37579,57801,445,0,0,70,70,0,1,0,1,0
37580,20409,23,0,0,60,60,0,1,0,1,0
37581,62765,16933,0,0,66,66,0,1,0,1,0
37582,57798,445,0,0,70,70,0,1,0,1,0
37583,13287,16933,0,0,62,62,0,1,0,1,0
37584,52537,37965,0,0,66,66,0,1,0,1,0
37585,57797,445,0,0,70,70,0,1,0,1,0
37586,52711,37965,0,0,62,62,0,1,0,1,0
37587,52740,51505,0,0,66,66,0,1,0,1,0
37588,62686,445,0,0,70,70,0,1,0,1,0
37589,62685,445,0,0,70,70,0,1,0,1,0
37590,62680,445,0,0,70,70,0,1,0,1,0
37591,15875,50584,0,0,62,62,0,1,0,1,0
37592,24288,23,0,0,60,60,0,1,0,1,0
37593,45682,37965,0,0,62,62,0,1,0,1,0
37594,57790,445,0,0,70,70,0,1,0,1,0
37595,49622,50584,0,0,62,62,0,1,0,1,0
37596,53218,56205,0,0,66,66,0,1,0,1,0
37597,63027,35440,0,0,66,66,0,1,0,1,0
37598,18750,57866,0,0,146,146,0,1,0,1,0
37599,35722,30188,0,0,62,62,0,1,0,1,0
37600,0,0,0,0,156,156,0,2,0,2,0
37601,0,0,0,0,244,244,0,2,0,2,0
37602,53966,57470,0,0,62,62,0,1,0,1,0
37603,58079,445,0,0,66,66,0,1,0,1,0
37604,62679,445,0,0,70,70,0,1,0,1,0
37605,62678,445,0,0,70,70,0,1,0,1,0
37606,57783,445,0,0,70,70,0,1,0,1,0
37607,57781,445,0,0,70,70,0,1,0,1,0
37608,56186,57470,0,0,62,62,0,1,0,1,0
37609,52976,31573,0,0,62,62,0,1,0,1,0
37610,59147,51505,0,0,66,66,0,1,0,1,0
37611,18472,5278,0,0,145,145,0,1,0,1,0
37612,26758,50584,0,0,66,66,0,1,0,1,0
37613,52836,36829,0,0,66,66,0,1,0,1,0
37614,57239,161,0,0,82,82,0,1,0,1,0
37615,57239,161,0,0,85,85,0,1,0,1,0
37616,55375,44847,0,0,62,62,0,1,0,1,0
37617,58072,445,0,0,66,66,0,1,0,1,0
37618,58069,445,0,0,66,66,0,1,0,1,0
37619,10036,44847,0,0,66,66,0,1,0,1,0
37620,59095,57470,0,0,66,66,0,1,0,1,0
37621,4876,42920,0,0,146,146,0,1,0,1,0
37622,35558,15503,0,0,66,66,0,1,0,1,0
37623,61147,22114,0,0,66,66,0,1,0,1,0
37624,57777,445,0,0,70,70,0,1,0,1,0
37625,57775,445,0,0,70,70,0,1,0,1,0
37626,8536,37965,0,0,62,62,0,1,0,1,0
37627,51300,64147,0,0,66,66,0,1,0,1,0
37628,33908,48983,0,0,145,145,0,1,0,1,0
37629,61744,11392,0,0,66,66,0,1,0,1,0
37630,62668,445,0,0,70,70,0,1,0,1,0
37631,49001,40108,0,0,161,161,0,1,0,1,0
37632,62662,445,0,0,70,70,0,1,0,1,0
37633,62658,445,0,0,70,70,0,1,0,1,0
37634,62655,445,0,0,70,70,0,1,0,1,0
37635,59985,57470,0,0,66,66,0,1,0,1,0
37636,61278,56205,0,0,66,66,0,1,0,1,0
37637,58068,445,0,0,66,66,0,1,0,1,0
37638,57771,445,0,0,70,70,0,1,0,1,0
37639,51185,37965,0,0,66,66,0,1,0,1,0
37640,45908,33330,0,0,60,60,0,1,0,1,0
37641,58059,445,0,0,66,66,0,1,0,1,0
37642,58060,445,0,0,66,66,0,1,0,1,0
37643,58054,445,0,0,66,66,0,1,0,1,0
37644,58058,445,0,0,66,66,0,1,0,1,0
37645,58057,445,0,0,66,66,0,1,0,1,0
37646,58056,445,0,0,66,66,0,1,0,1,0
37647,58053,445,0,0,66,66,0,1,0,1,0
37648,57770,445,0,0,70,70,0,1,0,1,0
37649,62651,445,0,0,70,70,0,1,0,1,0
37650,62649,445,0,0,70,70,0,1,0,1,0
37651,62648,445,0,0,70,70,0,1,0,1,0
37652,62645,445,0,0,70,70,0,1,0,1,0
37653,57765,445,0,0,70,70,0,1,0,1,0
37654,60335,443,9738,443,1853,1214,639,18,77,11,7
37655,53137,35111,13746,35111,70,70,0,2,8,2,0
37656,60241,80,52293,80,29924,6743,23181,37,150,16,21
37657,60332,443,37835,443,5413,3344,2069,32,87,16,16
37658,50574,443,63021,443,7352,1023,6329,19,16,11,8
37659,47089,15000,57898,15000,138,78,60,2,5,1,1
37660,57296,53,27311,53,771,101,670,2,30,1,1
37661,58917,53,38602,53,192,82,110,2,30,1,1
37662,59905,443,11259,443,343,163,180,6,15,3,3
37663,57239,53,63537,53,186,95,91,2,31,1,1
37664,55447,53,15473,53,1449,108,1341,4,33,2,2
37665,60259,443,51277,443,3285,2009,1276,26,150,16,10
37666,60244,443,61797,443,17829,9658,8171,92,150,46,46
37667,60235,443,27735,443,7990,1730,6260,25,151,13,12
37668,60242,80,7986,80,1493,737,756,11,150,6,5
37669,64884,53,2199,53,190,97,93,2,31,1,1
37670,63934,53,45085,53,202,103,99,2,30,1,1
37671,65218,53,11039,53,188,96,92,2,30,1,1
37672,6649,80,6649,80,103631,2766,100865,110,39,38,72
37673,56942,443,55057,443,8172,2656,5516,29,330,15,14
37674,51886,35965,55520,35965,66,66,0,1,5,1,0
37675,50573,443,27732,443,7282,953,6329,18,16,10,8
37676,60304,443,14746,443,3982,2461,1521,28,144,14,14
37677,50576,443,29225,443,7282,953,6329,18,16,10,8
37678,60262,443,35496,443,6627,1780,4847,23,149,13,10
37679,19648,7000,19648,7000,3610,2043,1567,16,15,9,7
37680,60300,80,12014,80,1343,846,497,11,145,6,5
37681,60208,80,42230,80,1313,738,575,10,152,6,4
37682,60263,443,35248,443,5889,2893,2996,45,149,24,21
37683,60225,443,43705,443,8989,3335,5654,65,152,31,34
37684,59993,80,25071,80,1883,1263,620,11,83,6,5
37685,65028,53,18830,53,182,93,89,2,30,1,1
37686,64583,53,25231,53,174,89,85,2,30,1,1
37687,49611,53,14294,53,184,94,90,2,30,1,1
37688,63910,53,63969,53,178,75,103,2,30,1,1
37689,49456,53,39013,53,198,101,97,2,31,1,1
37690,54990,53,8264,53,168,86,82,2,31,1,1
37691,65315,53,47241,53,767,102,665,2,31,1,1
37692,56115,53,48441,53,278,96,182,4,54,2,2
37693,49543,80,13855,80,1548,847,701,10,15,5,5
37694,64989,53,11063,53,578,286,292,9,15,5,4
37695,65382,53,48645,53,301,108,193,4,55,2,2
37696,53133,34853,20354,34853,758,320,438,11,16,6,5
37697,46327,25903,54070,25903,134,64,70,2,10,1,1
37698,51908,38446,5874,38446,316,136,180,6,6,3,3
37699,60258,80,44486,80,3348,2437,911,12,150,7,5
37700,60331,443,58220,443,1867,1228,639,18,87,11,7
37701,60224,443,54670,443,9079,3570,5509,68,152,34,34
37702,60209,443,58823,443,26423,2338,24085,50,152,24,26
37703,60305,80,11406,80,4419,3852,567,15,144,8,7
37704,60270,80,22290,80,1528,946,582,11,149,6,5
37705,52010,53,28769,53,218,85,133,2,30,1,1
37706,55929,53,16714,53,760,97,663,2,30,1,1
37707,55742,53,3708,53,780,93,687,2,30,1,1
37708,50938,53,64544,53,209,81,128,2,30,1,1
37709,52501,53,50653,53,201,80,121,2,30,1,1
37710,49952,53,50731,53,190,97,93,2,30,1,1
37711,52648,443,16992,443,64748,15327,49421,87,273,39,48
37712,55395,53,45676,53,767,102,665,2,31,1,1
37713,55748,53,59262,53,188,96,92,2,31,1,1
37714,56587,53,5530,53,184,94,90,2,31,1,1
37715,55605,53,8091,53,190,97,93,2,31,1,1
37716,48817,6889,48817,6889,1283,666,617,6,1200,3,3
37717,45980,443,15108,443,9611,2412,7199,44,20,22,22
37718,57912,53,13801,53,295,77,218,2,30,1,1
37719,55294,53,48651,53,295,101,194,4,30,2,2
37720,64811,53,5466,53,190,97,93,2,31,1,1
37721,49999,53,5056,53,178,91,87,2,31,1,1
37722,65496,53,42568,53,96,96,0,1,31,1,0
37723,38892,443,57044,443,83444,15305,68139,121,148,51,70
37724,55451,53,63000,53,751,95,656,2,30,1,1
37725,63950,53,13148,53,200,102,98,2,31,1,1
37726,55619,53,10755,53,182,93,89,2,31,1,1
37727,64707,53,28396,53,757,98,659,2,31,1,1
37728,55950,53,65022,53,752,93,659,2,31,1,1
37729,65209,53,6472,53,164,84,80,2,31,1,1
37730,56813,53,41752,53,753,96,657,2,31,1,1
37731,55310,53,30986,53,176,90,86,2,31,1,1
37732,55076,53,45529,53,182,93,89,2,31,1,1
37733,50516,53,48548,53,772,100,672,2,31,1,1
37734,53259,123,17557,123,184,94,90,2,31,1,1
37735,63930,443,21272,443,2940,669,2271,13,122,6,7
37736,51221,49683,21900,49683,870,330,540,12,1316,6,6
37737,30960,45731,48545,45731,330,330,0,6,3610,6,0
37738,55354,53,26809,53,212,108,104,2,31,1,1
37739,64428,53,57120,53,190,97,93,2,31,1,1
37740,55531,53,35408,53,772,100,672,2,31,1,1
37741,30960,45730,17923,45730,330,330,0,6,3610,6,0
37742,57020,36237,0,0,66,66,0,1,0,1,0
37743,22300,51505,0,0,66,66,0,1,0,1,0
37744,52036,5900,0,0,60,60,0,1,0,1,0
37745,21502,44847,0,0,66,66,0,1,0,1,0
37746,62643,445,0,0,70,70,0,1,0,1,0
37747,62640,445,0,0,70,70,0,1,0,1,0
37748,54992,53,3265,53,195,102,93,2,30,1,1
37749,58263,5223,22492,5223,3721,1173,2548,18,20,11,7
37750,60210,80,21481,80,5141,3706,1435,17,151,10,7
37751,64227,53,32450,53,245,94,151,2,30,1,1
37752,55076,53,43465,53,183,94,89,2,30,1,1
37753,49450,53,29878,53,758,102,656,2,30,1,1
37754,56820,53,17754,53,199,94,105,2,30,1,1
37755,50491,443,13045,443,11995,3850,8145,44,120,23,21
37756,54373,53,8646,53,200,86,114,2,30,1,1
37757,55221,443,65521,443,10435,2860,7575,27,46,15,12
37758,44075,80,12675,80,3560,1256,2304,22,86,10,12
37759,57432,53,35465,53,193,102,91,2,29,1,1
37760,54990,53,17689,53,168,86,82,2,29,1,1
37761,56137,53,49352,53,199,102,97,2,29,1,1
37762,49456,53,3975,53,199,102,97,2,30,1,1
37763,50063,443,44505,443,39888,5010,34878,60,104,32,28
37764,56718,80,40668,80,1462,703,759,8,15,5,3
37765,47262,443,28246,443,4609,763,3846,14,14,8,6
37766,64048,53,63585,53,326,92,234,4,31,2,2
37767,55804,53,21847,53,193,102,91,2,30,1,1
37768,50263,53,23939,53,172,94,78,2,30,1,1
37769,64070,53,45355,53,337,89,248,4,38,2,2
37770,51881,17997,36769,17997,414,136,278,6,16,3,3
37771,63888,6881,1639,6881,66,66,0,2,7,2,0
37772,49593,53,57101,53,212,94,118,2,29,1,1
37773,64583,53,3855,53,179,94,85,2,29,1,1
37774,64167,53,3978,53,211,102,109,2,29,1,1
37775,55165,53,51406,53,193,102,91,2,30,1,1
37776,59666,53,55387,53,497,118,379,2,30,1,1
37777,55165,53,23562,53,193,102,91,2,29,1,1
37778,56803,53,49854,53,195,102,93,2,29,1,1
37779,49501,53,7726,53,734,94,640,2,29,1,1
37780,55865,53,59326,53,196,102,94,2,29,1,1
37781,55745,53,9375,53,199,102,97,2,29,1,1
37782,65349,53,5493,53,284,94,190,2,29,1,1
37783,46949,53,11241,53,168,78,90,2,29,1,1
37784,63934,53,38044,53,209,110,99,2,30,1,1
37785,55865,53,56628,53,196,102,94,2,30,1,1
37786,55313,53,12662,53,168,78,90,2,29,1,1
37787,64428,53,56066,53,195,102,93,2,30,1,1
37788,58034,443,56445,443,4132,2158,1974,35,255,17,18
37789,60230,443,4763,443,1868,1229,639,18,151,11,7
37790,60248,80,33298,80,22768,6548,16220,31,149,14,17
37791,60214,80,20902,80,8317,6126,2191,23,151,14,9
37792,60292,80,43938,80,1462,864,598,11,144,6,5
37793,49761,443,53360,443,36615,5107,31508,108,125,49,59
37794,56489,53,32825,53,178,94,84,2,30,1,1
37795,58654,53,55637,53,168,78,90,2,30,1,1
37796,64155,53,12235,53,183,94,89,2,30,1,1
37797,55378,53,28719,53,277,102,175,2,30,1,1
37798,56481,53,28182,53,816,102,714,2,30,1,1
37799,58768,17,58768,17,66,66,0,1,30,1,0
37800,50363,53,11154,53,214,110,104,2,30,1,1
37801,60246,80,10832,80,17231,6415,10816,26,149,12,14
37802,60256,80,21007,80,3401,2157,1244,12,149,7,5
37803,37549,443,18373,443,203299,6930,196369,231,16,92,139
37804,58379,443,57467,443,24040,4851,19189,86,160,41,45
37805,60299,80,6795,80,1557,778,779,11,144,6,5
37806,60223,80,32982,80,17923,13519,4404,41,151,26,15
37807,47141,443,51949,443,2011,1238,773,16,330,9,7
37808,56115,53,55783,53,278,96,182,4,54,2,2
37809,37009,53,17382,53,78,78,0,1,30,1,0
37810,56948,53,61880,53,183,94,89,2,30,1,1
37811,33027,443,54809,443,3723,2408,1315,28,376,15,13
37812,43222,443,24936,443,2088188,38201,2049987,1829,84,404,1425
37813,58395,53,61283,53,307,86,221,2,30,1,1
37814,55473,53,5965,53,186,102,84,2,30,1,1
37815,55605,53,27341,53,195,102,93,2,30,1,1
37816,56948,53,22387,53,183,94,89,2,30,1,1
37817,60231,443,26634,443,1868,1229,639,18,151,11,7
37818,64739,53,37126,53,193,102,91,2,30,1,1
37819,42348,53,29230,53,199,94,105,2,30,1,1
37820,60217,80,28538,80,21163,16003,5160,47,151,30,17
37821,56489,53,51415,53,178,94,84,2,30,1,1
37822,54302,53,4566,53,168,78,90,2,30,1,1
37823,60207,80,10851,80,3596,2562,1034,14,151,8,6
37824,56304,53,20690,53,184,94,90,2,30,1,1
37825,65004,53,7635,53,261,102,159,2,30,1,1
37826,60293,80,44550,80,1462,864,598,11,144,6,5
37827,55804,53,9951,53,816,102,714,2,30,1,1
37828,6973,80,6973,80,132958,3923,129035,143,38,53,90
37829,56046,53,6511,53,193,102,91,2,31,1,1
37830,60303,443,13935,443,3928,2467,1461,27,144,14,13
37831,60229,443,63895,443,19536,7593,11943,76,151,37,39
37832,60221,80,44120,80,17981,13577,4404,41,151,26,15
37833,60298,443,32921,443,9565,3317,6248,25,144,14,11
37834,60296,80,32377,80,1463,865,598,11,144,6,5
37835,57418,53,56760,53,209,102,107,2,30,1,1
37836,47918,123,27276,123,184,94,90,2,30,1,1
37837,55748,53,60711,53,194,102,92,2,30,1,1
37838,51843,45702,23719,45702,1261,637,624,9,30,5,4
37839,50698,443,13372,443,24575,6565,18010,86,275,32,54
37840,38118,443,46227,443,70,70,0,1,5,1,0
37841,60247,80,40412,80,21505,6581,14924,31,149,14,17
37842,60218,80,20948,80,8268,6054,2214,23,151,14,9
37843,55906,53,30212,53,264,110,154,2,30,1,1
37844,55473,53,63957,53,186,102,84,2,30,1,1
37845,49999,53,61068,53,181,94,87,2,30,1,1
37846,42224,123,27890,123,184,94,90,2,30,1,1
37847,55294,53,35326,53,199,102,97,2,30,1,1
37848,65218,53,38514,53,194,102,92,2,31,1,1
37849,49755,443,49571,443,447301,17016,430285,539,128,196,343
37850,65382,53,33350,53,301,108,193,4,55,2,2
37851,46265,7700,48956,7700,1440,956,484,15,35,8,7
37852,34163,443,6967,443,5035,768,4267,14,15,8,6
37853,47261,443,56817,443,4536,845,3691,16,15,9,7
37854,57595,80,64244,80,2769,1396,1373,11,29,7,4
37855,26805,443,46763,443,7697,2940,4757,25,18,13,12
37856,55226,443,46963,443,8025,3048,4977,23,45,13,10
37857,59627,443,59627,443,4401,1494,2907,19,29,11,8
37858,56496,80,21274,80,458684,19849,438835,488,66,185,303
37859,49967,53,25418,53,193,102,91,2,31,1,1
37860,50125,443,38569,443,15687,3764,11923,32,34,18,14
37861,65340,53,2059,53,313,110,203,4,32,2,2
37862,51904,51883,62551,51883,70,70,0,2,8,2,0
37863,51887,16514,28256,16514,70,70,0,1,5,1,0
37864,63876,5968,40554,5968,70,70,0,1,4,1,0
37865,60238,80,26979,80,1176,701,475,9,150,6,3
37866,60239,443,31265,443,3149,1969,1180,19,150,11,8
37867,60250,443,56947,443,12389,5180,7209,31,149,17,14
37868,60289,80,35170,80,1928,906,1022,11,145,6,5
37869,60220,80,36816,80,21108,15948,5160,47,151,30,17
37870,60301,443,3566,443,7515,2022,5493,21,144,11,10
37871,8662,80,8662,80,194259,7011,187248,211,39,80,131
37872,64583,53,5543,53,426,89,337,4,58,2,2
37873,55786,53,25615,53,816,102,714,2,29,1,1
37874,55448,53,23931,53,184,94,90,2,29,1,1
37875,54635,53,0,0,197,86,111,2,29,1,1
37876,6932,80,6932,80,124405,3747,120658,131,38,46,85
37877,55570,53,24983,53,168,86,82,2,29,1,1
37878,65382,53,24981,53,301,108,193,4,54,2,2
37879,55010,53,35689,53,195,102,93,2,29,1,1
37880,64043,53,22374,53,320,94,226,2,29,1,1
37881,49567,53,36957,53,184,102,82,2,29,1,1
37882,55365,53,10129,53,184,94,90,2,29,1,1
37883,64352,53,14227,53,213,102,111,2,29,1,1
37884,63934,53,32673,53,209,110,99,2,29,1,1
37885,49212,53,34127,53,1188,94,1094,2,29,1,1
37886,49611,53,47629,53,184,94,90,2,29,1,1
37887,64255,53,54651,53,211,102,109,2,30,1,1
37888,55448,53,34800,53,184,94,90,2,29,1,1
37889,49952,53,48831,53,195,102,93,2,30,1,1
37890,56542,53,53986,53,183,94,89,2,29,1,1
37891,56739,53,42182,53,195,102,93,2,30,1,1
37892,56015,53,39973,53,195,102,93,2,30,1,1
37893,56739,53,65216,53,195,102,93,2,30,1,1
37894,64502,53,56214,53,199,102,97,2,30,1,1
37895,54560,53,54560,53,832,106,726,2,30,1,1
37896,55556,53,12940,53,302,78,224,2,30,1,1
37897,64739,53,1998,53,816,102,714,2,30,1,1
37898,49742,53,40944,53,790,110,680,2,30,1,1
37899,56434,53,28860,53,316,94,222,2,30,1,1
37900,50363,53,62670,53,214,110,104,2,30,1,1
37901,55294,53,55276,53,199,102,97,2,30,1,1
37902,49518,53,16482,53,193,102,91,2,30,1,1
37903,56332,443,3765,443,6028,1958,4070,34,124,14,20
37904,38175,443,55489,443,10208,2219,7989,37,125,19,18
37905,37965,51498,7708,51498,158,158,0,1,1199,1,0
37906,55877,53546,37144,53546,481,150,331,2,1200,1,1
37907,60290,80,20522,80,1366,785,581,11,145,6,5
37908,60297,80,29320,80,1463,865,598,11,144,6,5
37909,55650,18073,23998,18073,504,318,186,8,15,5,3
37910,51966,443,48480,443,130,70,60,2,15,1,1
37911,46155,443,27543,443,206090,6478,199612,211,170,69,142
37912,47971,443,15056,443,130,70,60,2,15,1,1
37913,63934,53,27798,53,347,103,244,4,46,2,2
37914,56115,53,39416,53,278,96,182,4,53,2,2
37915,64502,53,21170,53,199,102,97,2,30,1,1
37916,49243,53,10757,53,452,118,334,2,30,1,1
37917,55365,53,26447,53,184,94,90,2,30,1,1
37918,64854,53,19682,53,178,94,84,2,31,1,1
37919,65343,53,2539,53,184,94,90,2,31,1,1
37920,56288,53,3353,53,200,102,98,2,30,1,1
37921,56385,53,62602,53,402,142,260,2,30,1,1
37922,48733,443,64638,443,316457,19287,297170,382,80,157,225
37923,56365,80,15105,80,1636,699,937,10,15,5,5
37924,51903,35904,6046,35904,70,70,0,2,8,2,0
37925,60232,443,3016,443,1868,1229,639,18,151,11,7
37926,60215,80,6497,80,21073,15881,5192,47,151,30,17
37927,60219,80,48945,80,1987,1593,394,10,151,6,4
37928,60245,80,28831,80,14705,6415,8290,26,149,12,14
37929,60249,80,1265,80,31138,6772,24366,40,149,17,23
37930,60294,80,59530,80,1463,865,598,11,144,6,5
37931,49933,53,13874,53,186,102,84,2,30,1,1
37932,54992,53,62120,53,195,102,93,2,30,1,1
37933,63950,53,31406,53,200,102,98,2,30,1,1
37934,57378,53,5726,53,350,94,256,2,30,1,1
37935,49611,53,14406,53,184,94,90,2,30,1,1
37936,56046,53,40264,53,193,102,91,2,30,1,1
37937,37511,443,37511,443,4673,1766,2907,19,26,11,8
37938,64502,53,7896,53,374,101,273,4,42,2,2
37939,50123,443,58250,443,15011,5619,9392,50,35,26,24
37940,60216,80,20321,80,3606,2572,1034,14,151,8,6
37941,60222,80,61233,80,1989,1365,624,11,151,6,5
37942,60284,80,50056,80,1430,754,676,11,146,6,5
37943,7030,80,7030,80,115811,3862,111949,123,38,44,79
37944,49791,53,47745,53,226,94,132,2,30,1,1
37945,40755,123,40939,123,184,94,90,2,30,1,1
37946,36307,53,54070,53,200,86,114,2,30,1,1
37947,52804,443,52702,443,70,70,0,2,154,2,0
37948,55505,53,30588,53,199,102,97,2,31,1,1
37949,54990,53,35409,53,168,86,82,2,31,1,1
37950,56369,53,3077,53,193,102,91,2,31,1,1
37951,59630,443,48650,443,3304,1468,1836,18,139,10,8
37952,56854,17067,53674,17067,70,70,0,2,8,2,0
37953,53135,14297,49248,14297,70,70,0,1,5,1,0
37954,34162,443,17948,443,4897,850,4047,15,15,9,6
37955,60234,80,15861,80,1131,772,359,10,151,6,4
37956,60295,80,60202,80,8876,1061,7815,18,144,9,9
37957,52325,443,28114,443,3188,1601,1587,34,48,18,16
37958,60213,80,54393,80,47483,13980,33503,69,151,35,34
37959,60228,80,30633,80,6854,6211,643,16,151,9,7
37960,9291,80,9291,80,208056,7568,200488,227,39,88,139
37961,57528,53,37207,53,585,192,393,6,54,3,3
37962,57382,53,15348,53,969,86,883,2,30,1,1
37963,55146,53,34694,53,181,94,87,2,30,1,1
37964,64884,53,3518,53,195,102,93,2,30,1,1
37965,56754,53,65237,53,183,94,89,2,30,1,1
37966,63951,53,30484,53,193,102,91,2,30,1,1
37967,65209,53,36498,53,166,86,80,2,30,1,1
37968,57432,53,25990,53,193,102,91,2,30,1,1
37969,64385,53,43683,53,179,94,85,2,30,1,1
37970,56587,53,37194,53,184,94,90,2,30,1,1
37971,55310,53,16833,53,180,94,86,2,30,1,1
37972,56481,53,4723,53,193,102,91,2,30,1,1
37973,64762,53,50554,53,194,102,92,2,30,1,1
37974,55310,53,54071,53,180,94,86,2,30,1,1
37975,49767,53,22379,53,177,94,83,2,31,1,1
37976,36126,53,44357,53,326,78,248,2,31,1,1
37977,50779,443,59788,443,16067,4838,11229,43,121,21,22
37978,60794,443,17248,443,796772,27151,769621,878,137,302,576
37979,46337,443,56368,443,10379011,159069,10219942,8727,252,1321,7406
37980,37965,50321,10306,50321,158,158,0,1,1199,1,0
37981,63950,53,19633,53,200,102,98,2,30,1,1
37982,51607,53,31322,53,296,94,202,2,30,1,1
37983,55619,53,46483,53,183,94,89,2,30,1,1
37984,64132,53,11636,53,179,94,85,2,30,1,1
37985,55866,53,0,0,86,86,0,1,30,1,0
37986,64884,53,55819,53,195,102,93,2,31,1,1
37987,55076,53,14239,53,183,94,89,2,30,1,1
37988,55373,53,47253,53,164,86,78,2,31,1,1
37989,55373,53,29623,53,164,86,78,2,30,1,1
37990,50002,53,11892,53,196,102,94,2,31,1,1
37991,62458,53,43371,53,429,102,327,2,31,1,1
37992,56587,53,64159,53,184,94,90,2,31,1,1
37993,64762,53,20987,53,194,102,92,2,31,1,1
37994,56560,53,21034,53,198,102,96,2,31,1,1
37995,56975,53,65042,53,197,102,95,2,31,1,1
37996,57239,53,14403,53,193,102,91,2,31,1,1
37997,50967,443,6506,443,612314,25589,586725,676,127,234,442
37998,50969,443,44036,443,7221,2265,4956,16,127,7,9
37999,37965,23215,60797,23215,537,158,379,2,1199,1,1
38000,45409,53,56925,53,307,86,221,2,31,1,1
38001,65224,53,24023,53,994,86,908,2,31,1,1
38002,58476,443,24063,443,25370,5607,19763,40,138,18,22
38003,64569,53,2461,53,214,102,112,2,31,1,1
38004,61191,443,24135,443,569471,20976,548495,666,333,273,393
38005,51634,443,38565,443,3174,346,2828,12,121,5,7
38006,42820,443,40301,443,20255,5440,14815,32,122,16,16
38007,37965,51413,17500,51413,848,252,596,4,1199,2,2
38008,43904,443,27046,443,7552,2611,4941,24,360,13,11
38009,40214,443,5611,443,3910,2223,1687,24,3676,8,16
38010,56288,53,26260,53,200,102,98,2,31,1,1
38011,55748,53,57713,53,194,102,92,2,31,1,1
38012,51843,80,51843,80,35384,3225,32159,49,26,20,29
38013,38290,443,29490,443,6978,1169,5809,22,163,12,10
38014,49942,53,42847,53,264,94,170,2,31,1,1
38015,64132,53,36663,53,179,94,85,2,31,1,1
38016,51444,3027,51444,3027,156,156,0,3,8,3,0
38017,65209,53,37823,53,166,86,80,2,31,1,1
38018,51616,443,56570,443,62241,4598,57643,82,170,35,47
38019,51845,80,51845,80,28037,2069,25968,40,26,16,24
38020,63580,443,12197,443,5759,1721,4038,20,78,11,9
38021,62639,445,0,0,70,70,0,1,0,1,0
38022,33627,36237,0,0,66,66,0,1,0,1,0
38023,58043,445,0,0,66,66,0,1,0,1,0
38024,23900,64147,0,0,62,62,0,1,0,1,0
38025,62636,445,0,0,70,70,0,1,0,1,0
38026,33651,36237,0,0,146,146,0,1,0,1,0
38027,4760,44847,0,0,62,62,0,1,0,1,0
38028,32051,37965,0,0,62,62,0,1,0,1,0
38029,58042,445,0,0,66,66,0,1,0,1,0
38030,21179,44847,0,0,146,146,0,1,0,1,0
38031,58040,445,0,0,66,66,0,1,0,1,0
38032,6224,37965,0,0,62,62,0,1,0,1,0
38033,58039,445,0,0,66,66,0,1,0,1,0
38034,27402,37965,0,0,66,66,0,1,0,1,0
38035,58036,445,0,0,66,66,0,1,0,1,0
38036,57752,445,0,0,70,70,0,1,0,1,0
38037,26229,21247,0,0,66,66,0,1,0,1,0
38038,57151,39004,0,0,66,66,0,1,0,1,0
38039,57749,445,0,0,70,70,0,1,0,1,0
38040,62635,445,0,0,70,70,0,1,0,1,0
38041,62625,445,0,0,70,70,0,1,0,1,0
38042,62624,445,0,0,70,70,0,1,0,1,0
38043,31136,50584,0,0,146,146,0,1,0,1,0
38044,61522,64147,0,0,66,66,0,1,0,1,0
38045,37121,21247,0,0,66,66,0,1,0,1,0
38046,26048,21,0,0,60,60,0,1,0,1,0
38047,58026,445,0,0,66,66,0,1,0,1,0
38048,42044,60043,0,0,66,66,0,1,0,1,0
38049,57745,445,0,0,70,70,0,1,0,1,0
38050,43868,23,0,0,60,60,0,1,0,1,0
38051,15333,44847,0,0,62,62,0,1,0,1,0
38052,57743,445,0,0,70,70,0,1,0,1,0
38053,57741,445,0,0,70,70,0,1,0,1,0
38054,58018,445,0,0,66,66,0,1,0,1,0
38055,62608,445,0,0,70,70,0,1,0,1,0
38056,62849,62413,0,0,62,62,0,1,0,1,0
38057,65529,35440,0,0,62,62,0,1,0,1,0
38058,58016,445,0,0,66,66,0,1,0,1,0
38059,57734,445,0,0,70,70,0,1,0,1,0
38060,57732,445,0,0,70,70,0,1,0,1,0
38061,27528,35440,0,0,66,66,0,1,0,1,0
38062,60361,57470,0,0,66,66,0,1,0,1,0
38063,58007,445,0,0,66,66,0,1,0,1,0
38064,56381,51505,0,0,62,62,0,1,0,1,0
38065,5462,21247,0,0,66,66,0,1,0,1,0
38066,57998,445,0,0,66,66,0,1,0,1,0
38067,51401,6881,0,0,66,66,0,1,0,1,0
38068,57731,445,0,0,70,70,0,1,0,1,0
38069,57730,445,0,0,70,70,0,1,0,1,0
38070,57729,445,0,0,70,70,0,1,0,1,0
38071,57726,445,0,0,70,70,0,1,0,1,0
38072,57723,445,0,0,70,70,0,1,0,1,0
38073,31748,56205,0,0,62,62,0,1,0,1,0
38074,30303,30303,0,0,181,181,0,1,0,1,0
38075,49329,443,27397,443,460,394,66,4,0,3,1
38076,57711,445,0,0,70,70,0,1,0,1,0
38077,57710,445,0,0,70,70,0,1,0,1,0
38078,62599,445,0,0,70,70,0,1,0,1,0
38079,62597,445,0,0,70,70,0,1,0,1,0
38080,62596,445,0,0,70,70,0,1,0,1,0
38081,57706,445,0,0,70,70,0,1,0,1,0
38082,48676,53395,0,0,60,60,0,1,0,1,0
38083,64891,22,0,0,60,60,0,1,0,1,0
38084,57993,445,0,0,66,66,0,1,0,1,0
38085,57987,445,0,0,66,66,0,1,0,1,0
38086,57992,445,0,0,66,66,0,1,0,1,0
38087,57988,445,0,0,66,66,0,1,0,1,0
38088,57986,445,0,0,66,66,0,1,0,1,0
38089,57989,445,0,0,66,66,0,1,0,1,0
38090,57985,445,0,0,66,66,0,1,0,1,0
38091,57990,445,0,0,66,66,0,1,0,1,0
38092,57700,445,0,0,70,70,0,1,0,1,0
38093,57701,445,0,0,70,70,0,1,0,1,0
38094,47105,64147,0,0,62,62,0,1,0,1,0
38095,27537,25198,0,0,148,148,0,1,0,1,0
38096,63171,2323,0,0,60,60,0,1,0,1,0
38097,59626,22114,0,0,66,66,0,1,0,1,0
38098,22130,61248,0,0,159,159,0,1,0,1,0
38099,56794,46824,0,0,66,66,0,1,0,1,0
38100,48488,50584,0,0,62,62,0,1,0,1,0
38101,58664,64147,0,0,62,62,0,1,0,1,0
38102,19617,39004,0,0,145,145,0,1,0,1,0
38103,50644,35440,0,0,66,66,0,1,0,1,0
38104,61135,50265,0,0,62,62,0,1,0,1,0
38105,57689,445,0,0,70,70,0,1,0,1,0
38106,16760,10214,0,0,62,62,0,1,0,1,0
38107,62595,445,0,0,70,70,0,1,0,1,0
38108,62591,445,0,0,70,70,0,1,0,1,0
38109,62579,445,0,0,70,70,0,1,0,1,0
38110,62581,445,0,0,70,70,0,1,0,1,0
38111,65317,51221,0,0,78,78,0,1,0,1,0
38112,63341,53,0,0,77,77,0,1,0,1,0
38113,41429,50584,0,0,66,66,0,1,0,1,0
38114,57972,445,0,0,66,66,0,1,0,1,0
38115,57973,445,0,0,66,66,0,1,0,1,0
38116,57970,445,0,0,66,66,0,1,0,1,0
38117,46286,21247,0,0,62,62,0,1,0,1,0
38118,38538,22,0,0,60,60,0,1,0,1,0
38119,62577,445,0,0,70,70,0,1,0,1,0
38120,57685,445,0,0,70,70,0,1,0,1,0
38121,47682,64147,0,0,66,66,0,1,0,1,0
38122,62568,445,0,0,70,70,0,1,0,1,0
38123,62570,445,0,0,70,70,0,1,0,1,0
38124,62571,445,0,0,70,70,0,1,0,1,0
38125,14844,37965,0,0,62,62,0,1,0,1,0
38126,12465,11392,0,0,62,62,0,1,0,1,0
38127,57676,445,0,0,70,70,0,1,0,1,0
38128,57673,445,0,0,70,70,0,1,0,1,0
38129,57675,445,0,0,70,70,0,1,0,1,0
38130,6014,37965,0,0,62,62,0,1,0,1,0
38131,57672,445,0,0,70,70,0,1,0,1,0
38132,57669,445,0,0,70,70,0,1,0,1,0
38133,13285,29892,0,0,145,145,0,1,0,1,0
38134,13285,29892,0,0,145,145,0,1,0,1,0
38135,1373,22114,0,0,62,62,0,1,0,1,0
38136,62089,8604,0,0,66,66,0,1,0,1,0
38137,14343,6881,0,0,146,146,0,1,0,1,0
38138,51592,51505,0,0,66,66,0,1,0,1,0
38139,43724,35440,0,0,62,62,0,1,0,1,0
38140,65085,22114,0,0,66,66,0,1,0,1,0
38141,62559,445,0,0,70,70,0,1,0,1,0
38142,62556,445,0,0,70,70,0,1,0,1,0
38143,62552,445,0,0,70,70,0,1,0,1,0
38144,43723,5900,0,0,60,60,0,1,0,1,0
38145,57662,445,0,0,70,70,0,1,0,1,0
38146,30274,23,0,0,60,60,0,1,0,1,0
38147,23126,35440,0,0,62,62,0,1,0,1,0
38148,993,4543,0,0,66,66,0,1,0,1,0
38149,57387,70,0,0,60,60,0,1,0,1,0
38150,49001,40108,0,0,161,161,0,1,0,1,0
38151,57655,445,0,0,70,70,0,1,0,1,0
38152,57653,445,0,0,70,70,0,1,0,1,0
38153,57949,445,0,0,66,66,0,1,0,1,0
38154,5617,64147,0,0,62,62,0,1,0,1,0
38155,62549,445,0,0,70,70,0,1,0,1,0
38156,62548,445,0,0,70,70,0,1,0,1,0
38157,57649,445,0,0,70,70,0,1,0,1,0
38158,57942,445,0,0,66,66,0,1,0,1,0
38159,57941,445,0,0,66,66,0,1,0,1,0
38160,57647,445,0,0,70,70,0,1,0,1,0
38161,12242,51221,0,0,62,62,0,1,0,1,0
38162,993,18732,0,0,129,129,0,1,0,1,0
38163,51581,17546,0,0,66,66,0,1,0,1,0
38164,64762,53,32990,53,188,96,92,2,30,1,1
38165,65343,53,10337,53,184,94,90,2,30,1,1
38166,64132,53,9025,53,174,89,85,2,30,1,1
38167,56369,53,8270,53,186,95,91,2,31,1,1
38168,64327,53,33651,53,204,104,100,2,31,1,1
38169,56288,53,45590,53,200,102,98,2,31,1,1
38170,49558,53,59753,53,186,95,91,2,30,1,1
38171,65386,53,20616,53,762,101,661,2,30,1,1
38172,64385,53,34139,53,174,89,85,2,30,1,1
38173,51885,64546,12386,64546,66,66,0,1,5,1,0
38174,60378,443,48147,443,22073,10774,11299,48,107,26,22
38175,55660,53,37547,53,757,98,659,2,30,1,1
38176,51840,80,51840,80,525257,17273,507984,531,26,183,348
38177,51839,80,51839,80,951054,20747,930307,902,26,276,626
38178,55005,443,32809,443,134,60,74,3,11,2,1
38179,56219,53,32903,53,762,101,661,2,31,1,1
38180,49518,53,63252,53,186,95,91,2,30,1,1
38181,55396,53,1903,53,778,103,675,2,30,1,1
38182,51830,443,51830,443,17899,5015,12884,33,36,14,19
38183,62453,443,7833,443,8698,3272,5426,22,26,11,11
38184,58370,443,50234,443,6277528,124223,6153305,5970,160,1890,4080
38185,55649,42266,57482,42266,70,70,0,1,5,1,0
38186,53134,42369,37708,42369,70,70,0,1,5,1,0
38187,65264,53,54273,53,88,88,0,1,30,1,0
38188,64122,53,44861,53,212,108,104,2,31,1,1
38189,55175,80,55175,80,7452,1052,6400,20,22,11,9
38190,40545,443,53543,443,8691,6945,1746,25,80,14,11
38191,52787,443,46630,443,352,218,134,6,28,4,2
38192,39513,443,6930,443,16012,10450,5562,33,80,18,15
38193,56268,443,24537,443,10226,4435,5791,50,256,24,26
38194,50474,80,50474,80,4994,855,4139,14,21,7,7
38195,51899,47537,54934,47537,70,70,0,2,8,2,0
38196,49273,7000,49273,7000,2163,676,1487,14,15,7,7
38197,49512,443,62361,443,12472,1628,10844,35,195,16,19
38198,65422,53,10168,53,753,96,657,2,30,1,1
38199,64854,53,42024,53,172,88,84,2,30,1,1
38200,64595,53,56793,53,182,93,89,2,30,1,1
38201,49174,53,58915,53,198,101,97,2,30,1,1
38202,64888,60038,0,0,66,66,0,1,91,1,0
38203,51221,63128,42268,63128,480,149,331,2,1201,1,1
38204,56046,53,4218,53,186,95,91,2,31,1,1
38205,49160,50321,21626,50321,150,150,0,2,1200,2,0
38206,56975,53,53582,53,194,99,95,2,30,1,1
38207,50002,53,33820,53,192,98,94,2,31,1,1
38208,56560,53,34693,53,196,100,96,2,31,1,1
38209,49800,53,22865,53,182,93,89,2,31,1,1
38210,49967,53,41633,53,186,95,91,2,31,1,1
38211,55125,53,57418,53,170,87,83,2,31,1,1
38212,49767,53,46615,53,200,102,98,2,31,1,1
38213,57083,53,25967,53,196,100,96,2,31,1,1
38214,56561,53,4757,53,166,85,81,2,31,1,1
38215,49262,53,27998,53,168,86,82,2,31,1,1
38216,65307,53,2186,53,184,94,90,2,31,1,1
38217,55265,53,19057,53,740,93,647,2,31,1,1
38218,49531,53,21298,53,740,93,647,2,31,1,1
38219,15503,42286,2173,42286,480,149,331,2,1200,1,1
38220,58988,443,31183,443,4330,1777,2553,18,122,9,9
38221,56955,53,2081,53,182,93,89,2,31,1,1
38222,55760,53,53617,53,180,92,88,2,31,1,1
38223,49752,53,46099,53,180,92,88,2,31,1,1
38224,54351,443,26403,443,7900,2042,5858,27,36,15,12
38225,50557,53,32584,53,758,93,665,2,31,1,1
38226,56589,53,29325,53,198,101,97,2,31,1,1
38227,35608,443,39608,443,5007,3053,1954,24,394,8,16
38228,62670,443,51023,443,6179,3326,2853,26,186,12,14
38229,44884,443,19838,443,36435,28844,7591,65,396,35,30
38230,59242,443,7294,443,7192,2002,5190,24,360,11,13
38231,57643,445,0,0,70,70,0,1,0,1,0
38232,6889,48817,0,0,143,143,0,1,0,1,0
38233,62528,445,0,0,70,70,0,1,0,1,0
38234,62530,445,0,0,70,70,0,1,0,1,0
38235,62527,445,0,0,70,70,0,1,0,1,0
38236,32342,62413,0,0,66,66,0,1,0,1,0
38237,55733,51505,0,0,66,66,0,1,0,1,0
38238,57937,445,0,0,66,66,0,1,0,1,0
38239,53971,50265,0,0,66,66,0,1,0,1,0
38240,57642,445,0,0,70,70,0,1,0,1,0
38241,59511,21247,0,0,62,62,0,1,0,1,0
38242,57926,445,0,0,66,66,0,1,0,1,0
38243,57929,445,0,0,66,66,0,1,0,1,0
38244,57927,445,0,0,66,66,0,1,0,1,0
38245,57934,445,0,0,66,66,0,1,0,1,0
38246,57933,445,0,0,66,66,0,1,0,1,0
38247,57928,445,0,0,66,66,0,1,0,1,0
38248,57924,445,0,0,66,66,0,1,0,1,0
38249,64122,53,29748,53,214,110,104,2,30,1,1
38250,65343,53,12113,53,184,94,90,2,30,1,1
38251,62524,445,0,0,70,70,0,1,0,1,0
38252,62521,445,0,0,70,70,0,1,0,1,0
38253,62517,445,0,0,70,70,0,1,0,1,0
38254,62519,445,0,0,70,70,0,1,0,1,0
38255,63589,44847,0,0,66,66,0,1,0,1,0
38256,57637,445,0,0,70,70,0,1,0,1,0
38257,56418,41615,0,0,143,143,0,1,0,1,0
38258,51259,1433,0,0,60,60,0,1,0,1,0
38259,27869,51221,0,0,66,66,0,1,0,1,0
38260,6546,37965,0,0,62,62,0,1,0,1,0
38261,26448,41864,0,0,145,145,0,1,0,1,0
38262,11066,50584,0,0,66,66,0,1,0,1,0
38263,50292,22114,0,0,66,66,0,1,0,1,0
38264,44821,64147,0,0,62,62,0,1,0,1,0
38265,13968,29376,0,0,62,62,0,1,0,1,0
38266,54778,22114,0,0,62,62,0,1,0,1,0
38267,8486,56205,0,0,62,62,0,1,0,1,0
38268,62516,445,0,0,70,70,0,1,0,1,0
38269,62512,445,0,0,70,70,0,1,0,1,0
38270,62509,445,0,0,70,70,0,1,0,1,0
38271,32156,51505,0,0,146,146,0,1,0,1,0
38272,57918,445,0,0,66,66,0,1,0,1,0
38273,62508,445,0,0,70,70,0,1,0,1,0
38274,7181,64147,0,0,66,66,0,1,0,1,0
38275,64603,53,6564,53,258,102,156,2,30,1,1
38276,36531,443,53488,443,123782,10685,113097,157,180,65,92
38277,54982,53,55508,53,282,96,186,4,48,2,2
38278,45525,53,45525,53,469,165,304,4,30,2,2
38279,49406,53,22949,53,215,102,113,2,30,1,1
38280,64982,53,55675,53,215,102,113,2,30,1,1
38281,65172,53,25157,53,306,110,196,2,30,1,1
38282,49262,53,60170,53,168,86,82,2,30,1,1
38283,49603,53,29581,53,199,102,97,2,30,1,1
38284,53248,443,60652,443,532222,22112,510110,645,232,259,386
38285,38370,443,49097,443,9194,5026,4168,24,32,11,13
38286,55625,443,33412,443,96323,4044,92279,113,139,44,69
38287,55165,53,3036,53,193,102,91,2,29,1,1
38288,55605,53,24748,53,195,102,93,2,29,1,1
38289,50339,53,28610,53,498,204,294,6,29,3,3
38290,64811,53,22274,53,195,102,93,2,29,1,1
38291,64233,53,2922,53,257,126,131,2,29,1,1
38292,50289,443,30139,443,9571,2811,6760,45,87,24,21
38293,54989,443,3314,443,7745,2583,5162,27,100,15,12
38294,65382,53,20387,53,301,108,193,4,54,2,2
38295,50578,123,63477,123,184,94,90,2,30,1,1
38296,50258,443,57201,443,7975,1974,6001,31,210,15,16
38297,43220,443,18756,443,3178535,62767,3115768,2800,83,626,2174
38298,47817,443,22532,443,190,70,120,4,14,2,2
38299,38291,443,42711,443,6737,1006,5731,20,162,11,9
38300,42980,80,62897,80,944,529,415,11,315,6,5
38301,58363,443,44841,443,46992,4773,42219,89,160,36,53
38302,36325,443,45107,443,2930,1614,1316,16,249,9,7
38303,55220,80,9309,80,1146,606,540,8,45,5,3
38304,53710,27935,28057,27935,70,70,0,2,7,2,0
38305,55222,443,38278,443,5312,1510,3802,18,45,11,7
38306,55219,443,55870,443,6528,1918,4610,23,45,13,10
38307,60772,40010,29000,40010,316,136,180,6,5,3,3
38308,38368,443,41740,443,4392,1164,3228,17,34,9,8
38309,51907,47518,40645,47518,316,136,180,6,5,3,3
38310,53713,26085,43109,26085,70,70,0,2,7,2,0
38311,33069,80,38685,80,1899,1172,727,17,284,10,7
38312,64275,53,47631,53,324,90,234,4,35,2,2
38313,39208,5900,39208,5900,152,66,86,2,10,1,1
38314,51500,993,4543,993,14747,5073,9674,109,45,51,58
38315,42385,443,44650,443,26481,1832,24649,40,330,18,22
38316,36108,8245,12106,8245,280,214,66,2,29,1,1
38317,64132,53,49481,53,179,94,85,2,29,1,1
38318,65343,53,41692,53,184,94,90,2,29,1,1
38319,55599,53,39999,53,258,94,164,2,29,1,1
38320,50263,53,56865,53,164,86,78,2,29,1,1
38321,49381,53,64109,53,230,102,128,2,29,1,1
38322,64276,53,39382,53,197,102,95,2,29,1,1
38323,55354,53,62421,53,214,110,104,2,30,1,1
38324,49548,53,36556,53,198,94,104,2,29,1,1
38325,49952,53,64431,53,195,102,93,2,29,1,1
38326,51979,80,28537,80,6083,699,5384,14,46,7,7
38327,51965,80,35850,80,106904,5958,100946,139,66,62,77
38328,55821,53,65311,53,196,102,94,2,31,1,1
38329,64304,53,40913,53,1054,293,761,8,94,4,4
38330,62456,443,40302,443,8678,3253,5425,22,25,11,11
38331,49948,80,2205,80,19740,993,18747,28,15,12,16
38332,49862,53,51904,53,194,102,92,2,30,1,1
38333,64935,53,3553,53,198,102,96,2,30,1,1
38334,55076,53,24944,53,183,94,89,2,30,1,1
38335,65251,53,19717,53,819,102,717,2,30,1,1
38336,35824,443,2741,443,7237,2204,5033,15,120,7,8
38337,42289,443,63031,443,6827,1776,5051,26,121,13,13
38338,55052,53,42687,53,198,102,96,2,30,1,1
38339,65307,53,63090,53,184,94,90,2,30,1,1
38340,49174,53,59747,53,199,102,97,2,33,1,1
38341,55748,443,39721,443,21446,1599,19847,35,154,16,19
38342,49904,53,21659,53,749,94,655,2,30,1,1
38343,55354,53,63415,53,214,110,104,2,30,1,1
38344,49947,80,44031,80,362232,10443,351789,387,15,147,240
38345,50305,53,38735,53,209,110,99,2,30,1,1
38346,42904,53,51732,53,308,118,190,2,30,1,1
38347,55114,443,11994,443,14680,6119,8561,35,152,16,19
38348,54953,443,55555,443,9996,2043,7953,42,271,20,22
38349,56786,53,1954,53,194,102,92,2,30,1,1
38350,37067,443,4326,443,21446,1599,19847,35,155,16,19
38351,59834,80,63639,80,943291,17238,926053,869,72,249,620
38352,64854,53,27051,53,178,94,84,2,30,1,1
38353,55236,53,57748,53,216,102,114,2,30,1,1
38354,57315,443,45136,443,77504,4494,73010,112,200,54,58
38355,59773,53,31376,53,193,94,99,2,30,1,1
38356,55036,53,3360,53,177,94,83,2,30,1,1
38357,49999,53,62191,53,316,91,225,4,46,2,2
38358,49198,53,53619,53,308,118,190,2,30,1,1
38359,60381,443,9520,443,24271,17315,6956,53,107,34,19
38360,35201,53,32554,53,308,118,190,2,30,1,1
38361,56786,53,65502,53,817,102,715,2,30,1,1
38362,65251,53,30637,53,196,102,94,2,30,1,1
38363,50615,53,31516,53,785,110,675,2,30,1,1
38364,49360,53,51221,53,321,102,219,2,30,1,1
38365,55619,53,64151,53,183,94,89,2,30,1,1
38366,64684,53,23170,53,199,94,105,2,30,1,1
38367,64385,53,23181,53,179,94,85,2,30,1,1
38368,41641,443,28317,443,13106,6413,6693,24,121,12,12
38369,51973,80,59636,80,21570,1613,19957,33,54,16,17
38370,51966,80,56206,80,83302,3780,79522,105,66,47,58
38371,59874,443,18993,443,1066,545,521,11,28,5,6
38372,56637,80,52477,80,234,234,0,4,12,4,0
38373,56846,26665,43590,26665,70,70,0,1,5,1,0
38374,47258,443,16882,443,50898,2733,48165,73,218,33,40
38375,49946,80,45099,80,31517,1203,30314,38,15,15,23
38376,49943,80,26149,80,10767,783,9984,19,15,9,10
38377,57007,5333,59200,5333,7194101,1949033,5245068,50585,1008,24913,25672
38378,45525,53,45525,53,86,86,0,1,30,1,0
38379,55354,53,21132,53,214,110,104,2,30,1,1
38380,56955,53,1466,53,183,94,89,2,30,1,1
38381,50305,53,8454,53,209,110,99,2,30,1,1
38382,49514,443,28704,443,28361,1861,26500,49,195,19,30
38383,40527,443,2355,443,21750,1903,19847,39,154,20,19
38384,56687,443,11163,443,21086,2515,18571,42,25,21,21
38385,62454,443,55667,443,18884,4117,14767,37,25,16,21
38386,51929,80,26646,80,1213,821,392,8,15,6,2
38387,45300,443,4696,443,11748,7422,4326,59,113,31,28
38388,55564,80,32717,80,944,529,415,11,315,6,5
38389,64854,53,60425,53,178,94,84,2,30,1,1
38390,65486,53,61924,53,216,102,114,2,30,1,1
38391,64327,53,41700,53,210,110,100,2,30,1,1
38392,55605,53,6586,53,195,102,93,2,30,1,1
38393,57008,123,60959,123,184,94,90,2,30,1,1
38394,33706,80,48762,80,1265,473,792,8,15,5,3
38395,38700,443,49227,443,130,70,60,2,14,1,1
38396,50711,443,57174,443,7240,2265,4975,24,351,13,11
38397,42595,443,30091,443,190565,9979,180586,272,244,140,132
38398,49456,53,22820,53,308,101,207,4,32,2,2
38399,55740,8060,29494,8060,70,70,0,2,7,2,0
38400,51884,22828,1526,22828,70,70,0,1,5,1,0
38401,53249,443,17659,443,3292049,87705,3204344,3470,232,1188,2282
38402,36471,443,15597,443,83203,3599,79604,101,138,41,60
38403,62455,443,9859,443,8302,2895,5407,22,25,11,11
38404,49952,80,46004,80,4023,620,3403,14,15,7,7
38405,35991,443,26374,443,190,70,120,4,14,2,2
38406,51844,80,51844,80,72734,3432,69302,83,25,31,52
38407,51842,80,51842,80,407760,15074,392686,424,25,154,270
38408,50172,443,57262,443,130,70,60,2,14,1,1
38409,63863,34678,27822,34678,504,382,122,8,15,6,2
38410,51974,80,47213,80,38272,2881,35391,54,54,26,28
38411,53714,6882,37422,6882,70,70,0,2,7,2,0
38412,56369,53,59261,53,193,102,91,2,29,1,1
38413,55865,53,14766,53,325,98,227,4,40,2,2
38414,65447,53,50068,53,277,102,175,2,29,1,1
38415,49951,80,47463,80,38898,1623,37275,49,15,21,28
38416,29677,53,29677,53,218,90,128,2,29,1,1
38417,55294,53,64912,53,199,102,97,2,29,1,1
38418,56292,53,0,0,238,94,144,2,29,1,1
38419,64621,53,52780,53,387,134,253,2,29,1,1
38420,64428,53,23839,53,621,196,425,6,59,3,3
38421,49767,53,20343,53,177,94,83,2,29,1,1
38422,55619,53,44719,53,183,94,89,2,29,1,1
38423,65007,53,49517,53,330,94,236,4,55,2,2
38424,64595,53,56897,53,183,94,89,2,29,1,1
38425,64327,53,51961,53,210,110,100,2,30,1,1
38426,54992,53,53080,53,195,102,93,2,29,1,1
38427,49558,53,38507,53,193,102,91,2,29,1,1
38428,56489,53,35362,53,178,94,84,2,29,1,1
38429,55365,53,11222,53,214,110,104,2,29,1,1
38430,65221,53,38871,53,258,102,156,2,29,1,1
38431,64852,53,7184,53,248,102,146,2,29,1,1
38432,49999,53,13553,53,181,94,87,2,29,1,1
38433,55365,53,5213,53,214,110,104,2,29,1,1
38434,55505,53,4978,53,199,102,97,2,29,1,1
38435,56399,53,36148,53,498,204,294,6,29,3,3
38436,56975,53,38883,53,197,102,95,2,29,1,1
38437,55052,53,1245,53,198,102,96,2,30,1,1
38438,65411,53,34611,53,354,102,252,2,30,1,1
38439,64962,53,10417,53,196,94,102,2,30,1,1
38440,57005,53,13005,53,199,94,105,2,30,1,1
38441,49848,53,31476,53,167,86,81,2,30,1,1
38442,55760,53,12734,53,182,94,88,2,30,1,1
38443,64122,53,40984,53,214,110,104,2,30,1,1
38444,52566,443,55072,443,8594,1042,7552,16,120,7,9
38445,51629,443,13664,443,19743,2133,17610,32,187,11,21
38446,52100,443,14481,443,7711,1717,5994,26,361,13,13
38447,49301,53,26968,53,353,118,235,2,31,1,1
38448,44721,443,28122,443,24317,1518,22799,38,218,16,22
38449,63950,53,3217,53,348,102,246,4,39,2,2
38450,49950,80,54747,80,3991,620,3371,14,15,7,7
38451,49944,80,31108,80,3695,550,3145,12,15,6,6
38452,55036,53,7624,53,177,94,83,2,30,1,1
38453,55125,53,47085,53,177,94,83,2,30,1,1
38454,55872,53,55193,53,819,102,717,2,30,1,1
38455,50425,53,24348,53,199,102,97,2,30,1,1
38456,55405,53,55361,53,199,102,97,2,30,1,1
38457,49928,443,36059,443,11646,4774,6872,29,32,18,11
38458,56688,443,28124,443,19185,2445,16740,40,25,20,20
38459,49183,443,49342,443,473744,13158,460586,495,20,183,312
38460,63885,6969,1755,6969,66,66,0,2,8,2,0
38461,47828,443,4397,443,512466,48982,463484,912,124,446,466
38462,57240,443,57240,443,4623,1716,2907,19,26,11,8
38463,59873,443,3851,443,1066,545,521,11,28,5,6
38464,35212,443,35212,443,4700,1793,2907,19,27,11,8
38465,64811,53,57822,53,314,97,217,4,47,2,2
38466,65436,53,49533,53,286,90,196,4,55,2,2
38467,49862,53,59363,53,817,102,715,2,30,1,1
38468,50002,53,25520,53,196,102,94,2,30,1,1
38469,64935,53,55369,53,198,102,96,2,30,1,1
38470,64122,53,11077,53,214,110,104,2,30,1,1
38471,49800,53,14799,53,183,94,89,2,30,1,1
38472,49949,80,34072,80,16663,923,15740,25,15,11,14
38473,50477,80,50477,80,20873,1203,19670,30,21,13,17
38474,34746,443,4348,443,284320,14149,270171,398,244,203,195
38475,53675,29970,54968,29970,612,426,186,10,22,7,3
38476,49945,80,12569,80,4215,620,3595,14,15,7,7
38477,51980,80,55042,80,4247,699,3548,13,46,7,6
38478,51977,80,44699,80,4305,699,3606,13,46,7,6
38479,65497,53,19517,53,490,111,379,4,54,2,2
38480,57185,53,50357,53,784,94,690,2,30,1,1
38481,52780,53,38802,53,338,94,244,2,30,1,1
38482,49425,53,61081,53,772,102,670,2,30,1,1
38483,55821,53,40795,53,196,102,94,2,30,1,1
38484,56955,53,34703,53,183,94,89,2,30,1,1
38485,64945,53,35387,53,240,86,154,2,30,1,1
38486,64605,53,20190,53,183,94,89,2,31,1,1
38487,33313,443,29395,443,9675,2389,7286,43,143,21,22
38488,49657,80,55424,80,1278,774,504,12,361,7,5
38489,49781,53,21515,53,194,102,92,2,30,1,1
38490,55872,53,6785,53,196,102,94,2,30,1,1
38491,59283,53,37048,53,359,86,273,2,30,1,1
38492,49319,53,45899,53,166,86,80,2,30,1,1
38493,56979,53,50230,53,209,110,99,2,30,1,1
38494,50520,53,46734,53,732,86,646,2,30,1,1
38495,64762,53,37992,53,194,102,92,2,30,1,1
38496,49767,53,43872,53,200,102,98,2,31,1,1
38497,55310,53,54905,53,180,94,86,2,31,1,1
38498,49703,53,23224,53,288,102,186,2,31,1,1
38499,60796,443,14652,443,69973,4662,65311,108,135,43,65
38500,49573,443,42644,443,111881,6152,105729,137,139,51,86
38501,56288,53,47353,53,200,102,98,2,30,1,1
38502,49848,53,25784,53,167,86,81,2,30,1,1
38503,56430,53,26813,53,199,102,97,2,30,1,1
38504,50002,53,41135,53,196,102,94,2,30,1,1
38505,49800,53,2151,53,183,94,89,2,31,1,1
38506,56589,53,43560,53,166,86,80,2,31,1,1
38507,49518,53,53885,53,193,102,91,2,30,1,1
38508,57058,53,2739,53,167,86,81,2,31,1,1
38509,50523,53,46429,53,376,78,298,2,31,1,1
38510,55760,53,35277,53,182,94,88,2,31,1,1
38511,64022,53,48680,53,197,102,95,2,31,1,1
38512,49898,443,38870,443,8191,2343,5848,33,394,11,22
38513,6881,48608,12608,48608,228,118,110,2,1199,1,1
38514,46838,443,19080,443,10876,3774,7102,12,145,5,7
38515,43791,443,3031,443,6933,1677,5256,22,305,12,10
38516,56369,53,59110,53,193,102,91,2,31,1,1
38517,49973,53,27114,53,261,94,167,2,30,1,1
38518,57083,53,27580,53,198,102,96,2,30,1,1
38519,55405,53,37369,53,199,102,97,2,30,1,1
38520,56975,53,33537,53,197,102,95,2,30,1,1
38521,56743,53,62302,53,209,110,99,2,31,1,1
38522,55505,53,51745,53,199,102,97,2,31,1,1
38523,49820,53,29495,53,193,102,91,2,31,1,1
38524,55125,53,32465,53,177,94,83,2,31,1,1
38525,64327,53,41348,53,210,110,100,2,31,1,1
38526,56743,53,46707,53,209,110,99,2,30,1,1
38527,49809,53,6008,53,386,134,252,2,30,1,1
38528,57083,53,19689,53,198,102,96,2,30,1,1
38529,56589,53,12890,53,199,102,97,2,31,1,1
38530,56869,53,8171,53,198,94,104,2,31,1,1
38531,53709,15000,7812,15000,320,140,180,6,7,3,3
38532,50726,443,17287,443,6464,2707,3757,39,151,18,21
38533,49558,53,10290,53,193,102,91,2,30,1,1
38534,56589,53,14177,53,166,86,80,2,30,1,1
38535,49615,53,30558,53,413,170,243,6,31,3,3
38536,50291,443,61794,443,11617,4358,7259,48,86,26,22
38537,49967,53,25573,53,445,95,350,4,50,2,2
38538,5588,5588,0,0,3562,1936,1626,48,193,24,24
38539,57914,445,0,0,66,66,0,1,0,1,0
38540,23537,35253,0,0,66,66,0,1,0,1,0
38541,57624,445,0,0,70,70,0,1,0,1,0
38542,57911,445,0,0,66,66,0,1,0,1,0
38543,57910,445,0,0,66,66,0,1,0,1,0
38544,33543,44847,0,0,66,66,0,1,0,1,0
38545,57908,445,0,0,66,66,0,1,0,1,0
38546,9017,6881,0,0,66,66,0,1,0,1,0
38547,65179,44847,0,0,66,66,0,1,0,1,0
38548,9687,57470,0,0,78,78,0,1,0,1,0
38549,57621,445,0,0,70,70,0,1,0,1,0
38550,12128,37965,0,0,62,62,0,1,0,1,0
38551,50222,42873,0,0,66,66,0,1,0,1,0
38552,62504,445,0,0,70,70,0,1,0,1,0
38553,62498,445,0,0,70,70,0,1,0,1,0
38554,62497,445,0,0,70,70,0,1,0,1,0
38555,16883,22,0,0,60,60,0,1,0,1,0
38556,57617,445,0,0,70,70,0,1,0,1,0
38557,64115,2767,0,0,66,66,0,1,0,1,0
38558,39244,36829,0,0,62,62,0,1,0,1,0
38559,57987,56125,0,0,90,90,0,1,0,1,0
38560,57615,445,0,0,70,70,0,1,0,1,0
38561,39742,62413,0,0,66,66,0,1,0,1,0
38562,57898,445,0,0,66,66,0,1,0,1,0
38563,30039,7363,0,0,145,145,0,1,0,1,0
38564,57613,445,0,0,70,70,0,1,0,1,0
38565,5894,44847,0,0,66,66,0,1,0,1,0
38566,55874,64147,0,0,66,66,0,1,0,1,0
38567,61527,51050,0,0,66,66,0,1,0,1,0
38568,54458,64147,0,0,62,62,0,1,0,1,0
38569,54300,22114,0,0,66,66,0,1,0,1,0
38570,51262,35440,0,0,66,66,0,1,0,1,0
38571,58888,23718,0,0,62,62,0,1,0,1,0
38572,57890,445,0,0,66,66,0,1,0,1,0
38573,62484,445,0,0,70,70,0,1,0,1,0
38574,50470,61463,0,0,86,86,0,1,0,1,0
38575,48079,43227,0,0,66,66,0,1,0,1,0
38576,50283,49169,0,0,66,66,0,1,0,1,0
38577,57606,445,0,0,70,70,0,1,0,1,0
38578,57887,445,0,0,66,66,0,1,0,1,0
38579,57604,445,0,0,70,70,0,1,0,1,0
38580,39531,19473,0,0,62,62,0,1,0,1,0
38581,59227,11392,0,0,62,62,0,1,0,1,0
38582,61563,37807,0,0,62,62,0,1,0,1,0
38583,40216,50265,0,0,62,62,0,1,0,1,0
38584,57698,64147,0,0,66,66,0,1,0,1,0
38585,57603,445,0,0,70,70,0,1,0,1,0
38586,57879,445,0,0,66,66,0,1,0,1,0
38587,57602,445,0,0,70,70,0,1,0,1,0
38588,58085,57470,0,0,66,66,0,1,0,1,0
38589,49426,57470,0,0,66,66,0,1,0,1,0
38590,57601,445,0,0,70,70,0,1,0,1,0
38591,65096,37807,0,0,62,62,0,1,0,1,0
38592,57870,445,0,0,66,66,0,1,0,1,0
38593,57596,445,0,0,70,70,0,1,0,1,0
38594,57595,445,0,0,70,70,0,1,0,1,0
38595,1038,37965,0,0,62,62,0,1,0,1,0
38596,22346,51505,0,0,62,62,0,1,0,1,0
38597,57583,445,0,0,70,70,0,1,0,1,0
38598,57576,445,0,0,70,70,0,1,0,1,0
38599,58338,3363,0,0,60,60,0,1,0,1,0
38600,57572,445,0,0,70,70,0,1,0,1,0
38601,57573,445,0,0,70,70,0,1,0,1,0
38602,60962,64147,0,0,66,66,0,1,0,1,0
38603,47910,7454,0,0,60,60,0,1,0,1,0
38604,49001,40108,0,0,161,161,0,1,0,1,0
38605,62473,445,0,0,70,70,0,1,0,1,0
38606,62469,445,0,0,70,70,0,1,0,1,0
38607,62468,445,0,0,70,70,0,1,0,1,0
38608,30782,36237,0,0,62,62,0,1,0,1,0
38609,57863,445,0,0,66,66,0,1,0,1,0
38610,57864,445,0,0,66,66,0,1,0,1,0
38611,57859,445,0,0,66,66,0,1,0,1,0
38612,57862,445,0,0,66,66,0,1,0,1,0
38613,57861,445,0,0,66,66,0,1,0,1,0
38614,57858,445,0,0,66,66,0,1,0,1,0
38615,57860,445,0,0,66,66,0,1,0,1,0
38616,57857,445,0,0,66,66,0,1,0,1,0
38617,62051,11392,0,0,66,66,0,1,0,1,0
38618,42968,56205,0,0,62,62,0,1,0,1,0
38619,62388,39004,0,0,62,62,0,1,0,1,0
38620,62150,23718,0,0,66,66,0,1,0,1,0
38621,19068,37965,0,0,62,62,0,1,0,1,0
38622,57561,445,0,0,70,70,0,1,0,1,0
38623,39981,57470,0,0,62,62,0,1,0,1,0
38624,43584,24748,0,0,156,156,0,1,0,1,0
38625,43584,24748,0,0,156,156,0,1,0,1,0
38626,43584,24748,0,0,156,156,0,1,0,1,0
38627,64962,64147,0,0,66,66,0,1,0,1,0
38628,36738,123,0,0,234,234,0,1,0,1,0
38629,62463,445,0,0,70,70,0,1,0,1,0
38630,62461,445,0,0,70,70,0,1,0,1,0
38631,62453,445,0,0,70,70,0,1,0,1,0
38632,37927,50265,0,0,66,66,0,1,0,1,0
38633,15581,46713,0,0,66,66,0,1,0,1,0
38634,53465,57470,0,0,62,62,0,1,0,1,0
38635,46600,443,0,0,1097,1097,0,1,0,1,0
38636,2740,22,0,0,60,60,0,1,0,1,0
38637,57845,445,0,0,66,66,0,1,0,1,0
38638,57843,445,0,0,66,66,0,1,0,1,0
38639,57842,445,0,0,66,66,0,1,0,1,0
38640,59509,64147,0,0,62,62,0,1,0,1,0
38641,62451,445,0,0,70,70,0,1,0,1,0
38642,46409,35440,0,0,66,66,0,1,0,1,0
38643,57557,445,0,0,70,70,0,1,0,1,0
38644,63196,445,0,0,66,66,0,1,0,1,0
38645,57987,56125,0,0,90,90,0,1,0,1,0
38646,50298,37965,0,0,66,66,0,1,0,1,0
38647,62448,445,0,0,70,70,0,1,0,1,0
38648,60052,37965,0,0,66,66,0,1,0,1,0
38649,62443,445,0,0,70,70,0,1,0,1,0
38650,62444,445,0,0,70,70,0,1,0,1,0
38651,62438,445,0,0,70,70,0,1,0,1,0
38652,51505,17372,0,0,66,66,0,1,0,1,0
38653,57545,445,0,0,70,70,0,1,0,1,0
38654,57548,445,0,0,70,70,0,1,0,1,0
38655,57547,445,0,0,70,70,0,1,0,1,0
38656,60969,48637,0,0,78,78,0,1,0,1,0
38657,57543,445,0,0,70,70,0,1,0,1,0
38658,57541,445,0,0,70,70,0,1,0,1,0
38659,40642,23889,0,0,146,146,0,1,0,1,0
38660,9393,51505,0,0,66,66,0,1,0,1,0
38661,26750,57470,0,0,66,66,0,1,0,1,0
38662,51374,30317,0,0,66,66,0,1,0,1,0
38663,22390,19473,0,0,66,66,0,1,0,1,0
38664,34301,21247,0,0,62,62,0,1,0,1,0
38665,6661,23,0,0,60,60,0,1,0,1,0
38666,62431,445,0,0,70,70,0,1,0,1,0
38667,62430,445,0,0,70,70,0,1,0,1,0
38668,62424,445,0,0,70,70,0,1,0,1,0
38669,57535,445,0,0,70,70,0,1,0,1,0
38670,15955,48817,0,0,140,140,0,1,0,1,0
38671,57527,445,0,0,70,70,0,1,0,1,0
38672,56495,53,29192,53,198,101,97,2,30,1,1
38673,48757,80,48757,80,560,264,296,9,44,5,4
38674,41098,80,34310,80,1937,1193,744,12,16,7,5
38675,64605,53,39152,53,182,93,89,2,30,1,1
38676,56623,53,18777,53,771,101,670,2,30,1,1
38677,55934,53,51844,53,731,85,646,2,30,1,1
38678,64312,53,26634,53,202,103,99,2,31,1,1
38679,64485,53,38773,53,182,93,89,2,30,1,1
38680,49781,53,57974,53,188,96,92,2,30,1,1
38681,55581,53,6182,53,166,85,81,2,30,1,1
38682,56855,64607,58491,64607,316,136,180,6,6,3,3
38683,38660,15000,20760,15000,138,78,60,2,5,1,1
38684,13371,2323,13371,2323,124,60,64,2,5,1,1
38685,54958,53,54115,53,1413,85,1328,4,47,2,2
38686,24624,443,24624,443,5198,2221,2977,19,16,10,9
38687,54612,443,39989,443,6110,857,5253,17,16,9,8
38688,10216,80,10216,80,7548,1586,5962,18,21,8,10
38689,56824,3389,56824,3389,3910,1805,2105,20,18,12,8
38690,55028,443,52319,443,6791,1415,5376,19,51,12,7
38691,46986,443,11457,443,2809,1884,925,19,27,11,8
38692,64087,443,64087,443,150808,48110,102698,173,173,82,91
38693,51839,80,34402,80,3240,1194,2046,14,20,9,5
38694,56389,53,50951,53,279,93,186,4,32,2,2
38695,54982,53,63300,53,282,96,186,4,48,2,2
38696,46475,80,46475,80,8300,966,7334,14,20,6,8
38697,53897,443,3893,443,10781,3635,7146,27,221,15,12
38698,3234,80,3234,80,12425,835,11590,19,17,8,11
38699,56743,53,16205,53,202,103,99,2,30,1,1
38700,55966,53,62624,53,747,92,655,2,30,1,1
38701,6881,6881,56597,6881,231,111,120,2,1200,1,1
38702,55560,53,1916,53,164,84,80,2,31,1,1
38703,57028,53,32039,53,776,102,674,2,31,1,1
38704,6881,6889,18694,6889,221,111,110,2,1200,1,1
38705,30188,15370,58525,15370,10190,4774,5416,64,1490,32,32
38706,64127,53,29234,53,170,87,83,2,31,1,1
38707,65140,53,5924,53,774,101,673,2,31,1,1
38708,30960,45722,27416,45722,396,396,0,7,3616,7,0
38709,55859,53,35635,53,778,103,675,2,31,1,1
38710,49820,53,12064,53,186,95,91,2,31,1,1
38711,56946,53,14578,53,732,89,643,2,31,1,1
38712,46445,443,57162,443,13942,8293,5649,59,172,31,28
38713,50408,53,64657,53,755,94,661,2,31,1,1
38714,64525,53,31849,53,198,101,97,2,31,1,1
38715,49780,53,7446,53,182,93,89,2,31,1,1
38716,50273,443,63017,443,13363,4645,8718,54,241,32,22
38717,38059,443,31779,443,25214,14000,11214,66,99,34,32
38718,56674,53,43592,53,182,93,89,2,31,1,1
38719,55706,53,9914,53,202,103,99,2,31,1,1
38720,51229,443,49748,443,8590,1038,7552,16,120,7,9
38721,59658,443,33900,443,5433,925,4508,19,360,10,9
38722,6881,49001,20436,49001,210,111,99,2,1201,1,1
38723,55720,53,40889,53,774,101,673,2,31,1,1
38724,30960,45727,32973,45727,330,330,0,6,3610,6,0
38725,56876,30188,0,0,66,66,0,1,0,1,0
38726,57524,445,0,0,70,70,0,1,0,1,0
38727,25222,37965,0,0,62,62,0,1,0,1,0
38728,32609,64097,0,0,66,66,0,1,0,1,0
38729,57821,445,0,0,66,66,0,1,0,1,0
38730,62421,445,0,0,70,70,0,1,0,1,0
38731,62420,445,0,0,70,70,0,1,0,1,0
38732,65265,55067,0,0,62,62,0,1,0,1,0
38733,50470,61463,0,0,86,86,0,1,0,1,0
38734,57521,445,0,0,70,70,0,1,0,1,0
38735,13840,37965,0,0,146,146,0,1,0,1,0
38736,57585,19750,0,0,66,66,0,1,0,1,0
38737,57519,445,0,0,70,70,0,1,0,1,0
38738,35494,22114,0,0,66,66,0,1,0,1,0
38739,58976,43890,0,0,66,66,0,1,0,1,0
38740,57816,445,0,0,66,66,0,1,0,1,0
38741,57817,445,0,0,66,66,0,1,0,1,0
38742,64546,57470,0,0,66,66,0,1,0,1,0
38743,36301,443,2134,443,7316,1933,5383,27,15,15,12
38744,59675,80,26404,80,3437462,77916,3359546,3384,134,1140,2244
38745,57241,443,46273,443,1167125,49170,1117955,1459,92,635,824
38746,45964,3111,0,0,60,60,0,1,0,1,0
38747,57515,445,0,0,70,70,0,1,0,1,0
38748,62412,445,0,0,70,70,0,1,0,1,0
38749,57514,445,0,0,70,70,0,1,0,1,0
38750,35261,15503,0,0,74,74,0,1,0,1,0
38751,55565,64147,0,0,62,62,0,1,0,1,0
38752,62406,445,0,0,70,70,0,1,0,1,0
38753,62405,445,0,0,70,70,0,1,0,1,0
38754,62401,445,0,0,70,70,0,1,0,1,0
38755,57810,445,0,0,66,66,0,1,0,1,0
38756,52714,64147,0,0,66,66,0,1,0,1,0
38757,57806,445,0,0,66,66,0,1,0,1,0
38758,57805,445,0,0,66,66,0,1,0,1,0
38759,57804,445,0,0,66,66,0,1,0,1,0
38760,57803,445,0,0,66,66,0,1,0,1,0
38761,57800,445,0,0,66,66,0,1,0,1,0
38762,57799,445,0,0,66,66,0,1,0,1,0
38763,57795,445,0,0,66,66,0,1,0,1,0
38764,62396,445,0,0,70,70,0,1,0,1,0
38765,53656,31573,0,0,66,66,0,1,0,1,0
38766,57509,445,0,0,70,70,0,1,0,1,0
38767,62393,445,0,0,70,70,0,1,0,1,0
38768,62392,445,0,0,70,70,0,1,0,1,0
38769,62389,445,0,0,70,70,0,1,0,1,0
38770,29159,39004,0,0,62,62,0,1,0,1,0
38771,43350,58414,0,0,66,66,0,1,0,1,0
38772,53608,39004,0,0,66,66,0,1,0,1,0
38773,45051,23,0,0,60,60,0,1,0,1,0
38774,56794,46824,0,0,66,66,0,1,0,1,0
38775,60136,56205,0,0,66,66,0,1,0,1,0
38776,41165,23,0,0,60,60,0,1,0,1,0
38777,59668,51505,0,0,62,62,0,1,0,1,0
38778,49160,34068,0,0,146,146,0,1,0,1,0
38779,45908,3383,0,0,60,60,0,1,0,1,0
38780,443,64347,0,0,131,131,0,1,0,1,0
38781,9687,57470,0,0,78,78,0,1,0,1,0
38782,62387,445,0,0,70,70,0,1,0,1,0
38783,62386,445,0,0,70,70,0,1,0,1,0
38784,62384,445,0,0,70,70,0,1,0,1,0
38785,54742,37965,0,0,66,66,0,1,0,1,0
38786,58255,50584,0,0,62,62,0,1,0,1,0
38787,57789,445,0,0,66,66,0,1,0,1,0
38788,56743,53,5034,53,209,110,99,2,30,1,1
38789,57066,53,30352,53,197,94,103,2,30,1,1
38790,49752,53,61999,53,182,94,88,2,30,1,1
38791,49752,53,1168,53,182,94,88,2,30,1,1
38792,65067,53,22984,53,327,102,225,2,30,1,1
38793,48755,80,48755,80,630,264,366,10,44,5,5
38794,56697,443,50660,443,3593,2749,844,18,22,11,7
38795,53679,24300,62271,24300,1656,914,742,13,21,9,4
38796,35292,8100,19734,8100,234,234,0,4,11,4,0
38797,53693,26515,57249,26515,70,70,0,1,4,1,0
38798,49666,53,61369,53,392,124,268,4,35,2,2
38799,53145,27067,38874,27067,1231702,397859,833843,10382,185,4780,5602
38800,59703,443,2631,443,8867,2701,6166,21,105,9,12
38801,38779,80,43301,80,540,540,0,10,186,10,0
38802,38676,443,23921,443,101056,3737,97319,107,15,35,72
38803,64086,443,64086,443,79107,10743,68364,96,172,42,54
38804,52079,443,42023,443,4735,3589,1146,18,15,10,8
38805,42485,443,17248,443,130,70,60,3,5,2,1
38806,58865,443,1630,443,505070,16437,488633,543,45,187,356
38807,53690,42301,12821,42301,1821,1088,733,17,15,9,8
38808,64595,53,13089,53,299,93,206,4,35,2,2
38809,39818,443,44736,443,2211,1181,1030,23,40,11,12
38810,58293,443,58293,443,7134,2478,4656,18,75,10,8
38811,49319,53,1935,53,166,86,80,2,29,1,1
38812,64605,53,57757,53,183,94,89,2,29,1,1
38813,55125,53,57865,53,177,94,83,2,29,1,1
38814,55119,53,12117,53,994,86,908,2,29,1,1
38815,55943,53,30420,53,448,184,264,6,29,3,3
38816,56979,53,46725,53,209,110,99,2,29,1,1
38817,49253,53,38638,53,727,86,641,2,29,1,1
38818,49781,53,14753,53,194,102,92,2,30,1,1
38819,56533,53,7408,53,199,102,97,2,29,1,1
38820,49847,53,33024,53,448,184,264,6,29,3,3
38821,50216,443,60442,443,6320,1382,4938,24,167,13,11
38822,57598,443,59383,443,3323,2398,925,18,21,10,8
38823,56561,53,63189,53,167,86,81,2,30,1,1
38824,56589,53,29602,53,199,102,97,2,30,1,1
38825,54448,53,29193,53,70,70,0,1,30,1,0
38826,49820,53,34423,53,193,102,91,2,30,1,1
38827,56389,53,30370,53,279,93,186,4,31,2,2
38828,36717,443,50144,443,232,172,60,3,5,2,1
38829,56292,443,36478,443,10839,2145,8694,32,140,14,18
38830,55715,443,55715,443,4575,1668,2907,19,30,11,8
38831,38673,443,39946,443,379440,8281,371159,362,16,106,256
38832,59320,443,31815,443,4573,2614,1959,25,80,13,12
38833,64095,443,63841,443,9895,2094,7801,52,262,23,29
38834,60796,53,60796,53,248,106,142,2,30,1,1
38835,37993,49152,8346,49152,156,156,0,3,8,3,0
38836,64022,53,64185,53,197,102,95,2,30,1,1
38837,55581,53,26872,53,167,86,81,2,30,1,1
38838,37994,49152,32893,49152,156,156,0,3,8,3,0
38839,56094,443,60801,443,5616,3106,2510,22,223,13,9
38840,56955,53,43873,53,183,94,89,2,30,1,1
38841,38675,443,44099,443,90810,3417,87393,94,16,30,64
38842,60901,443,55846,443,622058,33681,588377,765,65,327,438
38843,56535,53,61823,53,200,94,106,2,30,1,1
38844,56782,53,51399,53,197,94,103,2,30,1,1
38845,59840,80,40850,80,469946,11862,458084,482,68,173,309
38846,56922,53,56922,53,219,98,121,2,30,1,1
38847,57083,53,55638,53,198,102,96,2,30,1,1
38848,56871,53,27631,53,198,86,112,2,30,1,1
38849,64813,16385,22226,16385,432,192,240,8,30,4,4
38850,35515,53,35515,53,235,98,137,2,30,1,1
38851,64525,53,63463,53,199,102,97,2,30,1,1
38852,50803,443,13145,443,98472,44922,53550,491,658,181,310
38853,56560,53,48488,53,198,102,96,2,30,1,1
38854,42408,443,51647,443,13108,2630,10478,26,120,12,14
38855,64485,53,11274,53,183,94,89,2,30,1,1
38856,56389,53,40774,53,279,93,186,4,32,2,2
38857,51882,15733,3672,15733,70,70,0,1,5,1,0
38858,34657,443,31367,443,448,78,370,6,25,1,5
38859,50985,80,61422,80,613,539,74,7,15,6,1
38860,39690,443,65323,443,5806,3167,2639,29,221,16,13
38861,65437,53,59504,53,488,111,377,4,53,2,2
38862,55524,53,46955,53,413,170,243,6,30,3,3
38863,55560,53,36102,53,166,86,80,2,30,1,1
38864,63068,443,30672,443,2928239,68426,2859813,2888,37,955,1933
38865,55029,443,56750,443,35270,2782,32488,48,51,22,26
38866,38677,443,24014,443,89883,3417,86466,94,15,30,64
38867,34135,443,33569,443,9932,1987,7945,22,16,12,10
38868,65307,53,33704,53,365,94,271,4,58,2,2
38869,56561,53,36683,53,167,86,81,2,30,1,1
38870,57027,53,20222,53,198,94,104,2,30,1,1
38871,55581,53,16064,53,167,86,81,2,30,1,1
38872,64485,53,10635,53,183,94,89,2,30,1,1
38873,60048,443,33885,443,12254,3186,9068,27,171,13,14
38874,58862,443,37549,443,1068717,27931,1040786,1093,45,351,742
38875,58864,443,26989,443,312852,8845,304007,317,45,99,218
38876,56588,443,28580,443,10615,5909,4706,28,42,14,14
38877,55625,80,27507,80,389326,9849,379477,391,21,138,253
38878,9109,443,23310,443,4400,433,3967,12,15,6,6
38879,47053,80,59078,80,1188,463,725,8,15,5,3
38880,49951,80,39870,80,1706,505,1201,8,14,5,3
38881,45074,443,48285,443,4493,2566,1927,40,130,21,19
38882,53706,59208,33732,59208,258,70,188,4,8,2,2
38883,48756,80,48756,80,560,264,296,9,44,5,4
38884,49531,53,39343,53,289,94,195,4,31,2,2
38885,49569,53,55862,53,181,94,87,2,31,1,1
38886,64144,53,27291,53,193,102,91,2,31,1,1
38887,64461,53,32838,53,350,89,261,4,53,2,2
38888,56046,53,55070,53,193,102,91,2,31,1,1
38889,65307,53,59322,53,184,94,90,2,29,1,1
38890,45052,443,37093,443,131573,4926,126647,152,152,55,97
38891,54982,53,58418,53,282,96,186,4,47,2,2
38892,60432,54312,22904,54312,701,455,246,8,15,4,4
38893,65532,53,6977,53,255,102,153,2,29,1,1
38894,48754,80,48754,80,560,264,296,9,44,5,4
38895,56611,443,56611,443,4530,1623,2907,19,26,11,8
38896,56495,53,8652,53,199,102,97,2,30,1,1
38897,33115,443,15120,443,75816,2178,73638,72,16,20,52
38898,54982,53,26204,53,282,96,186,4,48,2,2
38899,49429,53,3365,53,199,102,97,2,29,1,1
38900,55760,53,9967,53,182,94,88,2,30,1,1
38901,49863,8100,50615,8100,234,234,0,4,11,4,0
38902,56842,24233,45791,24233,70,70,0,1,5,1,0
38903,56495,53,46439,53,199,102,97,2,30,1,1
38904,49331,53,38875,53,200,94,106,2,29,1,1
38905,49262,53,13310,53,168,86,82,2,29,1,1
38906,49429,53,51638,53,199,102,97,2,29,1,1
38907,45589,53,45589,53,225,106,119,2,30,1,1
38908,64485,53,6047,53,183,94,89,2,30,1,1
38909,50405,53,35754,53,200,102,98,2,30,1,1
38910,55560,53,7666,53,166,86,80,2,30,1,1
38911,64334,53,44519,53,200,94,106,2,31,1,1
38912,55560,53,43077,53,166,86,80,2,30,1,1
38913,35868,123,20404,123,184,94,90,2,30,1,1
38914,56561,53,4933,53,167,86,81,2,30,1,1
38915,35099,53,35099,53,225,106,119,2,30,1,1
38916,65410,53,40006,53,229,110,119,2,31,1,1
38917,49780,53,9183,53,183,94,89,2,31,1,1
38918,57470,1337,6563,1337,330,330,0,6,1200,6,0
38919,49673,5223,52043,5223,4266,1448,2818,22,3088,13,9
38920,55086,53,37200,53,328,90,238,4,37,2,2
38921,56691,443,56691,443,4378,1471,2907,19,29,11,8
38922,44983,443,63267,443,4991,3096,1895,22,220,13,9
38923,60902,443,20935,443,924886,40519,884367,1075,65,442,633
38924,49831,53,63335,53,198,94,104,2,30,1,1
38925,55581,53,6275,53,167,86,81,2,30,1,1
38926,53443,123,34007,123,184,94,90,2,30,1,1
38927,64312,53,19518,53,209,110,99,2,30,1,1
38928,55622,53,55622,53,235,98,137,2,30,1,1
38929,64312,53,39914,53,209,110,99,2,30,1,1
38930,53864,53,0,0,181,86,95,2,30,1,1
38931,64567,53,38980,53,199,102,97,2,30,1,1
38932,65367,53,6408,53,251,94,157,2,30,1,1
38933,64257,53,61085,53,211,78,133,2,30,1,1
38934,48480,443,23315,443,10409,2670,7739,94,5805,17,77
38935,54349,443,33751,443,14063,6328,7735,33,37,16,17
38936,56389,53,5155,53,279,93,186,4,32,2,2
38937,65075,53,3072,53,278,100,178,4,31,2,2
38938,36368,80,28918,80,78,78,0,2,8,2,0
38939,49767,53,48677,53,200,102,98,2,30,1,1
38940,36003,123,29238,123,184,94,90,2,30,1,1
38941,56495,53,40690,53,199,102,97,2,30,1,1
38942,53771,53,15804,53,168,78,90,2,30,1,1
38943,50436,53,50436,53,248,106,142,2,30,1,1
38944,49767,53,59870,53,200,102,98,2,30,1,1
38945,64127,53,25934,53,177,94,83,2,30,1,1
38946,64814,16386,26637,16386,432,192,240,8,30,4,4
38947,64812,16384,57833,16384,556,256,300,10,30,5,5
38948,56589,53,35173,53,199,102,97,2,30,1,1
38949,64605,53,37496,53,183,94,89,2,30,1,1
38950,56913,53,26881,53,193,102,91,2,30,1,1
38951,46087,123,1853,123,184,94,90,2,30,1,1
38952,43224,443,58496,443,2027060,31188,1995872,1708,77,321,1387
38953,62984,8920,64791,8920,829,583,246,9,15,5,4
38954,51898,50677,11184,50677,70,70,0,2,8,2,0
38955,39691,443,19471,443,6219,4130,2089,29,221,16,13
38956,51594,443,50600,443,5854,1148,4706,18,23,10,8
38957,57058,53,29046,53,167,86,81,2,30,1,1
38958,47749,53,47749,53,248,106,142,2,30,1,1
38959,49212,53,2222,53,183,94,89,2,30,1,1
38960,54590,443,20540,443,12094,4159,7935,21,135,10,11
38961,64567,53,24261,53,199,102,97,2,30,1,1
38962,49262,53,46554,53,168,86,82,2,30,1,1
38963,50759,53,50759,53,225,106,119,2,30,1,1
38964,65468,53,8938,53,200,94,106,2,30,1,1
38965,57027,123,48138,123,184,94,90,2,30,1,1
38966,55261,53,52795,53,183,94,89,2,30,1,1
38967,65080,53,25627,53,209,110,99,2,30,1,1
38968,50686,443,65474,443,6586,1807,4779,23,360,12,11
38969,10151,54168,22661,54168,479,150,329,2,1200,1,1
38970,57265,53,29608,53,200,102,98,2,31,1,1
38971,41027,80,63019,80,540,540,0,10,186,10,0
38972,61229,443,47952,443,12708,2798,9910,36,258,13,23
38973,50802,443,32989,443,207859,77557,130302,849,753,312,537
38974,57470,20433,47061,20433,726,726,0,12,1200,12,0
38975,65080,53,11923,53,209,110,99,2,30,1,1
38976,50477,443,26806,443,55388,4069,51319,94,240,46,48
38977,57470,59208,35897,59208,1367,664,703,16,1199,9,7
38978,56674,53,17434,53,183,94,89,2,31,1,1
38979,65354,53,35359,53,272,94,178,2,31,1,1
38980,57470,10154,49581,10154,924,924,0,15,1200,15,0
38981,64085,53,40904,53,195,94,101,2,31,1,1
38982,49740,53,60867,53,341,85,256,4,42,2,2
38983,62021,443,62021,443,4625,1718,2907,19,27,11,8
38984,53272,80,30742,80,11060,3925,7135,24,108,13,11
38985,56950,443,41087,443,5601,1203,4398,14,60,9,5
38986,39880,80,44153,80,1779,793,986,17,58,6,11
38987,50825,443,14787,443,6601,1120,5481,17,116,9,8
38988,56260,80,50522,80,72600,58760,13840,186,1232,107,79
38989,56951,443,11252,443,5601,1203,4398,14,60,9,5
38990,43412,443,47585,443,2423,1465,958,18,171,10,8
38991,39743,80,10677,80,1563,570,993,10,16,6,4
38992,49415,53,12077,53,313,83,230,4,54,2,2
38993,63870,6881,25073,6881,70,70,0,1,5,1,0
38994,63864,44139,53899,44139,70,70,0,1,5,1,0
38995,56947,443,19771,443,5601,1203,4398,14,60,9,5
38996,56952,443,36539,443,5601,1203,4398,14,60,9,5
38997,49740,53,35003,53,167,86,81,2,30,1,1
38998,62068,64147,0,0,66,66,0,1,0,1,0
38999,57496,445,0,0,70,70,0,1,0,1,0
39000,62380,445,0,0,70,70,0,1,0,1,0
39001,57786,445,0,0,66,66,0,1,0,1,0
39002,57784,445,0,0,66,66,0,1,0,1,0
39003,57782,445,0,0,66,66,0,1,0,1,0
39004,28176,35440,0,0,146,146,0,1,0,1,0
39005,57493,445,0,0,70,70,0,1,0,1,0
39006,57780,445,0,0,66,66,0,1,0,1,0
39007,56646,48817,0,0,62,62,0,1,0,1,0
39008,53543,44847,0,0,146,146,0,1,0,1,0
39009,41840,50584,0,0,66,66,0,1,0,1,0
39010,40731,2323,0,0,60,60,0,1,0,1,0
39011,52472,51221,0,0,74,74,0,1,0,1,0
39012,62375,445,0,0,70,70,0,1,0,1,0
39013,26085,51221,0,0,72,72,0,1,0,1,0
39014,62371,445,0,0,70,70,0,1,0,1,0
39015,62369,445,0,0,70,70,0,1,0,1,0
39016,57488,445,0,0,70,70,0,1,0,1,0
39017,5688,44847,0,0,66,66,0,1,0,1,0
39018,63096,44847,0,0,66,66,0,1,0,1,0
39019,57487,445,0,0,70,70,0,1,0,1,0
39020,29017,2222,0,0,60,60,0,1,0,1,0
39021,28754,50584,0,0,62,62,0,1,0,1,0
39022,6666,50070,0,0,60,60,0,1,0,1,0
39023,46829,64147,0,0,146,146,0,1,0,1,0
39024,54280,3398,0,0,60,60,0,1,0,1,0
39025,57485,445,0,0,70,70,0,1,0,1,0
39026,53667,56205,0,0,62,62,0,1,0,1,0
39027,6721,37965,0,0,66,66,0,1,0,1,0
39028,17800,3389,17800,3389,293,223,70,4,0,3,1
39029,22285,3389,22285,3389,293,223,70,4,0,3,1
39030,19626,3389,19626,3389,293,223,70,4,0,3,1
39031,57769,445,0,0,66,66,0,1,0,1,0
39032,61945,48817,0,0,62,62,0,1,0,1,0
39033,12226,37965,0,0,62,62,0,1,0,1,0
39034,44529,6881,0,0,146,146,0,1,0,1,0
39035,57762,445,0,0,66,66,0,1,0,1,0
39036,62352,445,0,0,70,70,0,1,0,1,0
39037,57478,445,0,0,70,70,0,1,0,1,0
39038,57476,445,0,0,70,70,0,1,0,1,0
39039,52537,37965,0,0,66,66,0,1,0,1,0
39040,57760,445,0,0,66,66,0,1,0,1,0
39041,23969,57470,0,0,62,62,0,1,0,1,0
39042,57475,445,0,0,70,70,0,1,0,1,0
39043,54552,64147,0,0,62,62,0,1,0,1,0
39044,58973,57470,0,0,66,66,0,1,0,1,0
39045,16134,45680,0,0,148,148,0,1,0,1,0
39046,57474,445,0,0,70,70,0,1,0,1,0
39047,57473,445,0,0,70,70,0,1,0,1,0
39048,57987,56125,0,0,90,90,0,1,0,1,0
39049,57467,445,0,0,70,70,0,1,0,1,0
39050,57470,445,0,0,70,70,0,1,0,1,0
39051,57752,445,0,0,66,66,0,1,0,1,0
39052,57750,445,0,0,66,66,0,1,0,1,0
39053,58226,52848,0,0,62,62,0,1,0,1,0
39054,50470,61463,0,0,86,86,0,1,0,1,0
39055,57455,445,0,0,70,70,0,1,0,1,0
39056,57454,445,0,0,70,70,0,1,0,1,0
39057,60426,57470,0,0,62,62,0,1,0,1,0
39058,57450,445,0,0,70,70,0,1,0,1,0
39059,57445,445,0,0,70,70,0,1,0,1,0
39060,57444,445,0,0,70,70,0,1,0,1,0
39061,26937,23,0,0,60,60,0,1,0,1,0
39062,29011,32468,0,0,62,62,0,1,0,1,0
39063,49001,40108,0,0,161,161,0,1,0,1,0
39064,26048,21,0,0,60,60,0,1,0,1,0
39065,49305,57470,0,0,66,66,0,1,0,1,0
39066,62343,445,0,0,70,70,0,1,0,1,0
39067,50156,53,2104,53,777,87,690,2,0,1,1
39068,62341,445,0,0,70,70,0,1,0,1,0
39069,62340,445,0,0,70,70,0,1,0,1,0
39070,57729,445,0,0,66,66,0,1,0,1,0
39071,57732,445,0,0,66,66,0,1,0,1,0
39072,57736,445,0,0,66,66,0,1,0,1,0
39073,57737,445,0,0,66,66,0,1,0,1,0
39074,57733,445,0,0,66,66,0,1,0,1,0
39075,57734,445,0,0,66,66,0,1,0,1,0
39076,57730,445,0,0,66,66,0,1,0,1,0
39077,57731,445,0,0,66,66,0,1,0,1,0
39078,63027,35440,0,0,66,66,0,1,0,1,0
39079,1038,37965,0,0,62,62,0,1,0,1,0
39080,9529,26467,0,0,62,62,0,1,0,1,0
39081,52459,33890,0,0,60,60,0,1,0,1,0
39082,57433,445,0,0,70,70,0,1,0,1,0
39083,63288,52848,0,0,66,66,0,1,0,1,0
39084,59147,51505,0,0,66,66,0,1,0,1,0
39085,52459,33890,0,0,60,60,0,1,0,1,0
39086,62347,25,62347,25,291,126,165,4,0,2,2
39087,61147,22114,0,0,66,66,0,1,0,1,0
39088,59095,57470,0,0,66,66,0,1,0,1,0
39089,62336,445,0,0,70,70,0,1,0,1,0
39090,62329,445,0,0,70,70,0,1,0,1,0
39091,2691,64147,0,0,62,62,0,1,0,1,0
39092,62324,445,0,0,70,70,0,1,0,1,0
39093,55386,37965,0,0,66,66,0,1,0,1,0
39094,68,67,0,0,594,594,0,1,0,1,0
39095,2705,37,0,0,60,60,0,1,0,1,0
39096,51300,64147,0,0,66,66,0,1,0,1,0
39097,57717,445,0,0,66,66,0,1,0,1,0
39098,57716,445,0,0,66,66,0,1,0,1,0
39099,57714,445,0,0,66,66,0,1,0,1,0
39100,49159,23,0,0,60,60,0,1,0,1,0
39101,61744,11392,0,0,66,66,0,1,0,1,0
39102,57429,445,0,0,70,70,0,1,0,1,0
39103,52711,37965,0,0,62,62,0,1,0,1,0
39104,44569,3389,0,0,60,60,0,1,0,1,0
39105,62322,445,0,0,70,70,0,1,0,1,0
39106,57148,23,0,0,60,60,0,1,0,1,0
39107,41197,30188,0,0,146,146,0,1,0,1,0
39108,26351,22114,0,0,62,62,0,1,0,1,0
39109,51185,37965,0,0,66,66,0,1,0,1,0
39110,59563,30188,0,0,66,66,0,1,0,1,0
39111,59985,57470,0,0,66,66,0,1,0,1,0
39112,56186,57470,0,0,62,62,0,1,0,1,0
39113,6881,33156,0,0,146,146,0,1,0,1,0
39114,57419,445,0,0,70,70,0,1,0,1,0
39115,57417,445,0,0,70,70,0,1,0,1,0
39116,57420,445,0,0,70,70,0,1,0,1,0
39117,62320,445,0,0,70,70,0,1,0,1,0
39118,19875,30170,0,0,145,145,0,1,0,1,0
39119,57415,445,0,0,70,70,0,1,0,1,0
39120,62316,445,0,0,70,70,0,1,0,1,0
39121,62315,445,0,0,70,70,0,1,0,1,0
39122,62310,445,0,0,70,70,0,1,0,1,0
39123,57412,445,0,0,70,70,0,1,0,1,0
39124,60857,61689,0,0,146,146,0,1,0,1,0
39125,34983,26543,0,0,145,145,0,1,0,1,0
39126,63765,51221,0,0,62,62,0,1,0,1,0
39127,27898,52700,0,0,62,62,0,1,0,1,0
39128,58207,51505,0,0,62,62,0,1,0,1,0
39129,42044,60043,0,0,66,66,0,1,0,1,0
39130,17781,50265,0,0,62,62,0,1,0,1,0
39131,64614,53,3667,53,186,95,91,2,30,1,1
39132,8883,443,24361,443,9742,2044,7698,30,391,12,18
39133,56745,443,56745,443,101899,20048,81851,132,62,67,65
39134,60433,6881,35052,6881,70,70,0,1,5,1,0
39135,36417,443,45000,443,3579,1914,1665,23,291,8,15
39136,56552,443,10361,443,9518,3057,6461,21,43,12,9
39137,65315,53,25956,53,172,88,84,2,30,1,1
39138,52781,443,23345,443,1581,924,657,15,125,7,8
39139,55784,53,41751,53,184,94,90,2,30,1,1
39140,50082,53,42387,53,774,101,673,2,30,1,1
39141,50318,53,63172,53,732,89,643,2,30,1,1
39142,38065,443,63899,443,15799,7457,8342,42,98,22,20
39143,56746,443,56746,443,68504,9909,58595,93,62,46,47
39144,56957,443,26018,443,4359,924,3435,15,59,9,6
39145,56956,443,35896,443,4359,924,3435,15,59,9,6
39146,50906,443,11737,443,124,64,60,2,15,1,1
39147,52056,80,60936,80,3641,846,2795,18,44,7,11
39148,10047,443,65295,443,25316,10344,14972,84,170,48,36
39149,64567,53,15933,53,198,101,97,2,30,1,1
39150,50905,443,13622,443,124,64,60,2,15,1,1
39151,52783,443,32956,443,1581,924,657,15,125,7,8
39152,55018,53,31411,53,174,89,85,2,30,1,1
39153,53718,443,33767,443,318,192,126,6,16,4,2
39154,64144,53,48969,53,186,95,91,2,30,1,1
39155,63866,17623,15201,17623,66,66,0,1,5,1,0
39156,38058,443,33797,443,22970,12439,10531,61,98,32,29
39157,51317,443,42808,443,3565,640,2925,16,153,7,9
39158,51900,15755,25086,15755,316,136,180,6,6,3,3
39159,56388,53,28613,53,186,95,91,3,46,2,1
39160,55655,63670,23563,63670,70,70,0,2,8,2,0
39161,47642,443,46910,443,12735,10573,2162,33,316,16,17
39162,38545,443,54573,443,4961,2148,2813,30,90,13,17
39163,57290,53,48036,53,758,93,665,2,30,1,1
39164,49418,53,11471,53,776,102,674,2,30,1,1
39165,62063,443,35010,443,25511,1260,24251,34,121,13,21
39166,57308,443,38390,443,36373,15248,21125,172,123,69,103
39167,56853,13203,65279,13203,316,136,180,6,6,3,3
39168,52782,443,35099,443,1581,924,657,15,125,7,8
39169,55658,45261,40194,45261,70,70,0,2,8,2,0
39170,53465,80,64691,80,1360,540,820,20,187,10,10
39171,47728,443,8590,443,8404,3653,4751,25,256,14,11
39172,63865,48610,9039,48610,66,66,0,1,5,1,0
39173,50999,443,32321,443,3051,1801,1250,18,16,8,10
39174,11295,40002,5818,40002,356,170,186,6,53,3,3
39175,5588,5588,0,0,3562,1936,1626,48,195,24,24
39176,65321,53,29738,53,166,85,81,2,30,1,1
39177,65175,53,9313,53,778,103,675,2,30,1,1
39178,55821,53,64842,53,192,98,94,2,30,1,1
39179,49740,53,20760,53,166,85,81,2,30,1,1
39180,49573,443,16183,443,7332,2197,5135,18,135,8,10
39181,51772,443,20083,443,2320,327,1993,11,135,5,6
39182,56448,53,33079,53,200,102,98,2,30,1,1
39183,64331,53,12876,53,174,89,85,2,31,1,1
39184,56655,53,60599,53,168,86,82,2,31,1,1
39185,58986,443,40709,443,10624,6845,3779,50,123,25,25
39186,49351,53,12256,53,164,84,80,2,30,1,1
39187,50534,53,37578,53,168,86,82,2,31,1,1
39188,64967,53,49030,53,184,94,90,2,31,1,1
39189,49350,80,49350,80,450,246,204,8,142,5,3
39190,49346,80,49346,80,450,246,204,8,142,5,3
39191,49345,80,49345,80,450,246,204,8,142,5,3
39192,56331,443,61535,443,1786,172,1614,7,121,3,4
39193,49531,53,3594,53,182,93,89,2,31,1,1
39194,65341,53,36456,53,200,102,98,2,31,1,1
39195,53284,443,5586,443,4579,2245,2334,12,122,6,6
39196,48909,5228,27859,5228,11007,2491,8516,44,4411,18,26
39197,57078,443,63821,443,4730,2569,2161,16,135,8,8
39198,6882,6889,29221,6889,221,111,110,2,1201,1,1
39199,9144,3389,9144,3389,293,223,70,4,1,3,1
39200,38554,3389,38554,3389,293,223,70,4,1,3,1
39201,24041,55783,0,0,62,62,0,1,0,1,0
39202,57406,445,0,0,70,70,0,1,0,1,0
39203,38126,3389,38126,3389,293,223,70,4,1,3,1
39204,57020,36237,0,0,66,66,0,1,0,1,0
39205,58922,57470,0,0,66,66,0,1,0,1,0
39206,62301,445,0,0,70,70,0,1,0,1,0
39207,62297,445,0,0,70,70,0,1,0,1,0
39208,62296,445,0,0,70,70,0,1,0,1,0
39209,37075,3389,37075,3389,293,223,70,4,1,3,1
39210,10967,3389,10967,3389,293,223,70,4,1,3,1
39211,55706,53,61735,53,209,110,99,2,30,1,1
39212,64144,53,47875,53,193,102,91,2,30,1,1
39213,59728,80,65227,80,821011,16040,804971,778,100,238,540
39214,64373,53,26971,53,554,96,458,4,60,2,2
39215,54435,443,54824,443,18802,3386,15416,54,293,28,26
39216,57163,53,34170,53,209,110,99,2,30,1,1
39217,58049,443,10248,443,8242,1641,6601,22,360,12,10
39218,49435,443,28726,443,8602,1050,7552,16,120,7,9
39219,54763,443,60297,443,7136,5777,1359,22,200,13,9
39220,38671,443,56566,443,90139,3545,86594,96,15,32,64
39221,56948,443,19472,443,5601,1203,4398,14,59,9,5
39222,53712,44822,45976,44822,320,140,180,6,5,3,3
39223,63868,60392,13062,60392,70,70,0,1,4,1,0
39224,64519,53,14591,53,195,102,93,2,29,1,1
39225,49740,53,58621,53,167,86,81,2,29,1,1
39226,60520,53,60520,53,248,106,142,2,29,1,1
39227,51822,80,12401,80,3709,1390,2319,17,19,10,7
39228,54489,53,0,0,418,154,264,4,33,2,2
39229,38670,443,55536,443,501559,13849,487710,527,15,193,334
39230,8380,80,8380,80,25613,1592,24021,32,22,9,23
39231,64604,53,45485,53,429,109,320,4,37,2,2
39232,10011,443,63236,443,14565,3464,11101,59,151,31,28
39233,56497,80,9145,80,410119,16112,394007,424,63,155,269
39234,56949,443,2703,443,5601,1203,4398,14,59,9,5
39235,53711,30355,27778,30355,320,140,180,6,5,3,3
39236,53703,16426,15322,16426,70,70,0,2,7,2,0
39237,49752,53,44269,53,182,94,88,2,29,1,1
39238,65321,53,58472,53,167,86,81,2,29,1,1
39239,63867,43618,49838,43618,70,70,0,1,4,1,0
39240,64312,53,28741,53,209,110,99,2,29,1,1
39241,64127,53,58268,53,177,94,83,2,30,1,1
39242,56388,53,20730,53,275,95,180,4,44,2,2
39243,53704,15000,2505,15000,70,70,0,2,7,2,0
39244,55018,53,64174,53,312,89,223,4,36,2,2
39245,49781,53,31272,53,194,102,92,2,29,1,1
39246,56747,443,56747,443,33901,9598,24303,56,61,32,24
39247,56913,53,31255,53,193,102,91,2,29,1,1
39248,65321,53,36858,53,167,86,81,2,29,1,1
39249,49351,53,13338,53,166,86,80,2,30,1,1
39250,54463,53,52007,53,164,78,86,2,30,1,1
39251,51295,443,51295,443,4334,1427,2907,19,27,11,8
39252,51902,443,16953,443,6155,888,5267,17,15,8,9
39253,63859,80,37247,80,314,192,122,6,15,4,2
39254,56674,53,20676,53,183,94,89,2,30,1,1
39255,55706,53,23729,53,209,110,99,2,30,1,1
39256,50707,53,59770,53,181,86,95,2,30,1,1
39257,20746,53,43830,53,191,86,105,2,30,1,1
39258,57282,53,14101,53,199,102,97,2,30,1,1
39259,56491,443,52771,443,6066,1016,5050,20,26,11,9
39260,65136,53,56790,53,335,84,251,4,32,2,2
39261,51879,38564,56529,38564,70,70,0,1,5,1,0
39262,56636,80,30803,80,234,234,0,4,12,4,0
39263,40512,80,26257,80,2543,691,1852,13,17,8,5
39264,56499,80,63072,80,277848,13775,264073,301,63,118,183
39265,46778,53,46778,53,214,82,132,2,30,1,1
39266,56492,443,53818,443,6066,1016,5050,20,26,11,9
39267,56734,443,56734,443,373876,52153,321723,424,87,185,239
39268,34001,53,36189,53,225,78,147,2,30,1,1
39269,49627,443,59623,443,20583,3435,17148,54,95,27,27
39270,49806,53,63116,53,242,118,124,2,30,1,1
39271,54375,443,15828,443,5642,3872,1770,32,81,17,15
39272,64744,3389,64744,3389,3428,1714,1714,16,33,8,8
39273,55784,53,32669,53,184,94,90,2,30,1,1
39274,55706,53,42379,53,209,110,99,2,30,1,1
39275,56674,53,8365,53,183,94,89,2,30,1,1
39276,56448,53,9031,53,200,102,98,2,30,1,1
39277,55784,53,2771,53,184,94,90,2,30,1,1
39278,56500,80,50985,80,177736,11174,166562,198,63,77,121
39279,38666,443,18669,443,94827,3328,91499,97,16,30,67
39280,65445,53,54616,53,199,102,97,2,30,1,1
39281,56448,53,7304,53,200,102,98,2,30,1,1
39282,64614,53,56180,53,193,102,91,2,30,1,1
39283,56498,53,39557,53,199,102,97,2,30,1,1
39284,21147,53,21147,53,1413,688,725,3,30,2,1
39285,19473,13315,3345,13315,460,150,310,2,1200,1,1
39286,53328,53,0,0,418,154,264,4,33,2,2
39287,60766,28080,32813,28080,70,70,0,1,5,1,0
39288,36230,443,36230,443,4681,1774,2907,19,30,11,8
39289,35584,80,52820,80,1507,454,1053,10,15,5,5
39290,56498,80,33330,80,174021,11443,162578,197,63,81,116
39291,47161,443,37026,443,11342,3715,7627,28,92,17,11
39292,47045,53,20106,53,225,78,147,2,30,1,1
39293,65162,53,50444,53,328,102,226,2,30,1,1
39294,50542,53,12388,53,782,110,672,2,30,1,1
39295,53238,443,11082,443,27650,12347,15303,47,53,24,23
39296,50483,443,61825,443,12462,2612,9850,37,80,19,18
39297,51957,443,52201,443,3516,1732,1784,34,42,19,15
39298,50232,28356,48349,28356,4728691,2246710,2481981,40252,1121,19716,20536
39299,60111,443,2026,443,11519,3163,8356,51,25,26,25
39300,60770,40010,17084,40010,316,136,180,6,6,3,3
39301,51902,55933,35723,55933,316,136,180,6,5,3,3
39302,64420,53,3288,53,194,102,92,2,31,1,1
39303,51880,18468,34831,18468,70,70,0,1,5,1,0
39304,53702,51413,14183,51413,70,70,0,2,7,2,0
39305,51894,26116,38290,26116,70,70,0,2,8,2,0
39306,63869,34368,37141,34368,70,70,0,1,4,1,0
39307,51901,443,44241,443,6215,948,5267,18,15,9,9
39308,55648,80,35736,80,70,70,0,1,5,1,0
39309,51903,443,13827,443,1612,1089,523,12,15,7,5
39310,53402,443,53402,443,4582,1675,2907,19,29,11,8
39311,65382,443,15464,443,15607,5238,10369,36,126,19,17
39312,53623,50093,42211,50093,552,306,246,9,38,5,4
39313,9100,443,50468,443,4945,431,4514,12,15,6,6
39314,49212,53,38007,53,183,94,89,2,29,1,1
39315,56501,80,5186,80,300370,14101,286269,313,63,116,197
39316,55261,53,52324,53,183,94,89,2,29,1,1
39317,64525,53,5631,53,199,102,97,2,29,1,1
39318,57265,53,15033,53,200,102,98,2,30,1,1
39319,49780,53,34638,53,183,94,89,2,29,1,1
39320,56498,53,6287,53,199,102,97,2,30,1,1
39321,49800,53,33373,53,183,94,89,2,29,1,1
39322,55018,53,37429,53,179,94,85,2,30,1,1
39323,56388,53,28849,53,193,102,91,2,29,1,1
39324,50405,53,20541,53,200,102,98,2,29,1,1
39325,56305,53,56939,53,242,118,124,2,30,1,1
39326,64022,53,2782,53,197,102,95,2,30,1,1
39327,52361,53,7907,53,186,78,108,2,29,1,1
39328,49979,53,49459,53,197,94,103,2,30,1,1
39329,50013,53,7317,53,199,102,97,2,30,1,1
39330,60166,53,7820,53,258,94,164,2,30,1,1
39331,64567,53,19362,53,199,102,97,2,30,1,1
39332,57163,53,45195,53,209,110,99,2,30,1,1
39333,27327,53,27327,53,823,98,725,2,30,1,1
39334,56655,53,60035,53,168,86,82,2,30,1,1
39335,44913,80,22574,80,1270,387,883,16,393,4,12
39336,57470,6881,33137,6881,792,792,0,13,1200,13,0
39337,64525,53,61457,53,199,102,97,2,30,1,1
39338,49384,53,48199,53,193,102,91,2,31,1,1
39339,49632,53,3027,53,199,102,97,2,31,1,1
39340,51909,80,5336,80,6057,4543,1514,16,15,9,7
39341,11295,40033,3453,40033,213,89,124,4,32,2,2
39342,55656,31165,21172,31165,70,70,0,2,8,2,0
39343,51893,63924,11081,63924,70,70,0,2,8,2,0
39344,51896,43357,29923,43357,70,70,0,2,8,2,0
39345,26943,443,22865,443,21275,16156,5119,41,22,23,18
39346,52624,443,65468,443,5837,1982,3855,19,19,11,8
39347,64425,53,23618,53,289,134,155,2,30,1,1
39348,49351,53,27652,53,166,86,80,2,30,1,1
39349,57047,53,31984,53,198,94,104,2,31,1,1
39350,49516,53,42173,53,183,94,89,2,30,1,1
39351,55657,37273,33354,37273,70,70,0,2,8,2,0
39352,51895,17172,52457,17172,70,70,0,2,8,2,0
39353,51897,57057,49158,57057,70,70,0,2,8,2,0
39354,48371,443,24225,443,3908,630,3278,12,17,7,5
39355,9105,443,49589,443,4077,438,3639,12,15,6,6
39356,37236,53,35776,53,223,78,145,2,30,1,1
39357,50013,53,8187,53,199,102,97,2,30,1,1
39358,65315,53,36625,53,94,94,0,1,30,1,0
39359,38667,443,44334,443,496852,12216,484636,499,16,167,332
39360,53504,443,31592,443,2291912,60511,2231401,2353,196,863,1490
39361,60431,52867,18137,52867,70,70,0,1,5,1,0
39362,55784,53,64875,53,330,94,236,4,48,2,2
39363,56388,53,34689,53,275,95,180,4,49,2,2
39364,49460,53,64925,53,458,188,270,6,30,3,3
39365,65445,53,31304,53,199,102,97,2,30,1,1
39366,56432,53,34927,53,458,188,270,6,30,3,3
39367,52501,443,44230,443,163226,10147,153079,233,101,101,132
39368,55018,53,50628,53,179,94,85,2,30,1,1
39369,49531,53,34898,53,183,94,89,2,30,1,1
39370,65228,53,53617,53,212,86,126,2,30,1,1
39371,49997,53,1711,53,209,110,99,2,30,1,1
39372,64967,53,49368,53,184,94,90,2,31,1,1
39373,65365,53,42836,53,196,102,94,2,31,1,1
39374,41876,80,9169,80,1740,708,1032,19,396,6,13
39375,34548,443,60764,443,11549,3378,8171,33,196,16,17
39376,49348,80,49348,80,450,246,204,8,142,5,3
39377,45780,443,35080,443,7847,1591,6256,23,186,13,10
39378,57470,6881,47770,6881,330,330,0,6,1200,6,0
39379,21133,18719,1173,18719,150,150,0,1,1200,1,0
39380,57018,53,4073,53,209,110,99,2,30,1,1
39381,65341,53,7483,53,200,102,98,2,30,1,1
39382,49737,53,3736,53,338,110,228,2,30,1,1
39383,64331,53,26878,53,324,89,235,4,31,2,2
39384,51208,443,14745,443,3477,1216,2261,16,136,8,8
39385,52201,443,3597,443,5681,1441,4240,21,51,11,10
39386,63861,37832,64694,37832,70,70,0,1,5,1,0
39387,51089,80,45189,80,6240,4510,1730,40,131,22,18
39388,50286,443,30253,443,10203,2365,7838,40,86,22,18
39389,33150,53,60040,53,816,228,588,8,30,4,4
39390,63959,53,54075,53,246,102,144,2,31,1,1
39391,59851,80,45085,80,307815,6418,301397,285,63,84,201
39392,57593,80,6872,80,486,280,206,8,26,5,3
39393,65155,53,63407,53,295,103,192,4,49,2,2
39394,50021,53,58776,53,963,391,572,10,83,5,5
39395,51901,15860,21103,15860,316,136,180,6,6,3,3
39396,52327,443,53473,443,134,60,74,3,6,2,1
39397,51092,80,39250,80,3974,2713,1261,34,131,19,15
39398,49278,80,32439,80,991,525,466,10,136,6,4
39399,64331,53,61619,53,179,94,85,2,30,1,1
39400,56636,53,19411,53,302,86,216,2,30,1,1
39401,50534,53,27625,53,168,86,82,2,30,1,1
39402,64933,53,11327,53,349,94,255,2,30,1,1
39403,21502,44847,0,0,66,66,0,1,0,1,0
39404,57399,445,0,0,70,70,0,1,0,1,0
39405,443,36576,0,0,60,60,0,1,0,1,0
39406,57398,445,0,0,70,70,0,1,0,1,0
39407,62115,57470,0,0,66,66,0,1,0,1,0
39408,26793,3389,26793,3389,293,223,70,4,1,3,1
39409,64605,35993,0,0,62,62,0,1,0,1,0
39410,12604,3389,12604,3389,293,223,70,4,1,3,1
39411,57392,445,0,0,70,70,0,1,0,1,0
39412,57692,445,0,0,66,66,0,1,0,1,0
39413,32707,11392,0,0,146,146,0,1,0,1,0
39414,62292,445,0,0,70,70,0,1,0,1,0
39415,62294,445,0,0,70,70,0,1,0,1,0
39416,57389,445,0,0,70,70,0,1,0,1,0
39417,56413,51221,0,0,66,66,0,1,0,1,0
39418,1030,44847,0,0,146,146,0,1,0,1,0
39419,57151,39004,0,0,66,66,0,1,0,1,0
39420,45908,3383,0,0,60,60,0,1,0,1,0
39421,6881,6881,0,0,146,146,0,1,0,1,0
39422,44568,3389,0,0,60,60,0,1,0,1,0
39423,28809,50584,0,0,66,66,0,1,0,1,0
39424,57689,445,0,0,66,66,0,1,0,1,0
39425,57687,445,0,0,66,66,0,1,0,1,0
39426,61522,64147,0,0,66,66,0,1,0,1,0
39427,23900,64147,0,0,62,62,0,1,0,1,0
39428,57385,445,0,0,70,70,0,1,0,1,0
39429,37121,21247,0,0,66,66,0,1,0,1,0
39430,49622,50584,0,0,62,62,0,1,0,1,0
39431,61788,20000,0,0,60,60,0,1,0,1,0
39432,57384,445,0,0,70,70,0,1,0,1,0
39433,15333,44847,0,0,62,62,0,1,0,1,0
39434,62284,445,0,0,70,70,0,1,0,1,0
39435,62278,445,0,0,70,70,0,1,0,1,0
39436,62277,445,0,0,70,70,0,1,0,1,0
39437,62276,445,0,0,70,70,0,1,0,1,0
39438,57987,56125,0,0,90,90,0,1,0,1,0
39439,57684,445,0,0,66,66,0,1,0,1,0
39440,56693,1900,0,0,139,139,0,1,0,1,0
39441,57673,445,0,0,66,66,0,1,0,1,0
39442,57668,445,0,0,66,66,0,1,0,1,0
39443,57670,445,0,0,66,66,0,1,0,1,0
39444,57676,445,0,0,66,66,0,1,0,1,0
39445,57667,445,0,0,66,66,0,1,0,1,0
39446,57672,445,0,0,66,66,0,1,0,1,0
39447,57678,445,0,0,66,66,0,1,0,1,0
39448,14997,57470,0,0,72,72,0,1,0,1,0
39449,57379,445,0,0,70,70,0,1,0,1,0
39450,9687,57470,0,0,78,78,0,1,0,1,0
39451,50470,61463,0,0,86,86,0,1,0,1,0
39452,62267,445,0,0,70,70,0,1,0,1,0
39453,17344,62413,0,0,66,66,0,1,0,1,0
39454,33786,23,0,0,60,60,0,1,0,1,0
39455,62265,445,0,0,70,70,0,1,0,1,0
39456,62261,445,0,0,70,70,0,1,0,1,0
39457,62263,445,0,0,70,70,0,1,0,1,0
39458,56944,35894,0,0,62,62,0,1,0,1,0
39459,26953,30317,0,0,62,62,0,1,0,1,0
39460,65388,55783,0,0,66,66,0,1,0,1,0
39461,27528,35440,0,0,66,66,0,1,0,1,0
39462,60361,57470,0,0,66,66,0,1,0,1,0
39463,51401,6881,0,0,66,66,0,1,0,1,0
39464,57366,445,0,0,70,70,0,1,0,1,0
39465,65494,53,0,0,88,88,0,1,0,1,0
39466,62259,445,0,0,70,70,0,1,0,1,0
39467,62257,445,0,0,70,70,0,1,0,1,0
39468,62255,445,0,0,70,70,0,1,0,1,0
39469,57662,445,0,0,66,66,0,1,0,1,0
39470,62252,445,0,0,70,70,0,1,0,1,0
39471,61336,61689,0,0,62,62,0,1,0,1,0
39472,57657,445,0,0,66,66,0,1,0,1,0
39473,31748,56205,0,0,62,62,0,1,0,1,0
39474,57363,445,0,0,70,70,0,1,0,1,0
39475,57656,445,0,0,66,66,0,1,0,1,0
39476,57655,445,0,0,66,66,0,1,0,1,0
39477,57652,445,0,0,66,66,0,1,0,1,0
39478,40369,57470,0,0,62,62,0,1,0,1,0
39479,29300,35440,0,0,146,146,0,1,0,1,0
39480,45690,60038,0,0,62,62,0,1,0,1,0
39481,55505,53,61786,53,198,101,97,2,1,1,1
39482,57665,52700,0,0,66,66,0,1,0,1,0
39483,58743,35894,0,0,62,62,0,1,0,1,0
39484,57358,445,0,0,70,70,0,1,0,1,0
39485,62247,445,0,0,70,70,0,1,0,1,0
39486,57357,445,0,0,70,70,0,1,0,1,0
39487,62243,445,0,0,70,70,0,1,0,1,0
39488,62235,445,0,0,70,70,0,1,0,1,0
39489,57355,445,0,0,70,70,0,1,0,1,0
39490,38400,51505,0,0,146,146,0,1,0,1,0
39491,47515,5900,0,0,60,60,0,1,0,1,0
39492,57641,445,0,0,66,66,0,1,0,1,0
39493,27209,30170,0,0,145,145,0,1,0,1,0
39494,37420,44847,0,0,62,62,0,1,0,1,0
39495,1024,62609,0,0,148,148,0,1,0,1,0
39496,47134,37965,0,0,62,62,0,1,0,1,0
39497,57348,445,0,0,70,70,0,1,0,1,0
39498,11574,51505,0,0,66,66,0,1,0,1,0
39499,57634,445,0,0,66,66,0,1,0,1,0
39500,16654,50265,0,0,62,62,0,1,0,1,0
39501,28899,37965,0,0,62,62,0,1,0,1,0
39502,62225,445,0,0,70,70,0,1,0,1,0
39503,64681,35993,0,0,62,62,0,1,0,1,0
39504,57346,445,0,0,70,70,0,1,0,1,0
39505,57987,56125,0,0,90,90,0,1,0,1,0
39506,48841,51221,0,0,62,62,0,1,0,1,0
39507,57345,445,0,0,70,70,0,1,0,1,0
39508,57632,445,0,0,66,66,0,1,0,1,0
39509,57344,445,0,0,70,70,0,1,0,1,0
39510,57343,445,0,0,70,70,0,1,0,1,0
39511,57340,445,0,0,70,70,0,1,0,1,0
39512,57339,445,0,0,70,70,0,1,0,1,0
39513,28824,44847,0,0,62,62,0,1,0,1,0
39514,48219,55442,0,0,66,66,0,1,0,1,0
39515,44855,58414,0,0,62,62,0,1,0,1,0
39516,52432,50265,0,0,66,66,0,1,0,1,0
39517,57625,445,0,0,66,66,0,1,0,1,0
39518,0,0,0,0,320,320,0,5,0,5,0
39519,50767,57470,0,0,66,66,0,1,0,1,0
39520,57620,445,0,0,66,66,0,1,0,1,0
39521,57325,445,0,0,70,70,0,1,0,1,0
39522,57324,445,0,0,70,70,0,1,0,1,0
39523,57322,445,0,0,70,70,0,1,0,1,0
39524,62089,8604,0,0,66,66,0,1,0,1,0
39525,52614,44847,0,0,66,66,0,1,0,1,0
39526,57314,445,0,0,70,70,0,1,0,1,0
39527,57315,445,0,0,70,70,0,1,0,1,0
39528,57849,50584,0,0,66,66,0,1,0,1,0
39529,43724,35440,0,0,62,62,0,1,0,1,0
39530,18876,44847,0,0,66,66,0,1,0,1,0
39531,9522,51505,0,0,66,66,0,1,0,1,0
39532,62307,8055,0,0,159,159,0,1,0,1,0
39533,55553,37965,0,0,66,66,0,1,0,1,0
39534,50292,22114,0,0,66,66,0,1,0,1,0
39535,51015,64147,0,0,145,145,0,1,0,1,0
39536,62215,445,0,0,70,70,0,1,0,1,0
39537,62213,445,0,0,70,70,0,1,0,1,0
39538,62212,445,0,0,70,70,0,1,0,1,0
39539,57608,445,0,0,66,66,0,1,0,1,0
39540,57606,445,0,0,66,66,0,1,0,1,0
39541,57607,445,0,0,66,66,0,1,0,1,0
39542,57602,445,0,0,66,66,0,1,0,1,0
39543,57603,445,0,0,66,66,0,1,0,1,0
39544,57601,445,0,0,66,66,0,1,0,1,0
39545,20508,57470,0,0,62,62,0,1,0,1,0
39546,40521,23117,0,0,62,62,0,1,0,1,0
39547,51581,17546,0,0,66,66,0,1,0,1,0
39548,10436,37965,0,0,62,62,0,1,0,1,0
39549,57237,21247,0,0,62,62,0,1,0,1,0
39550,57303,445,0,0,70,70,0,1,0,1,0
39551,61150,11392,0,0,66,66,0,1,0,1,0
39552,59008,51221,0,0,62,62,0,1,0,1,0
39553,1078,30975,0,0,143,143,0,1,0,1,0
39554,42429,22114,0,0,146,146,0,1,0,1,0
39555,57500,23,0,0,60,60,0,1,0,1,0
39556,50470,61463,0,0,86,86,0,1,0,1,0
39557,61408,30188,0,0,66,66,0,1,0,1,0
39558,53147,37965,0,0,62,62,0,1,0,1,0
39559,15933,64147,0,0,62,62,0,1,0,1,0
39560,62207,445,0,0,70,70,0,1,0,1,0
39561,62211,445,0,0,70,70,0,1,0,1,0
39562,62197,445,0,0,70,70,0,1,0,1,0
39563,57299,445,0,0,70,70,0,1,0,1,0
39564,57589,445,0,0,66,66,0,1,0,1,0
39565,57588,445,0,0,66,66,0,1,0,1,0
39566,57586,445,0,0,66,66,0,1,0,1,0
39567,443,38385,0,0,66,66,0,1,90,1,0
39568,59723,443,54726,443,8380,1882,6498,29,396,9,20
39569,65075,53,1890,53,278,100,178,4,31,2,2
39570,65365,53,19962,53,192,98,94,2,30,1,1
39571,49384,53,2964,53,186,95,91,2,30,1,1
39572,34924,443,1749,443,2401,1149,1252,14,982,7,7
39573,61735,443,32889,443,57467,4506,52961,86,30,42,44
39574,60384,443,14731,443,130,70,60,2,15,1,1
39575,42602,443,64444,443,2378,1126,1252,14,982,7,7
39576,35702,443,5840,443,6751,1889,4862,24,316,13,11
39577,60187,443,37474,443,5656,1936,3720,23,57,11,12
39578,48268,443,29893,443,18462,11672,6790,47,63,26,21
39579,43415,443,53448,443,130,70,60,2,15,1,1
39580,60362,443,18140,443,130,70,60,2,15,1,1
39581,56852,49677,39171,49677,130,70,60,2,5,1,1
39582,50998,443,19722,443,3482,1985,1497,21,17,10,11
39583,50997,443,46270,443,3772,2099,1673,22,18,11,11
39584,53131,44021,31517,44021,698,320,378,10,16,6,4
39585,39572,443,3299,443,2396,1144,1252,14,982,7,7
39586,45363,443,50809,443,2396,1144,1252,14,982,7,7
39587,56772,53,9066,53,168,86,82,2,30,1,1
39588,41632,443,56228,443,8507,4462,4045,27,141,14,13
39589,47595,33439,0,0,106,106,0,1,60,1,0
39590,39716,443,56404,443,131171,10346,120825,183,150,93,90
39591,65155,53,8256,53,295,103,192,4,48,2,2
39592,60378,443,38205,443,130,70,60,2,15,1,1
39593,59835,53,53528,53,168,78,90,2,30,1,1
39594,55644,45579,20057,45579,70,70,0,1,5,1,0
39595,43423,443,64524,443,130,70,60,2,15,1,1
39596,35178,8635,35178,8635,138,78,60,2,5,1,1
39597,55000,5222,35744,5222,32608,22014,10594,225,215,124,101
39598,48269,443,55381,443,4800,3396,1404,19,60,10,9
39599,50996,443,8675,443,3536,2039,1497,22,18,11,11
39600,50661,80,9944,80,2693,461,2232,14,17,6,8
39601,56945,443,12296,443,7818,2136,5682,31,322,14,17
39602,50990,443,22704,443,6090,2628,3462,21,24,11,10
39603,49516,53,51751,53,182,93,89,2,30,1,1
39604,55945,53,51093,53,733,86,647,2,30,1,1
39605,56946,443,38559,443,10408,4790,5618,34,322,16,18
39606,51142,80,61764,80,1114,534,580,12,16,7,5
39607,44912,80,52893,80,1602,1282,320,10,15,5,5
39608,50988,443,14910,443,6938,2686,4252,25,27,12,13
39609,60374,443,9623,443,130,70,60,2,15,1,1
39610,64245,53,8045,53,198,101,97,2,31,1,1
39611,60167,5222,36653,5222,908,650,258,11,20,7,4
39612,56948,53,35699,53,93,93,0,1,30,1,0
39613,63882,49163,63411,49163,66,66,0,2,8,2,0
39614,51878,9999,7906,9999,66,66,0,1,5,1,0
39615,55169,53,64266,53,775,103,672,2,30,1,1
39616,55272,53,11966,53,285,103,182,4,51,2,2
39617,52414,80,51546,80,9534,746,8788,18,49,9,9
39618,55821,53,40940,53,168,86,82,2,30,1,1
39619,57282,53,60817,53,198,101,97,2,30,1,1
39620,64420,53,14172,53,188,96,92,2,30,1,1
39621,49632,53,30803,53,198,101,97,2,30,1,1
39622,58279,443,21713,443,3878,1156,2722,14,136,7,7
39623,52682,443,30711,443,5406,922,4484,19,360,10,9
39624,30188,32873,43392,32873,502,150,352,2,1200,1,1
39625,59772,443,48331,443,181413,11493,169920,167,85,41,126
39626,64483,53,26683,53,168,86,82,2,31,1,1
39627,55714,443,18718,443,11626,4173,7453,25,121,12,13
39628,62616,443,35713,443,32504,1730,30774,44,122,17,27
39629,53283,443,51039,443,3369,1036,2333,11,121,5,6
39630,44858,5228,3088,5228,6819,1586,5233,18,3603,9,9
39631,58080,443,57943,443,646,358,288,10,133,6,4
39632,50303,443,16402,443,13459,1604,11855,27,187,14,13
39633,62194,445,0,0,70,70,0,1,0,1,0
39634,57287,445,0,0,70,70,0,1,0,1,0
39635,57290,445,0,0,70,70,0,1,0,1,0
39636,55733,51505,0,0,66,66,0,1,0,1,0
39637,57289,445,0,0,70,70,0,1,0,1,0
39638,53971,50265,0,0,66,66,0,1,0,1,0
39639,57286,445,0,0,70,70,0,1,0,1,0
39640,12060,37965,0,0,66,66,0,1,0,1,0
39641,61135,50265,0,0,62,62,0,1,0,1,0
39642,53971,55442,0,0,66,66,0,1,0,1,0
39643,57282,445,0,0,70,70,0,1,0,1,0
39644,54423,21247,0,0,62,62,0,1,0,1,0
39645,62192,445,0,0,70,70,0,1,0,1,0
39646,63589,44847,0,0,66,66,0,1,0,1,0
39647,62188,445,0,0,70,70,0,1,0,1,0
39648,62184,445,0,0,70,70,0,1,0,1,0
39649,62180,445,0,0,70,70,0,1,0,1,0
39650,24311,22617,0,0,60,60,0,1,0,1,0
39651,64958,53,33266,53,395,102,293,2,30,1,1
39652,55272,53,17246,53,285,103,182,4,50,2,2
39653,50580,80,18240,80,1513,694,819,10,15,5,5
39654,53815,44847,0,0,62,62,0,1,0,1,0
39655,10396,62609,0,0,148,148,0,1,0,1,0
39656,33896,57470,0,0,74,74,0,1,0,1,0
39657,12074,10197,0,0,72,72,0,1,0,1,0
39658,63080,37965,0,0,66,66,0,1,0,1,0
39659,57276,445,0,0,70,70,0,1,0,1,0
39660,50442,37807,0,0,66,66,0,1,0,1,0
39661,12242,51221,0,0,62,62,0,1,0,1,0
39662,11066,50584,0,0,66,66,0,1,0,1,0
39663,27869,51221,0,0,66,66,0,1,0,1,0
39664,62175,445,0,0,70,70,0,1,0,1,0
39665,62172,445,0,0,70,70,0,1,0,1,0
39666,49531,53,38676,53,183,94,89,2,29,1,1
39667,64967,53,8909,53,184,94,90,2,29,1,1
39668,63380,443,31712,443,4704,2139,2565,13,119,7,6
39669,48265,443,35728,443,7379,2268,5111,18,134,8,10
39670,56622,443,37505,443,3575,1079,2496,15,155,7,8
39671,51087,80,58473,80,6363,3093,3270,36,130,19,17
39672,57594,80,6266,80,486,280,206,8,25,5,3
39673,51091,80,22433,80,4033,2712,1321,35,130,19,16
39674,63457,443,6711,443,606,300,306,11,60,6,5
39675,50669,443,15933,443,8464,2256,6208,25,255,13,12
39676,46505,443,30509,443,59700,5399,54301,109,32,57,52
39677,57282,53,4028,53,199,102,97,2,29,1,1
39678,51086,80,8200,80,6365,3093,3272,36,130,19,17
39679,49820,53,16935,53,193,102,91,2,29,1,1
39680,65315,53,35548,53,178,94,84,2,29,1,1
39681,65341,53,19741,53,200,102,98,2,29,1,1
39682,57018,53,62434,53,209,110,99,2,29,1,1
39683,56948,53,55604,53,183,94,89,2,29,1,1
39684,49307,53,61453,53,210,102,108,2,29,1,1
39685,57282,53,23204,53,199,102,97,2,29,1,1
39686,64144,53,4671,53,193,102,91,2,29,1,1
39687,55809,443,23452,443,180,180,0,4,11,4,0
39688,49165,53,17672,53,212,102,110,2,29,1,1
39689,65075,53,49710,53,278,100,178,4,30,2,2
39690,51675,8245,24099,8245,346,214,132,3,29,1,2
39691,49780,53,4418,53,183,94,89,2,29,1,1
39692,52312,443,50036,443,1574859,55851,1519008,1758,185,656,1102
39693,49312,53,8379,53,216,94,122,2,29,1,1
39694,51890,31122,40957,31122,70,70,0,2,8,2,0
39695,51892,46647,34851,46647,70,70,0,2,8,2,0
39696,55272,53,42714,53,285,103,182,4,50,2,2
39697,49884,53,44954,53,232,110,122,2,30,1,1
39698,55646,14420,30714,14420,70,70,0,1,5,1,0
39699,50552,80,61160,80,2367,1240,1127,10,16,5,5
39700,65486,443,40088,443,375786,11380,364406,388,16,137,251
39701,50594,80,12498,80,1635,824,811,10,15,5,5
39702,56841,29753,13885,29753,70,70,0,1,5,1,0
39703,49500,443,11255,443,16888,2692,14196,42,150,22,20
39704,65319,53,47160,53,285,103,182,4,44,2,2
39705,63458,443,33627,443,7934,1372,6562,25,63,12,13
39706,42595,443,31051,443,1093,606,487,11,15,7,4
39707,65485,443,65115,443,92447,4519,87928,105,16,39,66
39708,53684,25933,35129,25933,552,306,246,9,15,5,4
39709,65341,53,20700,53,200,102,98,2,30,1,1
39710,49621,443,59596,443,14888,3555,11333,58,256,23,35
39711,45891,443,41811,443,5718,1527,4191,24,22,13,11
39712,56772,53,56028,53,168,86,82,2,30,1,1
39713,49632,53,14328,53,199,102,97,2,30,1,1
39714,64245,53,44468,53,199,102,97,2,30,1,1
39715,56341,443,63475,443,8325,1483,6842,24,47,13,11
39716,59065,443,57168,443,25840,18434,7406,45,171,26,19
39717,38579,80,3885,80,996,507,489,10,200,5,5
39718,50467,80,50467,80,886702,38812,847890,1134,23,558,576
39719,52133,443,32677,443,7601,1919,5682,24,76,13,11
39720,49632,53,26153,53,199,102,97,2,30,1,1
39721,58209,53,58209,53,645,90,555,2,30,1,1
39722,42050,53,28616,53,168,78,90,2,30,1,1
39723,54063,443,37024,443,1313,652,661,13,185,7,6
39724,65155,53,21805,53,295,103,192,4,48,2,2
39725,53717,443,48427,443,318,192,126,6,15,4,2
39726,39612,443,50624,443,482030,16677,465353,539,28,207,332
39727,58506,443,5356,443,2408,1399,1009,18,274,9,9
39728,49349,80,49349,80,450,246,204,8,141,5,3
39729,63460,443,27370,443,502,250,252,9,63,5,4
39730,49997,53,42691,53,209,110,99,2,29,1,1
39731,50655,80,3910,80,1507,682,825,13,20,8,5
39732,57584,443,57584,443,8019,4063,3956,33,92,16,17
39733,51891,23238,33315,23238,70,70,0,2,8,2,0
39734,43376,443,45691,443,7123,1331,5792,22,81,11,11
39735,53719,443,60186,443,70,70,0,1,5,1,0
39736,62776,443,62776,443,4398,1491,2907,19,26,11,8
39737,60591,53,64106,53,78,78,0,1,29,1,0
39738,64967,53,42572,53,184,94,90,2,29,1,1
39739,56448,53,62354,53,200,102,98,2,29,1,1
39740,41029,53,0,0,86,86,0,1,29,1,0
39741,56655,53,54773,53,86,86,0,1,29,1,0
39742,51582,5223,65291,5223,4183,1283,2900,23,163,13,10
39743,49973,80,59362,80,1352,364,988,13,15,6,7
39744,64331,53,48009,53,179,94,85,2,29,1,1
39745,65194,53,28428,53,196,94,102,2,29,1,1
39746,56655,53,28955,53,168,86,82,2,29,1,1
39747,64844,53,45693,53,733,86,647,2,29,1,1
39748,55821,53,13953,53,196,102,94,2,29,1,1
39749,49516,53,31257,53,183,94,89,2,29,1,1
39750,49351,53,56042,53,166,86,80,2,29,1,1
39751,49516,53,60499,53,183,94,89,2,29,1,1
39752,59902,53,0,0,220,83,137,2,30,1,1
39753,57305,53,52868,53,168,86,82,2,29,1,1
39754,65365,53,13159,53,196,102,94,2,30,1,1
39755,64292,53,46657,53,199,94,105,2,30,1,1
39756,42291,53,6078,53,168,78,90,2,30,1,1
39757,49600,53,23356,53,243,94,149,2,30,1,1
39758,44847,6881,3314,6881,501,150,351,2,1200,1,1
39759,59560,443,54712,443,4038,1219,2819,22,135,9,13
39760,65155,53,9340,53,613,200,413,6,59,3,3
39761,57867,27019,59183,27019,802,472,330,8,30,5,3
39762,56937,8200,16885,8200,78,78,0,1,30,1,0
39763,63975,53,64486,53,316,94,222,2,30,1,1
39764,55629,53,49009,53,208,94,114,2,30,1,1
39765,9087,53,9087,53,178,82,96,2,30,1,1
39766,65422,53,59464,53,208,94,114,2,30,1,1
39767,64298,443,45877,443,115035,5282,109753,128,120,44,84
39768,60434,11339,49665,11339,70,70,0,2,8,2,0
39769,34158,443,8410,443,130,70,60,2,15,1,1
39770,56772,53,47377,53,168,86,82,2,30,1,1
39771,64348,53,23011,53,321,102,219,2,30,1,1
39772,49724,53,34584,53,210,102,108,2,30,1,1
39773,64245,53,47905,53,199,102,97,2,30,1,1
39774,56772,53,27354,53,168,86,82,2,30,1,1
39775,65292,53,10766,53,385,106,279,4,33,2,2
39776,51889,44348,63585,44348,70,70,0,2,8,2,0
39777,55272,53,40097,53,599,198,401,6,50,3,3
39778,58017,53,58017,53,832,106,726,2,30,1,1
39779,64420,53,3880,53,194,102,92,2,30,1,1
39780,55258,443,6481,443,1786,172,1614,7,120,3,4
39781,46334,443,50617,443,9759,2304,7455,28,138,14,14
39782,65075,53,30736,53,278,100,178,4,30,2,2
39783,49347,80,49347,80,450,246,204,8,141,5,3
39784,56524,443,14904,443,344632,9074,335558,354,121,122,232
39785,57470,58125,57009,58125,1572,664,908,14,1200,9,5
39786,54121,443,19391,443,26357358,863775,25493583,27347,208,8650,18697
39787,55345,53,38199,53,255,102,153,2,30,1,1
39788,39208,53,0,0,86,86,0,1,30,1,0
39789,50407,8080,50407,8080,378,180,198,7,33,4,3
39790,53697,6224,21795,6224,70,70,0,2,8,2,0
39791,53683,30218,33662,30218,492,306,186,8,15,5,3
39792,38654,443,36804,443,9144,1783,7361,19,16,10,9
39793,53698,8120,50996,8120,70,70,0,2,8,2,0
39794,55026,53,55024,53,196,94,102,2,30,1,1
39795,64245,53,26898,53,199,102,97,2,30,1,1
39796,64726,53,58493,53,352,94,258,2,30,1,1
39797,56947,53,11234,53,239,102,137,2,30,1,1
39798,62169,445,0,0,70,70,0,1,0,1,0
39799,56636,43890,0,0,66,66,0,1,0,1,0
39800,57269,445,0,0,70,70,0,1,0,1,0
39801,28009,36237,0,0,146,146,0,1,0,1,0
39802,57268,445,0,0,70,70,0,1,0,1,0
39803,47910,7461,0,0,60,60,0,1,0,1,0
39804,23537,35253,0,0,66,66,0,1,0,1,0
39805,57263,445,0,0,70,70,0,1,0,1,0
39806,6666,138,0,0,60,60,0,1,0,1,0
39807,1972,57470,0,0,78,78,0,1,0,1,0
39808,6881,6881,0,0,62,62,0,1,0,1,0
39809,65179,44847,0,0,66,66,0,1,0,1,0
39810,57261,445,0,0,70,70,0,1,0,1,0
39811,57566,445,0,0,66,66,0,1,0,1,0
39812,52569,30188,0,0,66,66,0,1,0,1,0
39813,62167,445,0,0,70,70,0,1,0,1,0
39814,62164,445,0,0,70,70,0,1,0,1,0
39815,22922,35440,0,0,66,66,0,1,0,1,0
39816,27272,64147,0,0,66,66,0,1,0,1,0
39817,18754,30188,0,0,62,62,0,1,0,1,0
39818,57257,445,0,0,70,70,0,1,0,1,0
39819,50529,44847,0,0,66,66,0,1,0,1,0
39820,61925,51505,0,0,62,62,0,1,0,1,0
39821,41381,23,0,0,60,60,0,1,0,1,0
39822,57558,445,0,0,66,66,0,1,0,1,0
39823,57557,445,0,0,66,66,0,1,0,1,0
39824,58501,44847,0,0,66,66,0,1,0,1,0
39825,52626,44847,0,0,66,66,0,1,0,1,0
39826,57256,445,0,0,70,70,0,1,0,1,0
39827,64115,2767,0,0,66,66,0,1,0,1,0
39828,9687,57470,0,0,78,78,0,1,0,1,0
39829,443,7387,0,0,60,60,0,1,0,1,0
39830,52472,51221,0,0,74,74,0,1,0,1,0
39831,61559,23,0,0,60,60,0,1,0,1,0
39832,62155,445,0,0,70,70,0,1,0,1,0
39833,35120,26467,0,0,62,62,0,1,0,1,0
39834,62150,445,0,0,70,70,0,1,0,1,0
39835,62149,445,0,0,70,70,0,1,0,1,0
39836,62147,445,0,0,70,70,0,1,0,1,0
39837,61527,51050,0,0,66,66,0,1,0,1,0
39838,45941,23386,0,0,60,60,0,1,0,1,0
39839,57554,445,0,0,66,66,0,1,0,1,0
39840,49367,51505,0,0,62,62,0,1,0,1,0
39841,57251,445,0,0,70,70,0,1,0,1,0
39842,41954,2323,0,0,60,60,0,1,0,1,0
39843,51222,35440,0,0,62,62,0,1,0,1,0
39844,48676,53395,0,0,60,60,0,1,0,1,0
39845,57550,445,0,0,66,66,0,1,0,1,0
39846,57546,445,0,0,66,66,0,1,0,1,0
39847,57541,445,0,0,66,66,0,1,0,1,0
39848,57542,445,0,0,66,66,0,1,0,1,0
39849,57547,445,0,0,66,66,0,1,0,1,0
39850,57545,445,0,0,66,66,0,1,0,1,0
39851,57539,445,0,0,66,66,0,1,0,1,0
39852,38852,37965,0,0,62,62,0,1,0,1,0
39853,62140,445,0,0,70,70,0,1,0,1,0
39854,57987,56125,0,0,90,90,0,1,0,1,0
39855,2705,37,0,0,60,60,0,1,0,1,0
39856,62137,445,0,0,70,70,0,1,0,1,0
39857,62136,445,0,0,70,70,0,1,0,1,0
39858,62133,445,0,0,70,70,0,1,0,1,0
39859,57698,64147,0,0,66,66,0,1,0,1,0
39860,44821,64147,0,0,62,62,0,1,0,1,0
39861,13727,13751,0,0,148,148,0,1,0,1,0
39862,59227,11392,0,0,62,62,0,1,0,1,0
39863,16994,57866,0,0,146,146,0,1,0,1,0
39864,49426,57470,0,0,66,66,0,1,0,1,0
39865,16001,48817,0,0,143,143,0,1,0,1,0
39866,48079,43227,0,0,66,66,0,1,0,1,0
39867,2170,43227,0,0,62,62,0,1,0,1,0
39868,57238,445,0,0,70,70,0,1,0,1,0
39869,30797,23,0,0,60,60,0,1,0,1,0
39870,64022,53,20960,53,194,99,95,2,1,1,1
39871,17010,57470,0,0,62,62,0,1,0,1,0
39872,62130,445,0,0,70,70,0,1,0,1,0
39873,62129,445,0,0,70,70,0,1,0,1,0
39874,62126,445,0,0,70,70,0,1,0,1,0
39875,57235,445,0,0,70,70,0,1,0,1,0
39876,57533,445,0,0,66,66,0,1,0,1,0
39877,22346,51505,0,0,62,62,0,1,0,1,0
39878,19004,51505,0,0,62,62,0,1,0,1,0
39879,62124,445,0,0,70,70,0,1,0,1,0
39880,50470,61463,0,0,86,86,0,1,0,1,0
39881,57529,445,0,0,66,66,0,1,0,1,0
39882,60962,64147,0,0,66,66,0,1,0,1,0
39883,57526,445,0,0,66,66,0,1,0,1,0
39884,57528,445,0,0,66,66,0,1,0,1,0
39885,57525,445,0,0,66,66,0,1,0,1,0
39886,57231,445,0,0,70,70,0,1,0,1,0
39887,50298,37965,0,0,66,66,0,1,0,1,0
39888,57229,445,0,0,70,70,0,1,0,1,0
39889,19068,37965,0,0,62,62,0,1,0,1,0
39890,50066,30188,0,0,62,62,0,1,0,1,0
39891,57227,445,0,0,70,70,0,1,0,1,0
39892,62119,445,0,0,70,70,0,1,0,1,0
39893,65285,50584,0,0,66,66,0,1,0,1,0
39894,49644,30188,0,0,66,66,0,1,0,1,0
39895,62107,445,0,0,70,70,0,1,0,1,0
39896,62110,445,0,0,70,70,0,1,0,1,0
39897,59611,56205,0,0,66,66,0,1,0,1,0
39898,54167,50584,0,0,62,62,0,1,0,1,0
39899,40216,50265,0,0,62,62,0,1,0,1,0
39900,37927,50265,0,0,66,66,0,1,0,1,0
39901,37343,21247,0,0,62,62,0,1,0,1,0
39902,57513,445,0,0,66,66,0,1,0,1,0
39903,65317,51221,0,0,78,78,0,1,0,1,0
39904,63927,50265,0,0,62,62,0,1,0,1,0
39905,39244,36829,0,0,62,62,0,1,0,1,0
39906,57220,445,0,0,70,70,0,1,0,1,0
39907,0,0,0,0,82,82,0,1,0,1,0
39908,0,0,0,0,480,244,236,4,0,2,2
39909,60674,8055,0,0,145,145,0,1,0,1,0
39910,52658,64147,0,0,145,145,0,1,0,1,0
39911,63196,445,0,0,66,66,0,1,0,1,0
39912,57218,445,0,0,70,70,0,1,0,1,0
39913,63098,35440,0,0,66,66,0,1,0,1,0
39914,46409,35440,0,0,66,66,0,1,0,1,0
39915,57633,50584,0,0,146,146,0,1,0,1,0
39916,57506,445,0,0,66,66,0,1,0,1,0
39917,5222,18733,0,0,66,66,0,1,0,1,0
39918,10427,32480,0,0,66,66,0,1,0,1,0
39919,62096,445,0,0,70,70,0,1,0,1,0
39920,29951,34021,0,0,62,62,0,1,0,1,0
39921,6546,37965,0,0,62,62,0,1,0,1,0
39922,57217,445,0,0,70,70,0,1,0,1,0
39923,57216,445,0,0,70,70,0,1,0,1,0
39924,39390,15503,0,0,74,74,0,1,0,1,0
39925,57215,445,0,0,70,70,0,1,0,1,0
39926,57212,445,0,0,70,70,0,1,0,1,0
39927,57211,445,0,0,70,70,0,1,0,1,0
39928,51505,17372,0,0,66,66,0,1,0,1,0
39929,57503,445,0,0,66,66,0,1,0,1,0
39930,57987,56125,0,0,90,90,0,1,0,1,0
39931,57131,35776,0,0,145,145,0,1,0,1,0
39932,2828,35253,0,0,66,66,0,1,0,1,0
39933,39981,57470,0,0,62,62,0,1,0,1,0
39934,61404,52700,0,0,72,72,0,1,0,1,0
39935,58424,52700,0,0,66,66,0,1,0,1,0
39936,57497,445,0,0,66,66,0,1,0,1,0
39937,57197,445,0,0,70,70,0,1,0,1,0
39938,57196,445,0,0,70,70,0,1,0,1,0
39939,57192,445,0,0,70,70,0,1,0,1,0
39940,19161,26296,0,0,159,159,0,1,0,1,0
39941,34301,21247,0,0,62,62,0,1,0,1,0
39942,51320,44847,0,0,66,66,0,1,0,1,0
39943,57491,445,0,0,66,66,0,1,0,1,0
39944,57186,445,0,0,70,70,0,1,0,1,0
39945,57187,445,0,0,70,70,0,1,0,1,0
39946,22390,19473,0,0,66,66,0,1,0,1,0
39947,39531,19473,0,0,62,62,0,1,0,1,0
39948,5222,1504,0,0,66,66,0,1,0,1,0
39949,50090,50265,0,0,62,62,0,1,0,1,0
39950,62089,445,0,0,70,70,0,1,0,1,0
39951,62085,445,0,0,70,70,0,1,0,1,0
39952,62084,445,0,0,70,70,0,1,0,1,0
39953,26448,9192,0,0,145,145,0,1,0,1,0
39954,57475,445,0,0,66,66,0,1,0,1,0
39955,57476,445,0,0,66,66,0,1,0,1,0
39956,57478,445,0,0,66,66,0,1,0,1,0
39957,57477,445,0,0,66,66,0,1,0,1,0
39958,57479,445,0,0,66,66,0,1,0,1,0
39959,57480,445,0,0,66,66,0,1,0,1,0
39960,57474,445,0,0,66,66,0,1,0,1,0
39961,57473,445,0,0,66,66,0,1,0,1,0
39962,57175,445,0,0,70,70,0,1,0,1,0
39963,23277,53733,0,0,62,62,0,1,0,1,0
39964,58574,21247,0,0,66,66,0,1,0,1,0
39965,62132,42873,0,0,66,66,0,1,0,1,0
39966,46662,36237,0,0,62,62,0,1,0,1,0
39967,35494,22114,0,0,66,66,0,1,0,1,0
39968,63037,443,11934,443,303,85,218,2,31,1,1
39969,63038,53,49856,53,303,85,218,2,31,1,1
39970,53216,443,34085,443,14933,1671,13262,31,66,15,16
39971,50523,443,44131,443,1389,868,521,12,25,6,6
39972,53676,80,62250,80,154478,6934,147544,194,24,86,108
39973,65319,53,30506,53,285,103,182,4,44,2,2
39974,59867,443,26148,443,6197,843,5354,21,27,10,11
39975,45346,443,29212,443,2438,1442,996,21,20,12,9
39976,56848,19556,62974,19556,70,70,0,2,8,2,0
39977,53052,443,55345,443,214,140,74,4,15,3,1
39978,52009,443,21173,443,10339,2028,8311,28,46,16,12
39979,50546,80,2878,80,1990,812,1178,9,15,5,4
39980,63045,443,61231,443,510,164,346,2,30,1,1
39981,63046,53,33586,53,510,164,346,2,30,1,1
39982,50521,80,1574,80,454,262,192,8,25,5,3
39983,50468,80,50468,80,90393,7684,82709,132,22,69,63
39984,49555,53,60187,53,578,286,292,9,15,5,4
39985,61714,443,1566,443,2484,330,2154,12,135,5,7
39986,53253,443,34431,443,36393,27741,8652,147,210,76,71
39987,47289,443,7853,443,16114,7882,8232,37,104,15,22
39988,53217,443,21683,443,6058,1038,5020,20,66,11,9
39989,28755,80,28755,80,21270,2178,19092,35,29,15,20
39990,50466,80,50466,80,78335,7114,71221,114,22,60,54
39991,49655,80,18992,80,1056,682,374,10,15,6,4
39992,55654,18251,23263,18251,70,70,0,2,8,2,0
39993,51877,13472,45197,13472,66,66,0,1,5,1,0
39994,38634,443,16123,443,9096,1676,7420,20,18,10,10
39995,49292,443,18411,443,80199,66182,14017,134,163,87,47
39996,50408,8080,50408,8080,378,180,198,7,32,4,3
39997,46383,443,46383,443,4661,1754,2907,19,30,11,8
39998,44638,443,36875,443,20062,11233,8829,48,94,29,19
39999,49525,443,29311,443,14786,2845,11941,32,121,17,15
40000,59787,443,61520,443,20036,2088,17948,51,334,21,30
40001,58854,443,61370,443,19134,6811,12323,39,83,18,21
40002,50524,443,21568,443,1389,868,521,12,25,6,6
40003,56849,23745,4233,23745,70,70,0,2,8,2,0
40004,41247,80,52056,80,234,234,0,4,12,4,0
40005,63461,443,13278,443,622,310,312,11,59,6,5
40006,33383,443,13969,443,24440,2215,22225,46,316,20,26
40007,53223,443,54102,443,7457,1726,5731,25,65,13,12
40008,45019,53,52189,53,168,78,90,2,30,1,1
40009,53224,443,28053,443,6001,982,5019,19,65,10,9
40010,47196,443,63403,443,2701330,44089,2657241,2230,134,296,1934
40011,33775,80,33775,80,424,198,226,7,142,4,3
40012,57170,445,0,0,70,70,0,1,0,1,0
40013,62081,445,0,0,70,70,0,1,0,1,0
40014,62075,445,0,0,70,70,0,1,0,1,0
40015,62068,445,0,0,70,70,0,1,0,1,0
40016,30782,36237,0,0,62,62,0,1,0,1,0
40017,64546,57470,0,0,66,66,0,1,0,1,0
40018,53465,57470,0,0,62,62,0,1,0,1,0
40019,57461,445,0,0,66,66,0,1,0,1,0
40020,57460,445,0,0,66,66,0,1,0,1,0
40021,57458,445,0,0,66,66,0,1,0,1,0
40022,57159,445,0,0,70,70,0,1,0,1,0
40023,57162,445,0,0,70,70,0,1,0,1,0
40024,57161,445,0,0,70,70,0,1,0,1,0
40025,57157,445,0,0,70,70,0,1,0,1,0
40026,62067,445,0,0,70,70,0,1,0,1,0
40027,57154,445,0,0,70,70,0,1,0,1,0
40028,36963,23,0,0,60,60,0,1,0,1,0
40029,52714,64147,0,0,66,66,0,1,0,1,0
40030,62064,445,0,0,70,70,0,1,0,1,0
40031,19885,64147,0,0,62,62,0,1,0,1,0
40032,61981,9000,0,0,60,60,0,1,0,1,0
40033,61242,35253,0,0,66,66,0,1,0,1,0
40034,62059,445,0,0,70,70,0,1,0,1,0
40035,50470,61463,0,0,86,86,0,1,0,1,0
40036,62060,445,0,0,70,70,0,1,0,1,0
40037,62055,445,0,0,70,70,0,1,0,1,0
40038,48706,23393,0,0,60,60,0,1,0,1,0
40039,1441,51221,0,0,62,62,0,1,0,1,0
40040,59364,44847,0,0,66,66,0,1,0,1,0
40041,1171,18375,0,0,146,146,0,1,0,1,0
40042,56653,22114,0,0,66,66,0,1,0,1,0
40043,57148,445,0,0,70,70,0,1,0,1,0
40044,53608,39004,0,0,66,66,0,1,0,1,0
40045,29159,39004,0,0,62,62,0,1,0,1,0
40046,2705,37,0,0,60,60,0,1,0,1,0
40047,45007,22114,0,0,146,146,0,1,0,1,0
40048,57141,445,0,0,70,70,0,1,0,1,0
40049,62045,445,0,0,70,70,0,1,0,1,0
40050,62044,445,0,0,70,70,0,1,0,1,0
40051,62041,445,0,0,70,70,0,1,0,1,0
40052,57140,445,0,0,70,70,0,1,0,1,0
40053,25222,37965,0,0,62,62,0,1,0,1,0
40054,54742,37965,0,0,66,66,0,1,0,1,0
40055,60136,56205,0,0,66,66,0,1,0,1,0
40056,16001,48817,0,0,143,143,0,1,0,1,0
40057,8194,21247,0,0,146,146,0,1,0,1,0
40058,49977,57470,0,0,62,62,0,1,0,1,0
40059,57134,445,0,0,70,70,0,1,0,1,0
40060,53132,29384,35704,29384,70,70,0,1,5,1,0
40061,64255,53,15083,53,260,86,174,2,30,1,1
40062,64516,53,21568,53,215,94,121,2,30,1,1
40063,48658,53,48919,53,368,80,288,4,30,2,2
40064,52997,443,53080,443,17380,7747,9633,52,121,23,29
40065,55421,53,63396,53,168,78,90,2,30,1,1
40066,39385,443,14896,443,89229,6918,82311,131,33,63,68
40067,50531,80,35066,80,21782,2162,19620,28,20,11,17
40068,65029,53,39227,53,214,102,112,2,29,1,1
40069,64020,53,46952,53,302,118,184,2,29,1,1
40070,60232,53,0,0,202,86,116,2,29,1,1
40071,59537,80,26442,80,3892,1824,2068,21,187,12,9
40072,57470,47099,22688,47099,330,330,0,6,1199,6,0
40073,45624,443,55280,443,6697,1606,5091,23,17,13,10
40074,59350,443,59350,443,4401,1494,2907,19,27,11,8
40075,60014,443,21323,443,10021,3035,6986,30,46,17,13
40076,65528,53,22092,53,199,86,113,2,29,1,1
40077,65108,53,46911,53,195,94,101,2,29,1,1
40078,59928,53,57258,53,320,94,226,2,29,1,1
40079,53696,50321,25044,50321,70,70,0,2,7,2,0
40080,64537,53,43379,53,251,102,149,2,30,1,1
40081,53236,443,39010,443,41247,1363,39884,51,37,13,38
40082,65055,53,62687,53,225,86,139,2,30,1,1
40083,53282,443,30859,443,1786,172,1614,7,119,3,4
40084,53232,443,62934,443,102629,3555,99074,114,58,40,74
40085,51876,35624,49210,35624,70,70,0,1,5,1,0
40086,63050,53,33894,53,384,166,218,2,30,1,1
40087,65018,53,20967,53,310,102,208,2,30,1,1
40088,50265,18659,34655,18659,481,150,331,2,1200,1,1
40089,53212,443,62292,443,81114,4708,76406,108,66,39,69
40090,64734,53,19737,53,383,90,293,4,43,2,2
40091,49944,80,49944,80,220279,13007,207272,266,22,115,151
40092,63041,53,42776,53,448,166,282,2,30,1,1
40093,12477,80,12477,80,6835,961,5874,17,27,9,8
40094,53219,443,33001,443,6058,1038,5020,20,66,11,9
40095,53228,443,43258,443,5026,973,4053,19,59,10,9
40096,53231,443,2130,443,8906,1533,7373,32,58,16,16
40097,53230,443,3800,443,6177,1038,5139,22,58,11,11
40098,49941,80,49941,80,493003,23995,469008,578,22,246,332
40099,60770,443,16135,443,4239,2026,2213,15,120,7,8
40100,65276,53,33888,53,226,86,140,2,30,1,1
40101,44911,443,42749,443,10194,2176,8018,25,186,14,11
40102,31956,53,16501,53,268,94,174,2,30,1,1
40103,63047,443,26730,443,304,86,218,2,30,1,1
40104,53234,443,53501,443,6059,1040,5019,20,58,11,9
40105,62464,41090,36975,41090,454923,271912,183011,516,549,295,221
40106,8449,80,8449,80,48320,1685,46635,57,126,22,35
40107,53136,41442,29017,41442,70,70,0,2,8,2,0
40108,57432,66,52808,66,70,70,0,1,5,1,0
40109,49943,80,49943,80,254742,14106,240636,305,22,131,174
40110,49942,80,49942,80,323714,18296,305418,384,22,165,219
40111,60387,80,36861,80,214,140,74,4,15,3,1
40112,52119,443,11235,443,10583,3353,7230,32,83,16,16
40113,63048,53,53568,53,304,86,218,2,30,1,1
40114,64109,53,30318,53,225,102,123,2,30,1,1
40115,64004,53,17770,53,247,94,153,2,30,1,1
40116,14697,8000,59482,8000,212,150,62,2,30,1,1
40117,37857,443,49755,443,7051,5086,1965,32,100,18,14
40118,56635,80,4559,80,234,234,0,4,12,4,0
40119,55974,80,55609,80,613,539,74,7,15,6,1
40120,50463,80,50463,80,210639,12949,197690,287,23,147,140
40121,63042,443,30142,443,512,166,346,2,30,1,1
40122,17750,25326,52113,25326,491,150,341,2,1200,1,1
40123,56521,443,40583,443,11375,1770,9605,27,55,15,12
40124,49218,5222,44351,5222,85080,31769,53311,661,1172,305,356
40125,48191,5223,34035,5223,4164,1264,2900,23,1140,13,10
40126,65319,53,38266,53,285,103,182,4,43,2,2
40127,38653,443,4233,443,9664,1703,7961,22,15,11,11
40128,53685,53,0,0,547,97,450,4,40,2,2
40129,53328,53,0,0,232,77,155,2,32,1,1
40130,50464,80,50464,80,218570,13559,205011,291,22,146,145
40131,55032,5222,63875,5222,138,64,74,3,5,2,1
40132,65319,53,28841,53,285,103,182,4,43,2,2
40133,50465,80,50465,80,202622,12371,190251,264,22,132,132
40134,60386,80,35408,80,214,140,74,4,15,3,1
40135,59837,80,33837,80,830733,17622,813111,789,66,245,544
40136,65021,53,29449,53,589,91,498,4,54,2,2
40137,65365,53,10909,53,196,102,94,2,29,1,1
40138,49384,53,22527,53,193,102,91,2,29,1,1
40139,64483,53,53474,53,168,86,82,2,29,1,1
40140,64256,53,36499,53,211,78,133,2,29,1,1
40141,56738,53,53123,53,242,110,132,2,29,1,1
40142,38629,443,15765,443,9198,2279,6919,18,18,9,9
40143,64483,53,39103,53,168,86,82,2,29,1,1
40144,31201,53,38511,53,197,78,119,2,30,1,1
40145,49385,53,9929,53,843,285,558,8,56,4,4
40146,26690,53,55791,53,197,94,103,2,29,1,1
40147,49742,53,9539,53,213,102,111,2,29,1,1
40148,49208,53,8830,53,216,94,122,2,29,1,1
40149,53229,443,57933,443,91414,11700,79714,174,59,65,109
40150,64089,53,20449,53,197,94,103,2,30,1,1
40151,63049,443,56063,443,384,166,218,2,30,1,1
40152,57174,53,49148,53,210,94,116,2,30,1,1
40153,53221,443,43184,443,57706,2486,55220,67,65,23,44
40154,53227,443,7377,443,16336,3219,13117,46,59,21,25
40155,64483,53,3911,53,168,86,82,2,30,1,1
40156,50820,443,50820,443,37757,4416,33341,44,32,17,27
40157,65216,53,59898,53,244,94,150,2,30,1,1
40158,56891,53,21983,53,200,94,106,2,30,1,1
40159,39758,53,26339,53,86,86,0,1,30,1,0
40160,53233,443,34879,443,6059,1040,5019,20,58,11,9
40161,64753,53,4084,53,287,102,185,2,30,1,1
40162,36387,443,45505,443,7139,1751,5388,32,1372,10,22
40163,37827,443,64403,443,424,210,214,7,131,4,3
40164,60388,80,19317,80,214,140,74,4,15,3,1
40165,38633,443,44108,443,3448,1619,1829,18,18,8,10
40166,19874,3389,19874,3389,4145,1976,2169,22,18,13,9
40167,53235,443,2490,443,11111,1014,10097,24,37,10,14
40168,53226,443,20634,443,5993,974,5019,19,59,10,9
40169,53222,443,42780,443,4531,974,3557,18,65,10,8
40170,53218,443,1969,443,245772,8639,237133,291,66,103,188
40171,56350,53,30997,53,287,102,185,2,30,1,1
40172,33497,53,21271,53,168,78,90,2,30,1,1
40173,63043,53,52366,53,448,166,282,2,30,1,1
40174,38174,443,51209,443,7034,1885,5149,28,95,15,13
40175,62896,993,16279,993,9831,4069,5762,88,192,40,48
40176,50028,53,16611,53,210,102,108,2,30,1,1
40177,63044,443,58831,443,512,166,346,2,30,1,1
40178,61465,443,63826,443,9619,879,8740,19,135,8,11
40179,59538,80,24164,80,3835,1767,2068,21,187,12,9
40180,25,63566,25,63566,102,102,0,1,5,1,0
40181,46286,443,2203,443,1053,566,487,10,41,6,4
40182,28509,80,28509,80,10145,1446,8699,23,29,11,12
40183,49476,53,2698,53,200,94,106,2,30,1,1
40184,49257,80,49257,80,19393,1504,17889,30,32,12,18
40185,63876,5968,28223,5968,66,66,0,2,8,2,0
40186,53687,51471,5153,51471,70,70,0,1,5,1,0
40187,63034,443,35751,443,304,86,218,2,30,1,1
40188,47010,53,59094,53,294,94,200,2,30,1,1
40189,59166,443,40050,443,130458,7920,122538,199,359,94,105
40190,63033,53,19877,53,304,86,218,2,30,1,1
40191,49977,53,37356,53,212,94,118,2,30,1,1
40192,9067,443,32087,443,11768028,275478,11492550,12305,77,4158,8147
40193,63878,50829,45177,50829,66,66,0,2,8,2,0
40194,63032,53,34881,53,304,86,218,2,30,1,1
40195,56702,53,49433,53,168,78,90,2,30,1,1
40196,9055,443,33529,443,6594797,175738,6419059,6398,123,1755,4643
40197,55770,443,27394,443,40169,4646,35523,61,122,24,37
40198,28897,35440,0,0,62,62,0,1,0,1,0
40199,57133,445,0,0,70,70,0,1,0,1,0
40200,62029,22114,0,0,66,66,0,1,0,1,0
40201,11478,51221,0,0,66,66,0,1,0,1,0
40202,9743,23,0,0,60,60,0,1,0,1,0
40203,9687,57470,0,0,78,78,0,1,0,1,0
40204,60126,35440,0,0,62,62,0,1,0,1,0
40205,58128,44847,0,0,146,146,0,1,0,1,0
40206,57439,445,0,0,66,66,0,1,0,1,0
40207,62037,445,0,0,70,70,0,1,0,1,0
40208,62035,445,0,0,70,70,0,1,0,1,0
40209,57129,445,0,0,70,70,0,1,0,1,0
40210,58672,43890,0,0,66,66,0,1,0,1,0
40211,7274,64147,0,0,62,62,0,1,0,1,0
40212,52472,51221,0,0,74,74,0,1,0,1,0
40213,60646,11392,0,0,66,66,0,1,0,1,0
40214,65494,53,0,0,88,88,0,1,0,1,0
40215,57128,445,0,0,70,70,0,1,0,1,0
40216,19245,64147,0,0,66,66,0,1,0,1,0
40217,57432,445,0,0,66,66,0,1,0,1,0
40218,57429,445,0,0,66,66,0,1,0,1,0
40219,37701,23,0,0,60,60,0,1,0,1,0
40220,41220,59356,0,0,62,62,0,1,0,1,0
40221,2705,37,0,0,60,60,0,1,0,1,0
40222,63096,44847,0,0,66,66,0,1,0,1,0
40223,6721,37965,0,0,66,66,0,1,0,1,0
40224,65515,22114,0,0,66,66,0,1,0,1,0
40225,62026,445,0,0,70,70,0,1,0,1,0
40226,52989,51505,0,0,66,66,0,1,0,1,0
40227,34306,37965,0,0,62,62,0,1,0,1,0
40228,48576,443,26108,443,476,410,66,4,0,3,1
40229,9522,51505,0,0,66,66,0,1,0,1,0
40230,57123,445,0,0,70,70,0,1,0,1,0
40231,62019,445,0,0,70,70,0,1,0,1,0
40232,62018,445,0,0,70,70,0,1,0,1,0
40233,62015,445,0,0,70,70,0,1,0,1,0
40234,57987,56125,0,0,90,90,0,1,0,1,0
40235,55174,53,1640,53,774,101,673,2,0,1,1
40236,57428,445,0,0,66,66,0,1,0,1,0
40237,43611,1879,0,0,145,145,0,1,0,1,0
40238,50877,35776,0,0,159,159,0,1,0,1,0
40239,57412,445,0,0,66,66,0,1,0,1,0
40240,57419,445,0,0,66,66,0,1,0,1,0
40241,57413,445,0,0,66,66,0,1,0,1,0
40242,57418,445,0,0,66,66,0,1,0,1,0
40243,57417,445,0,0,66,66,0,1,0,1,0
40244,57414,445,0,0,66,66,0,1,0,1,0
40245,57411,445,0,0,66,66,0,1,0,1,0
40246,57874,26467,0,0,62,62,0,1,0,1,0
40247,62012,445,0,0,70,70,0,1,0,1,0
40248,10775,35440,0,0,62,62,0,1,0,1,0
40249,62007,445,0,0,70,70,0,1,0,1,0
40250,62005,445,0,0,70,70,0,1,0,1,0
40251,62004,445,0,0,70,70,0,1,0,1,0
40252,43129,15503,0,0,62,62,0,1,0,1,0
40253,55766,36237,0,0,146,146,0,1,0,1,0
40254,53090,59356,0,0,66,66,0,1,0,1,0
40255,63340,53,0,0,84,84,0,1,0,1,0
40256,40185,64147,0,0,62,62,0,1,0,1,0
40257,57110,445,0,0,70,70,0,1,0,1,0
40258,65526,28793,0,0,62,62,0,1,0,1,0
40259,25565,44521,0,0,60,60,0,1,0,1,0
40260,57107,445,0,0,70,70,0,1,0,1,0
40261,15875,50584,0,0,62,62,0,1,0,1,0
40262,62003,445,0,0,70,70,0,1,0,1,0
40263,62002,445,0,0,70,70,0,1,0,1,0
40264,61999,445,0,0,70,70,0,1,0,1,0
40265,443,41545,0,0,60,60,0,1,0,1,0
40266,57403,445,0,0,66,66,0,1,0,1,0
40267,61995,445,0,0,70,70,0,1,0,1,0
40268,57402,445,0,0,66,66,0,1,0,1,0
40269,57400,445,0,0,66,66,0,1,0,1,0
40270,57399,445,0,0,66,66,0,1,0,1,0
40271,47381,8305,0,0,159,159,0,1,0,1,0
40272,57103,445,0,0,70,70,0,1,0,1,0
40273,57396,445,0,0,66,66,0,1,0,1,0
40274,45682,37965,0,0,62,62,0,1,0,1,0
40275,15641,26467,0,0,62,62,0,1,0,1,0
40276,57101,445,0,0,70,70,0,1,0,1,0
40277,57612,28793,0,0,66,66,0,1,0,1,0
40278,57099,445,0,0,70,70,0,1,0,1,0
40279,61085,37965,0,0,62,62,0,1,0,1,0
40280,53966,57470,0,0,62,62,0,1,0,1,0
40281,61990,445,0,0,70,70,0,1,0,1,0
40282,59435,37807,0,0,62,62,0,1,0,1,0
40283,1040,37965,0,0,62,62,0,1,0,1,0
40284,52976,31573,0,0,66,66,0,1,0,1,0
40285,61984,445,0,0,70,70,0,1,0,1,0
40286,61981,445,0,0,70,70,0,1,0,1,0
40287,35558,15503,0,0,66,66,0,1,0,1,0
40288,60060,443,0,0,1097,1097,0,1,0,1,0
40289,50470,61463,0,0,86,86,0,1,0,1,0
40290,10036,44847,0,0,66,66,0,1,0,1,0
40291,55375,44847,0,0,66,66,0,1,0,1,0
40292,57385,445,0,0,66,66,0,1,0,1,0
40293,57092,445,0,0,70,70,0,1,0,1,0
40294,27018,61508,0,0,753,753,0,1,0,1,0
40295,27018,61508,0,0,753,753,0,1,0,1,0
40296,50901,26467,0,0,66,66,0,1,0,1,0
40297,57090,445,0,0,70,70,0,1,0,1,0
40298,61510,37965,0,0,66,66,0,1,0,1,0
40299,59563,30188,0,0,66,66,0,1,0,1,0
40300,57089,445,0,0,70,70,0,1,0,1,0
40301,57378,445,0,0,66,66,0,1,0,1,0
40302,61968,445,0,0,70,70,0,1,0,1,0
40303,57088,445,0,0,70,70,0,1,0,1,0
40304,8536,37965,0,0,62,62,0,1,0,1,0
40305,57087,445,0,0,70,70,0,1,0,1,0
40306,47910,7464,0,0,60,60,0,1,0,1,0
40307,56752,44847,0,0,62,62,0,1,0,1,0
40308,59352,37965,0,0,66,66,0,1,0,1,0
40309,57082,445,0,0,70,70,0,1,0,1,0
40310,57083,445,0,0,70,70,0,1,0,1,0
40311,57376,445,0,0,66,66,0,1,0,1,0
40312,48681,11392,0,0,62,62,0,1,0,1,0
40313,57069,445,0,0,70,70,0,1,0,1,0
40314,57068,445,0,0,70,70,0,1,0,1,0
40315,57066,445,0,0,70,70,0,1,0,1,0
40316,8080,37965,0,0,62,62,0,1,0,1,0
40317,47091,5228,39353,5228,3113,1395,1718,20,3608,8,12
40318,52064,443,64308,443,9003,2598,6405,33,345,15,18
40319,57470,41024,3847,41024,330,330,0,6,1200,6,0
40320,55172,80,55172,80,268230,8528,259702,292,231,106,186
40321,47293,443,64269,443,6318,1025,5293,17,31,9,8
40322,59866,443,32010,443,6135,843,5292,20,26,10,10
40323,57470,58973,26085,58973,330,330,0,6,1200,6,0
40324,33795,80,33795,80,490,264,226,8,142,5,3
40325,40866,8434,40866,8434,156,156,0,3,8,3,0
40326,53685,38978,33015,38978,70,70,0,1,5,1,0
40327,50542,80,60343,80,1607,970,637,8,16,5,3
40328,51209,443,64337,443,84768,21103,63665,136,133,58,78
40329,49941,443,34505,443,8754,2895,5859,26,16,15,11
40330,51886,35965,10726,35965,70,70,0,2,8,2,0
40331,51874,43161,26415,43161,66,66,0,1,5,1,0
40332,64335,443,56064,443,230615,48569,182046,379,176,157,222
40333,57470,6881,6226,6881,453,251,202,4,1200,2,2
40334,59868,443,32881,443,502,250,252,9,26,5,4
40335,42473,80,36510,80,1737,796,941,12,16,7,5
40336,45345,443,9986,443,2438,1442,996,21,27,12,9
40337,53681,31466,20007,31466,70,70,0,1,5,1,0
40338,56840,20413,2836,20413,66,66,0,1,5,1,0
40339,8282,40200,5762,40200,133,64,69,3,30,2,1
40340,57470,6881,28610,6881,396,396,0,7,1200,7,0
40341,57470,24260,9692,24260,806,163,643,2,1201,1,1
40342,57058,445,0,0,70,70,0,1,0,1,0
40343,57059,445,0,0,70,70,0,1,0,1,0
40344,57369,445,0,0,66,66,0,1,0,1,0
40345,25565,58771,0,0,60,60,0,1,0,1,0
40346,60854,42873,0,0,66,66,0,1,0,1,0
40347,57361,445,0,0,66,66,0,1,0,1,0
40348,26351,22114,0,0,62,62,0,1,0,1,0
40349,48020,7484,0,0,60,60,0,1,0,1,0
40350,57987,56125,0,0,90,90,0,1,0,1,0
40351,58922,57470,0,0,66,66,0,1,0,1,0
40352,54028,37965,0,0,62,62,0,1,0,1,0
40353,29787,37965,0,0,62,62,0,1,0,1,0
40354,50325,80,28914,80,19438,12019,7419,53,312,30,23
40355,59974,443,38243,443,354,140,214,6,130,3,3
40356,57047,445,0,0,70,70,0,1,0,1,0
40357,61960,445,0,0,70,70,0,1,0,1,0
40358,61956,445,0,0,70,70,0,1,0,1,0
40359,15403,51505,0,0,66,66,0,1,0,1,0
40360,57347,445,0,0,66,66,0,1,0,1,0
40361,57352,445,0,0,66,66,0,1,0,1,0
40362,57349,445,0,0,66,66,0,1,0,1,0
40363,57350,445,0,0,66,66,0,1,0,1,0
40364,57353,445,0,0,66,66,0,1,0,1,0
40365,57348,445,0,0,66,66,0,1,0,1,0
40366,57346,445,0,0,66,66,0,1,0,1,0
40367,57345,445,0,0,66,66,0,1,0,1,0
40368,40260,44610,0,0,145,145,0,1,0,1,0
40369,26058,1433,0,0,60,60,0,1,0,1,0
40370,60405,5900,0,0,60,60,0,1,0,1,0
40371,56413,51221,0,0,66,66,0,1,0,1,0
40372,63765,51221,0,0,62,62,0,1,0,1,0
40373,27401,37965,0,0,66,66,0,1,0,1,0
40374,45964,2666,0,0,60,60,0,1,0,1,0
40375,57042,445,0,0,70,70,0,1,0,1,0
40376,31613,23,0,0,60,60,0,1,0,1,0
40377,28809,50584,0,0,66,66,0,1,0,1,0
40378,55459,50584,0,0,62,62,0,1,0,1,0
40379,61953,445,0,0,70,70,0,1,0,1,0
40380,57470,3800,54639,3800,150,150,0,1,1199,1,0
40381,33538,80,33538,80,424,198,226,7,141,4,3
40382,47918,443,24262,443,7936,2847,5089,15,120,7,8
40383,53689,42719,50216,42719,70,70,0,1,4,1,0
40384,51956,443,47122,443,8256,3157,5099,28,46,16,12
40385,63039,443,48295,443,448,166,282,2,29,1,1
40386,63031,443,4313,443,304,86,218,2,29,1,1
40387,50083,80,45276,80,38045,26409,11636,105,476,68,37
40388,59744,80,14710,80,699554,16426,683128,701,95,244,457
40389,58707,80,41124,80,2542,1879,663,12,14,6,6
40390,56850,64932,41419,64932,70,70,0,1,5,1,0
40391,63036,53,45835,53,304,86,218,2,29,1,1
40392,50608,443,53757,443,8058,2722,5336,17,31,10,7
40393,40342,53,32234,53,168,78,90,2,29,1,1
40394,57593,443,14217,443,7037,1786,5251,23,200,13,10
40395,59865,443,51225,443,502,250,252,9,26,5,4
40396,54768,25,54768,25,194,66,128,3,15,1,2
40397,41945,443,44467,443,12146,2681,9465,63,4156,25,38
40398,60782,3389,60782,3389,3504,1790,1714,17,33,9,8
40399,61571,53,17660,53,211,78,133,2,30,1,1
40400,51887,16514,22575,16514,70,70,0,2,8,2,0
40401,51875,25072,3449,25072,70,70,0,1,5,1,0
40402,33871,443,48273,443,11277,2233,9044,43,215,20,23
40403,34739,5222,35050,5222,26914,4119,22795,85,539,41,44
40404,59559,443,17669,443,6328,1536,4792,23,17,12,11
40405,53452,443,10617,443,15368,8643,6725,36,49,19,17
40406,49708,80,56764,80,179277,5324,173953,171,108,49,122
40407,49707,80,15833,80,196092,6387,189705,189,108,57,132
40408,49704,80,31664,80,217502,6597,210905,211,109,62,149
40409,55665,443,34619,443,6291,1499,4792,22,17,11,11
40410,64484,53,32900,53,732,239,493,6,51,3,3
40411,49454,443,27908,443,7212,1757,5455,20,17,10,10
40412,49221,80,26224,80,214,140,74,4,15,3,1
40413,51776,8000,6250,8000,328,142,186,6,90,3,3
40414,65298,53,43096,53,246,102,144,2,30,1,1
40415,56438,3389,56438,3389,3425,1470,1955,16,17,8,8
40416,44521,443,14957,443,6502,1347,5155,31,1195,10,21
40417,36712,53,0,0,139,70,69,2,30,1,1
40418,42770,443,4955,443,8820,2996,5824,27,95,14,13
40419,56800,443,21923,443,79399,4048,75351,90,120,32,58
40420,57470,5254,14927,5254,453,251,202,4,1200,2,2
40421,43346,443,33396,443,3691281,56325,3634956,3201,138,570,2631
40422,49705,80,59166,80,132198,5466,126732,140,109,45,95
40423,9074,443,22062,443,318,192,126,6,29,4,2
40424,45042,443,17332,443,8445,2120,6325,27,107,15,12
40425,44509,80,44509,80,84030,4287,79743,107,145,47,60
40426,62453,53,64784,53,441,162,279,6,32,3,3
40427,53135,14297,19034,14297,70,70,0,2,8,2,0
40428,36367,443,61564,443,1209,709,500,14,26,8,6
40429,37390,443,2795,443,4859,964,3895,17,26,10,7
40430,59713,3389,59713,3389,4213,2429,1784,18,32,9,9
40431,64698,53,34866,53,211,102,109,2,30,1,1
40432,50012,53,31232,53,209,102,107,2,30,1,1
40433,65164,53,35312,53,262,94,168,2,30,1,1
40434,56995,53,19045,53,196,94,102,2,30,1,1
40435,57470,6885,1463,6885,616,414,202,5,1200,3,2
40436,57470,32251,57534,32251,132,132,0,3,1199,3,0
40437,59862,443,40236,443,5301,953,4348,17,28,9,8
40438,57402,443,10569,443,6649,1556,5093,23,21,13,10
40439,51712,443,2406,443,66148,6145,60003,116,80,60,56
40440,53686,8999,26730,8999,70,70,0,1,4,1,0
40441,53682,20884,50647,20884,70,70,0,1,4,1,0
40442,60060,22,60060,22,7974,3469,4505,57,40,28,29
40443,53688,17106,13403,17106,70,70,0,1,4,1,0
40444,57266,443,13002,443,16452,7129,9323,44,47,25,19
40445,63040,53,20975,53,512,166,346,2,29,1,1
40446,49839,53,59644,53,258,110,148,2,29,1,1
40447,63035,443,45890,443,304,86,218,2,29,1,1
40448,49230,53,36534,53,351,94,257,2,30,1,1
40449,50265,37449,54760,37449,925,594,331,11,2335,10,1
40450,56992,53,30426,53,355,102,253,2,30,1,1
40451,58771,443,41397,443,4726,2487,2239,19,305,9,10
40452,33367,80,33367,80,424,198,226,7,141,4,3
40453,34285,80,34285,80,424,198,226,7,141,4,3
40454,9064,443,8179,443,11738,6980,4758,34,81,19,15
40455,47245,443,62935,443,1989,1183,806,16,94,9,7
40456,51873,19311,22096,19311,70,70,0,1,5,1,0
40457,49709,80,35500,80,128214,4961,123253,134,108,43,91
40458,63995,53,52864,53,212,94,118,2,30,1,1
40459,49213,53,44755,53,211,102,109,2,30,1,1
40460,53719,443,54352,443,3225,1939,1286,26,139,14,12
40461,35954,443,60270,443,6406,1614,4792,24,17,13,11
40462,64801,7000,64801,7000,2269,815,1454,14,15,7,7
40463,56679,443,4543,443,7941,1952,5989,20,15,11,9
40464,59595,80,6644,80,1052,612,440,10,15,5,5
40465,64925,53,10435,53,338,110,228,2,30,1,1
40466,57470,6881,57710,6881,453,251,202,4,1200,2,2
40467,56523,443,56096,443,28479,3138,25341,42,42,17,25
40468,44850,443,60943,443,4502,895,3607,15,25,9,6
40469,56680,443,53449,443,7889,1900,5989,20,15,11,9
40470,59864,443,10819,443,6066,833,5233,19,26,10,9
40471,59863,443,41870,443,622,310,312,11,28,6,5
40472,40175,80,8302,80,130,70,60,2,15,1,1
40473,49706,80,39061,80,118813,4128,114685,122,108,38,84
40474,49667,53,38974,53,261,94,167,2,30,1,1
40475,53895,443,14973,443,390740,13639,377101,441,132,152,289
40476,65219,443,28202,443,4748,2193,2555,14,135,7,7
40477,6881,45711,37473,45711,228,118,110,2,1199,1,1
40478,49160,38552,12049,38552,868,150,718,4,1200,2,2
40479,57470,6881,64620,6881,577,251,326,4,1200,2,2
40480,37965,15509,12475,15509,481,150,331,2,1199,1,1
40481,27005,1301,24545,1301,860,126,734,2,30,1,1
40482,27005,1303,22373,1303,868,126,742,2,30,1,1
40483,41891,443,2286,443,235626,4546,231080,232,339,53,179
40484,60768,40010,23273,40010,316,136,180,6,7,3,3
40485,50985,80,32837,80,5823,1570,4253,17,20,10,7
40486,53233,443,40528,443,47830,23388,24442,74,51,37,37
40487,49206,443,6191,443,15982,9199,6783,95,160,40,55
40488,37026,80,28562,80,2849,1631,1218,9,721,5,4
40489,80,13743,80,13743,70,70,0,1,5,1,0
40490,27005,1201,20493,1201,867,126,741,2,30,1,1
40491,33443,443,53620,443,14402,2801,11601,28,205,11,17
40492,50983,80,17764,80,7765,2215,5550,20,20,12,8
40493,13375,53,13375,53,213,82,131,2,30,1,1
40494,61949,445,0,0,70,70,0,1,0,1,0
40495,61939,445,0,0,70,70,0,1,0,1,0
40496,57034,445,0,0,70,70,0,1,0,1,0
40497,57031,445,0,0,70,70,0,1,0,1,0
40498,57032,445,0,0,70,70,0,1,0,1,0
40499,57029,445,0,0,70,70,0,1,0,1,0
40500,57026,445,0,0,70,70,0,1,0,1,0
40501,57333,445,0,0,66,66,0,1,0,1,0
40502,57331,445,0,0,66,66,0,1,0,1,0
40503,57330,445,0,0,66,66,0,1,0,1,0
40504,61937,445,0,0,70,70,0,1,0,1,0
40505,61935,445,0,0,70,70,0,1,0,1,0
40506,51313,64147,0,0,62,62,0,1,0,1,0
40507,61933,445,0,0,70,70,0,1,0,1,0
40508,61929,445,0,0,70,70,0,1,0,1,0
40509,61927,445,0,0,70,70,0,1,0,1,0
40510,62849,62413,0,0,66,66,0,1,0,1,0
40511,34809,57470,0,0,66,66,0,1,0,1,0
40512,17344,62413,0,0,66,66,0,1,0,1,0
40513,40500,25356,0,0,146,146,0,1,0,1,0
40514,57020,445,0,0,70,70,0,1,0,1,0
40515,46365,53413,0,0,71,71,0,1,0,1,0
40516,6224,37965,0,0,62,62,0,1,0,1,0
40517,26921,57470,0,0,62,62,0,1,0,1,0
40518,10028,25604,0,0,62,62,0,1,0,1,0
40519,56463,17,0,0,60,60,0,1,0,1,0
40520,14997,57470,0,0,72,72,0,1,0,1,0
40521,9687,57470,0,0,78,78,0,1,0,1,0
40522,62625,37965,0,0,62,62,0,1,0,1,0
40523,57013,445,0,0,70,70,0,1,0,1,0
40524,35261,15503,0,0,74,74,0,1,0,1,0
40525,57010,445,0,0,70,70,0,1,0,1,0
40526,51163,23,0,0,60,60,0,1,0,1,0
40527,6881,6881,0,0,62,62,0,1,0,1,0
40528,61916,445,0,0,70,70,0,1,0,1,0
40529,61918,445,0,0,70,70,0,1,0,1,0
40530,61915,445,0,0,70,70,0,1,0,1,0
40531,443,62451,0,0,60,60,0,1,0,1,0
40532,65494,53,0,0,88,88,0,1,0,1,0
40533,47910,7461,0,0,60,60,0,1,0,1,0
40534,57007,445,0,0,70,70,0,1,0,1,0
40535,50470,61463,0,0,86,86,0,1,0,1,0
40536,22528,48817,0,0,148,148,0,1,0,1,0
40537,65494,53,0,0,88,88,0,1,0,1,0
40538,57005,445,0,0,70,70,0,1,0,1,0
40539,61195,56205,0,0,62,62,0,1,0,1,0
40540,53781,37965,0,0,62,62,0,1,0,1,0
40541,57001,445,0,0,70,70,0,1,0,1,0
40542,49293,22,0,0,60,60,0,1,0,1,0
40543,57310,445,0,0,66,66,0,1,0,1,0
40544,61908,445,0,0,70,70,0,1,0,1,0
40545,61907,445,0,0,70,70,0,1,0,1,0
40546,59889,30188,0,0,62,62,0,1,0,1,0
40547,47105,64147,0,0,62,62,0,1,0,1,0
40548,57000,445,0,0,70,70,0,1,0,1,0
40549,61681,23,0,0,60,60,0,1,0,1,0
40550,58664,64147,0,0,66,66,0,1,0,1,0
40551,57305,445,0,0,66,66,0,1,0,1,0
40552,57302,445,0,0,66,66,0,1,0,1,0
40553,45941,23384,0,0,60,60,0,1,0,1,0
40554,52410,8604,0,0,66,66,0,1,0,1,0
40555,1024,64147,0,0,62,62,0,1,0,1,0
40556,58884,23,0,0,60,60,0,1,0,1,0
40557,16687,10214,0,0,66,66,0,1,0,1,0
40558,56995,445,0,0,70,70,0,1,0,1,0
40559,61897,445,0,0,70,70,0,1,0,1,0
40560,41429,50584,0,0,66,66,0,1,0,1,0
40561,5222,32859,0,0,66,66,0,1,0,1,0
40562,61891,445,0,0,70,70,0,1,0,1,0
40563,61892,445,0,0,70,70,0,1,0,1,0
40564,61887,445,0,0,70,70,0,1,0,1,0
40565,57298,445,0,0,66,66,0,1,0,1,0
40566,57287,445,0,0,66,66,0,1,0,1,0
40567,57292,445,0,0,66,66,0,1,0,1,0
40568,57281,445,0,0,66,66,0,1,0,1,0
40569,57284,445,0,0,66,66,0,1,0,1,0
40570,57280,445,0,0,66,66,0,1,0,1,0
40571,57285,445,0,0,66,66,0,1,0,1,0
40572,57279,445,0,0,66,66,0,1,0,1,0
40573,49248,35993,0,0,66,66,0,1,0,1,0
40574,57987,56125,0,0,90,90,0,1,0,1,0
40575,11574,51505,0,0,66,66,0,1,0,1,0
40576,50644,35440,0,0,66,66,0,1,0,1,0
40577,47682,64147,0,0,66,66,0,1,0,1,0
40578,61884,445,0,0,70,70,0,1,0,1,0
40579,33931,50584,0,0,146,146,0,1,0,1,0
40580,50327,1433,0,0,60,60,0,1,0,1,0
40581,59965,36237,0,0,62,62,0,1,0,1,0
40582,6014,37965,0,0,66,66,0,1,0,1,0
40583,61880,445,0,0,70,70,0,1,0,1,0
40584,61879,445,0,0,70,70,0,1,0,1,0
40585,61876,445,0,0,70,70,0,1,0,1,0
40586,45908,3383,0,0,60,60,0,1,0,1,0
40587,56982,445,0,0,70,70,0,1,0,1,0
40588,44855,58414,0,0,62,62,0,1,0,1,0
40589,55022,23,0,0,60,60,0,1,0,1,0
40590,48219,55442,0,0,66,66,0,1,0,1,0
40591,16654,50265,0,0,62,62,0,1,0,1,0
40592,1373,22114,0,0,66,66,0,1,0,1,0
40593,52432,50265,0,0,66,66,0,1,0,1,0
40594,56376,44847,0,0,62,62,0,1,0,1,0
40595,56979,445,0,0,70,70,0,1,0,1,0
40596,51093,57470,0,0,66,66,0,1,0,1,0
40597,40369,57470,0,0,62,62,0,1,0,1,0
40598,50783,23,0,0,60,60,0,1,0,1,0
40599,65317,51221,0,0,78,78,0,1,0,1,0
40600,52614,44847,0,0,66,66,0,1,0,1,0
40601,10348,25604,0,0,62,62,0,1,0,1,0
40602,61875,445,0,0,70,70,0,1,0,1,0
40603,61872,445,0,0,70,70,0,1,0,1,0
40604,61868,445,0,0,70,70,0,1,0,1,0
40605,27621,50584,0,0,146,146,0,1,0,1,0
40606,57849,50584,0,0,66,66,0,1,0,1,0
40607,57277,445,0,0,66,66,0,1,0,1,0
40608,18876,44847,0,0,66,66,0,1,0,1,0
40609,61867,445,0,0,70,70,0,1,0,1,0
40610,26953,30317,0,0,62,62,0,1,0,1,0
40611,6824,26467,0,0,62,62,0,1,0,1,0
40612,57273,445,0,0,66,66,0,1,0,1,0
40613,56975,445,0,0,70,70,0,1,0,1,0
40614,28899,37965,0,0,62,62,0,1,0,1,0
40615,50767,57470,0,0,66,66,0,1,0,1,0
40616,57272,445,0,0,66,66,0,1,0,1,0
40617,57271,445,0,0,66,66,0,1,0,1,0
40618,56973,445,0,0,70,70,0,1,0,1,0
40619,57268,445,0,0,66,66,0,1,0,1,0
40620,42389,42873,0,0,74,74,0,1,0,1,0
40621,56971,445,0,0,70,70,0,1,0,1,0
40622,47134,37965,0,0,62,62,0,1,0,1,0
40623,20939,60461,0,0,60,60,0,1,0,1,0
40624,40834,50584,0,0,146,146,0,1,0,1,0
40625,53513,56205,0,0,62,62,0,1,0,1,0
40626,55553,37965,0,0,66,66,0,1,0,1,0
40627,27323,23117,0,0,146,146,0,1,0,1,0
40628,61862,445,0,0,70,70,0,1,0,1,0
40629,23126,35440,0,0,66,66,0,1,0,1,0
40630,61855,445,0,0,70,70,0,1,0,1,0
40631,61858,445,0,0,70,70,0,1,0,1,0
40632,19875,30170,0,0,145,145,0,1,0,1,0
40633,61408,30188,0,0,66,66,0,1,0,1,0
40634,56964,445,0,0,70,70,0,1,0,1,0
40635,57258,445,0,0,66,66,0,1,0,1,0
40636,56962,445,0,0,70,70,0,1,0,1,0
40637,39351,23,0,0,60,60,0,1,0,1,0
40638,60222,22114,0,0,62,62,0,1,0,1,0
40639,56961,445,0,0,70,70,0,1,0,1,0
40640,56960,445,0,0,70,70,0,1,0,1,0
40641,56959,445,0,0,70,70,0,1,0,1,0
40642,56957,445,0,0,70,70,0,1,0,1,0
40643,26900,27017,16696,27017,168,82,86,2,30,1,1
40644,5237,30128,2836,30128,621281,256,621025,881,49,5,876
40645,26900,27017,64848,27017,422,164,258,6,30,3,3
40646,37390,80,53231,80,78,78,0,1,5,1,0
40647,63855,29799,41914,29799,66,66,0,1,5,1,0
40648,26900,27017,27524,27017,422,164,258,6,30,3,3
40649,57255,443,56046,443,36865,3692,33173,61,47,30,31
40650,50613,80,39114,80,85306,4735,80571,120,22,55,65
40651,50660,80,5489,80,875,327,548,9,15,5,4
40652,26900,27017,46103,27017,422,164,258,6,30,3,3
40653,52669,443,6202,443,18814,2623,16191,54,25,26,28
40654,26900,27017,33807,27017,422,164,258,6,30,3,3
40655,60174,80,16526,80,1564,990,574,15,24,8,7
40656,51885,64546,64002,64546,70,70,0,2,8,2,0
40657,55649,42266,41427,42266,70,70,0,2,8,2,0
40658,53134,42369,45499,42369,70,70,0,2,8,2,0
40659,63856,6881,31846,6881,66,66,0,1,5,1,0
40660,56558,443,2694,443,7702,2155,5547,19,39,11,8
40661,42388,161,0,0,109,109,0,2,35,2,0
40662,50814,53,0,0,82,82,0,1,30,1,0
40663,54346,443,54346,443,4651,1744,2907,19,27,11,8
40664,49869,80,36356,80,43386,3876,39510,79,22,42,37
40665,57275,53,57275,53,217,86,131,2,30,1,1
40666,50968,443,5698,443,7532,3051,4481,13,120,6,7
40667,42460,443,50577,443,2907,1719,1188,17,361,9,8
40668,38611,443,14308,443,22215289,662818,21552471,25924,349,8862,17062
40669,58702,80,13752,80,2424,529,1895,11,75,6,5
40670,45523,443,20387,443,8636,1914,6722,31,95,16,15
40671,43028,443,42197,443,6748,1643,5105,26,138,14,12
40672,57843,443,8573,443,25053,19627,5426,38,76,23,15
40673,57894,443,47420,443,85263,3763,81500,115,216,46,69
40674,61489,443,14014,443,7299,4561,2738,32,193,16,16
40675,9061,80,4144,80,639,279,360,8,121,4,4
40676,51442,443,61245,443,4591,3237,1354,18,271,10,8
40677,41852,443,11364,443,22648,14673,7975,96,245,45,51
40678,56210,5228,6603,5228,7061,1730,5331,21,3600,11,10
40679,26900,27017,2558,27017,422,164,258,6,30,3,3
40680,55594,53,15652,53,202,83,119,2,31,1,1
40681,55767,443,58129,443,1786,172,1614,7,122,3,4
40682,57470,14435,56762,14435,1035,253,782,4,1200,2,2
40683,50265,45682,46008,45682,402,132,270,6,1209,3,3
40684,64085,443,64085,443,140818,8751,132067,156,168,57,99
40685,59278,443,45402,443,10495,9044,1451,29,35,18,11
40686,27005,27216,53096,27216,883,126,757,2,31,1,1
40687,49097,80,63676,80,1739,740,999,17,235,5,12
40688,45155,443,55125,443,4000,1726,2274,13,135,6,7
40689,59275,443,56019,443,242735602,5306961,237428641,238334,3604,81340,156994
40690,56954,445,0,0,70,70,0,1,0,1,0
40691,53971,55442,0,0,66,66,0,1,0,1,0
40692,59511,21247,0,0,66,66,0,1,0,1,0
40693,57250,445,0,0,66,66,0,1,0,1,0
40694,61839,445,0,0,70,70,0,1,0,1,0
40695,993,54748,0,0,66,66,0,1,0,1,0
40696,54000,53,0,0,202,86,116,2,30,1,1
40697,49453,443,59315,443,8251,2124,6127,21,16,11,10
40698,58831,443,5275,443,8004,2236,5768,41,18,23,18
40699,51884,22828,5463,22828,70,70,0,2,8,2,0
40700,50470,61463,0,0,86,86,0,1,0,1,0
40701,57247,445,0,0,66,66,0,1,0,1,0
40702,56941,445,0,0,70,70,0,1,0,1,0
40703,56940,445,0,0,70,70,0,1,0,1,0
40704,56938,445,0,0,70,70,0,1,0,1,0
40705,19096,64147,0,0,62,62,0,1,0,1,0
40706,56930,445,0,0,70,70,0,1,0,1,0
40707,56931,445,0,0,70,70,0,1,0,1,0
40708,57240,445,0,0,66,66,0,1,0,1,0
40709,51164,64147,0,0,62,62,0,1,0,1,0
40710,57235,445,0,0,66,66,0,1,0,1,0
40711,50442,37807,0,0,66,66,0,1,0,1,0
40712,8486,56205,0,0,66,66,0,1,0,1,0
40713,56919,445,0,0,70,70,0,1,0,1,0
40714,54778,22114,0,0,66,66,0,1,0,1,0
40715,49242,22114,0,0,62,62,0,1,0,1,0
40716,50137,1433,0,0,60,60,0,1,0,1,0
40717,61830,445,0,0,70,70,0,1,0,1,0
40718,61827,445,0,0,70,70,0,1,0,1,0
40719,61828,445,0,0,70,70,0,1,0,1,0
40720,56636,43890,0,0,66,66,0,1,0,1,0
40721,57222,445,0,0,66,66,0,1,0,1,0
40722,57217,445,0,0,66,66,0,1,0,1,0
40723,57221,445,0,0,66,66,0,1,0,1,0
40724,57223,445,0,0,66,66,0,1,0,1,0
40725,57225,445,0,0,66,66,0,1,0,1,0
40726,57220,445,0,0,66,66,0,1,0,1,0
40727,57218,445,0,0,66,66,0,1,0,1,0
40728,57224,445,0,0,66,66,0,1,0,1,0
40729,50470,61463,0,0,86,86,0,1,0,1,0
40730,15933,64147,0,0,62,62,0,1,0,1,0
40731,27272,64147,0,0,66,66,0,1,0,1,0
40732,59699,55783,0,0,62,62,0,1,0,1,0
40733,51745,57470,0,0,62,62,0,1,0,1,0
40734,56915,445,0,0,70,70,0,1,0,1,0
40735,50222,42873,0,0,66,66,0,1,0,1,0
40736,22922,35440,0,0,66,66,0,1,0,1,0
40737,58131,15503,0,0,146,146,0,1,0,1,0
40738,5617,64147,0,0,62,62,0,1,0,1,0
40739,65285,44847,0,0,146,146,0,1,0,1,0
40740,50529,44847,0,0,66,66,0,1,0,1,0
40741,61925,51505,0,0,62,62,0,1,0,1,0
40742,56906,445,0,0,70,70,0,1,0,1,0
40743,56904,445,0,0,70,70,0,1,0,1,0
40744,56903,445,0,0,70,70,0,1,0,1,0
40745,58501,44847,0,0,66,66,0,1,0,1,0
40746,56901,445,0,0,70,70,0,1,0,1,0
40747,52626,44847,0,0,66,66,0,1,0,1,0
40748,63938,3389,63938,3389,3364,1714,1650,15,32,8,7
40749,50988,80,43692,80,5956,1595,4361,17,19,10,7
40750,55747,53,47798,53,199,94,105,2,29,1,1
40751,58058,53,63439,53,168,78,90,2,29,1,1
40752,55760,443,60909,443,12723734,404530,12319204,13539,134,4494,9045
40753,34085,80,34085,80,490,264,226,8,140,5,3
40754,26900,27017,2675,27017,422,164,258,6,30,3,3
40755,42119,443,42119,443,9299,1697,7602,21,146,12,9
40756,36505,443,41059,443,6293,1501,4792,22,16,11,11
40757,56678,443,56425,443,7889,1900,5989,20,15,11,9
40758,26900,27017,59495,27017,422,164,258,6,30,3,3
40759,50986,80,14169,80,8074,2261,5813,22,19,13,9
40760,54437,80,15743,80,95298,61941,33357,182,929,95,87
40761,37780,443,60477,443,134,60,74,3,5,2,1
40762,44300,443,36814,443,7746,2015,5731,29,15,16,13
40763,50530,80,18434,80,3561,1337,2224,13,20,7,6
40764,63853,10659,8048,10659,70,70,0,1,4,1,0
40765,33922,443,8890,443,6084,1842,4242,26,329,14,12
40766,63854,16437,6082,16437,70,70,0,1,4,1,0
40767,27005,1107,18135,1107,824,126,698,2,29,1,1
40768,49937,80,61073,80,1130,613,517,11,15,6,5
40769,26900,27017,17453,27017,172,86,86,2,29,1,1
40770,27005,1304,58771,1304,859,126,733,2,29,1,1
40771,51880,8001,53470,8001,86,86,0,1,29,1,0
40772,52925,53,48232,53,168,78,90,2,29,1,1
40773,26900,27017,4107,27017,422,164,258,6,29,3,3
40774,51880,8000,3169,8000,172,94,78,2,29,1,1
40775,8358,80,8358,80,1875,567,1308,11,31,6,5
40776,7197,80,7197,80,450,246,204,8,31,5,3
40777,54797,80,8308,80,8957,4075,4882,32,416,17,15
40778,56634,80,24022,80,234,234,0,4,12,4,0
40779,60429,46854,20959,46854,70,70,0,1,5,1,0
40780,54828,443,1359,443,150,150,0,1,5,1,0
40781,51692,993,54748,993,11462,4282,7180,61,37,28,33
40782,60037,443,12655,443,6194,1289,4905,23,66,12,11
40783,46278,443,29099,443,6685,4843,1842,29,17,18,11
40784,63847,45598,22596,45598,376,254,122,6,15,4,2
40785,49943,53,23345,53,596,90,506,4,59,2,2
40786,26900,27017,44727,27017,422,164,258,6,30,3,3
40787,26900,27017,63917,27017,422,164,258,6,30,3,3
40788,33564,443,54838,443,314376,14130,300246,399,246,169,230
40789,56675,443,33305,443,7941,1952,5989,20,15,11,9
40790,49568,443,30225,443,6408,2531,3877,21,16,11,10
40791,49875,53,45365,53,445,94,351,2,30,1,1
40792,64577,443,50601,443,24686,1935,22751,36,16,17,19
40793,63875,43485,59709,43485,312,132,180,6,6,3,3
40794,50089,443,20398,443,292,172,120,4,15,2,2
40795,26900,27017,11839,27017,422,164,258,6,30,3,3
40796,49294,53,7678,53,287,94,193,2,30,1,1
40797,64505,53,32135,53,214,102,112,2,30,1,1
40798,51872,48108,27950,48108,70,70,0,1,5,1,0
40799,40980,443,52078,443,567854,22650,545204,713,158,311,402
40800,53375,53,19528,53,298,86,212,2,30,1,1
40801,46964,80,54750,80,1687,951,736,10,93,6,4
40802,55894,53,40691,53,216,102,114,2,30,1,1
40803,65169,53,4248,53,211,102,109,2,30,1,1
40804,55161,53,36813,53,197,94,103,2,30,1,1
40805,26900,27017,46394,27017,422,164,258,6,30,3,3
40806,56846,26665,12553,26665,70,70,0,2,8,2,0
40807,51870,40490,51955,40490,70,70,0,1,5,1,0
40808,53403,443,55979,443,38342,14090,24252,83,159,40,43
40809,50517,80,5050,80,502,256,246,9,25,5,4
40810,51548,80,13460,80,1861,1219,642,10,15,5,5
40811,49940,80,46739,80,1130,613,517,11,15,6,5
40812,56254,80,61838,80,1196,682,514,12,15,6,6
40813,26900,27017,28688,27017,422,164,258,6,30,3,3
40814,57731,53,26408,53,237,86,151,2,30,1,1
40815,26900,27017,53527,27017,254,82,172,4,30,2,2
40816,50394,443,24134,443,60424,4482,55942,101,686,39,62
40817,56677,443,24316,443,7941,1952,5989,20,15,11,9
40818,57804,443,57804,443,4378,1471,2907,19,26,11,8
40819,50984,80,27335,80,8706,2289,6417,22,19,13,9
40820,50987,80,34293,80,8047,2291,5756,22,19,13,9
40821,65278,53,33473,53,403,91,312,4,34,2,2
40822,38369,443,64342,443,434,226,208,7,28,4,3
40823,56676,443,53618,443,7889,1900,5989,20,15,11,9
40824,53132,443,46008,443,6515,1516,4999,23,16,12,11
40825,58547,53,0,0,86,86,0,1,29,1,0
40826,26900,27017,49129,27017,422,164,258,6,30,3,3
40827,50817,53,0,0,182,73,109,2,30,1,1
40828,36949,443,20544,443,7474,1298,6176,25,81,11,14
40829,61862,80,50297,80,9747,537,9210,14,16,6,8
40830,49205,443,49232,443,512444,20822,491622,555,159,191,364
40831,61049,53,17729,53,525,150,375,6,33,3,3
40832,60430,51413,49908,51413,70,70,0,1,5,1,0
40833,54347,443,29019,443,9976,3230,6746,22,58,13,9
40834,54279,443,54279,443,4699,1792,2907,19,28,11,8
40835,50516,80,41134,80,502,256,246,9,25,5,4
40836,26900,27017,30872,27017,422,164,258,6,29,3,3
40837,63578,5228,10061,5228,8544,2633,5911,51,154,28,23
40838,50512,80,4579,80,318,192,126,6,25,4,2
40839,26900,27017,12522,27017,422,164,258,6,30,3,3
40840,54000,53,38105,53,294,86,208,2,30,1,1
40841,26900,27017,60227,27017,422,164,258,6,30,3,3
40842,46189,443,46189,443,4398,1491,2907,19,30,11,8
40843,64817,53,59265,53,199,94,105,2,29,1,1
40844,58427,53,30619,53,197,94,103,2,30,1,1
40845,26900,27017,22476,27017,422,164,258,6,30,3,3
40846,57470,6881,12266,6881,453,251,202,4,1199,2,2
40847,55877,6380,28997,6380,149,149,0,2,1200,2,0
40848,52660,443,21035,443,5042,2002,3040,14,119,7,7
40849,19412,53,19412,53,229,98,131,2,30,1,1
40850,26900,27017,5951,27017,422,164,258,6,30,3,3
40851,26900,27017,3690,27017,422,164,258,6,30,3,3
40852,54978,53,3492,53,198,94,104,2,30,1,1
40853,49976,53,44388,53,245,110,135,2,30,1,1
40854,27005,1302,11338,1302,862,126,736,2,30,1,1
40855,27005,27015,49083,27015,872,126,746,2,30,1,1
40856,27005,1401,26580,1401,864,126,738,2,30,1,1
40857,49932,53,19133,53,237,86,151,2,30,1,1
40858,51091,53,0,0,325,75,250,2,30,1,1
40859,56224,53,54618,53,221,102,119,2,30,1,1
40860,56972,53,60729,53,301,126,175,2,30,1,1
40861,65145,53,64400,53,338,110,228,2,30,1,1
40862,42433,443,64701,443,6381,3801,2580,19,135,10,9
40863,62073,443,18581,443,7989,4098,3891,34,136,15,19
40864,41498,443,27057,443,2733,1555,1178,22,275,11,11
40865,57470,6881,1701,6881,453,251,202,4,1199,2,2
40866,27005,27272,38443,27272,887,126,761,2,30,1,1
40867,57430,80,9392,80,4509,2976,1533,13,15,6,7
40868,53378,443,65278,443,5090,1692,3398,19,82,11,8
40869,50510,80,5594,80,378,192,186,7,25,4,3
40870,17046,53,17046,53,220,90,130,2,30,1,1
40871,26900,27017,1204,27017,422,164,258,6,30,3,3
40872,49597,53,64001,53,216,102,114,2,30,1,1
40873,64975,53,43514,53,198,94,104,2,30,1,1
40874,54656,443,58488,443,6509,1635,4874,21,186,11,10
40875,37653,5223,42431,5223,142,142,0,1,5,1,0
40876,50513,80,33823,80,318,192,126,6,25,4,2
40877,49939,80,14388,80,1130,613,517,11,15,6,5
40878,49938,80,5232,80,1130,613,517,11,15,6,5
40879,50511,80,14463,80,318,192,126,6,25,4,2
40880,34313,53,0,0,184,86,98,2,30,1,1
40881,11236,53,11236,53,197,90,107,2,30,1,1
40882,36942,53,36942,53,197,90,107,2,30,1,1
40883,49903,443,11070,443,355761,14847,340914,423,33,183,240
40884,54846,53,32938,53,168,78,90,2,30,1,1
40885,64888,53,40321,53,767,102,665,2,30,1,1
40886,26900,27017,39625,27017,422,164,258,6,30,3,3
40887,61700,53,61700,53,221,90,131,2,30,1,1
40888,37748,80,57196,80,1090,609,481,13,329,7,6
40889,51437,443,45199,443,6286,1494,4792,22,16,11,11
40890,60277,443,60277,443,7428,729,6699,19,80,7,12
40891,58439,443,16787,443,232,172,60,3,5,2,1
40892,48462,80,48462,80,19738,890,18848,25,20,9,16
40893,50131,443,16533,443,12716,2575,10141,55,141,27,28
40894,56610,80,6975,80,1604,700,904,15,116,7,8
40895,64243,53,51060,53,258,102,156,2,30,1,1
40896,6881,13929,23344,13929,502,150,352,2,1200,1,1
40897,6881,25243,30519,25243,498,150,348,4,1273,2,2
40898,55732,53,56337,53,280,126,154,2,30,1,1
40899,60597,53,0,0,344,94,250,2,30,1,1
40900,64784,53,44632,53,195,102,93,2,30,1,1
40901,27005,1403,18731,1403,857,126,731,2,30,1,1
40902,56901,53,16725,53,264,94,170,2,31,1,1
40903,49583,443,53752,443,10877,2925,7952,56,285,23,33
40904,54970,443,62898,443,251620,16028,235592,353,371,159,194
40905,27005,1307,27385,1307,857,126,731,2,30,1,1
40906,64558,53,57812,53,321,102,219,2,31,1,1
40907,9057,443,55377,443,7769,3958,3811,17,121,9,8
40908,60206,443,52179,443,4706,2475,2231,13,120,7,6
40909,41787,443,37748,443,34237,22442,11795,86,131,41,45
40910,61113,443,60052,443,23915,14776,9139,66,136,35,31
40911,6881,31026,35308,31026,509,150,359,2,1199,1,1
40912,48817,11373,48817,11373,481,150,331,2,1200,1,1
40913,27005,1101,40896,1101,902,126,776,2,30,1,1
40914,63616,443,48346,443,1296,612,684,18,120,9,9
40915,60026,443,38651,443,3643,607,3036,13,120,6,7
40916,64510,443,61997,443,18370,2434,15936,26,120,11,15
40917,33654,443,14790,443,8628,2898,5730,20,144,9,11
40918,63992,443,1306,443,4360,2142,2218,15,120,7,8
40919,37965,39108,36972,39108,1056,1056,0,17,1550,17,0
40920,57470,6969,61511,6969,37677,7875,29802,115,3342,58,57
40921,54961,443,45503,443,25572,2605,22967,56,133,29,27
40922,51888,42529,42090,42529,316,136,180,6,6,3,3
40923,56691,443,48234,443,3986,2645,1341,18,18,10,8
40924,56692,443,32743,443,3932,2581,1351,18,18,10,8
40925,37570,443,52731,443,130,64,66,3,6,2,1
40926,40231,443,30990,443,10401,3375,7026,33,22,17,16
40927,56694,443,2147,443,3723,2372,1351,18,18,10,8
40928,56690,443,32613,443,3936,2585,1351,18,18,10,8
40929,50257,3389,50257,3389,3473,1518,1955,17,18,9,8
40930,56693,443,44446,443,3886,2545,1341,18,18,10,8
40931,50688,5222,59884,5222,402,342,60,2,15,1,1
40932,34170,80,4419,80,2865,2000,865,12,16,7,5
40933,55214,443,10396,443,10048,2128,7920,44,118,24,20
40934,53816,22114,0,0,146,146,0,1,0,1,0
40935,61818,445,0,0,70,70,0,1,0,1,0
40936,61813,445,0,0,70,70,0,1,0,1,0
40937,61811,445,0,0,70,70,0,1,0,1,0
40938,56898,445,0,0,70,70,0,1,0,1,0
40939,57205,445,0,0,66,66,0,1,0,1,0
40940,57203,445,0,0,66,66,0,1,0,1,0
40941,57202,445,0,0,66,66,0,1,0,1,0
40942,61810,445,0,0,70,70,0,1,0,1,0
40943,58888,23718,0,0,66,66,0,1,0,1,0
40944,61808,445,0,0,70,70,0,1,0,1,0
40945,443,48346,0,0,81,81,0,1,0,1,0
40946,56892,445,0,0,70,70,0,1,0,1,0
40947,61803,445,0,0,70,70,0,1,0,1,0
40948,61800,445,0,0,70,70,0,1,0,1,0
40949,61802,445,0,0,70,70,0,1,0,1,0
40950,9528,44847,0,0,146,146,0,1,0,1,0
40951,61563,37807,0,0,66,66,0,1,0,1,0
40952,56885,445,0,0,70,70,0,1,0,1,0
40953,13911,57470,0,0,60,60,0,1,0,1,0
40954,12128,37965,0,0,62,62,0,1,0,1,0
40955,56882,445,0,0,70,70,0,1,0,1,0
40956,56127,35440,0,0,62,62,0,1,0,1,0
40957,65096,37807,0,0,66,66,0,1,0,1,0
40958,54489,53,0,0,232,77,155,2,2,1,1
40959,61787,445,0,0,70,70,0,1,0,1,0
40960,61788,445,0,0,70,70,0,1,0,1,0
40961,61784,445,0,0,70,70,0,1,0,1,0
40962,9327,57470,0,0,62,62,0,1,0,1,0
40963,56879,445,0,0,70,70,0,1,0,1,0
40964,56877,445,0,0,70,70,0,1,0,1,0
40965,60462,47967,0,0,148,148,0,1,0,1,0
40966,56873,445,0,0,70,70,0,1,0,1,0
40967,60248,30188,0,0,62,62,0,1,0,1,0
40968,52672,22114,0,0,146,146,0,1,0,1,0
40969,50713,57470,0,0,62,62,0,1,0,1,0
40970,57649,6881,0,0,62,62,0,1,0,1,0
40971,56872,445,0,0,70,70,0,1,0,1,0
40972,57182,445,0,0,66,66,0,1,0,1,0
40973,61781,445,0,0,70,70,0,1,0,1,0
40974,61779,445,0,0,70,70,0,1,0,1,0
40975,59611,56205,0,0,66,66,0,1,0,1,0
40976,62150,23718,0,0,66,66,0,1,0,1,0
40977,15854,50584,0,0,62,62,0,1,0,1,0
40978,56867,445,0,0,70,70,0,1,0,1,0
40979,12074,10197,0,0,72,72,0,1,0,1,0
40980,57176,445,0,0,66,66,0,1,0,1,0
40981,58341,10197,0,0,78,78,0,1,0,1,0
40982,57173,445,0,0,66,66,0,1,0,1,0
40983,40161,443,23210,443,13459,1604,11855,27,66,14,13
40984,61769,445,0,0,70,70,0,1,0,1,0
40985,49644,30188,0,0,66,66,0,1,0,1,0
40986,1038,37965,0,0,62,62,0,1,0,1,0
40987,61764,445,0,0,70,70,0,1,0,1,0
40988,61761,445,0,0,70,70,0,1,0,1,0
40989,61760,445,0,0,70,70,0,1,0,1,0
40990,57169,445,0,0,66,66,0,1,0,1,0
40991,65285,50584,0,0,66,66,0,1,0,1,0
40992,63098,35440,0,0,66,66,0,1,0,1,0
40993,10427,32480,0,0,66,66,0,1,0,1,0
40994,65317,51221,0,0,78,78,0,1,0,1,0
40995,26969,29434,0,0,146,146,0,1,0,1,0
40996,61755,445,0,0,70,70,0,1,0,1,0
40997,56854,445,0,0,70,70,0,1,0,1,0
40998,61751,445,0,0,70,70,0,1,0,1,0
40999,61750,445,0,0,70,70,0,1,0,1,0
41000,61748,445,0,0,70,70,0,1,0,1,0
41001,57162,445,0,0,66,66,0,1,0,1,0
41002,30169,35776,0,0,159,159,0,1,0,1,0
41003,57158,445,0,0,66,66,0,1,0,1,0
41004,57157,445,0,0,66,66,0,1,0,1,0
41005,57156,445,0,0,66,66,0,1,0,1,0
41006,56851,445,0,0,70,70,0,1,0,1,0
41007,26729,57470,0,0,66,66,0,1,0,1,0
41008,57153,445,0,0,66,66,0,1,0,1,0
41009,57152,445,0,0,66,66,0,1,0,1,0
41010,57151,445,0,0,66,66,0,1,0,1,0
41011,61404,52700,0,0,72,72,0,1,0,1,0
41012,58424,52700,0,0,66,66,0,1,0,1,0
41013,51320,44847,0,0,66,66,0,1,0,1,0
41014,64276,26467,0,0,66,66,0,1,0,1,0
41015,61743,445,0,0,70,70,0,1,0,1,0
41016,61742,445,0,0,70,70,0,1,0,1,0
41017,61741,445,0,0,70,70,0,1,0,1,0
41018,59509,64147,0,0,62,62,0,1,0,1,0
41019,56846,445,0,0,70,70,0,1,0,1,0
41020,57148,445,0,0,66,66,0,1,0,1,0
41021,61739,445,0,0,70,70,0,1,0,1,0
41022,30016,36237,0,0,62,62,0,1,0,1,0
41023,56845,445,0,0,70,70,0,1,0,1,0
41024,57146,445,0,0,66,66,0,1,0,1,0
41025,60052,37965,0,0,66,66,0,1,0,1,0
41026,56843,445,0,0,70,70,0,1,0,1,0
41027,57142,445,0,0,66,66,0,1,0,1,0
41028,57143,445,0,0,66,66,0,1,0,1,0
41029,48840,50584,0,0,146,146,0,1,0,1,0
41030,57140,445,0,0,66,66,0,1,0,1,0
41031,2681,48817,0,0,146,146,0,1,0,1,0
41032,65265,55067,0,0,66,66,0,1,0,1,0
41033,61738,445,0,0,70,70,0,1,0,1,0
41034,34311,5900,0,0,60,60,0,1,0,1,0
41035,49807,443,23954,443,2796,1730,1066,15,126,9,6
41036,49911,80,3385,80,1519,787,732,10,110,6,4
41037,62325,443,62325,443,1210,637,573,14,51,7,7
41038,49761,80,17829,80,2113,1181,932,10,127,6,4
41039,49712,443,1489,443,11365,1278,10087,23,131,10,13
41040,49750,443,8728,443,7370,1474,5896,19,128,10,9
41041,59219,80,51900,80,1658,1344,314,10,15,5,5
41042,49639,443,37506,443,7521,2117,5404,22,89,12,10
41043,49765,443,44439,443,17982,2337,15645,34,127,16,18
41044,49760,80,15959,80,2113,1181,932,10,127,6,4
41045,49805,443,42807,443,2839,1654,1185,15,126,9,6
41046,49808,443,22176,443,1101,654,447,12,126,7,5
41047,43184,80,44137,80,1972,1464,508,15,16,7,8
41048,55177,80,55177,80,374,240,134,7,15,5,2
41049,57911,443,43527,443,9662,4079,5583,66,194,30,36
41050,49706,443,36455,443,32941,1850,31091,46,131,19,27
41051,49803,80,1813,80,2553,1621,932,13,126,8,5
41052,49746,443,2591,443,54014,2565,51449,65,128,24,41
41053,48837,53,7815,53,198,93,105,2,30,1,1
41054,57078,3389,57078,3389,3407,1518,1889,16,17,9,7
41055,62328,443,62328,443,1210,637,573,14,51,7,7
41056,43309,80,55504,80,805,665,140,6,32,4,2
41057,49813,443,15951,443,10103,3140,6963,29,126,16,13
41058,55176,80,55176,80,374,240,134,7,15,5,2
41059,49769,443,60646,443,14166,2015,12151,27,127,11,16
41060,49277,80,55324,80,254,128,126,5,16,3,2
41061,49762,80,8921,80,2114,1182,932,10,127,6,4
41062,51145,80,51145,80,33072,3959,29113,40,46,14,26
41063,49774,443,35552,443,26623,5756,20867,42,126,18,24
41064,55178,80,55178,80,374,240,134,7,15,5,2
41065,49749,443,40981,443,7398,1597,5801,20,128,10,10
41066,49246,443,11384,443,29705,9203,20502,41,18,21,20
41067,51760,443,1508,443,1569,1044,525,14,94,9,5
41068,57913,443,36692,443,10457,4216,6241,70,194,31,39
41069,49718,80,57630,80,11291,1348,9943,17,131,6,11
41070,49811,443,7864,443,7551,2453,5098,22,126,12,10
41071,62329,443,62329,443,1210,637,573,14,51,7,7
41072,49912,80,32939,80,1590,858,732,10,110,6,4
41073,57596,80,43063,80,1231,726,505,10,18,6,4
41074,62327,443,62327,443,1210,637,573,14,51,7,7
41075,60681,443,60681,443,5667,1393,4274,19,16,9,10
41076,35894,53,14493,53,198,93,105,2,30,1,1
41077,57597,443,32556,443,12528,7238,5290,26,91,15,11
41078,62962,443,7055,443,5036,2564,2472,15,125,8,7
41079,30960,45724,8617,45724,330,330,0,6,3609,6,0
41080,65415,443,12568,443,2494,1643,851,17,26,9,8
41081,56527,53,0,0,206,83,123,2,31,1,1
41082,42601,443,30864,443,10845900,123386,10722514,8862,139,1081,7781
41083,45941,23386,0,0,60,60,0,1,0,1,0
41084,61729,445,0,0,70,70,0,1,0,1,0
41085,61723,445,0,0,70,70,0,1,0,1,0
41086,56836,445,0,0,70,70,0,1,0,1,0
41087,56834,445,0,0,70,70,0,1,0,1,0
41088,9283,57470,0,0,66,66,0,1,0,1,0
41089,54099,80,63919,80,214,140,74,4,15,3,1
41090,37780,443,37780,443,4294,695,3599,15,20,8,7
41091,49748,443,24833,443,7084,1703,5381,19,128,10,9
41092,50338,443,61638,443,6441,1651,4790,22,53,12,10
41093,49782,443,2557,443,7757,1997,5760,23,126,13,10
41094,57129,445,0,0,66,66,0,1,0,1,0
41095,57987,56125,0,0,90,90,0,1,0,1,0
41096,56833,445,0,0,70,70,0,1,0,1,0
41097,56832,445,0,0,70,70,0,1,0,1,0
41098,56831,445,0,0,70,70,0,1,0,1,0
41099,56825,445,0,0,70,70,0,1,0,1,0
41100,56828,445,0,0,70,70,0,1,0,1,0
41101,33896,57470,0,0,74,74,0,1,0,1,0
41102,57131,26296,0,0,145,145,0,1,0,1,0
41103,55565,64147,0,0,66,66,0,1,0,1,0
41104,13281,51050,0,0,62,62,0,1,0,1,0
41105,51324,11392,0,0,66,66,0,1,0,1,0
41106,54210,36237,0,0,62,62,0,1,0,1,0
41107,57122,445,0,0,66,66,0,1,0,1,0
41108,61711,445,0,0,70,70,0,1,0,1,0
41109,63447,44847,0,0,62,62,0,1,0,1,0
41110,56256,62413,0,0,62,62,0,1,0,1,0
41111,61242,35253,0,0,66,66,0,1,0,1,0
41112,13462,35440,0,0,62,62,0,1,0,1,0
41113,56811,445,0,0,70,70,0,1,0,1,0
41114,56810,445,0,0,70,70,0,1,0,1,0
41115,443,21255,0,0,66,66,0,1,0,1,0
41116,45964,55559,0,0,60,60,0,1,0,1,0
41117,56806,445,0,0,70,70,0,1,0,1,0
41118,59364,44847,0,0,66,66,0,1,0,1,0
41119,56800,445,0,0,70,70,0,1,0,1,0
41120,56801,445,0,0,70,70,0,1,0,1,0
41121,56646,48817,0,0,62,62,0,1,0,1,0
41122,61945,48817,0,0,66,66,0,1,0,1,0
41123,57120,445,0,0,66,66,0,1,0,1,0
41124,41282,53,19391,53,168,78,90,2,30,1,1
41125,56744,53,53021,53,274,110,164,2,30,1,1
41126,49951,53,52674,53,525,110,415,2,30,1,1
41127,57470,41813,46944,41813,519,166,353,2,1200,1,1
41128,15503,48319,24114,48319,481,150,331,2,1199,1,1
41129,49816,443,49816,443,4682,1775,2907,19,28,11,8
41130,61407,443,61407,443,4552,1645,2907,19,26,11,8
41131,56695,443,49657,443,3874,2523,1351,18,17,10,8
41132,49777,443,39129,443,8638,2215,6423,24,126,14,10
41133,64784,53,28832,53,195,102,93,2,29,1,1
41134,57470,18634,6347,18634,594,594,0,10,1199,10,0
41135,49828,443,43122,443,7284,1353,5931,26,186,14,12
41136,53237,443,24814,443,33472,16066,17406,57,48,29,28
41137,42156,80,29548,80,891,536,355,10,255,6,4
41138,51612,443,45282,443,6777,3431,3346,27,15,14,13
41139,53693,26515,52761,26515,70,70,0,2,7,2,0
41140,63846,80,10554,80,314,192,122,6,15,4,2
41141,51465,443,37534,443,318,70,248,5,17,1,4
41142,51443,443,10966,443,1048,1048,0,9,16,9,0
41143,48187,443,22685,443,1515,568,947,14,82,6,8
41144,51690,993,38356,993,15022,5202,9820,113,36,53,60
41145,55179,80,55179,80,374,240,134,7,15,5,2
41146,49747,443,22101,443,7087,1705,5382,19,128,10,9
41147,49714,80,42166,80,2096,1011,1085,11,130,6,5
41148,65173,53,61112,53,508,186,322,6,51,3,3
41149,49527,53,42526,53,268,94,174,2,29,1,1
41150,27005,27015,16145,27015,879,126,753,2,29,1,1
41151,50509,80,1536,80,49872,11098,38774,65,24,27,38
41152,49775,80,20586,80,1302,849,453,10,126,6,4
41153,49711,443,12474,443,18088,1844,16244,34,130,14,20
41154,49779,443,29819,443,10057,1887,8170,23,126,12,11
41155,49838,443,6189,443,8555,1821,6734,24,123,13,11
41156,54654,6881,17557,6881,470,348,122,6,26,4,2
41157,59001,80,22174,80,1266,383,883,16,393,4,12
41158,36513,443,42006,443,4216,2615,1601,26,80,13,13
41159,62326,443,62326,443,1210,637,573,14,51,7,7
41160,51461,443,45147,443,318,70,248,5,17,1,4
41161,55733,53,46441,53,463,128,335,4,41,2,2
41162,51867,48059,47188,48059,160,70,90,2,5,1,1
41163,49740,443,61794,443,7554,2281,5273,22,129,13,9
41164,49766,443,21804,443,12026,1450,10576,27,127,12,15
41165,49741,443,56871,443,6060,1553,4507,18,129,10,8
41166,49738,443,60730,443,5572,1446,4126,17,129,10,7
41167,49786,443,41630,443,10079,2855,7224,23,126,12,11
41168,49715,443,3770,443,7681,1658,6023,21,130,11,10
41169,49716,443,11903,443,9323,3144,6179,24,130,14,10
41170,49809,443,59332,443,83683,2747,80936,92,125,32,60
41171,49700,80,32872,80,56411,2447,53964,58,130,19,39
41172,49801,443,19605,443,44380,1589,42791,48,126,14,34
41173,49743,443,63725,443,157156,3872,153284,160,128,48,112
41174,49736,443,65019,443,52574,2783,49791,61,129,19,42
41175,49745,443,54598,443,4043,1781,2262,19,128,11,8
41176,49791,443,8451,443,6057,767,5290,16,126,8,8
41177,62732,443,28854,443,50000,36438,13562,98,336,61,37
41178,49719,443,9783,443,40332,2476,37856,57,130,26,31
41179,35452,443,39555,443,5120,3761,1359,21,49,12,9
41180,49710,443,57720,443,9772,1954,7818,23,130,12,11
41181,54926,6789,33904,6789,124239,48650,75589,1342,84,628,714
41182,64772,53,64772,53,241,98,143,2,30,1,1
41183,49834,443,28335,443,9890,4516,5374,26,124,14,12
41184,49835,443,4788,443,10066,4676,5390,27,123,15,12
41185,65232,53,42020,53,311,94,217,2,30,1,1
41186,55411,53,35188,53,200,94,106,2,30,1,1
41187,49183,53,43011,53,592,198,394,6,78,3,3
41188,48189,443,41896,443,1343,616,727,14,82,7,7
41189,51868,30305,17475,30305,70,70,0,1,5,1,0
41190,33858,443,46476,443,12017,2031,9986,38,216,18,20
41191,49778,443,56574,443,10105,1951,8154,24,126,13,11
41192,49727,443,62181,443,1461,761,700,15,130,8,7
41193,65052,53,65052,53,240,98,142,2,30,1,1
41194,41321,443,40754,443,6989232,188564,6800668,7110,288,2412,4698
41195,56076,53,58265,53,311,94,217,2,30,1,1
41196,34306,53,34306,53,241,98,143,2,30,1,1
41197,49981,53,18517,53,200,94,106,2,30,1,1
41198,50288,443,59061,443,8207,2558,5649,41,80,23,18
41199,49702,80,20428,80,2014,1216,798,13,130,8,5
41200,49780,80,65003,80,1429,931,498,10,126,6,4
41201,49783,443,33987,443,10095,2871,7224,23,126,12,11
41202,49836,443,16827,443,6611,2169,4442,20,123,12,8
41203,49812,443,57189,443,6503,2037,4466,24,125,13,11
41204,49763,443,64834,443,8439,1840,6599,21,127,11,10
41205,55142,443,55142,443,4480,555,3925,11,20,6,5
41206,64272,53,63528,53,626,190,436,6,60,3,3
41207,57167,53,41895,53,195,102,93,2,30,1,1
41208,56659,53,34690,53,199,94,105,2,30,1,1
41209,9047,443,22557,443,3645,609,3036,13,120,6,7
41210,57150,53,63337,53,286,97,189,4,47,2,2
41211,49810,80,21965,80,1469,979,490,10,125,6,4
41212,41133,443,38649,443,6964782,246690,6718092,7203,184,2494,4709
41213,49815,443,20999,443,3964,780,3184,14,125,8,6
41214,42186,443,43705,443,10165,2433,7732,19,49,10,9
41215,63590,443,25710,443,6187,933,5254,18,147,10,8
41216,53912,443,53912,443,4447,1540,2907,19,30,11,8
41217,44890,443,40961,443,2134,1397,737,18,1162,10,8
41218,56674,443,42391,443,7889,1900,5989,20,15,11,9
41219,52077,443,25258,443,6317,2196,4121,19,15,10,9
41220,56842,24233,12414,24233,70,70,0,2,8,2,0
41221,49795,443,22996,443,7243,777,6466,17,126,8,9
41222,10165,80,10165,80,6714,929,5785,17,33,8,9
41223,49826,443,35074,443,5635,1599,4036,19,125,11,8
41224,56696,443,27730,443,3140,1782,1358,18,17,10,8
41225,48509,443,53083,443,4922,950,3972,17,34,10,7
41226,41685,161,0,0,109,109,0,2,34,2,0
41227,55174,80,55174,80,374,240,134,7,15,5,2
41228,49701,80,18933,80,6132,634,5498,13,130,6,7
41229,58682,443,48693,443,5061,876,4185,16,70,8,8
41230,49490,53,6765,53,364,92,272,4,38,2,2
41231,14394,443,16776,443,4649,2928,1721,40,415,21,19
41232,49806,443,11715,443,37255,2202,35053,46,125,17,29
41233,41487,443,27679,443,7112,5916,1196,20,30,10,10
41234,49717,443,12194,443,20576,8959,11617,42,130,24,18
41235,62730,443,41025,443,12539,6472,6067,81,406,37,44
41236,49790,80,49818,80,1769,1271,498,10,126,6,4
41237,49731,80,40624,80,318,192,126,6,130,4,2
41238,34767,443,6327,443,6313,1368,4945,21,846,11,10
41239,49788,443,22621,443,74171,1888,72283,72,126,18,54
41240,49734,80,8310,80,88983,2379,86604,92,129,30,62
41241,60425,60425,17270,60425,1728,1031,697,14,17,8,6
41242,27005,1402,23160,1402,870,126,744,2,29,1,1
41243,49817,443,20632,443,4504,839,3665,16,125,8,8
41244,48186,443,28155,443,1947,688,1259,18,82,8,10
41245,37462,53,30454,53,207,86,121,2,30,1,1
41246,46384,443,46384,443,4594,1687,2907,19,30,11,8
41247,56306,53,41144,53,228,94,134,2,30,1,1
41248,34995,443,34995,443,1542,489,1053,8,20,5,3
41249,60597,53,0,0,344,94,250,2,29,1,1
41250,57470,22646,6893,22646,353,166,187,2,1200,1,1
41251,64944,53,42030,53,228,94,134,2,30,1,1
41252,50975,53,27923,53,199,94,105,2,30,1,1
41253,22583,53,22583,53,213,82,131,2,30,1,1
41254,55638,53,61828,53,184,86,98,2,30,1,1
41255,57167,53,27604,53,195,102,93,2,30,1,1
41256,46385,53,10375,53,199,94,105,2,30,1,1
41257,54320,27016,15570,27016,924,924,0,3,30,3,0
41258,52883,53,22567,53,339,94,245,2,30,1,1
41259,47037,80,10159,80,613,539,74,7,15,6,1
41260,38897,443,50921,443,11019,4204,6815,23,49,13,10
41261,51869,25355,56016,25355,70,70,0,1,5,1,0
41262,49767,443,22404,443,11883,1419,10464,26,127,11,15
41263,49735,443,18914,443,1143,672,471,12,129,7,5
41264,49792,443,3776,443,6089,799,5290,16,126,8,8
41265,49781,443,43148,443,7877,1949,5928,24,126,12,12
41266,49794,443,25276,443,7307,841,6466,18,126,9,9
41267,39762,443,10128,443,9264,2848,6416,31,100,16,15
41268,49804,443,24644,443,5938,1521,4417,20,125,10,10
41269,49837,443,60962,443,9634,2232,7402,24,123,12,12
41270,49764,443,53395,443,7128,865,6263,19,127,9,10
41271,58536,53,40631,53,522,162,360,6,64,3,3
41272,55595,443,57179,443,448,166,282,2,30,1,1
41273,58302,443,57426,443,4568,2059,2509,17,33,9,8
41274,56673,443,15225,443,7941,1952,5989,20,15,11,9
41275,39820,443,46872,443,2190,1249,941,23,26,12,11
41276,51882,15733,38796,15733,70,70,0,2,8,2,0
41277,49742,443,32248,443,4490,750,3740,16,128,8,8
41278,49785,443,35177,443,7757,1949,5808,22,126,12,10
41279,49732,80,4505,80,2052,711,1341,10,130,6,4
41280,49787,443,47487,443,34175,1680,32495,42,126,15,27
41281,49713,80,27859,80,5029,1986,3043,16,130,8,8
41282,56672,443,28399,443,7888,1899,5989,20,15,11,9
41283,39814,443,9384,443,5761,3561,2200,45,51,23,22
41284,54685,53,54685,53,832,106,726,2,30,1,1
41285,55768,443,42706,443,5263,2534,2729,16,120,8,8
41286,27005,27212,63313,27212,889,126,763,2,30,1,1
41287,56615,443,28312,443,4425,2899,1526,24,34,14,10
41288,49768,443,40344,443,12934,1419,11515,27,127,11,16
41289,50999,443,48896,443,33716,17750,15966,134,329,72,62
41290,57948,443,51203,443,6885,3239,3646,53,190,24,29
41291,59480,443,64952,443,5058,2667,2391,25,92,13,12
41292,49737,443,56529,443,5566,1444,4122,17,129,10,7
41293,49784,443,6049,443,7805,1949,5856,22,126,12,10
41294,64335,53,51507,53,293,95,198,4,46,2,2
41295,64222,53,1206,53,264,94,170,2,30,1,1
41296,6881,35045,1586,35045,475,150,325,2,1200,1,1
41297,61569,53,2254,53,211,78,133,2,30,1,1
41298,55829,53,23534,53,168,78,90,2,30,1,1
41299,64706,27065,4529,27065,924,924,0,3,30,3,0
41300,56707,443,58509,443,40263,17490,22773,75,403,35,40
41301,15503,7750,61935,7750,858,858,0,14,1200,14,0
41302,34878,53,44059,53,339,94,245,2,30,1,1
41303,53260,53,10585,53,199,94,105,2,30,1,1
41304,57008,53,37986,53,255,110,145,2,30,1,1
41305,27005,27237,36473,27237,876,126,750,2,30,1,1
41306,49737,53,34228,53,184,86,98,2,31,1,1
41307,55312,53,28336,53,195,102,93,2,31,1,1
41308,55766,443,53751,443,1864,250,1614,8,120,4,4
41309,37580,443,41939,443,24810,10597,14213,51,123,22,29
41310,57470,13551,21268,13551,761,166,595,2,1200,1,1
41311,57470,21178,29997,21178,166,166,0,1,1200,1,0
41312,27005,27268,57130,27268,884,126,758,2,30,1,1
41313,57470,6889,19938,6889,546,166,380,2,1200,1,1
41314,8979,443,54799,443,62149740,2002795,60146945,62894,211,19380,43514
41315,56845,27201,52716,27201,316,136,180,6,7,3,3
41316,57582,443,57582,443,2506,1461,1045,21,88,10,11
41317,48188,443,44045,443,1263,536,727,13,82,6,7
41318,11296,443,11296,443,1311,782,529,12,23,7,5
41319,53666,50321,61664,50321,736,490,246,8,17,4,4
41320,9073,443,37513,443,4187235,99258,4087977,4375,28,1464,2911
41321,38087,443,27935,443,6147,910,5237,18,100,10,8
41322,56671,443,59090,443,7940,1951,5989,20,16,11,9
41323,57641,80,57641,80,35197,3040,32157,40,32,14,26
41324,63869,34368,47992,34368,66,66,0,2,8,2,0
41325,11319,443,11319,443,179461,16904,162557,220,36,105,115
41326,11992,443,11992,443,12020,5977,6043,38,30,23,15
41327,11028,443,11028,443,6671,3244,3427,26,30,16,10
41328,10886,51505,0,0,62,62,0,1,0,1,0
41329,37343,21247,0,0,62,62,0,1,0,1,0
41330,443,48346,0,0,81,81,0,1,0,1,0
41331,993,38356,0,0,66,66,0,1,0,1,0
41332,27785,37965,0,0,66,66,0,1,0,1,0
41333,57111,445,0,0,66,66,0,1,0,1,0
41334,59668,51505,0,0,66,66,0,1,0,1,0
41335,57109,445,0,0,66,66,0,1,0,1,0
41336,51413,48637,0,0,72,72,0,1,0,1,0
41337,50674,35440,0,0,146,146,0,1,0,1,0
41338,50637,44847,0,0,62,62,0,1,0,1,0
41339,46662,36237,0,0,62,62,0,1,0,1,0
41340,56789,445,0,0,70,70,0,1,0,1,0
41341,65285,44847,0,0,62,62,0,1,0,1,0
41342,52720,35894,0,0,62,62,0,1,0,1,0
41343,50470,61463,0,0,86,86,0,1,0,1,0
41344,50716,50584,0,0,70,70,0,1,0,1,0
41345,61701,445,0,0,70,70,0,1,0,1,0
41346,61702,445,0,0,70,70,0,1,0,1,0
41347,61700,445,0,0,70,70,0,1,0,1,0
41348,40474,23117,0,0,146,146,0,1,0,1,0
41349,1441,51221,0,0,62,62,0,1,0,1,0
41350,11478,51221,0,0,66,66,0,1,0,1,0
41351,57092,445,0,0,66,66,0,1,0,1,0
41352,62029,22114,0,0,66,66,0,1,0,1,0
41353,57090,445,0,0,66,66,0,1,0,1,0
41354,57097,445,0,0,66,66,0,1,0,1,0
41355,57094,445,0,0,66,66,0,1,0,1,0
41356,57095,445,0,0,66,66,0,1,0,1,0
41357,57096,445,0,0,66,66,0,1,0,1,0
41358,57093,445,0,0,66,66,0,1,0,1,0
41359,57091,445,0,0,66,66,0,1,0,1,0
41360,56835,35894,0,0,66,66,0,1,0,1,0
41361,56785,445,0,0,70,70,0,1,0,1,0
41362,27783,57470,0,0,62,62,0,1,0,1,0
41363,35261,15503,0,0,74,74,0,1,0,1,0
41364,58672,43890,0,0,66,66,0,1,0,1,0
41365,56773,445,0,0,70,70,0,1,0,1,0
41366,56775,445,0,0,70,70,0,1,0,1,0
41367,56776,445,0,0,70,70,0,1,0,1,0
41368,56772,445,0,0,70,70,0,1,0,1,0
41369,56768,445,0,0,70,70,0,1,0,1,0
41370,28754,50584,0,0,66,66,0,1,0,1,0
41371,61696,445,0,0,70,70,0,1,0,1,0
41372,61691,445,0,0,70,70,0,1,0,1,0
41373,61683,445,0,0,70,70,0,1,0,1,0
41374,62068,64147,0,0,66,66,0,1,0,1,0
41375,59564,57470,0,0,66,66,0,1,0,1,0
41376,42379,443,23985,443,499,425,74,4,0,3,1
41377,20400,64147,0,0,62,62,0,1,0,1,0
41378,57074,445,0,0,66,66,0,1,0,1,0
41379,57076,445,0,0,66,66,0,1,0,1,0
41380,57075,445,0,0,66,66,0,1,0,1,0
41381,65515,22114,0,0,66,66,0,1,0,1,0
41382,13911,57470,0,0,60,60,0,1,0,1,0
41383,3996,57470,0,0,62,62,0,1,0,1,0
41384,52989,51505,0,0,66,66,0,1,0,1,0
41385,61682,445,0,0,70,70,0,1,0,1,0
41386,25348,23,0,0,60,60,0,1,0,1,0
41387,64903,51050,0,0,62,62,0,1,0,1,0
41388,23770,50584,0,0,62,62,0,1,0,1,0
41389,48706,23393,0,0,60,60,0,1,0,1,0
41390,19245,64147,0,0,66,66,0,1,0,1,0
41391,56763,445,0,0,70,70,0,1,0,1,0
41392,59874,22114,0,0,146,146,0,1,0,1,0
41393,61679,445,0,0,70,70,0,1,0,1,0
41394,34193,17,0,0,60,60,0,1,0,1,0
41395,45344,443,7513,443,2593,1394,1199,20,13,11,9
41396,48230,57866,0,0,146,146,0,1,0,1,0
41397,61669,445,0,0,70,70,0,1,0,1,0
41398,61672,445,0,0,70,70,0,1,0,1,0
41399,61671,445,0,0,70,70,0,1,0,1,0
41400,63867,64147,0,0,62,62,0,1,0,1,0
41401,57987,56125,0,0,90,90,0,1,0,1,0
41402,56755,445,0,0,70,70,0,1,0,1,0
41403,56754,445,0,0,70,70,0,1,0,1,0
41404,23969,57470,0,0,62,62,0,1,0,1,0
41405,443,48346,0,0,81,81,0,1,0,1,0
41406,15875,50584,0,0,62,62,0,1,0,1,0
41407,56748,445,0,0,70,70,0,1,0,1,0
41408,8889,33698,0,0,60,60,0,1,0,1,0
41409,56747,445,0,0,70,70,0,1,0,1,0
41410,58226,52848,0,0,62,62,0,1,0,1,0
41411,61662,445,0,0,70,70,0,1,0,1,0
41412,61661,445,0,0,70,70,0,1,0,1,0
41413,61659,445,0,0,70,70,0,1,0,1,0
41414,1972,57470,0,0,78,78,0,1,0,1,0
41415,60426,57470,0,0,62,62,0,1,0,1,0
41416,8297,37965,0,0,62,62,0,1,0,1,0
41417,26085,51221,0,0,72,72,0,1,0,1,0
41418,48258,37965,0,0,62,62,0,1,0,1,0
41419,56743,445,0,0,70,70,0,1,0,1,0
41420,49305,57470,0,0,66,66,0,1,0,1,0
41421,56742,445,0,0,70,70,0,1,0,1,0
41422,57874,26467,0,0,62,62,0,1,0,1,0
41423,13285,29892,0,0,145,145,0,1,0,1,0
41424,57054,445,0,0,66,66,0,1,0,1,0
41425,13285,29892,0,0,145,145,0,1,0,1,0
41426,61653,445,0,0,70,70,0,1,0,1,0
41427,61652,445,0,0,70,70,0,1,0,1,0
41428,12226,37965,0,0,62,62,0,1,0,1,0
41429,53966,57470,0,0,62,62,0,1,0,1,0
41430,49977,57470,0,0,62,62,0,1,0,1,0
41431,45099,57470,0,0,62,62,0,1,0,1,0
41432,60423,35440,0,0,62,62,0,1,0,1,0
41433,443,32698,0,0,89,89,0,1,0,1,0
41434,56737,445,0,0,70,70,0,1,0,1,0
41435,52976,31573,0,0,66,66,0,1,0,1,0
41436,63288,52848,0,0,66,66,0,1,0,1,0
41437,55386,37965,0,0,66,66,0,1,0,1,0
41438,35558,15503,0,0,66,66,0,1,0,1,0
41439,65317,51221,0,0,78,78,0,1,0,1,0
41440,443,48346,0,0,81,81,0,1,0,1,0
41441,46518,44847,0,0,62,62,0,1,0,1,0
41442,10036,44847,0,0,66,66,0,1,0,1,0
41443,55375,44847,0,0,66,66,0,1,0,1,0
41444,57049,445,0,0,66,66,0,1,0,1,0
41445,43129,15503,0,0,62,62,0,1,0,1,0
41446,57045,445,0,0,66,66,0,1,0,1,0
41447,80,37649,0,0,60,60,0,1,0,1,0
41448,61642,445,0,0,70,70,0,1,0,1,0
41449,55394,123,0,0,234,234,0,1,0,1,0
41450,61638,445,0,0,70,70,0,1,0,1,0
41451,61637,445,0,0,70,70,0,1,0,1,0
41452,61630,445,0,0,70,70,0,1,0,1,0
41453,57044,445,0,0,66,66,0,1,0,1,0
41454,50470,61463,0,0,86,86,0,1,0,1,0
41455,56724,445,0,0,70,70,0,1,0,1,0
41456,58381,57470,0,0,66,66,0,1,0,1,0
41457,61626,445,0,0,70,70,0,1,0,1,0
41458,60192,35440,0,0,146,146,0,1,0,1,0
41459,443,48346,0,0,81,81,0,1,0,1,0
41460,61624,445,0,0,70,70,0,1,0,1,0
41461,61622,445,0,0,70,70,0,1,0,1,0
41462,61620,445,0,0,70,70,0,1,0,1,0
41463,56721,445,0,0,70,70,0,1,0,1,0
41464,58207,51505,0,0,66,66,0,1,0,1,0
41465,57034,445,0,0,66,66,0,1,0,1,0
41466,57987,56125,0,0,90,90,0,1,0,1,0
41467,25254,5555,0,0,60,60,0,1,0,1,0
41468,50052,65008,0,0,60,60,0,1,0,1,0
41469,57033,445,0,0,66,66,0,1,0,1,0
41470,57030,445,0,0,66,66,0,1,0,1,0
41471,57027,445,0,0,66,66,0,1,0,1,0
41472,48706,23393,0,0,60,60,0,1,0,1,0
41473,48681,11392,0,0,62,62,0,1,0,1,0
41474,53625,64147,0,0,62,62,0,1,0,1,0
41475,48681,11392,0,0,146,146,0,1,0,1,0
41476,57026,445,0,0,66,66,0,1,0,1,0
41477,57025,445,0,0,66,66,0,1,0,1,0
41478,57023,445,0,0,66,66,0,1,0,1,0
41479,30960,45723,17261,45723,330,330,0,6,3608,6,0
41480,55312,53,10081,53,190,97,93,2,30,1,1
41481,56684,443,25036,443,8737,1821,6916,23,23,14,9
41482,59930,80,22245,80,1638,1324,314,10,15,5,5
41483,63849,16632,40129,16632,66,66,0,1,5,1,0
41484,51104,13011,33495,13011,948,473,475,13,15,7,6
41485,14272,53,14272,53,1415,689,726,3,31,2,1
41486,58478,443,30017,443,19356,2148,17208,34,112,17,17
41487,45343,443,52570,443,2312,1382,930,19,26,11,8
41488,53508,80,33768,80,16965052,382638,16582414,16619,61,5458,11161
41489,60113,443,5252,443,704,280,424,11,19,5,6
41490,54448,443,65424,443,1786,172,1614,7,120,3,4
41491,57470,6881,39218,6881,517,163,354,2,1200,1,1
41492,11761,443,11761,443,5626,2487,3139,23,29,14,9
41493,51412,443,11649,443,8933,1958,6975,25,81,14,11
41494,56683,443,10179,443,8735,1819,6916,23,23,14,9
41495,63865,48610,16202,48610,66,66,0,2,8,2,0
41496,52829,80,23872,80,2078,726,1352,10,15,5,5
41497,57830,7635,57830,7635,138,78,60,2,5,1,1
41498,57639,80,57639,80,104868,1493,103375,90,31,17,73
41499,49131,443,28166,443,6150,914,5236,18,97,10,8
41500,57636,80,57636,80,147506,3521,143985,125,32,23,102
41501,32899,443,18208,443,47948,40338,7610,82,17,43,39
41502,35078,443,18726,443,78,78,0,1,5,1,0
41503,57638,80,57638,80,29263,2432,26831,36,31,13,23
41504,37561,80,40884,80,1630,918,712,12,16,7,5
41505,57642,80,57642,80,220515,3488,217027,180,31,31,149
41506,47471,80,60446,80,1114,534,580,12,16,7,5
41507,38502,443,34798,443,2378,1126,1252,14,978,7,7
41508,57581,443,57581,443,2512,1465,1047,21,87,10,11
41509,48726,80,33900,80,1794,1480,314,13,15,8,5
41510,59809,443,46540,443,35140,3700,31440,67,76,30,37
41511,51501,993,18732,993,12667,4060,8607,87,32,39,48
41512,47947,80,61494,80,2917,870,2047,14,16,8,6
41513,54693,443,58435,443,5220,922,4298,17,100,10,7
41514,27452,5222,13129,5222,3751,1007,2744,35,425,11,24
41515,50995,443,19177,443,3115,1849,1266,18,16,8,10
41516,36276,7000,36276,7000,3638,2027,1611,17,15,9,8
41517,41151,80,58286,80,1711,786,925,12,16,7,5
41518,63866,17623,35380,17623,66,66,0,2,8,2,0
41519,38433,443,38484,443,33344,25806,7538,105,130,56,49
41520,40909,443,25631,443,1062,724,338,16,41,11,5
41521,60433,6881,42209,6881,70,70,0,2,8,2,0
41522,37716,443,28375,443,14009,10561,3448,30,135,16,14
41523,27005,27241,34573,27241,885,126,759,2,30,1,1
41524,50265,50262,19967,50262,3758,2456,1302,52,2355,31,21
41525,51221,55497,56542,55497,528,528,0,9,1200,9,0
41526,61192,35440,0,0,146,146,0,1,0,1,0
41527,60854,42873,0,0,66,66,0,1,0,1,0
41528,1138,42873,0,0,62,62,0,1,0,1,0
41529,24041,55783,0,0,62,62,0,1,0,1,0
41530,56717,445,0,0,70,70,0,1,0,1,0
41531,56715,445,0,0,70,70,0,1,0,1,0
41532,29011,32468,0,0,66,66,0,1,0,1,0
41533,61619,445,0,0,70,70,0,1,0,1,0
41534,61616,445,0,0,70,70,0,1,0,1,0
41535,61614,445,0,0,70,70,0,1,0,1,0
41536,33801,62413,0,0,62,62,0,1,0,1,0
41537,46945,64147,0,0,62,62,0,1,0,1,0
41538,57020,445,0,0,66,66,0,1,0,1,0
41539,26180,35440,0,0,62,62,0,1,0,1,0
41540,61611,445,0,0,70,70,0,1,0,1,0
41541,56713,445,0,0,70,70,0,1,0,1,0
41542,57017,445,0,0,66,66,0,1,0,1,0
41543,57016,445,0,0,66,66,0,1,0,1,0
41544,52281,161,0,0,550,550,0,6,35,6,0
41545,54974,443,56766,443,8670,2248,6422,36,90,21,15
41546,52313,443,33219,443,52235,4973,47262,81,179,39,42
41547,56361,80,32552,80,9997,1306,8691,17,25,8,9
41548,11901,443,11901,443,5599,2459,3140,23,29,14,9
41549,11801,443,11801,443,19187,5127,14060,38,22,23,15
41550,63850,6881,4556,6881,70,70,0,1,4,1,0
41551,50460,443,12819,443,1346,918,428,10,31,6,4
41552,53912,443,35610,443,1346,918,428,10,33,6,4
41553,47600,53,23679,53,168,78,90,2,29,1,1
41554,27005,27015,28770,27015,879,126,753,2,29,1,1
41555,27005,27207,59346,27207,875,126,749,2,29,1,1
41556,54322,27015,26816,27015,924,924,0,3,29,3,0
41557,42587,53,63043,53,199,94,105,2,30,1,1
41558,65455,3389,65455,3389,4350,2261,2089,21,17,11,10
41559,57470,50321,46751,50321,538,166,372,2,1199,1,1
41560,12157,80,12157,80,2144,1519,625,9,29,6,3
41561,49567,443,55321,443,6408,2531,3877,21,15,11,10
41562,46409,80,63158,80,1053,613,440,10,15,5,5
41563,63848,48560,32430,48560,70,70,0,1,4,1,0
41564,60973,443,19022,443,398300,18473,379827,492,72,222,270
41565,51880,18468,1087,18468,70,70,0,2,8,2,0
41566,60977,443,59690,443,275026,15030,259996,353,72,167,186
41567,56970,53,57331,53,428,103,325,4,34,2,2
41568,63867,43618,62706,43618,66,66,0,2,7,2,0
41569,64900,53,36772,53,314,102,212,2,29,1,1
41570,56081,53,45307,53,237,94,143,2,29,1,1
41571,56314,53,21778,53,211,102,109,2,29,1,1
41572,61568,53,62912,53,260,86,174,2,29,1,1
41573,54321,27015,42449,27015,924,924,0,3,29,3,0
41574,64998,27037,18339,27037,3287,2072,1215,12,30,6,6
41575,27005,27203,54242,27203,871,126,745,2,29,1,1
41576,37611,53,57023,53,199,94,105,2,30,1,1
41577,57298,53,55060,53,323,110,213,2,30,1,1
41578,49663,53,0,0,86,86,0,1,30,1,0
41579,51455,443,21298,443,8618,3110,5508,34,1695,18,16
41580,60766,28080,64298,28080,70,70,0,2,8,2,0
41581,33243,443,33380,443,1067,650,417,10,31,6,4
41582,56669,443,61657,443,8058,2038,6020,20,15,11,9
41583,56100,53,62385,53,211,102,109,2,30,1,1
41584,56637,443,17039,443,8865,1819,7046,24,30,14,10
41585,33231,443,11220,443,1067,650,417,10,35,6,4
41586,41547,80,41547,80,120443,1965,118478,108,20,21,87
41587,49424,53,53979,53,228,110,118,2,30,1,1
41588,43391,80,44561,80,1560,684,876,10,15,5,5
41589,33834,443,55526,443,1178,820,358,9,15,6,3
41590,37893,53,0,0,86,86,0,1,30,1,0
41591,6189,53,29429,53,229,86,143,2,30,1,1
41592,35106,53,20275,53,271,102,169,2,30,1,1
41593,51221,15886,64989,15886,481,150,331,2,1200,1,1
41594,64573,53,28615,53,380,110,270,2,30,1,1
41595,64566,53,50358,53,347,107,240,4,42,2,2
41596,50448,443,19311,443,1346,918,428,10,35,6,4
41597,60425,80,53766,80,186,64,122,4,28,2,2
41598,58676,443,61726,443,6144,939,5205,18,70,9,9
41599,37846,443,26954,443,30620,20855,9765,91,112,45,46
41600,41914,123,34175,123,184,94,90,2,30,1,1
41601,37923,443,39242,443,2593394,70243,2523151,2678,303,908,1770
41602,51221,55497,24312,55497,330,330,0,6,1200,6,0
41603,50968,443,1299,443,10759,3158,7601,29,75,16,13
41604,56670,443,11392,443,8006,1986,6020,20,15,11,9
41605,65483,443,48950,443,92479,4869,87610,109,16,44,65
41606,56431,80,21703,80,17248,1619,15629,26,25,11,15
41607,49540,53,16812,53,279,94,185,2,30,1,1
41608,33539,53,23280,53,336,231,105,3,30,2,1
41609,43680,53,64871,53,271,102,169,2,30,1,1
41610,10151,60419,62503,60419,479,150,329,2,1200,1,1
41611,53911,443,57422,443,1346,918,428,10,33,6,4
41612,60974,443,22731,443,166465,9498,156967,220,72,100,120
41613,60975,443,27000,443,333131,17461,315670,435,72,211,224
41614,53958,80,17834,80,23134,15926,7208,53,541,32,21
41615,50750,443,64318,443,70,70,0,2,171,2,0
41616,50749,443,31608,443,70,70,0,2,171,2,0
41617,57586,443,57586,443,13517,1521,11996,32,87,11,21
41618,63870,6881,42274,6881,66,66,0,2,7,2,0
41619,54657,443,15364,443,7070,1030,6040,19,33,11,8
41620,34308,3389,34308,3389,4930,2691,2239,24,19,14,10
41621,60409,80,41783,80,10970,7709,3261,24,29,13,11
41622,60427,80,8033,80,186,64,122,4,28,2,2
41623,57583,443,57583,443,2512,1466,1046,21,87,10,11
41624,46256,443,26728,443,15090,9197,5893,33,97,19,14
41625,56633,80,19210,80,234,234,0,4,12,4,0
41626,11897,443,11897,443,1452,817,635,16,29,9,7
41627,60431,52867,31778,52867,70,70,0,2,8,2,0
41628,63864,44139,1189,44139,66,66,0,2,7,2,0
41629,12266,443,12266,443,18634,3895,14739,48,29,27,21
41630,60741,443,38588,443,2042,559,1483,20,89,6,14
41631,57640,80,57640,80,64437,2630,61807,64,31,18,46
41632,57585,443,57585,443,2504,1458,1046,21,87,10,11
41633,51879,38564,27585,38564,70,70,0,2,8,2,0
41634,50016,53,35137,53,275,94,181,2,29,1,1
41635,55312,53,37351,53,195,102,93,2,29,1,1
41636,27005,27214,50051,27214,876,126,750,2,29,1,1
41637,63868,60392,39941,60392,66,66,0,2,7,2,0
41638,56639,443,6220,443,10138,2213,7925,27,30,16,11
41639,55713,53,11593,53,308,94,214,2,30,1,1
41640,57414,53,33094,53,214,102,112,2,29,1,1
41641,50242,80,35975,80,2793,1071,1722,14,105,7,7
41642,65484,443,29745,443,148284,6200,142084,165,16,63,102
41643,56634,443,43198,443,8865,1819,7046,24,30,14,10
41644,27005,27015,21869,27015,877,126,751,2,29,1,1
41645,51550,443,50088,443,13331,2421,10910,38,209,20,18
41646,27005,27202,9481,27202,872,126,746,2,29,1,1
41647,55773,53,51846,53,102,102,0,1,60,1,0
41648,65406,53,1627,53,102,102,0,1,60,1,0
41649,40931,443,31983,443,7399,3328,4071,76,4153,33,43
41650,32806,7275,35238,7275,130,70,60,2,15,1,1
41651,54935,443,10103,443,10198,3881,6317,46,146,26,20
41652,55648,80,53307,80,70,70,0,2,8,2,0
41653,51865,14732,14153,14732,70,70,0,1,5,1,0
41654,60556,28678,33348,28678,1806,1806,0,22,224,22,0
41655,60583,443,60583,443,1315,786,529,12,36,7,5
41656,56668,443,3930,443,8005,1985,6020,20,15,11,9
41657,49128,53,21318,53,199,94,105,2,30,1,1
41658,58890,53,58890,53,198,90,108,2,30,1,1
41659,36851,53,52640,53,404,261,143,3,30,2,1
41660,55281,53,41810,53,236,94,142,2,30,1,1
41661,57015,53,23440,53,363,102,261,2,30,1,1
41662,53565,443,13839,443,12007,942,11065,19,120,8,11
41663,44847,12269,58091,12269,502,150,352,2,1200,1,1
41664,39105,443,21624,443,2853588,73973,2779615,2907,129,994,1913
41665,53692,16624,3177,16624,320,140,180,6,6,3,3
41666,51866,23431,28853,23431,70,70,0,1,5,1,0
41667,50476,80,25570,80,5049,4344,705,11,30,6,5
41668,54453,443,45461,443,4227,1086,3141,15,29,8,7
41669,56636,443,16823,443,8865,1819,7046,24,30,14,10
41670,55887,53,35825,53,339,98,241,4,47,2,2
41671,64265,53,25534,53,550,133,417,4,47,2,2
41672,55470,53,60625,53,310,94,216,2,30,1,1
41673,31602,53,0,0,327,102,225,2,30,1,1
41674,50278,443,50420,443,36958,2966,33992,48,120,18,30
41675,57097,443,3043,443,3578432,133577,3444855,4291,426,1634,2657
41676,50584,51413,31327,51413,498,150,348,4,2396,2,2
41677,56640,443,54047,443,8735,1819,6916,23,30,14,9
41678,56682,443,39754,443,8735,1819,6916,23,22,14,9
41679,33725,53,33725,53,216,90,126,2,30,1,1
41680,56135,53,30728,53,258,118,140,2,30,1,1
41681,64564,53,49143,53,273,94,179,2,30,1,1
41682,46838,80,4801,80,70,70,0,1,120,1,0
41683,51221,62348,26234,62348,132,132,0,3,1200,3,0
41684,44871,53,64533,53,164,78,86,2,31,1,1
41685,64516,443,9177,443,2649258,1156086,1493172,7283,5215,3384,3899
41686,6882,40796,60379,40796,228,118,110,2,1200,1,1
41687,57470,38871,35688,38871,545,166,379,2,1199,1,1
41688,53678,31592,21651,31592,70,70,0,1,5,1,0
41689,6666,21,6666,21,66,66,0,1,5,1,0
41690,59626,443,63020,443,5837,1982,3855,19,18,11,8
41691,56667,443,7226,443,8057,2037,6020,20,16,11,9
41692,49911,53,3623,53,200,94,106,2,30,1,1
41693,55144,53,47771,53,209,102,107,2,30,1,1
41694,55312,53,24613,53,195,102,93,2,30,1,1
41695,27005,27240,14670,27240,868,126,742,2,31,1,1
41696,63123,443,2036,443,5530,2343,3187,22,128,10,12
41697,50277,443,37349,443,3182,1568,1614,8,120,4,4
41698,55105,53,24892,53,194,94,100,2,30,1,1
41699,45035,80,33169,80,3720,1663,2057,17,186,10,7
41700,56845,53,65473,53,233,102,131,2,30,1,1
41701,49278,53,60636,53,200,94,106,2,30,1,1
41702,65036,53,31003,53,209,94,115,2,30,1,1
41703,27005,27016,20035,27016,903,126,777,2,31,1,1
41704,51806,443,31513,443,19093,3390,15703,26,126,10,16
41705,57470,52177,52924,52177,1980,1980,0,31,2321,31,0
41706,57014,445,0,0,66,66,0,1,0,1,0
41707,57433,21247,0,0,66,66,0,1,0,1,0
41708,45941,23386,0,0,60,60,0,1,0,1,0
41709,57012,445,0,0,66,66,0,1,0,1,0
41710,64605,35993,0,0,66,66,0,1,0,1,0
41711,62115,57470,0,0,66,66,0,1,0,1,0
41712,8536,37965,0,0,62,62,0,1,0,1,0
41713,27401,37965,0,0,66,66,0,1,0,1,0
41714,56706,445,0,0,70,70,0,1,0,1,0
41715,443,48346,0,0,81,81,0,1,0,1,0
41716,61610,445,0,0,70,70,0,1,0,1,0
41717,9529,26467,0,0,62,62,0,1,0,1,0
41718,61599,445,0,0,70,70,0,1,0,1,0
41719,61593,445,0,0,70,70,0,1,0,1,0
41720,56704,445,0,0,70,70,0,1,0,1,0
41721,56703,445,0,0,70,70,0,1,0,1,0
41722,45964,55559,0,0,60,60,0,1,0,1,0
41723,57002,445,0,0,66,66,0,1,0,1,0
41724,56702,445,0,0,70,70,0,1,0,1,0
41725,56701,445,0,0,70,70,0,1,0,1,0
41726,56699,445,0,0,70,70,0,1,0,1,0
41727,56697,445,0,0,70,70,0,1,0,1,0
41728,28385,50584,0,0,146,146,0,1,0,1,0
41729,80,53945,0,0,60,60,0,1,0,1,0
41730,12107,22114,0,0,62,62,0,1,0,1,0
41731,52318,17,0,0,60,60,0,1,0,1,0
41732,56994,445,0,0,66,66,0,1,0,1,0
41733,56683,445,0,0,70,70,0,1,0,1,0
41734,56682,445,0,0,70,70,0,1,0,1,0
41735,61585,445,0,0,70,70,0,1,0,1,0
41736,56676,445,0,0,70,70,0,1,0,1,0
41737,14165,51050,0,0,146,146,0,1,0,1,0
41738,56672,445,0,0,70,70,0,1,0,1,0
41739,56673,445,0,0,70,70,0,1,0,1,0
41740,1026,30188,0,0,62,62,0,1,0,1,0
41741,62849,62413,0,0,66,66,0,1,0,1,0
41742,8239,37965,0,0,146,146,0,1,0,1,0
41743,56991,445,0,0,66,66,0,1,0,1,0
41744,65388,55783,0,0,66,66,0,1,0,1,0
41745,28424,35440,0,0,66,66,0,1,0,1,0
41746,443,22323,0,0,61,61,0,1,0,1,0
41747,443,22323,0,0,83,83,0,1,0,1,0
41748,56983,445,0,0,66,66,0,1,0,1,0
41749,56980,445,0,0,66,66,0,1,0,1,0
41750,56661,445,0,0,70,70,0,1,0,1,0
41751,59772,62413,0,0,62,62,0,1,0,1,0
41752,48125,7548,0,0,60,60,0,1,0,1,0
41753,50470,61463,0,0,86,86,0,1,0,1,0
41754,54118,6004,0,0,66,66,0,1,0,1,0
41755,64693,26467,0,0,62,62,0,1,0,1,0
41756,58743,35894,0,0,66,66,0,1,0,1,0
41757,35261,15503,0,0,74,74,0,1,0,1,0
41758,55600,22,0,0,60,60,0,1,0,1,0
41759,61574,445,0,0,70,70,0,1,0,1,0
41760,61571,445,0,0,70,70,0,1,0,1,0
41761,56656,445,0,0,70,70,0,1,0,1,0
41762,56969,445,0,0,66,66,0,1,0,1,0
41763,56961,445,0,0,66,66,0,1,0,1,0
41764,56965,445,0,0,66,66,0,1,0,1,0
41765,56967,445,0,0,66,66,0,1,0,1,0
41766,56968,445,0,0,66,66,0,1,0,1,0
41767,56963,445,0,0,66,66,0,1,0,1,0
41768,56962,445,0,0,66,66,0,1,0,1,0
41769,56964,445,0,0,66,66,0,1,0,1,0
41770,61336,61689,0,0,66,66,0,1,0,1,0
41771,13911,57470,0,0,60,60,0,1,0,1,0
41772,56648,445,0,0,70,70,0,1,0,1,0
41773,56645,445,0,0,70,70,0,1,0,1,0
41774,56646,445,0,0,70,70,0,1,0,1,0
41775,56643,445,0,0,70,70,0,1,0,1,0
41776,56640,445,0,0,70,70,0,1,0,1,0
41777,6224,37965,0,0,62,62,0,1,0,1,0
41778,58664,64147,0,0,66,66,0,1,0,1,0
41779,59724,64147,0,0,62,62,0,1,0,1,0
41780,61569,445,0,0,70,70,0,1,0,1,0
41781,61560,445,0,0,70,70,0,1,0,1,0
41782,61555,445,0,0,70,70,0,1,0,1,0
41783,16687,10214,0,0,66,66,0,1,0,1,0
41784,37420,44847,0,0,66,66,0,1,0,1,0
41785,56948,445,0,0,66,66,0,1,0,1,0
41786,56946,445,0,0,66,66,0,1,0,1,0
41787,56947,445,0,0,66,66,0,1,0,1,0
41788,7947,50584,0,0,62,62,0,1,0,1,0
41789,65495,11392,0,0,62,62,0,1,0,1,0
41790,41429,50584,0,0,66,66,0,1,0,1,0
41791,45908,33330,0,0,60,60,0,1,0,1,0
41792,56635,445,0,0,70,70,0,1,0,1,0
41793,61554,445,0,0,70,70,0,1,0,1,0
41794,17561,52700,0,0,62,62,0,1,0,1,0
41795,33528,23,0,0,60,60,0,1,0,1,0
41796,61057,31573,0,0,146,146,0,1,0,1,0
41797,6014,37965,0,0,66,66,0,1,0,1,0
41798,56026,51505,0,0,146,146,0,1,0,1,0
41799,52870,22197,0,0,62,62,0,1,0,1,0
41800,61551,445,0,0,70,70,0,1,0,1,0
41801,64681,35993,0,0,66,66,0,1,0,1,0
41802,61550,445,0,0,70,70,0,1,0,1,0
41803,61548,445,0,0,70,70,0,1,0,1,0
41804,61543,445,0,0,70,70,0,1,0,1,0
41805,50470,61463,0,0,86,86,0,1,0,1,0
41806,47682,64147,0,0,66,66,0,1,0,1,0
41807,47105,64147,0,0,62,62,0,1,0,1,0
41808,52724,64147,0,0,62,62,0,1,0,1,0
41809,56627,445,0,0,70,70,0,1,0,1,0
41810,50644,35440,0,0,66,66,0,1,0,1,0
41811,56624,445,0,0,70,70,0,1,0,1,0
41812,19698,502,0,0,60,60,0,1,0,1,0
41813,28824,44847,0,0,66,66,0,1,0,1,0
41814,54530,35440,0,0,66,66,0,1,0,1,0
41815,56619,445,0,0,70,70,0,1,0,1,0
41816,56618,445,0,0,70,70,0,1,0,1,0
41817,1373,22114,0,0,66,66,0,1,0,1,0
41818,28135,34021,0,0,62,62,0,1,0,1,0
41819,57472,44847,0,0,62,62,0,1,0,1,0
41820,0,0,0,0,156,156,0,2,0,2,0
41821,0,0,0,0,707,707,0,2,0,2,0
41822,0,0,0,0,1188,1188,0,2,0,2,0
41823,0,0,0,0,244,244,0,2,0,2,0
41824,57665,52700,0,0,66,66,0,1,0,1,0
41825,61533,445,0,0,70,70,0,1,0,1,0
41826,61532,445,0,0,70,70,0,1,0,1,0
41827,61530,445,0,0,70,70,0,1,0,1,0
41828,58131,3855,0,0,146,146,0,1,0,1,0
41829,28124,37965,0,0,62,62,0,1,0,1,0
41830,56614,445,0,0,70,70,0,1,0,1,0
41831,65317,51221,0,0,78,78,0,1,0,1,0
41832,56613,445,0,0,70,70,0,1,0,1,0
41833,43657,50011,0,0,62,62,0,1,0,1,0
41834,20170,23,0,0,60,60,0,1,0,1,0
41835,48841,51221,0,0,62,62,0,1,0,1,0
41836,40521,23117,0,0,66,66,0,1,0,1,0
41837,10436,37965,0,0,62,62,0,1,0,1,0
41838,56925,445,0,0,66,66,0,1,0,1,0
41839,443,20995,0,0,83,83,0,1,0,1,0
41840,20508,57470,0,0,62,62,0,1,0,1,0
41841,61524,445,0,0,70,70,0,1,0,1,0
41842,61522,445,0,0,70,70,0,1,0,1,0
41843,26183,22114,0,0,62,62,0,1,0,1,0
41844,57234,21247,0,0,66,66,0,1,0,1,0
41845,56608,445,0,0,70,70,0,1,0,1,0
41846,59008,51221,0,0,66,66,0,1,0,1,0
41847,49367,51505,0,0,66,66,0,1,0,1,0
41848,6881,33454,0,0,100,100,0,1,0,1,0
41849,17719,49153,0,0,145,145,0,1,0,1,0
41850,54047,50011,0,0,62,62,0,1,0,1,0
41851,56919,445,0,0,66,66,0,1,0,1,0
41852,49160,57470,0,0,146,146,0,1,0,1,0
41853,56916,445,0,0,66,66,0,1,0,1,0
41854,61514,445,0,0,70,70,0,1,0,1,0
41855,47396,23,0,0,60,60,0,1,0,1,0
41856,55644,45579,38445,45579,70,70,0,2,8,2,0
41857,48440,53,22120,53,198,93,105,2,30,1,1
41858,52993,443,64908,443,16229,3316,12913,23,125,9,14
41859,61591,80,1732,80,124,64,60,2,16,1,1
41860,5588,5588,0,0,3562,1936,1626,48,194,24,24
41861,27005,27216,33781,27216,872,126,746,2,30,1,1
41862,19473,12345,64156,12345,478,149,329,2,1200,1,1
41863,54993,443,50582,443,38985,4250,34735,58,19,27,31
41864,27005,27246,16977,27246,865,126,739,2,30,1,1
41865,56330,53,24669,53,711,87,624,2,30,1,1
41866,49858,443,3076,443,16232,3319,12913,23,124,9,14
41867,54994,443,29516,443,13580,3864,9716,40,18,23,17
41868,51411,443,6428,443,5550,1177,4373,24,80,13,11
41869,57470,6346,6625,6346,330,330,0,6,1200,6,0
41870,47595,33438,0,0,106,106,0,1,60,1,0
41871,58496,53,58496,53,204,92,112,2,30,1,1
41872,45341,443,7736,443,2754,1394,1360,22,36,11,11
41873,46860,15000,54542,15000,130,70,60,2,6,1,1
41874,54991,443,1653,443,20604,3530,17074,40,19,21,19
41875,53662,443,56042,443,7471,2800,4671,21,76,13,8
41876,50518,80,23907,80,2864,1338,1526,17,21,9,8
41877,36631,443,36631,443,4568,1661,2907,19,29,11,8
41878,44682,443,42842,443,2750,1891,859,17,25,10,7
41879,51878,9999,48543,9999,70,70,0,2,8,2,0
41880,56522,443,44815,443,43823,7381,36442,84,38,42,42
41881,48483,443,20913,443,60944,9555,51389,71,362,25,46
41882,64224,443,1301,443,24320,6711,17609,45,122,20,25
41883,58911,443,49541,443,23915,4341,19574,37,120,15,22
41884,54988,443,63071,443,69664,6958,62706,98,23,46,52
41885,58705,5228,47511,5228,4706,2850,1856,44,6872,25,19
41886,54995,443,42324,443,13281,4753,8528,32,17,18,14
41887,59772,80,1176,80,5558,3386,2172,29,36,15,14
41888,59276,443,40586,443,16232,3319,12913,23,125,9,14
41889,50994,443,10248,443,3137,1855,1282,19,16,9,10
41890,56125,80,28714,80,891,536,355,10,255,6,4
41891,52261,53,8647,53,578,286,292,9,15,5,4
41892,27005,27255,55228,27255,879,126,753,2,30,1,1
41893,35644,53,9492,53,198,93,105,2,30,1,1
41894,58642,443,2998,443,7127,3015,4112,24,144,12,12
41895,44822,11848,0,0,148,148,0,1,0,1,0
41896,61508,445,0,0,70,70,0,1,0,1,0
41897,61509,445,0,0,70,70,0,1,0,1,0
41898,61507,445,0,0,70,70,0,1,0,1,0
41899,23126,35440,0,0,66,66,0,1,0,1,0
41900,1821,64147,0,0,66,66,0,1,0,1,0
41901,56914,445,0,0,66,66,0,1,0,1,0
41902,56595,445,0,0,70,70,0,1,0,1,0
41903,53147,37965,0,0,62,62,0,1,0,1,0
41904,12060,37965,0,0,66,66,0,1,0,1,0
41905,59511,21247,0,0,66,66,0,1,0,1,0
41906,54423,21247,0,0,66,66,0,1,0,1,0
41907,40100,17,0,0,60,60,0,1,0,1,0
41908,61499,445,0,0,70,70,0,1,0,1,0
41909,56592,445,0,0,70,70,0,1,0,1,0
41910,6881,45711,0,0,100,100,0,1,0,1,0
41911,6881,57470,0,0,100,100,0,1,0,1,0
41912,53815,44847,0,0,66,66,0,1,0,1,0
41913,49254,53,34045,53,214,102,112,2,30,1,1
41914,39077,443,60900,443,24631,1902,22729,37,215,17,20
41915,55646,14420,49852,14420,70,70,0,2,8,2,0
41916,51861,23919,4159,23919,70,70,0,1,5,1,0
41917,65297,53,52505,53,241,118,123,2,30,1,1
41918,61496,445,0,0,70,70,0,1,0,1,0
41919,61494,445,0,0,70,70,0,1,0,1,0
41920,61492,445,0,0,70,70,0,1,0,1,0
41921,56905,445,0,0,66,66,0,1,0,1,0
41922,56900,445,0,0,66,66,0,1,0,1,0
41923,56901,445,0,0,66,66,0,1,0,1,0
41924,56899,445,0,0,66,66,0,1,0,1,0
41925,56897,445,0,0,66,66,0,1,0,1,0
41926,56896,445,0,0,66,66,0,1,0,1,0
41927,56895,445,0,0,66,66,0,1,0,1,0
41928,63080,37965,0,0,66,66,0,1,0,1,0
41929,33896,57470,0,0,74,74,0,1,0,1,0
41930,53513,56205,0,0,62,62,0,1,0,1,0
41931,56587,445,0,0,70,70,0,1,0,1,0
41932,8999,48817,0,0,146,146,0,1,0,1,0
41933,57093,26467,0,0,62,62,0,1,0,1,0
41934,24260,50584,0,0,62,62,0,1,0,1,0
41935,52754,26467,0,0,62,62,0,1,0,1,0
41936,56586,445,0,0,70,70,0,1,0,1,0
41937,8486,56205,0,0,66,66,0,1,0,1,0
41938,56584,445,0,0,70,70,0,1,0,1,0
41939,33563,14037,0,0,78,78,0,1,0,1,0
41940,61491,445,0,0,70,70,0,1,0,1,0
41941,61488,445,0,0,70,70,0,1,0,1,0
41942,63861,37832,6242,37832,66,66,0,2,7,2,0
41943,53677,10657,55902,10657,70,70,0,1,4,1,0
41944,51862,27758,53526,27758,70,70,0,1,5,1,0
41945,64208,53,37921,53,194,94,100,2,29,1,1
41946,56983,53,62235,53,221,94,127,2,29,1,1
41947,52327,53,21249,53,224,94,130,2,29,1,1
41948,49790,53,34832,53,195,102,93,2,30,1,1
41949,57470,19641,64041,19641,132,132,0,3,1199,3,0
41950,58183,443,49158,443,841459,41656,799803,1083,141,389,694
41951,34344,443,5583,443,9167,2205,6962,37,120,19,18
41952,53674,31724,6450,31724,70,70,0,1,4,1,0
41953,60272,443,56856,443,13199834,344312,12855522,13125,121,3739,9386
41954,32296,443,32296,443,5421,2444,2977,20,15,11,9
41955,49917,53,46665,53,168,78,90,2,29,1,1
41956,27005,27237,41184,27237,891,126,765,2,30,1,1
41957,40808,53,41572,53,168,78,90,2,29,1,1
41958,27005,27257,60876,27257,883,126,757,2,30,1,1
41959,57048,53,62627,53,512,95,417,4,34,2,2
41960,39488,53,45099,53,199,94,105,2,29,1,1
41961,64330,53,63113,53,200,94,106,2,29,1,1
41962,27005,27017,51500,27017,901,126,775,2,30,1,1
41963,64394,443,20424,443,3182,1568,1614,8,120,4,4
41964,27005,27269,13554,27269,886,126,760,2,30,1,1
41965,37087,443,26551,443,9710,2136,7574,26,363,11,15
41966,49542,443,22517,443,9824,1839,7985,27,172,13,14
41967,64347,53,35603,53,321,109,212,4,47,2,2
41968,35742,53,48792,53,199,94,105,2,30,1,1
41969,46965,53,4424,53,199,94,105,2,30,1,1
41970,56164,53,3250,53,226,110,116,2,30,1,1
41971,39716,53,15462,53,86,86,0,1,30,1,0
41972,33262,443,40811,443,4067,2672,1395,23,23,14,9
41973,56841,29753,27881,29753,70,70,0,2,8,2,0
41974,45551,443,60203,443,6964,2091,4873,20,15,10,10
41975,55410,80,63972,80,1250,472,778,13,46,3,10
41976,51863,22038,12301,22038,70,70,0,1,5,1,0
41977,41472,53,41472,53,218,90,128,2,30,1,1
41978,34366,443,52089,443,520306,17622,502684,582,210,210,372
41979,35263,443,2697,443,22457,12680,9777,65,20,34,31
41980,44047,443,38951,443,6750,4410,2340,19,120,9,10
41981,56004,53,16480,53,177,94,83,2,30,1,1
41982,41316,443,15056,443,4997074,153969,4843105,5249,343,1861,3388
41983,37965,58909,50714,58909,1577,594,983,20,1724,10,10
41984,56004,53,53891,53,177,94,83,2,30,1,1
41985,58797,443,26512,443,3311,1069,2242,13,135,6,7
41986,55930,443,56260,443,6271,1354,4917,25,113,14,11
41987,53660,443,7808,443,9028,3897,5131,24,83,15,9
41988,54992,443,45267,443,31183,3879,27304,52,19,26,26
41989,40988,80,28753,80,19112,2192,16920,46,90,23,23
41990,65236,53,36812,53,215,102,113,2,30,1,1
41991,57073,53,17930,53,197,102,95,2,35,1,1
41992,59609,443,2759,443,7762,1777,5985,22,80,13,9
41993,64709,53,12288,53,229,110,119,2,30,1,1
41994,55127,80,31027,80,4239,2334,1905,17,187,10,7
41995,60921,443,34285,443,9869,2448,7421,61,1253,24,37
41996,58848,443,23115,443,1362,627,735,14,81,7,7
41997,51883,16325,58501,16325,316,136,180,6,6,3,3
41998,41693,443,28921,443,27069,3064,24005,44,178,19,25
41999,26865,443,22998,443,21239,16302,4937,35,20,20,15
42000,60426,80,65008,80,4515,3889,626,11,27,6,5
42001,53719,443,48486,443,70,70,0,2,8,2,0
42002,56844,44445,50438,44445,70,70,0,1,5,1,0
42003,64683,53,5338,53,376,95,281,4,36,2,2
42004,41868,443,44888,443,6204,1328,4876,21,139,12,9
42005,53676,3678,50673,3678,70,70,0,1,4,1,0
42006,33259,443,58382,443,4193,2689,1504,23,23,14,9
42007,57555,443,43596,443,25519,7061,18458,37,16,20,17
42008,53444,443,53444,443,960,539,421,9,30,5,4
42009,53445,443,53445,443,960,539,421,9,30,5,4
42010,49668,53,59883,53,200,94,106,2,29,1,1
42011,42089,53,62601,53,199,94,105,2,29,1,1
42012,53127,30467,24380,30467,314,128,186,6,18,3,3
42013,56665,443,40335,443,8058,2038,6020,20,15,11,9
42014,24891,53,42889,53,168,78,90,2,30,1,1
42015,57600,53,41878,53,168,78,90,2,30,1,1
42016,54262,53,54262,53,198,90,108,2,30,1,1
42017,27005,27015,15539,27015,881,126,755,2,30,1,1
42018,44949,53,44949,53,198,90,108,2,30,1,1
42019,34167,80,27156,80,3643,1738,1905,17,187,10,7
42020,57360,53,29113,53,231,110,121,2,30,1,1
42021,50279,443,56387,443,1786,172,1614,7,119,3,4
42022,56666,443,25263,443,8006,1986,6020,20,15,11,9
42023,33258,443,43741,443,6958,4394,2564,30,28,17,13
42024,40203,80,61605,80,28577,1878,26699,47,31,23,24
42025,57139,53,26096,53,181,86,95,2,30,1,1
42026,64864,53,28778,53,275,126,149,2,30,1,1
42027,65425,53,4149,53,402,142,260,2,30,1,1
42028,42184,53,42184,53,334,226,108,3,30,2,1
42029,40836,443,10613,443,9524,3934,5590,20,135,10,10
42030,38083,443,10081,443,2465,1356,1109,18,180,8,10
42031,50126,443,42712,443,8464,2699,5765,48,147,26,22
42032,53447,443,53447,443,960,539,421,9,30,5,4
42033,17176,443,17176,443,6311,1229,5082,18,16,8,10
42034,35207,53,52779,53,168,78,90,2,30,1,1
42035,65374,53,60025,53,261,102,159,2,30,1,1
42036,59101,53,46129,53,195,94,101,2,30,1,1
42037,50694,80,52061,80,3481,1576,1905,17,187,10,7
42038,33260,443,40517,443,4051,2618,1433,21,23,13,8
42039,54452,443,13624,443,4227,1086,3141,15,28,8,7
42040,56843,64277,53228,64277,70,70,0,1,5,1,0
42041,59828,443,59390,443,7083,2786,4297,24,81,14,10
42042,53446,443,53446,443,960,539,421,9,30,5,4
42043,56358,80,8330,80,1569,1077,492,11,30,6,5
42044,37835,443,55999,443,63724,45783,17941,171,123,85,86
42045,56952,53,53652,53,487,136,351,4,46,2,2
42046,65182,53,61284,53,634,199,435,6,79,3,3
42047,61838,53,61838,53,216,90,126,2,30,1,1
42048,65270,53,38040,53,226,110,116,2,30,1,1
42049,52361,443,27364,443,7488,2474,5014,23,3600,12,11
42050,60767,40010,24332,40010,316,136,180,6,6,3,3
42051,48743,443,24308,443,26609,2444,24165,45,21,21,24
42052,36841,443,36841,443,4401,1494,2907,19,27,11,8
42053,56486,443,16895,443,2673671,30446,2643225,2145,125,234,1911
42054,49547,443,61463,443,7817,1780,6037,26,172,13,13
42055,48744,443,35880,443,2098,1239,859,22,20,12,10
42056,26499,80,26499,80,168957,11365,157592,202,31,90,112
42057,26501,80,26501,80,93644,8868,84776,131,31,64,67
42058,26504,80,26504,80,13592,1419,12173,25,31,13,12
42059,49276,80,4660,80,254,128,126,5,16,3,2
42060,46555,53,62486,53,168,78,90,2,30,1,1
42061,27005,27015,37450,27015,879,126,753,2,31,1,1
42062,61484,445,0,0,70,70,0,1,0,1,0
42063,56893,445,0,0,66,66,0,1,0,1,0
42064,61483,445,0,0,70,70,0,1,0,1,0
42065,56888,445,0,0,66,66,0,1,0,1,0
42066,54778,22114,0,0,66,66,0,1,0,1,0
42067,45941,23388,0,0,60,60,0,1,0,1,0
42068,56885,445,0,0,66,66,0,1,0,1,0
42069,56887,445,0,0,66,66,0,1,0,1,0
42070,6881,6881,0,0,62,62,0,1,0,1,0
42071,56883,445,0,0,66,66,0,1,0,1,0
42072,48676,53393,0,0,60,60,0,1,0,1,0
42073,8889,47679,0,0,60,60,0,1,0,1,0
42074,56577,445,0,0,70,70,0,1,0,1,0
42075,11880,36829,0,0,146,146,0,1,0,1,0
42076,57131,8055,0,0,145,145,0,1,0,1,0
42077,443,15564,0,0,85,85,0,1,0,1,0
42078,52569,30188,0,0,66,66,0,1,0,1,0
42079,56575,445,0,0,70,70,0,1,0,1,0
42080,11030,37965,0,0,62,62,0,1,0,1,0
42081,61478,445,0,0,70,70,0,1,0,1,0
42082,20198,17372,0,0,62,62,0,1,0,1,0
42083,50222,42873,0,0,66,66,0,1,0,1,0
42084,61467,445,0,0,70,70,0,1,0,1,0
42085,61465,445,0,0,70,70,0,1,0,1,0
42086,18754,30188,0,0,66,66,0,1,0,1,0
42087,56574,445,0,0,70,70,0,1,0,1,0
42088,16430,31573,0,0,62,62,0,1,0,1,0
42089,56573,445,0,0,70,70,0,1,0,1,0
42090,56572,445,0,0,70,70,0,1,0,1,0
42091,56568,445,0,0,70,70,0,1,0,1,0
42092,56569,445,0,0,70,70,0,1,0,1,0
42093,57987,56125,0,0,90,90,0,1,0,1,0
42094,22981,15503,0,0,62,62,0,1,0,1,0
42095,56872,445,0,0,66,66,0,1,0,1,0
42096,23197,44847,0,0,62,62,0,1,0,1,0
42097,443,9986,0,0,669,669,0,1,0,1,0
42098,63213,15503,0,0,62,62,0,1,0,1,0
42099,56554,445,0,0,70,70,0,1,0,1,0
42100,56552,445,0,0,70,70,0,1,0,1,0
42101,56547,445,0,0,70,70,0,1,0,1,0
42102,58550,21247,0,0,62,62,0,1,0,1,0
42103,56543,445,0,0,70,70,0,1,0,1,0
42104,56544,445,0,0,70,70,0,1,0,1,0
42105,56148,37965,0,0,66,66,0,1,0,1,0
42106,56865,445,0,0,66,66,0,1,0,1,0
42107,38852,37965,0,0,62,62,0,1,0,1,0
42108,61455,445,0,0,70,70,0,1,0,1,0
42109,58888,23718,0,0,66,66,0,1,0,1,0
42110,51222,35440,0,0,66,66,0,1,0,1,0
42111,56862,445,0,0,66,66,0,1,0,1,0
42112,53459,37807,0,0,146,146,0,1,0,1,0
42113,3980,63710,0,0,62,62,0,1,0,1,0
42114,61563,37807,0,0,66,66,0,1,0,1,0
42115,13911,57470,0,0,60,60,0,1,0,1,0
42116,56532,445,0,0,70,70,0,1,0,1,0
42117,56855,445,0,0,66,66,0,1,0,1,0
42118,47210,50584,0,0,146,146,0,1,0,1,0
42119,56846,445,0,0,66,66,0,1,0,1,0
42120,65096,37807,0,0,66,66,0,1,0,1,0
42121,56380,36829,0,0,66,66,0,1,0,1,0
42122,25067,50265,0,0,145,145,0,1,0,1,0
42123,17010,57470,0,0,62,62,0,1,0,1,0
42124,19004,51505,0,0,66,66,0,1,0,1,0
42125,45941,23386,0,0,60,60,0,1,0,1,0
42126,56528,445,0,0,70,70,0,1,0,1,0
42127,61447,445,0,0,70,70,0,1,0,1,0
42128,61444,445,0,0,70,70,0,1,0,1,0
42129,61443,445,0,0,70,70,0,1,0,1,0
42130,56840,445,0,0,66,66,0,1,0,1,0
42131,56838,445,0,0,66,66,0,1,0,1,0
42132,56839,445,0,0,66,66,0,1,0,1,0
42133,56835,445,0,0,66,66,0,1,0,1,0
42134,56834,445,0,0,66,66,0,1,0,1,0
42135,56836,445,0,0,66,66,0,1,0,1,0
42136,56837,445,0,0,66,66,0,1,0,1,0
42137,56832,445,0,0,66,66,0,1,0,1,0
42138,56519,445,0,0,70,70,0,1,0,1,0
42139,56516,445,0,0,70,70,0,1,0,1,0
42140,56517,445,0,0,70,70,0,1,0,1,0
42141,56514,445,0,0,70,70,0,1,0,1,0
42142,35120,26467,0,0,62,62,0,1,0,1,0
42143,42465,57470,0,0,60,60,0,1,0,1,0
42144,56511,445,0,0,70,70,0,1,0,1,0
42145,21459,23,0,0,60,60,0,1,0,1,0
42146,41586,1900,0,0,139,139,0,1,0,1,0
42147,3730,37965,0,0,62,62,0,1,0,1,0
42148,46108,48817,0,0,145,145,0,1,0,1,0
42149,50066,30188,0,0,66,66,0,1,0,1,0
42150,62150,23718,0,0,66,66,0,1,0,1,0
42151,54167,50584,0,0,66,66,0,1,0,1,0
42152,443,20995,0,0,83,83,0,1,0,1,0
42153,1972,57470,0,0,78,78,0,1,0,1,0
42154,51676,23718,0,0,62,62,0,1,0,1,0
42155,61435,445,0,0,70,70,0,1,0,1,0
42156,61428,445,0,0,70,70,0,1,0,1,0
42157,56505,445,0,0,70,70,0,1,0,1,0
42158,56817,445,0,0,66,66,0,1,0,1,0
42159,56820,445,0,0,66,66,0,1,0,1,0
42160,56819,445,0,0,66,66,0,1,0,1,0
42161,53003,11392,0,0,66,66,0,1,0,1,0
42162,5617,64147,0,0,62,62,0,1,0,1,0
42163,61425,445,0,0,70,70,0,1,0,1,0
42164,0,0,0,0,320,320,0,5,0,5,0
42165,63927,50265,0,0,62,62,0,1,0,1,0
42166,45832,51050,0,0,62,62,0,1,0,1,0
42167,61423,445,0,0,70,70,0,1,0,1,0
42168,56498,445,0,0,70,70,0,1,0,1,0
42169,50881,50584,0,0,66,66,0,1,0,1,0
42170,2828,35253,0,0,66,66,0,1,0,1,0
42171,56496,445,0,0,70,70,0,1,0,1,0
42172,61420,445,0,0,70,70,0,1,0,1,0
42173,61417,445,0,0,70,70,0,1,0,1,0
42174,61414,445,0,0,70,70,0,1,0,1,0
42175,1038,37965,0,0,62,62,0,1,0,1,0
42176,60052,37965,0,0,66,66,0,1,0,1,0
42177,64362,35253,0,0,146,146,0,1,0,1,0
42178,65317,51221,0,0,78,78,0,1,0,1,0
42179,56491,445,0,0,70,70,0,1,0,1,0
42180,26729,57470,0,0,66,66,0,1,0,1,0
42181,56490,445,0,0,70,70,0,1,0,1,0
42182,61406,445,0,0,70,70,0,1,0,1,0
42183,61404,445,0,0,70,70,0,1,0,1,0
42184,61403,445,0,0,70,70,0,1,0,1,0
42185,56486,445,0,0,70,70,0,1,0,1,0
42186,50470,61463,0,0,86,86,0,1,0,1,0
42187,12128,37965,0,0,62,62,0,1,0,1,0
42188,45941,23388,0,0,60,60,0,1,0,1,0
42189,56485,445,0,0,70,70,0,1,0,1,0
42190,19875,30170,0,0,145,145,0,1,0,1,0
42191,80,9918,0,0,60,60,0,1,0,1,0
42192,61945,48817,0,0,66,66,0,1,0,1,0
42193,56646,48817,0,0,62,62,0,1,0,1,0
42194,40294,28680,0,0,145,145,0,1,0,1,0
42195,58574,21247,0,0,66,66,0,1,0,1,0
42196,55642,26872,27323,26872,70,70,0,1,5,1,0
42197,5588,5588,0,0,3562,1936,1626,48,196,24,24
42198,43923,5222,15090,5222,3007,1354,1653,28,83,15,13
42199,53129,38413,41585,38413,70,70,0,1,5,1,0
42200,57335,443,6083,443,4048,3089,959,24,15,13,11
42201,34837,80,34635,80,7794,1470,6324,18,151,9,9
42202,55377,3389,55377,3389,3343,1454,1889,15,16,8,7
42203,51858,44647,20973,44647,66,66,0,1,5,1,0
42204,49258,80,49258,80,17197,1551,15646,29,27,13,16
42205,26503,80,26503,80,225609,13986,211623,285,31,134,151
42206,27005,30002,50231,30002,1780,252,1528,5,44,3,2
42207,50987,443,24921,443,3278,1962,1316,20,20,9,11
42208,53668,50678,10621,50678,70,70,0,1,5,1,0
42209,26496,80,26496,80,160989,10162,150827,189,31,81,108
42210,27992,443,34351,443,7775,3104,4671,18,76,10,8
42211,50116,443,45796,443,48255,4798,43457,100,149,47,53
42212,37309,53,0,0,82,82,0,1,30,1,0
42213,53669,59056,20109,59056,70,70,0,1,5,1,0
42214,55706,22,55706,22,252,60,192,5,14,2,3
42215,51102,443,51987,443,13990,9102,4888,28,15,16,12
42216,50124,443,10944,443,48860,5749,43111,91,147,47,44
42217,51877,13472,10032,13472,70,70,0,2,8,2,0
42218,56908,443,5972,443,187104,26358,160746,205,190,58,147
42219,34814,80,10830,80,9105,1930,7175,18,16,9,9
42220,49790,53,24988,53,190,97,93,2,30,1,1
42221,43536,443,9827,443,13710,4975,8735,22,121,9,13
42222,54660,443,15942,443,7077,3245,3832,24,173,12,12
42223,38795,40032,51125,40032,243,180,63,2,31,1,1
42224,57744,53,14767,53,198,93,105,2,31,1,1
42225,53350,443,63189,443,2950,679,2271,13,120,6,7
42226,57470,50321,43161,50321,9414,7249,2165,91,3838,76,15
42227,61688,443,16509,443,14462,3625,10837,31,63,16,15
42228,54586,161,0,0,14172,5597,8575,50,31,25,25
42229,47355,161,0,0,7809,3013,4796,28,31,14,14
42230,42162,53,42162,53,227,88,139,2,31,1,1
42231,59371,161,59371,161,2085,880,1205,10,31,5,5
42232,50719,443,22608,443,17803069,497380,17305689,17583,219,5899,11684
42233,57807,443,2939,443,9783,5855,3928,22,122,11,11
42234,49160,6889,21794,6889,311,311,0,3,1200,3,0
42235,21133,54322,33050,54322,480,149,331,2,1200,1,1
42236,47058,443,44896,443,328838,76878,251960,449,243,185,264
42237,11988,48817,0,0,66,66,0,1,0,1,0
42238,63271,52752,0,0,78,78,0,1,0,1,0
42239,56480,445,0,0,70,70,0,1,0,1,0
42240,56798,445,0,0,66,66,0,1,0,1,0
42241,61398,445,0,0,70,70,0,1,0,1,0
42242,61395,445,0,0,70,70,0,1,0,1,0
42243,23277,53733,0,0,66,66,0,1,0,1,0
42244,57987,56125,0,0,90,90,0,1,0,1,0
42245,65265,55067,0,0,66,66,0,1,0,1,0
42246,3818,37965,0,0,66,66,0,1,0,1,0
42247,56790,445,0,0,66,66,0,1,0,1,0
42248,443,20995,0,0,83,83,0,1,0,1,0
42249,60426,25988,33152,25988,70,70,0,1,5,1,0
42250,51859,35365,59521,35365,70,70,0,1,5,1,0
42251,58442,123,61048,123,184,94,90,2,30,1,1
42252,34367,443,31324,443,25205,2243,22962,41,149,17,24
42253,53671,60416,30870,60416,70,70,0,1,4,1,0
42254,27005,27016,31585,27016,876,126,750,2,30,1,1
42255,61009,27065,32929,27065,1582,1386,196,6,30,4,2
42256,49255,7000,49255,7000,2163,676,1487,14,14,7,7
42257,41410,80,40896,80,1484,877,607,11,34,6,5
42258,56909,443,38825,443,31860,21778,10082,84,190,42,42
42259,41409,80,32220,80,1484,877,607,11,34,6,5
42260,39483,443,14932,443,3884,1859,2025,20,255,10,10
42261,26500,80,26500,80,57276,6978,50298,77,30,34,43
42262,41484,443,11902,443,10024,6237,3787,22,27,11,11
42263,53670,32016,15201,32016,70,70,0,1,4,1,0
42264,64323,53,33071,53,376,126,250,2,30,1,1
42265,27005,27015,15962,27015,906,126,780,2,30,1,1
42266,27005,28115,50771,28115,910,126,784,2,30,1,1
42267,27005,28315,51531,28315,875,126,749,2,30,1,1
42268,27005,28015,54917,28015,888,126,762,2,30,1,1
42269,40695,53,6681,53,168,78,90,2,29,1,1
42270,27005,27015,43397,27015,884,126,758,2,30,1,1
42271,52125,53,31811,53,205,86,119,2,29,1,1
42272,9042,443,33866,443,15177,5713,9464,37,120,17,20
42273,56661,443,32722,443,8059,2039,6020,20,15,11,9
42274,27005,27019,20474,27019,2024,504,1520,7,33,5,2
42275,56632,80,25180,80,234,234,0,4,12,4,0
42276,28238,443,59283,443,8456,3501,4955,20,90,11,9
42277,34373,28678,41304,28678,1806,1806,0,22,224,22,0
42278,49549,443,52947,443,7896,1770,6126,26,171,13,13
42279,37314,80,28984,80,1348,844,504,13,255,8,5
42280,47650,443,47650,443,4585,1678,2907,19,28,11,8
42281,38123,443,24032,443,15449,1976,13473,32,16,16,16
42282,55367,53,25329,53,215,102,113,2,30,1,1
42283,59597,443,2305,443,10310,2469,7841,35,255,18,17
42284,53132,29384,28228,29384,70,70,0,2,8,2,0
42285,65074,53,29931,53,284,118,166,2,30,1,1
42286,56663,443,10408,443,8057,2037,6020,20,15,11,9
42287,49180,443,17664,443,888019,22655,865364,902,18,322,580
42288,49790,53,51287,53,195,102,93,2,30,1,1
42289,41037,80,6510,80,613,539,74,7,15,6,1
42290,38082,443,40503,443,9037,1851,7186,26,180,14,12
42291,56925,443,10686,443,33095,18485,14610,73,185,43,30
42292,50324,443,12034,443,13002,1895,11107,31,202,17,14
42293,38121,443,50120,443,1515436,54168,1461268,1689,16,687,1002
42294,57402,2258,57402,2258,156,156,0,3,8,3,0
42295,51860,53854,59221,53854,70,70,0,1,5,1,0
42296,60410,80,39027,80,186,64,122,4,27,2,2
42297,65337,53,53258,53,460,112,348,4,56,2,2
42298,58849,443,31441,443,1366,631,735,14,81,7,7
42299,56664,443,21855,443,8005,1985,6020,20,15,11,9
42300,60374,443,14239,443,15475,7059,8416,33,97,18,15
42301,60380,443,36908,443,24243,17180,7063,52,97,33,19
42302,49538,443,16302,443,2926,1825,1101,22,171,11,11
42303,51876,35624,28526,35624,70,70,0,2,8,2,0
42304,56830,17793,18491,17793,564,318,246,9,15,5,4
42305,26502,80,26502,80,184480,11115,173365,239,30,116,123
42306,57054,80,1820,80,25138,16043,9095,79,2410,53,26
42307,57084,443,60490,443,9905,4321,5584,27,315,13,14
42308,49219,443,60965,443,70,70,0,2,4,2,0
42309,51857,40561,47310,40561,70,70,0,1,5,1,0
42310,37712,443,12957,443,7660,2239,5421,32,255,16,16
42311,53672,20380,47465,20380,70,70,0,1,4,1,0
42312,49790,53,41551,53,195,102,93,2,29,1,1
42313,55641,61762,29914,61762,70,70,0,1,5,1,0
42314,53280,443,38767,443,4228,1083,3145,15,31,8,7
42315,27005,27016,51239,27016,888,126,762,2,30,1,1
42316,27005,27015,1608,27015,888,126,762,2,30,1,1
42317,58648,443,61974,443,7509,1262,6247,22,16,12,10
42318,51412,53,4036,53,252,78,174,2,30,1,1
42319,57508,443,43486,443,6749,2649,4100,19,142,9,10
42320,27005,28215,29356,28215,879,126,753,2,30,1,1
42321,54417,53,12775,53,259,86,173,2,30,1,1
42322,37965,33622,23125,33622,132,132,0,3,1199,3,0
42323,60427,61137,28150,61137,70,70,0,1,5,1,0
42324,59314,443,58564,443,16862,7584,9278,97,8912,60,37
42325,42630,443,10044,443,6039,1327,4712,19,121,11,8
42326,47387,443,50220,443,3930,392,3538,9,15,4,5
42327,60428,80,55142,80,20301,1264,19037,28,26,11,17
42328,57370,6969,42648,6969,70,70,0,1,5,1,0
42329,56662,443,9856,443,8007,1987,6020,20,15,11,9
42330,57507,7000,57507,7000,3562,1995,1567,16,15,9,7
42331,54618,53,15831,53,263,86,177,2,30,1,1
42332,62952,443,20995,443,1304,612,692,18,120,9,9
42333,59912,443,31539,443,7763,1354,6409,25,82,13,12
42334,57432,66,6875,66,70,70,0,2,8,2,0
42335,53540,443,65354,443,20948,4141,16807,76,616,37,39
42336,49699,443,3417,443,9968,2106,7862,27,128,14,13
42337,42090,443,42090,443,3509,1693,1816,21,96,10,11
42338,52955,443,44904,443,3617,2035,1582,30,346,15,15
42339,64708,53,55981,53,294,134,160,2,30,1,1
42340,64968,27030,53742,27030,735,462,273,2,30,1,1
42341,46009,53,4263,53,199,94,105,2,30,1,1
42342,50915,53,63317,53,168,78,90,2,30,1,1
42343,49589,53,16073,53,214,102,112,2,31,1,1
42344,62928,443,42185,443,52219,4148,48071,75,125,33,42
42345,27005,27015,24637,27015,1630,126,1504,4,31,2,2
42346,27005,27021,42135,27021,1708,126,1582,4,31,2,2
42347,27005,30015,42725,30015,1700,126,1574,4,31,2,2
42348,60295,53,27114,53,224,94,130,2,30,1,1
42349,47969,53,59484,53,199,94,105,2,30,1,1
42350,52258,443,2636,443,3757,356,3401,12,120,5,7
42351,35205,53,35205,53,240,98,142,2,30,1,1
42352,64185,53,32210,53,403,110,293,2,31,1,1
42353,38544,161,0,0,8977,3570,5407,30,31,15,15
42354,59424,443,28784,443,2288,1131,1157,25,119,12,13
42355,35145,443,40787,443,3542,1045,2497,13,120,6,7
42356,51765,443,19120,443,3026,965,2061,14,135,7,7
42357,57626,443,3957,443,3858,1277,2581,12,120,6,6
42358,53688,17106,21939,17106,70,70,0,2,8,2,0
42359,54455,443,48160,443,282,148,134,5,27,3,2
42360,56673,443,23897,443,6693,1072,5621,18,26,10,8
42361,58209,53,48023,53,259,86,173,2,30,1,1
42362,45325,53,64530,53,168,78,90,2,30,1,1
42363,55647,61042,18333,61042,320,140,180,6,7,3,3
42364,53687,51471,3936,51471,70,70,0,2,8,2,0
42365,60281,80,39760,80,1151,711,440,10,16,5,5
42366,64910,53,52147,53,259,86,173,2,30,1,1
42367,27005,27016,48849,27016,1688,126,1562,4,31,2,2
42368,27005,27016,24190,27016,1696,126,1570,4,31,2,2
42369,41230,443,13536,443,78,78,0,1,5,1,0
42370,35756,80,35756,80,364170,17670,346500,412,31,170,242
42371,51240,443,5101,443,9668,4688,4980,42,16,25,17
42372,39387,443,57166,443,204,70,134,4,26,2,2
42373,51241,443,60698,443,8083,2502,5581,40,16,22,18
42374,40358,443,63081,443,626,352,274,10,16,6,4
42375,56788,445,0,0,66,66,0,1,0,1,0
42376,61384,445,0,0,70,70,0,1,0,1,0
42377,50090,50265,0,0,66,66,0,1,0,1,0
42378,62872,50584,0,0,62,62,0,1,0,1,0
42379,33896,57470,0,0,74,74,0,1,0,1,0
42380,33193,50584,0,0,62,62,0,1,0,1,0
42381,61381,445,0,0,70,70,0,1,0,1,0
42382,61379,445,0,0,70,70,0,1,0,1,0
42383,61375,445,0,0,70,70,0,1,0,1,0
42384,56467,445,0,0,70,70,0,1,0,1,0
42385,56784,445,0,0,66,66,0,1,0,1,0
42386,10000,10214,0,0,62,62,0,1,0,1,0
42387,55565,64147,0,0,66,66,0,1,0,1,0
42388,59509,64147,0,0,62,62,0,1,0,1,0
42389,61053,44847,0,0,66,66,0,1,0,1,0
42390,42389,42873,0,0,74,74,0,1,0,1,0
42391,56464,445,0,0,70,70,0,1,0,1,0
42392,2422,50584,0,0,62,62,0,1,0,1,0
42393,61370,445,0,0,70,70,0,1,0,1,0
42394,443,20087,0,0,83,83,0,1,0,1,0
42395,15854,50584,0,0,62,62,0,1,0,1,0
42396,61368,445,0,0,70,70,0,1,0,1,0
42397,61365,445,0,0,70,70,0,1,0,1,0
42398,61366,445,0,0,70,70,0,1,0,1,0
42399,56653,22114,0,0,66,66,0,1,0,1,0
42400,52430,35440,0,0,62,62,0,1,0,1,0
42401,56778,445,0,0,66,66,0,1,0,1,0
42402,26333,23,0,0,60,60,0,1,0,1,0
42403,56776,445,0,0,66,66,0,1,0,1,0
42404,56774,445,0,0,66,66,0,1,0,1,0
42405,56773,445,0,0,66,66,0,1,0,1,0
42406,56460,445,0,0,70,70,0,1,0,1,0
42407,33563,14037,0,0,78,78,0,1,0,1,0
42408,56769,445,0,0,66,66,0,1,0,1,0
42409,56768,445,0,0,66,66,0,1,0,1,0
42410,56767,445,0,0,66,66,0,1,0,1,0
42411,56458,445,0,0,70,70,0,1,0,1,0
42412,59668,51505,0,0,66,66,0,1,0,1,0
42413,39056,22114,0,0,62,62,0,1,0,1,0
42414,56456,445,0,0,70,70,0,1,0,1,0
42415,65285,44847,0,0,62,62,0,1,0,1,0
42416,443,20995,0,0,83,83,0,1,0,1,0
42417,61361,445,0,0,70,70,0,1,0,1,0
42418,61360,445,0,0,70,70,0,1,0,1,0
42419,61363,445,0,0,70,70,0,1,0,1,0
42420,56764,445,0,0,66,66,0,1,0,1,0
42421,45941,23386,0,0,60,60,0,1,0,1,0
42422,42252,33303,0,0,60,60,0,1,0,1,0
42423,61355,445,0,0,70,70,0,1,0,1,0
42424,56761,445,0,0,66,66,0,1,0,1,0
42425,45654,67,0,0,60,60,0,1,0,1,0
42426,56759,445,0,0,66,66,0,1,0,1,0
42427,56757,445,0,0,66,66,0,1,0,1,0
42428,56755,445,0,0,66,66,0,1,0,1,0
42429,31330,15503,0,0,145,145,0,1,0,1,0
42430,56449,445,0,0,70,70,0,1,0,1,0
42431,28897,35440,0,0,66,66,0,1,0,1,0
42432,60168,35440,0,0,66,66,0,1,0,1,0
42433,56447,445,0,0,70,70,0,1,0,1,0
42434,65064,30188,0,0,66,66,0,1,0,1,0
42435,61350,445,0,0,70,70,0,1,0,1,0
42436,56446,445,0,0,70,70,0,1,0,1,0
42437,51413,48637,0,0,72,72,0,1,0,1,0
42438,56445,445,0,0,70,70,0,1,0,1,0
42439,61341,445,0,0,70,70,0,1,0,1,0
42440,61338,445,0,0,70,70,0,1,0,1,0
42441,56444,445,0,0,70,70,0,1,0,1,0
42442,443,20995,0,0,83,83,0,1,0,1,0
42443,56442,445,0,0,70,70,0,1,0,1,0
42444,56438,445,0,0,70,70,0,1,0,1,0
42445,60646,11392,0,0,66,66,0,1,0,1,0
42446,7273,64147,0,0,66,66,0,1,0,1,0
42447,28754,50584,0,0,66,66,0,1,0,1,0
42448,20005,37965,0,0,62,62,0,1,0,1,0
42449,56456,1433,0,0,60,60,0,1,0,1,0
42450,56745,445,0,0,66,66,0,1,0,1,0
42451,62068,64147,0,0,66,66,0,1,0,1,0
42452,56426,445,0,0,70,70,0,1,0,1,0
42453,56425,445,0,0,70,70,0,1,0,1,0
42454,56423,445,0,0,70,70,0,1,0,1,0
42455,60126,35440,0,0,66,66,0,1,0,1,0
42456,56415,445,0,0,70,70,0,1,0,1,0
42457,56416,445,0,0,70,70,0,1,0,1,0
42458,6881,21416,0,0,146,146,0,1,0,1,0
42459,32727,23,0,0,60,60,0,1,0,1,0
42460,56737,445,0,0,66,66,0,1,0,1,0
42461,41220,59356,0,0,62,62,0,1,0,1,0
42462,61327,445,0,0,70,70,0,1,0,1,0
42463,52200,23,0,0,60,60,0,1,0,1,0
42464,56734,445,0,0,66,66,0,1,0,1,0
42465,45342,443,2921,443,2378,1382,996,20,21,11,9
42466,10775,35440,0,0,66,66,0,1,0,1,0
42467,28764,2323,0,0,60,60,0,1,0,1,0
42468,56404,445,0,0,70,70,0,1,0,1,0
42469,51910,37965,0,0,62,62,0,1,0,1,0
42470,53090,59356,0,0,66,66,0,1,0,1,0
42471,40185,64147,0,0,66,66,0,1,0,1,0
42472,33012,50265,0,0,145,145,0,1,0,1,0
42473,443,20995,0,0,83,83,0,1,0,1,0
42474,65526,28793,0,0,66,66,0,1,0,1,0
42475,14350,56205,0,0,146,146,0,1,0,1,0
42476,42465,57470,0,0,60,60,0,1,0,1,0
42477,56719,445,0,0,66,66,0,1,0,1,0
42478,34306,37965,0,0,62,62,0,1,0,1,0
42479,63779,26467,0,0,62,62,0,1,0,1,0
42480,52282,37965,0,0,66,66,0,1,0,1,0
42481,45941,23388,0,0,60,60,0,1,0,1,0
42482,56399,445,0,0,70,70,0,1,0,1,0
42483,38093,11392,0,0,146,146,0,1,0,1,0
42484,23969,57470,0,0,62,62,0,1,0,1,0
42485,10886,51505,0,0,62,62,0,1,0,1,0
42486,61085,37965,0,0,62,62,0,1,0,1,0
42487,49305,57470,0,0,66,66,0,1,0,1,0
42488,1972,57470,0,0,78,78,0,1,0,1,0
42489,56390,445,0,0,70,70,0,1,0,1,0
42490,56391,445,0,0,70,70,0,1,0,1,0
42491,56389,445,0,0,70,70,0,1,0,1,0
42492,61318,445,0,0,70,70,0,1,0,1,0
42493,61315,445,0,0,70,70,0,1,0,1,0
42494,61316,445,0,0,70,70,0,1,0,1,0
42495,56369,22114,0,0,62,62,0,1,0,1,0
42496,1523,22,0,0,60,60,0,1,0,1,0
42497,56387,445,0,0,70,70,0,1,0,1,0
42498,56706,445,0,0,66,66,0,1,0,1,0
42499,56710,445,0,0,66,66,0,1,0,1,0
42500,56709,445,0,0,66,66,0,1,0,1,0
42501,56707,445,0,0,66,66,0,1,0,1,0
42502,56704,445,0,0,66,66,0,1,0,1,0
42503,56712,445,0,0,66,66,0,1,0,1,0
42504,56711,445,0,0,66,66,0,1,0,1,0
42505,56705,445,0,0,66,66,0,1,0,1,0
42506,56383,445,0,0,70,70,0,1,0,1,0
42507,45682,1,0,0,62,62,0,1,0,1,0
42508,57612,28793,0,0,66,66,0,1,0,1,0
42509,41022,30975,0,0,157,157,0,1,0,1,0
42510,52144,49344,0,0,62,62,0,1,0,1,0
42511,1040,37965,0,0,62,62,0,1,0,1,0
42512,59435,37807,0,0,66,66,0,1,0,1,0
42513,65317,51221,0,0,78,78,0,1,0,1,0
42514,26085,51221,0,0,72,72,0,1,0,1,0
42515,57987,56125,0,0,90,90,0,1,0,1,0
42516,15641,26467,0,0,62,62,0,1,0,1,0
42517,60423,35440,0,0,62,62,0,1,0,1,0
42518,31995,61689,0,0,146,146,0,1,0,1,0
42519,61313,445,0,0,70,70,0,1,0,1,0
42520,56377,445,0,0,70,70,0,1,0,1,0
42521,61307,445,0,0,70,70,0,1,0,1,0
42522,61301,445,0,0,70,70,0,1,0,1,0
42523,63288,52848,0,0,66,66,0,1,0,1,0
42524,58226,52848,0,0,62,62,0,1,0,1,0
42525,9473,26467,0,0,66,66,0,1,0,1,0
42526,56690,445,0,0,66,66,0,1,0,1,0
42527,56691,445,0,0,66,66,0,1,0,1,0
42528,56689,445,0,0,66,66,0,1,0,1,0
42529,36227,23,0,0,60,60,0,1,0,1,0
42530,50901,26467,0,0,66,66,0,1,0,1,0
42531,61298,445,0,0,70,70,0,1,0,1,0
42532,56370,445,0,0,70,70,0,1,0,1,0
42533,52830,22114,0,0,146,146,0,1,0,1,0
42534,56367,445,0,0,70,70,0,1,0,1,0
42535,55386,37965,0,0,66,66,0,1,0,1,0
42536,12226,37965,0,0,62,62,0,1,0,1,0
42537,61295,445,0,0,70,70,0,1,0,1,0
42538,61294,445,0,0,70,70,0,1,0,1,0
42539,61292,445,0,0,70,70,0,1,0,1,0
42540,61288,445,0,0,70,70,0,1,0,1,0
42541,56752,44847,0,0,66,66,0,1,0,1,0
42542,17532,23,0,0,60,60,0,1,0,1,0
42543,56363,445,0,0,70,70,0,1,0,1,0
42544,56362,445,0,0,70,70,0,1,0,1,0
42545,33595,23,0,0,60,60,0,1,0,1,0
42546,26799,6881,0,0,146,146,0,1,0,1,0
42547,58207,51505,0,0,66,66,0,1,0,1,0
42548,47910,7461,0,0,60,60,0,1,0,1,0
42549,61510,37965,0,0,66,66,0,1,0,1,0
42550,56358,445,0,0,70,70,0,1,0,1,0
42551,59352,37965,0,0,66,66,0,1,0,1,0
42552,63271,52752,0,0,78,78,0,1,0,1,0
42553,51412,51505,0,0,62,62,0,1,0,1,0
42554,45405,161,0,0,5858,2302,3556,22,30,11,11
42555,32833,53,32833,53,227,88,139,2,30,1,1
42556,22199,443,22199,443,79787,12741,67046,117,31,65,52
42557,22773,443,22773,443,6993,960,6033,17,31,10,7
42558,54553,443,44028,443,68345,58488,9857,122,329,62,60
42559,56840,20413,10874,20413,70,70,0,2,8,2,0
42560,35753,80,35753,80,158890,11318,147572,182,30,74,108
42561,60374,80,60374,80,118413,7486,110927,151,33,70,81
42562,27331,443,27331,443,1251,722,529,11,147,6,5
42563,26961,443,26961,443,1251,722,529,11,147,6,5
42564,5588,5588,0,0,3562,1936,1626,48,193,24,24
42565,56680,161,0,0,15721,6203,9518,50,30,25,25
42566,51385,161,51385,161,2315,979,1336,10,30,5,5
42567,8069,80,8069,80,638,306,332,11,84,6,5
42568,56976,80,37703,80,214,140,74,4,35,3,1
42569,8389,80,8389,80,1700,1073,627,15,84,8,7
42570,62440,443,45155,443,28183,7016,21167,51,45,23,28
42571,26504,443,26504,443,1251,722,529,11,147,6,5
42572,39287,53,1937,53,198,93,105,2,30,1,1
42573,45000,443,43427,443,2227,1018,1209,17,16,8,9
42574,56978,80,63683,80,214,140,74,4,35,3,1
42575,49181,2710,52440,2710,66,66,0,1,5,1,0
42576,27008,443,27008,443,1251,722,529,11,147,6,5
42577,39915,443,44120,443,6922156,117604,6804552,6122,50,1519,4603
42578,43310,443,13938,443,60,60,0,1,5,1,0
42579,10344,80,10344,80,6705,702,6003,13,16,6,7
42580,56975,80,23804,80,214,140,74,4,35,3,1
42581,56988,80,5679,80,214,140,74,4,35,3,1
42582,56624,443,46421,443,12807,129,12678,13,147,2,11
42583,47748,161,0,0,6387,2535,3852,22,30,11,11
42584,54234,80,54234,80,2334,1575,759,11,148,6,5
42585,22678,443,22678,443,18172,3573,14599,39,26,20,19
42586,35755,80,35755,80,201552,13184,188368,245,30,111,134
42587,22939,443,22939,443,6993,960,6033,17,31,10,7
42588,35752,80,35752,80,871846,24071,847775,900,30,326,574
42589,22376,443,22376,443,6620,3193,3427,23,26,13,10
42590,22404,443,22404,443,5576,2436,3140,21,26,12,9
42591,38852,443,38852,443,4747,1840,2907,19,28,11,8
42592,43309,443,32781,443,60,60,0,1,5,1,0
42593,16262,80,16262,80,14671,951,13720,23,16,10,13
42594,60112,443,25865,443,572,280,292,9,16,5,4
42595,8160,80,8160,80,1670,1044,626,15,84,8,7
42596,56828,53156,12395,53156,66,66,0,1,5,1,0
42597,53660,18599,61340,18599,492,306,186,8,16,5,3
42598,56979,80,46084,80,214,140,74,4,35,3,1
42599,55645,18904,52547,18904,320,140,180,6,6,3,3
42600,51077,13021,36103,13021,154976,25739,129237,605,387,321,284
42601,51874,43161,58126,43161,70,70,0,2,8,2,0
42602,27005,27016,32182,27016,1648,126,1522,4,30,2,2
42603,57577,443,53525,443,4752,2561,2191,32,256,16,16
42604,56977,80,20065,80,214,140,74,4,35,3,1
42605,64216,53,64216,53,220,100,120,2,30,1,1
42606,61053,443,61053,443,40415,2911,37504,57,18,27,30
42607,8485,80,8485,80,572,240,332,10,84,5,5
42608,41528,161,0,0,14381,5620,8761,50,30,25,25
42609,53132,22448,0,0,66,66,0,1,90,1,0
42610,50265,38203,29229,38203,480,149,331,2,1200,1,1
42611,53685,38978,44279,38978,70,70,0,2,8,2,0
42612,43308,443,4843,443,120,120,0,2,5,2,0
42613,53681,31466,64750,31466,70,70,0,2,8,2,0
42614,57878,80,49228,80,5518,527,4991,13,75,6,7
42615,54028,443,7656,443,11123,4258,6865,48,197,27,21
42616,27005,27015,49049,27015,1610,126,1484,4,30,2,2
42617,64091,443,50015,443,3258,1197,2061,14,136,7,7
42618,60306,443,16522,443,2866,623,2243,13,136,6,7
42619,55288,443,7334,443,15679,1532,14147,16,139,3,13
42620,27005,30002,14816,30002,1652,126,1526,4,31,2,2
42621,61275,445,0,0,70,70,0,1,0,1,0
42622,61276,445,0,0,70,70,0,1,0,1,0
42623,61273,445,0,0,70,70,0,1,0,1,0
42624,34273,36829,0,0,146,146,0,1,0,1,0
42625,56357,445,0,0,70,70,0,1,0,1,0
42626,50341,37965,0,0,62,62,0,1,0,1,0
42627,54028,37965,0,0,66,66,0,1,0,1,0
42628,49191,35440,0,0,62,62,0,1,0,1,0
42629,29011,32468,0,0,66,66,0,1,0,1,0
42630,15403,51505,0,0,66,66,0,1,0,1,0
42631,54869,35440,0,0,146,146,0,1,0,1,0
42632,62115,57470,0,0,66,66,0,1,0,1,0
42633,53294,443,27871,443,7740,4267,3473,39,97,21,18
42634,23066,443,23066,443,5573,2434,3139,21,25,12,9
42635,56980,80,6065,80,214,140,74,4,35,3,1
42636,7660,443,7660,443,5640,2394,3246,25,82,13,12
42637,60426,57470,0,0,62,62,0,1,0,1,0
42638,64605,35993,0,0,66,66,0,1,0,1,0
42639,56670,445,0,0,66,66,0,1,0,1,0
42640,61270,445,0,0,70,70,0,1,0,1,0
42641,61268,445,0,0,70,70,0,1,0,1,0
42642,37662,2323,0,0,60,60,0,1,0,1,0
42643,6712,5632,0,0,60,60,0,1,0,1,0
42644,50470,61463,0,0,86,86,0,1,0,1,0
42645,29787,37965,0,0,62,62,0,1,0,1,0
42646,55373,1,0,0,66,66,0,1,0,1,0
42647,56662,445,0,0,66,66,0,1,0,1,0
42648,56339,445,0,0,70,70,0,1,0,1,0
42649,50025,53,43960,53,536,120,416,4,59,2,2
42650,49760,1443,52471,1443,626,352,274,10,15,6,4
42651,60375,80,60375,80,172473,8713,163760,205,33,91,114
42652,35754,80,35754,80,141193,10612,130581,165,30,69,96
42653,49928,443,22562,443,9330,2410,6920,25,81,13,12
42654,7797,443,7797,443,1474,697,777,18,82,8,10
42655,43156,53,17212,53,168,78,90,2,29,1,1
42656,65001,53,54840,53,224,78,146,2,30,1,1
42657,58278,443,51446,443,7349712,213635,7136077,7600,192,2303,5297
42658,35094,53,9610,53,371,94,277,2,30,1,1
42659,40941,443,61408,443,9794,2178,7616,26,48,16,10
42660,38936,80,38936,80,8429,1098,7331,16,20,8,8
42661,53278,443,21560,443,38395,6930,31465,56,30,27,29
42662,2777,23,2777,23,130,66,64,2,4,1,1
42663,56602,443,24699,443,27035,4207,22828,43,31,21,22
42664,56799,443,31346,443,6496,1340,5156,31,506,10,21
42665,53682,20884,39828,20884,70,70,0,2,7,2,0
42666,60376,80,60376,80,180425,10839,169586,213,33,93,120
42667,53686,8999,46759,8999,70,70,0,2,7,2,0
42668,35751,80,35751,80,336615,15190,321425,383,31,159,224
42669,27005,27015,42995,27015,1758,252,1506,5,32,3,2
42670,49229,53,37715,53,243,110,133,2,29,1,1
42671,59222,53,30617,53,181,86,95,2,30,1,1
42672,53102,53,13819,53,70,70,0,1,30,1,0
42673,57388,53,31918,53,266,86,180,2,30,1,1
42674,42487,443,53584,443,4887,895,3992,16,29,9,7
42675,49940,443,49940,443,13342,2357,10985,25,18,14,11
42676,61040,443,61040,443,4886,1530,3356,17,17,10,7
42677,57373,443,61209,443,5620,927,4693,17,15,10,7
42678,56989,80,28425,80,526,304,222,8,35,5,3
42679,6881,6881,56925,6881,238,118,120,2,1200,1,1
42680,50494,80,52508,80,18059,13615,4444,29,27,16,13
42681,56658,53,56658,53,257,114,143,2,30,1,1
42682,59743,80,42514,80,815748,15896,799852,777,90,244,533
42683,50508,443,58389,443,7588,1850,5738,19,25,10,9
42684,51873,19311,58554,19311,70,70,0,2,7,2,0
42685,54961,443,58980,443,1015861,30762,985099,1147,257,421,726
42686,56659,443,54837,443,8058,2038,6020,20,15,11,9
42687,49523,53,19380,53,314,93,221,4,43,2,2
42688,7928,80,7928,80,25909,3016,22893,40,83,15,25
42689,37941,443,61204,443,69429,16478,52951,156,182,83,73
42690,50474,80,43879,80,19357,10244,9113,36,27,19,17
42691,56987,80,45961,80,214,140,74,4,35,3,1
42692,56986,80,18351,80,214,140,74,4,35,3,1
42693,56984,80,27269,80,214,140,74,4,35,3,1
42694,23023,80,23023,80,2270,1645,625,9,26,6,3
42695,8167,443,8167,443,1474,697,777,18,82,8,10
42696,40806,8000,49174,8000,1259,639,620,20,300,10,10
42697,51481,53,20508,53,168,78,90,2,30,1,1
42698,55952,443,28479,443,24272,12428,11844,70,213,32,38
42699,51073,80,13586,80,525373,237667,287706,1387,390,693,694
42700,50408,7000,50408,7000,3132,815,2317,14,18,7,7
42701,48105,53,48105,53,262,106,156,2,33,1,1
42702,51875,25072,31017,25072,70,70,0,2,7,2,0
42703,4956,53,4956,53,203,82,121,2,30,1,1
42704,60399,161,0,0,18789,5169,13620,54,30,27,27
42705,53125,10693,11015,10693,954,454,500,14,21,8,6
42706,51856,62841,45068,62841,136,136,0,3,13,3,0
42707,51855,23268,16577,23268,70,70,0,1,5,1,0
42708,62439,443,26291,443,16246,11056,5190,37,45,21,16
42709,32967,80,37431,80,21387,1482,19905,38,18,19,19
42710,22,15260,22,15260,130,70,60,2,15,1,1
42711,8024,80,8024,80,572,240,332,10,83,5,5
42712,64530,53,46090,53,211,102,109,2,30,1,1
42713,38260,443,50232,443,7173,1419,5754,32,383,11,21
42714,58847,443,24312,443,3143,1064,2079,18,82,8,10
42715,35915,443,57098,443,1786,172,1614,7,120,3,4
42716,60369,80,60369,80,266818,12375,254443,285,34,107,178
42717,57066,443,13444,443,556770,88286,468484,777,202,314,463
42718,27005,27016,56355,27016,1646,126,1520,4,31,2,2
42719,43087,443,6969,443,4909,1007,3902,14,35,8,6
42720,56660,443,63035,443,8006,1986,6020,20,15,11,9
42721,13743,80,13743,80,724,366,358,11,142,6,5
42722,27563,443,27563,443,1181,722,459,10,147,6,4
42723,53689,42719,61267,42719,70,70,0,2,7,2,0
42724,57790,443,8937,443,117653,21783,95870,251,556,93,158
42725,10038,443,58313,443,7481,2070,5411,25,315,12,13
42726,47120,443,47120,443,4604,1697,2907,19,29,11,8
42727,62441,443,36404,443,4651,3116,1535,19,44,10,9
42728,22592,443,22592,443,29021,6752,22269,48,30,29,19
42729,7934,443,7934,443,6593,3073,3520,27,82,14,13
42730,49502,53,35075,53,179,86,93,2,29,1,1
42731,59262,80,59262,80,94514,14468,80046,152,15,41,111
42732,23022,443,23022,443,10943,5186,5757,32,25,18,14
42733,56985,80,59526,80,214,140,74,4,35,3,1
42734,57184,53,36086,53,272,94,178,2,29,1,1
42735,22205,443,22205,443,10793,2049,8744,23,30,14,9
42736,43743,53,43743,53,240,98,142,2,29,1,1
42737,56981,80,19891,80,214,140,74,4,35,3,1
42738,43039,53,27551,53,168,78,90,2,29,1,1
42739,61217,53,50317,53,281,94,187,2,30,1,1
42740,55552,53,60195,53,211,102,109,2,30,1,1
42741,27005,28515,30330,28515,1660,126,1534,4,30,2,2
42742,27005,27017,47971,27017,1616,126,1490,4,30,2,2
42743,49182,53,44371,53,211,102,109,2,30,1,1
42744,55531,53,57594,53,370,126,244,2,30,1,1
42745,60121,161,0,0,8215,3237,4978,30,30,15,15
42746,50502,123,1103,123,184,94,90,2,30,1,1
42747,33027,161,0,0,15505,6180,9325,50,30,25,25
42748,53512,53,23746,53,168,78,90,2,30,1,1
42749,61567,53,3917,53,183,86,97,2,30,1,1
42750,34044,161,0,0,18549,5061,13488,54,30,27,27
42751,6881,48533,62658,48533,502,150,352,2,1199,1,1
42752,57791,443,18201,443,30057,13955,16102,146,556,65,81
42753,60276,80,60276,80,671,313,358,7,75,4,3
42754,56990,80,57120,80,214,140,74,4,35,3,1
42755,53471,161,0,0,5907,2302,3605,22,30,11,11
42756,64438,53,23542,53,211,102,109,2,30,1,1
42757,56852,6057,3356,6057,2499,2499,0,22,300,22,0
42758,48962,161,0,0,8507,3320,5187,28,30,14,14
42759,65166,53,40990,53,211,102,109,2,30,1,1
42760,49826,80,54409,80,6311,4340,1971,20,186,12,8
42761,64679,53,17226,53,211,102,109,2,31,1,1
42762,60921,443,60921,443,4886,1530,3356,17,17,10,7
42763,62295,443,30041,443,3538,2015,1523,28,325,14,14
42764,56983,80,30863,80,214,140,74,4,35,3,1
42765,56982,80,63526,80,214,140,74,4,35,3,1
42766,8583,443,8583,443,19994,4745,15249,47,82,21,26
42767,8168,443,8168,443,10130,4701,5429,34,82,18,16
42768,41486,443,65300,443,204,70,134,4,26,2,2
42769,65039,53,3857,53,302,102,200,2,30,1,1
42770,23769,53,45289,53,334,226,108,3,30,2,1
42771,64430,53,41812,53,493,91,402,4,31,2,2
42772,49565,53,54064,53,768,193,575,6,40,3,3
42773,22807,443,22807,443,4518,1665,2853,19,25,11,8
42774,22983,443,22983,443,205941,20753,185188,264,30,129,135
42775,56658,443,31194,443,8007,1987,6020,20,15,11,9
42776,49736,443,25787,443,8028,1787,6241,32,28,17,15
42777,64703,53,13570,53,214,102,112,2,30,1,1
42778,56529,53,10690,53,378,94,284,2,30,1,1
42779,46398,443,65303,443,12982,7168,5814,50,165,23,27
42780,27005,27022,35280,27022,1654,126,1528,4,31,2,2
42781,17750,12550,53024,12550,491,150,341,2,1200,1,1
42782,27005,27018,36101,27018,1634,126,1508,4,31,2,2
42783,27005,27019,51161,27019,1698,126,1572,4,31,2,2
42784,61766,443,43724,443,4326,2217,2109,14,120,7,7
42785,56648,443,37098,443,1327,918,409,10,26,6,4
42786,63853,10659,14752,10659,66,66,0,2,8,2,0
42787,48839,443,60350,443,111590,17663,93927,212,115,93,119
42788,49936,80,9467,80,1130,613,517,11,15,6,5
42789,64096,443,64096,443,5661,2415,3246,26,160,14,12
42790,61286,443,41653,443,248071,7320,240751,269,268,89,180
42791,65361,53,22669,53,249,94,155,2,30,1,1
42792,49615,53,9854,53,276,94,182,2,30,1,1
42793,56655,443,7969,443,1272,876,396,10,26,6,4
42794,49737,443,13001,443,37094,22774,14320,125,27,72,53
42795,64824,53,60323,53,94,94,0,1,30,1,0
42796,27005,27015,55058,27015,1666,126,1540,4,31,2,2
42797,56646,443,10246,443,1327,918,409,10,26,6,4
42798,59291,53,59291,53,197,90,107,2,30,1,1
42799,56660,445,0,0,66,66,0,1,0,1,0
42800,61256,445,0,0,70,70,0,1,0,1,0
42801,61252,445,0,0,70,70,0,1,0,1,0
42802,61248,445,0,0,70,70,0,1,0,1,0
42803,61247,445,0,0,70,70,0,1,0,1,0
42804,55459,50584,0,0,66,66,0,1,0,1,0
42805,56656,445,0,0,66,66,0,1,0,1,0
42806,33563,14037,0,0,78,78,0,1,0,1,0
42807,34247,48817,0,0,145,145,0,1,0,1,0
42808,56336,445,0,0,70,70,0,1,0,1,0
42809,54989,50265,0,0,66,66,0,1,0,1,0
42810,51313,64147,0,0,66,66,0,1,0,1,0
42811,50292,62413,0,0,62,62,0,1,0,1,0
42812,46518,44847,0,0,62,62,0,1,0,1,0
42813,60312,57470,0,0,74,74,0,1,0,1,0
42814,11136,15503,0,0,62,62,0,1,0,1,0
42815,61240,445,0,0,70,70,0,1,0,1,0
42816,61236,445,0,0,70,70,0,1,0,1,0
42817,61237,445,0,0,70,70,0,1,0,1,0
42818,38683,17,0,0,60,60,0,1,0,1,0
42819,56649,445,0,0,66,66,0,1,0,1,0
42820,56331,445,0,0,70,70,0,1,0,1,0
42821,56330,445,0,0,70,70,0,1,0,1,0
42822,56643,445,0,0,66,66,0,1,0,1,0
42823,56648,445,0,0,66,66,0,1,0,1,0
42824,56645,445,0,0,66,66,0,1,0,1,0
42825,34809,57470,0,0,66,66,0,1,0,1,0
42826,56328,445,0,0,70,70,0,1,0,1,0
42827,56640,445,0,0,66,66,0,1,0,1,0
42828,56641,445,0,0,66,66,0,1,0,1,0
42829,56638,445,0,0,66,66,0,1,0,1,0
42830,1026,30188,0,0,62,62,0,1,0,1,0
42831,45964,3111,0,0,60,60,0,1,0,1,0
42832,62625,37965,0,0,66,66,0,1,0,1,0
42833,17579,57470,0,0,62,62,0,1,0,1,0
42834,65388,55783,0,0,66,66,0,1,0,1,0
42835,24041,55783,0,0,62,62,0,1,0,1,0
42836,61235,445,0,0,70,70,0,1,0,1,0
42837,61230,445,0,0,70,70,0,1,0,1,0
42838,61229,445,0,0,70,70,0,1,0,1,0
42839,26921,57470,0,0,62,62,0,1,0,1,0
42840,56635,445,0,0,66,66,0,1,0,1,0
42841,61227,445,0,0,70,70,0,1,0,1,0
42842,56633,445,0,0,66,66,0,1,0,1,0
42843,54118,6004,0,0,66,66,0,1,0,1,0
42844,56321,445,0,0,70,70,0,1,0,1,0
42845,56631,445,0,0,66,66,0,1,0,1,0
42846,56630,445,0,0,66,66,0,1,0,1,0
42847,22399,22,0,0,60,60,0,1,0,1,0
42848,56627,445,0,0,66,66,0,1,0,1,0
42849,56319,445,0,0,70,70,0,1,0,1,0
42850,57174,57470,0,0,66,66,0,1,0,1,0
42851,10028,25604,0,0,62,62,0,1,0,1,0
42852,35461,44847,0,0,146,146,0,1,0,1,0
42853,61336,61689,0,0,66,66,0,1,0,1,0
42854,31021,35440,0,0,146,146,0,1,0,1,0
42855,61195,56205,0,0,66,66,0,1,0,1,0
42856,56318,445,0,0,70,70,0,1,0,1,0
42857,56944,35894,0,0,62,62,0,1,0,1,0
42858,46701,1433,0,0,60,60,0,1,0,1,0
42859,50991,443,38073,443,6448,2376,4072,22,2,10,12
42860,56317,445,0,0,70,70,0,1,0,1,0
42861,58743,35894,0,0,66,66,0,1,0,1,0
42862,48283,42873,0,0,66,66,0,1,0,1,0
42863,56316,445,0,0,70,70,0,1,0,1,0
42864,1024,29892,0,0,145,145,0,1,0,1,0
42865,56312,445,0,0,70,70,0,1,0,1,0
42866,56310,445,0,0,70,70,0,1,0,1,0
42867,61222,445,0,0,70,70,0,1,0,1,0
42868,4257,35440,0,0,62,62,0,1,0,1,0
42869,47037,1,0,0,62,62,0,1,0,1,0
42870,59889,30188,0,0,66,66,0,1,0,1,0
42871,61218,445,0,0,70,70,0,1,0,1,0
42872,61210,445,0,0,70,70,0,1,0,1,0
42873,57987,56125,0,0,90,90,0,1,0,1,0
42874,24949,47224,0,0,145,145,0,1,0,1,0
42875,52410,8604,0,0,66,66,0,1,0,1,0
42876,56298,445,0,0,70,70,0,1,0,1,0
42877,56297,445,0,0,70,70,0,1,0,1,0
42878,56616,445,0,0,66,66,0,1,0,1,0
42879,56291,445,0,0,70,70,0,1,0,1,0
42880,56288,445,0,0,70,70,0,1,0,1,0
42881,56287,445,0,0,70,70,0,1,0,1,0
42882,37420,44847,0,0,66,66,0,1,0,1,0
42883,44849,46478,0,0,74,74,0,1,0,1,0
42884,9529,26467,0,0,62,62,0,1,0,1,0
42885,52705,42873,0,0,66,66,0,1,0,1,0
42886,42465,57470,0,0,60,60,0,1,0,1,0
42887,56609,445,0,0,66,66,0,1,0,1,0
42888,61199,445,0,0,70,70,0,1,0,1,0
42889,49248,35993,0,0,66,66,0,1,0,1,0
42890,64681,35993,0,0,66,66,0,1,0,1,0
42891,56276,445,0,0,70,70,0,1,0,1,0
42892,56606,445,0,0,66,66,0,1,0,1,0
42893,59965,36237,0,0,66,66,0,1,0,1,0
42894,1972,57470,0,0,78,78,0,1,0,1,0
42895,28824,44847,0,0,66,66,0,1,0,1,0
42896,56376,44847,0,0,66,66,0,1,0,1,0
42897,56600,445,0,0,66,66,0,1,0,1,0
42898,48755,23,0,0,60,60,0,1,0,1,0
42899,57665,52700,0,0,66,66,0,1,0,1,0
42900,56595,445,0,0,66,66,0,1,0,1,0
42901,17561,52700,0,0,62,62,0,1,0,1,0
42902,0,0,0,0,124,64,60,2,0,1,1
42903,13285,29892,0,0,145,145,0,1,0,1,0
42904,1024,64147,0,0,62,62,0,1,0,1,0
42905,56272,445,0,0,70,70,0,1,0,1,0
42906,30783,51505,0,0,62,62,0,1,0,1,0
42907,10348,25604,0,0,66,66,0,1,0,1,0
42908,443,20087,0,0,83,83,0,1,0,1,0
42909,51093,57470,0,0,66,66,0,1,0,1,0
42910,54305,26467,0,0,66,66,0,1,0,1,0
42911,45964,7776,0,0,60,60,0,1,0,1,0
42912,56263,445,0,0,70,70,0,1,0,1,0
42913,56260,445,0,0,70,70,0,1,0,1,0
42914,56261,445,0,0,70,70,0,1,0,1,0
42915,56259,445,0,0,70,70,0,1,0,1,0
42916,51818,37965,0,0,66,66,0,1,0,1,0
42917,28364,23,0,0,60,60,0,1,0,1,0
42918,56256,445,0,0,70,70,0,1,0,1,0
42919,61192,445,0,0,70,70,0,1,0,1,0
42920,61189,445,0,0,70,70,0,1,0,1,0
42921,61187,445,0,0,70,70,0,1,0,1,0
42922,56579,445,0,0,66,66,0,1,0,1,0
42923,56580,445,0,0,66,66,0,1,0,1,0
42924,56582,445,0,0,66,66,0,1,0,1,0
42925,56584,445,0,0,66,66,0,1,0,1,0
42926,56583,445,0,0,66,66,0,1,0,1,0
42927,56581,445,0,0,66,66,0,1,0,1,0
42928,56577,445,0,0,66,66,0,1,0,1,0
42929,56576,445,0,0,66,66,0,1,0,1,0
42930,58131,30228,0,0,146,146,0,1,0,1,0
42931,6666,21,0,0,60,60,0,1,0,1,0
42932,40521,23117,0,0,66,66,0,1,0,1,0
42933,51183,56205,0,0,62,62,0,1,0,1,0
42934,27407,36237,0,0,146,146,0,1,0,1,0
42935,57234,21247,0,0,66,66,0,1,0,1,0
42936,1035,26467,0,0,62,62,0,1,0,1,0
42937,49976,5900,0,0,60,60,0,1,0,1,0
42938,56249,445,0,0,70,70,0,1,0,1,0
42939,48841,51221,0,0,62,62,0,1,0,1,0
42940,59008,51221,0,0,66,66,0,1,0,1,0
42941,62540,29892,0,0,145,145,0,1,0,1,0
42942,16944,50584,0,0,62,62,0,1,0,1,0
42943,61181,445,0,0,70,70,0,1,0,1,0
42944,61180,445,0,0,70,70,0,1,0,1,0
42945,61176,445,0,0,70,70,0,1,0,1,0
42946,62438,37807,0,0,62,62,0,1,0,1,0
42947,35849,30188,0,0,62,62,0,1,0,1,0
42948,56563,445,0,0,66,66,0,1,0,1,0
42949,56564,445,0,0,66,66,0,1,0,1,0
42950,56562,445,0,0,66,66,0,1,0,1,0
42951,56242,445,0,0,70,70,0,1,0,1,0
42952,54210,64097,0,0,66,66,0,1,0,1,0
42953,56241,445,0,0,70,70,0,1,0,1,0
42954,61170,445,0,0,70,70,0,1,0,1,0
42955,61167,445,0,0,70,70,0,1,0,1,0
42956,60222,22114,0,0,66,66,0,1,0,1,0
42957,54873,443,62397,443,9238,3472,5766,43,75,24,19
42958,46415,53,46415,53,211,80,131,2,30,1,1
42959,62408,3478,27920,3478,140,140,0,1,30,1,0
42960,63856,6881,6366,6881,66,66,0,2,8,2,0
42961,51434,53,0,0,202,93,109,2,30,1,1
42962,55773,53,49268,53,97,97,0,1,60,1,0
42963,27005,31010,2449,31010,1626,126,1500,4,31,2,2
42964,57329,443,20931,443,7472,2014,5458,29,16,16,13
42965,49651,443,6996,443,920003,731041,188962,2024,929,1212,812
42966,63855,29799,24538,29799,66,66,0,2,8,2,0
42967,51851,48605,8820,48605,136,136,0,3,14,3,0
42968,57332,443,64135,443,2687,1728,959,23,15,12,11
42969,57331,443,8045,443,7468,2225,5243,27,16,15,12
42970,53450,443,18001,443,5931,1750,4181,24,48,14,10
42971,64093,443,64093,443,5663,2416,3247,26,159,14,12
42972,64097,443,64097,443,13511,6811,6700,43,159,23,20
42973,46750,80,46750,80,27124,1455,25669,41,15,20,21
42974,62457,7000,62457,7000,3959,1738,2221,15,15,8,7
42975,57947,443,8723,443,2791,1800,991,26,185,15,11
42976,56666,443,31326,443,1299,730,569,13,25,7,6
42977,41842,443,41842,443,4707,1800,2907,19,28,11,8
42978,56665,443,57309,443,1299,730,569,13,25,7,6
42979,27005,27013,28763,27013,1628,126,1502,4,31,2,2
42980,48655,53,0,0,82,82,0,2,40,2,0
42981,46230,53,46230,53,257,101,156,2,33,1,1
42982,51853,30585,59624,30585,136,136,0,3,14,3,0
42983,33038,443,55545,443,7338,2419,4919,19,35,12,7
42984,37534,443,60202,443,6927,1883,5044,25,46,14,11
42985,59487,53,59487,53,211,80,131,2,30,1,1
42986,60108,443,32347,443,9091,2988,6103,47,19,22,25
42987,44467,53,44467,53,211,80,131,2,30,1,1
42988,37485,161,0,0,6435,2535,3900,22,30,11,11
42989,65408,53,49701,53,817,98,719,2,30,1,1
42990,62408,3478,24308,3478,140,140,0,1,30,1,0
42991,43749,443,15009,443,8900,2090,6810,26,80,14,12
42992,64095,443,64095,443,17046,2620,14426,42,159,19,23
42993,56662,443,60423,443,1233,730,503,12,25,7,5
42994,56663,443,26937,443,1299,730,569,13,25,7,6
42995,64573,443,63298,443,29112,2866,26246,53,31,28,25
42996,80,34539,80,34539,1468,1468,0,1,5,1,0
42997,64092,443,64092,443,5643,2397,3246,26,159,14,12
42998,62408,3478,62290,3478,140,140,0,1,30,1,0
42999,44949,443,55206,443,190,70,120,4,15,2,2
43000,27005,30004,43558,30004,1646,126,1520,4,30,2,2
43001,49300,443,31684,443,4364,2129,2235,12,121,6,6
43002,46505,443,50685,443,7072,1541,5531,27,271,12,15
43003,64538,443,60340,443,4658,1652,3006,10,121,5,5
43004,56543,443,22323,443,1323,616,707,18,120,9,9
43005,27200,34021,0,0,66,66,0,1,90,1,0
43006,50930,443,14420,443,1786,172,1614,7,121,3,4
43007,12060,37965,0,0,66,66,0,1,0,1,0
43008,10436,37965,0,0,62,62,0,1,0,1,0
43009,61165,445,0,0,70,70,0,1,0,1,0
43010,61160,445,0,0,70,70,0,1,0,1,0
43011,61156,445,0,0,70,70,0,1,0,1,0
43012,56236,445,0,0,70,70,0,1,0,1,0
43013,54423,21247,0,0,66,66,0,1,0,1,0
43014,56234,445,0,0,70,70,0,1,0,1,0
43015,53815,44847,0,0,66,66,0,1,0,1,0
43016,20508,57470,0,0,62,62,0,1,0,1,0
43017,18623,1,0,0,66,66,0,1,0,1,0
43018,56230,445,0,0,70,70,0,1,0,1,0
43019,60430,51413,63647,51413,70,70,0,2,8,2,0
43020,37865,123,17478,123,184,94,90,2,30,1,1
43021,53521,443,40751,443,130,70,60,2,14,1,1
43022,55637,27816,50457,27816,316,190,126,5,15,3,2
43023,56647,443,58814,443,1327,918,409,10,25,6,4
43024,56653,443,22218,443,1272,876,396,10,25,6,4
43025,49146,443,26817,443,47589,17003,30586,283,238,128,155
43026,63983,53,48725,53,447,94,353,4,54,2,2
43027,64374,53,21599,53,211,94,117,2,30,1,1
43028,56657,443,53403,443,8059,2039,6020,20,15,11,9
43029,49718,443,50184,443,7644833,215496,7429337,8664,135,2509,6155
43030,56656,443,24919,443,1342,918,424,10,25,6,4
43031,64094,443,64094,443,5647,2402,3245,26,159,14,12
43032,45531,53,30846,53,168,78,90,2,30,1,1
43033,38710,80,33174,80,190,70,120,4,17,2,2
43034,56657,443,37201,443,1342,918,424,10,25,6,4
43035,53934,443,47963,443,360,360,0,7,4,7,0
43036,49440,53,64789,53,415,88,327,4,52,2,2
43037,27005,27016,56293,27016,1640,126,1514,4,31,2,2
43038,56631,80,19501,80,234,234,0,4,12,4,0
43039,51854,13923,55002,13923,136,136,0,3,13,3,0
43040,63563,24096,6074,24096,70,70,0,1,5,1,0
43041,64685,53,19809,53,535,100,435,4,36,2,2
43042,65179,53,9786,53,289,102,187,2,30,1,1
43043,38772,53,26700,53,168,78,90,2,30,1,1
43044,62447,53,48844,53,296,94,202,2,30,1,1
43045,49934,80,37957,80,1130,613,517,11,15,6,5
43046,49652,80,41270,80,1854,945,909,13,106,7,6
43047,35023,53,0,0,82,82,0,2,40,2,0
43048,49933,80,49306,80,1130,613,517,11,15,6,5
43049,56651,443,36673,443,4628,1035,3593,19,25,11,8
43050,50293,443,30749,443,6697,1606,5091,23,36,13,10
43051,56655,443,40290,443,8058,2038,6020,20,15,11,9
43052,58689,123,57350,123,184,94,90,2,30,1,1
43053,60130,80,60130,80,23216,1806,21410,40,28,20,20
43054,57294,53,58964,53,387,134,253,2,30,1,1
43055,64914,53,14005,53,224,94,130,2,30,1,1
43056,37531,443,49565,443,17284,5197,12087,46,48,25,21
43057,64403,53,53109,53,387,134,253,2,30,1,1
43058,58688,53,58261,53,184,78,106,2,30,1,1
43059,57236,443,34862,443,2294,1126,1168,25,120,12,13
43060,51872,48108,5295,48108,70,70,0,2,8,2,0
43061,51852,18636,28064,18636,136,136,0,3,13,3,0
43062,56656,443,38705,443,8006,1986,6020,20,15,11,9
43063,57919,443,32808,443,21293,7315,13978,85,188,37,48
43064,63952,53,35871,53,289,102,187,2,30,1,1
43065,27005,27018,47150,27018,1898,378,1520,6,31,4,2
43066,27005,27015,40771,27015,1618,126,1492,4,31,2,2
43067,49663,443,52474,443,8161,1929,6232,26,46,15,11
43068,45657,443,4313,443,2553,1355,1198,22,77,13,9
43069,59261,80,59261,80,109128,4773,104355,197,15,68,129
43070,49730,443,62541,443,400810,14719,386091,506,39,164,342
43071,60379,443,42355,443,4162,2121,2041,25,95,14,11
43072,37313,443,31778,443,1364815,60410,1304405,1401,901,341,1060
43073,64574,443,40988,443,9151,2109,7042,27,30,15,12
43074,52815,80,10358,80,1152,712,440,10,15,5,5
43075,56654,443,1981,443,8007,1987,6020,20,15,11,9
43076,53279,443,22916,443,36459,6736,29723,54,29,24,30
43077,53648,80,65465,80,2162,1608,554,10,34,6,4
43078,55638,32765,61121,32765,564,318,246,9,15,5,4
43079,57946,443,19612,443,2791,1800,991,26,185,15,11
43080,49935,80,29909,80,1130,613,517,11,15,6,5
43081,56649,443,46574,443,4628,1035,3593,19,25,11,8
43082,45124,80,4219,80,1808,636,1172,16,16,8,8
43083,26923,443,40541,443,7362,1770,5592,31,87,16,15
43084,56652,443,14295,443,1272,876,396,10,25,6,4
43085,27005,27015,32807,27015,1622,126,1496,4,30,2,2
43086,46308,123,1425,123,184,94,90,2,30,1,1
43087,49892,53,17000,53,525,110,415,4,43,2,2
43088,63854,16437,39591,16437,66,66,0,2,7,2,0
43089,53128,29593,52824,29593,70,70,0,1,4,1,0
43090,53640,443,55622,443,3201,1057,2144,13,135,6,7
43091,56650,443,36450,443,4628,1035,3593,19,25,11,8
43092,51870,40490,10666,40490,70,70,0,2,8,2,0
43093,60429,46854,52028,46854,70,70,0,2,8,2,0
43094,54828,443,16065,443,572,572,0,5,11,5,0
43095,60760,20010,11977,20010,70,70,0,1,5,1,0
43096,63838,80,51652,80,314,192,122,6,15,4,2
43097,41857,443,32439,443,1633,1010,623,14,2424,7,7
43098,60422,62456,45228,62456,341,215,126,5,16,3,2
43099,45484,443,14429,443,5766,1575,4191,24,589,13,11
43100,33982,80,37305,80,1152,712,440,10,15,5,5
43101,55639,62954,47207,62954,504,318,186,8,15,5,3
43102,52831,3389,52831,3389,4145,1976,2169,22,18,13,9
43103,51971,80,13099,80,60753,2612,58141,76,46,34,42
43104,64908,53,50995,53,304,94,210,2,30,1,1
43105,49795,53,1877,53,211,102,109,2,30,1,1
43106,52070,443,55434,443,8971,4228,4743,20,95,12,8
43107,49651,80,48758,80,1854,945,909,13,106,7,6
43108,62408,3478,14278,3478,142,142,0,1,30,1,0
43109,50106,53,56744,53,296,94,202,2,30,1,1
43110,45475,161,0,0,41552,20621,20931,212,31,106,106
43111,35989,161,0,0,18741,9242,9499,96,31,48,48
43112,62482,443,44604,443,4427,2362,2065,11,119,6,5
43113,64090,443,49482,443,7360,2435,4925,19,135,9,10
43114,51951,443,35308,443,3854,1151,2703,20,135,10,10
43115,54520,443,49982,443,8152,4874,3278,22,138,11,11
43116,37965,8999,40313,8999,491,150,341,2,1199,1,1
43117,49924,53,63883,53,353,94,259,2,31,1,1
43118,57470,22838,37190,22838,481,150,331,2,1199,1,1
43119,6881,34746,2559,34746,484,150,334,2,1200,1,1
43120,47053,5228,30906,5228,11647,2439,9208,47,3724,21,26
43121,49661,443,46909,443,10553,2117,8436,24,46,12,12
43122,62766,443,26712,443,4911,3442,1469,29,322,16,13
43123,50484,80,53622,80,318,192,126,6,26,4,2
43124,50485,80,52438,80,318,192,126,6,26,4,2
43125,35412,443,65351,443,1251,749,502,11,68,6,5
43126,45152,80,61047,80,2865,2000,865,12,18,7,5
43127,56660,443,12588,443,1579,988,591,13,25,7,6
43128,63928,53,2140,53,376,126,250,2,30,1,1
43129,49318,53,58973,53,718,94,624,2,30,1,1
43130,57171,443,13487,443,13932,3673,10259,26,121,11,15
43131,53894,443,60349,443,6375,1019,5356,21,16,11,10
43132,39108,443,16198,443,330651,13398,317253,404,115,179,225
43133,39094,443,50838,443,828718,43410,785308,1071,347,479,592
43134,50528,80,29242,80,1658,1247,411,8,16,5,3
43135,60763,40010,33856,40010,316,136,180,6,6,3,3
43136,64503,53,37724,53,209,102,107,2,30,1,1
43137,64551,53,2637,53,354,94,260,2,30,1,1
43138,29989,26467,0,0,62,62,0,1,0,1,0
43139,51164,64147,0,0,66,66,0,1,0,1,0
43140,53147,37965,0,0,62,62,0,1,0,1,0
43141,63080,37965,0,0,66,66,0,1,0,1,0
43142,24260,50584,0,0,62,62,0,1,0,1,0
43143,42389,42873,0,0,74,74,0,1,0,1,0
43144,56229,445,0,0,70,70,0,1,0,1,0
43145,59509,64147,0,0,145,145,0,1,0,1,0
43146,48676,53395,0,0,60,60,0,1,0,1,0
43147,63271,52752,0,0,78,78,0,1,0,1,0
43148,31637,17348,0,0,60,60,0,1,0,1,0
43149,61145,445,0,0,70,70,0,1,0,1,0
43150,61147,445,0,0,70,70,0,1,0,1,0
43151,61144,445,0,0,70,70,0,1,0,1,0
43152,50828,123,0,0,234,234,0,1,0,1,0
43153,57878,55108,0,0,148,148,0,1,0,1,0
43154,48676,53392,0,0,60,60,0,1,0,1,0
43155,56222,445,0,0,70,70,0,1,0,1,0
43156,61314,23,0,0,60,60,0,1,0,1,0
43157,17781,50265,0,0,62,62,0,1,0,1,0
43158,56540,445,0,0,66,66,0,1,0,1,0
43159,47348,23,0,0,60,60,0,1,0,1,0
43160,61140,445,0,0,70,70,0,1,0,1,0
43161,61141,445,0,0,70,70,0,1,0,1,0
43162,9353,32761,0,0,110,110,0,1,0,1,0
43163,52569,30188,0,0,66,66,0,1,0,1,0
43164,16430,31573,0,0,62,62,0,1,0,1,0
43165,19204,56448,0,0,78,78,0,1,0,1,0
43166,18754,30188,0,0,66,66,0,1,0,1,0
43167,24882,50647,0,0,60,60,0,1,0,1,0
43168,56209,445,0,0,70,70,0,1,0,1,0
43169,52123,1433,0,0,60,60,0,1,0,1,0
43170,52123,1433,0,0,60,60,0,1,0,1,0
43171,56237,26467,0,0,66,66,0,1,0,1,0
43172,56536,445,0,0,66,66,0,1,0,1,0
43173,57987,56125,0,0,90,90,0,1,0,1,0
43174,56578,64147,0,0,62,62,0,1,0,1,0
43175,53156,35993,0,0,66,66,0,1,0,1,0
43176,23197,44847,0,0,62,62,0,1,0,1,0
43177,56532,445,0,0,66,66,0,1,0,1,0
43178,61127,445,0,0,70,70,0,1,0,1,0
43179,45964,2666,0,0,60,60,0,1,0,1,0
43180,49325,41615,0,0,157,157,0,1,0,1,0
43181,56206,445,0,0,70,70,0,1,0,1,0
43182,61126,445,0,0,70,70,0,1,0,1,0
43183,61124,445,0,0,70,70,0,1,0,1,0
43184,61121,445,0,0,70,70,0,1,0,1,0
43185,56529,445,0,0,66,66,0,1,0,1,0
43186,26183,22114,0,0,62,62,0,1,0,1,0
43187,16948,990,0,0,60,60,0,1,0,1,0
43188,1024,6881,0,0,62,62,0,1,0,1,0
43189,51222,35440,0,0,66,66,0,1,0,1,0
43190,61114,445,0,0,70,70,0,1,0,1,0
43191,56201,445,0,0,70,70,0,1,0,1,0
43192,45673,30188,0,0,146,146,0,1,0,1,0
43193,56200,445,0,0,70,70,0,1,0,1,0
43194,61111,445,0,0,70,70,0,1,0,1,0
43195,61109,445,0,0,70,70,0,1,0,1,0
43196,61108,445,0,0,70,70,0,1,0,1,0
43197,56523,445,0,0,66,66,0,1,0,1,0
43198,2440,37807,0,0,66,66,0,1,0,1,0
43199,56198,445,0,0,70,70,0,1,0,1,0
43200,56516,445,0,0,66,66,0,1,0,1,0
43201,56519,445,0,0,66,66,0,1,0,1,0
43202,56517,445,0,0,66,66,0,1,0,1,0
43203,19698,502,0,0,60,60,0,1,0,1,0
43204,59699,55783,0,0,62,62,0,1,0,1,0
43205,56512,445,0,0,66,66,0,1,0,1,0
43206,56513,445,0,0,66,66,0,1,0,1,0
43207,56511,445,0,0,66,66,0,1,0,1,0
43208,44059,23,0,0,60,60,0,1,0,1,0
43209,56127,35440,0,0,62,62,0,1,0,1,0
43210,19096,64147,0,0,62,62,0,1,0,1,0
43211,49367,51505,0,0,66,66,0,1,0,1,0
43212,51745,57470,0,0,62,62,0,1,0,1,0
43213,61107,445,0,0,70,70,0,1,0,1,0
43214,61104,445,0,0,70,70,0,1,0,1,0
43215,61102,445,0,0,70,70,0,1,0,1,0
43216,40936,5900,0,0,60,60,0,1,0,1,0
43217,56509,445,0,0,66,66,0,1,0,1,0
43218,56191,445,0,0,70,70,0,1,0,1,0
43219,61099,445,0,0,70,70,0,1,0,1,0
43220,56505,445,0,0,66,66,0,1,0,1,0
43221,56189,445,0,0,70,70,0,1,0,1,0
43222,56502,445,0,0,66,66,0,1,0,1,0
43223,56503,445,0,0,66,66,0,1,0,1,0
43224,443,20087,0,0,83,83,0,1,0,1,0
43225,9327,57470,0,0,62,62,0,1,0,1,0
43226,56499,445,0,0,66,66,0,1,0,1,0
43227,56188,445,0,0,70,70,0,1,0,1,0
43228,19004,51505,0,0,66,66,0,1,0,1,0
43229,56187,445,0,0,70,70,0,1,0,1,0
43230,56186,445,0,0,70,70,0,1,0,1,0
43231,50713,57470,0,0,66,66,0,1,0,1,0
43232,56181,445,0,0,70,70,0,1,0,1,0
43233,56183,445,0,0,70,70,0,1,0,1,0
43234,28194,32468,0,0,62,62,0,1,0,1,0
43235,42465,57470,0,0,60,60,0,1,0,1,0
43236,61093,445,0,0,70,70,0,1,0,1,0
43237,15701,37965,0,0,146,146,0,1,0,1,0
43238,60248,30188,0,0,66,66,0,1,0,1,0
43239,50470,61463,0,0,86,86,0,1,0,1,0
43240,61090,445,0,0,70,70,0,1,0,1,0
43241,61085,445,0,0,70,70,0,1,0,1,0
43242,59481,30975,0,0,146,146,0,1,0,1,0
43243,61002,37965,0,0,145,145,0,1,0,1,0
43244,56168,445,0,0,70,70,0,1,0,1,0
43245,56167,445,0,0,70,70,0,1,0,1,0
43246,56164,445,0,0,70,70,0,1,0,1,0
43247,54167,50584,0,0,66,66,0,1,0,1,0
43248,56158,445,0,0,70,70,0,1,0,1,0
43249,56157,445,0,0,70,70,0,1,0,1,0
43250,50066,30188,0,0,66,66,0,1,0,1,0
43251,47814,51505,0,0,62,62,0,1,0,1,0
43252,56489,445,0,0,66,66,0,1,0,1,0
43253,45682,37965,0,0,62,62,0,1,0,1,0
43254,56753,44847,0,0,146,146,0,1,0,1,0
43255,2828,35253,0,0,66,66,0,1,0,1,0
43256,1972,57470,0,0,78,78,0,1,0,1,0
43257,25297,11530,0,0,145,145,0,1,0,1,0
43258,0,0,0,0,164,164,0,2,0,2,0
43259,0,0,0,0,70,70,0,1,0,1,0
43260,56481,445,0,0,66,66,0,1,0,1,0
43261,61072,445,0,0,70,70,0,1,0,1,0
43262,5222,27389,0,0,66,66,0,1,0,1,0
43263,56146,445,0,0,70,70,0,1,0,1,0
43264,38852,37965,0,0,62,62,0,1,0,1,0
43265,56479,445,0,0,66,66,0,1,0,1,0
43266,48557,37965,0,0,62,62,0,1,0,1,0
43267,56472,445,0,0,66,66,0,1,0,1,0
43268,56142,445,0,0,70,70,0,1,0,1,0
43269,57820,32753,0,0,361,361,0,1,0,1,0
43270,56461,445,0,0,66,66,0,1,0,1,0
43271,17010,57470,0,0,62,62,0,1,0,1,0
43272,56133,445,0,0,70,70,0,1,0,1,0
43273,56131,445,0,0,70,70,0,1,0,1,0
43274,56130,445,0,0,70,70,0,1,0,1,0
43275,56129,445,0,0,70,70,0,1,0,1,0
43276,56126,445,0,0,70,70,0,1,0,1,0
43277,30015,36237,0,0,66,66,0,1,0,1,0
43278,61062,445,0,0,70,70,0,1,0,1,0
43279,61060,445,0,0,70,70,0,1,0,1,0
43280,61059,445,0,0,70,70,0,1,0,1,0
43281,56456,445,0,0,66,66,0,1,0,1,0
43282,56450,445,0,0,66,66,0,1,0,1,0
43283,56455,445,0,0,66,66,0,1,0,1,0
43284,56453,445,0,0,66,66,0,1,0,1,0
43285,56454,445,0,0,66,66,0,1,0,1,0
43286,56449,445,0,0,66,66,0,1,0,1,0
43287,56451,445,0,0,66,66,0,1,0,1,0
43288,56448,445,0,0,66,66,0,1,0,1,0
43289,1663,30188,0,0,62,62,0,1,0,1,0
43290,443,20087,0,0,83,83,0,1,0,1,0
43291,23277,53733,0,0,66,66,0,1,0,1,0
43292,50090,50265,0,0,66,66,0,1,0,1,0
43293,49186,53,49186,53,257,101,156,2,32,1,1
43294,53710,80,64568,80,2499,531,1968,11,75,6,5
43295,50504,443,62477,443,6051,1149,4902,16,25,9,7
43296,61335,443,41509,443,42437,8035,34402,79,247,30,49
43297,41973,443,27764,443,26109,3251,22858,60,256,31,29
43298,53711,80,6435,80,2391,532,1859,11,75,6,5
43299,50500,80,1291,80,318,192,126,6,25,4,2
43300,50499,80,43182,80,318,192,126,6,25,4,2
43301,59623,161,0,0,11212,5520,5692,58,30,29,29
43302,49488,443,58643,443,90030,13137,76893,92,47,29,63
43303,53713,80,58765,80,5778,661,5117,17,75,8,9
43304,50479,80,2241,80,312,192,120,6,25,4,2
43305,61304,443,62811,443,8594,1042,7552,16,120,7,9
43306,61496,443,4674,443,27232,3841,23391,42,38,17,25
43307,50125,443,44397,443,9798,3571,6227,43,143,23,20
43308,36520,3142,36520,3142,138,78,60,2,5,1,1
43309,61338,443,62752,443,39067,7713,31354,74,247,29,45
43310,48890,443,48166,443,79665,4371,75294,110,256,45,65
43311,27005,27016,41130,27016,1622,126,1496,4,31,2,2
43312,36601,443,32906,443,16455,11185,5270,37,271,22,15
43313,53712,80,11675,80,2424,529,1895,11,75,6,5
43314,39569,443,39569,443,4601,1694,2907,19,28,11,8
43315,46984,443,45323,443,416,210,206,7,35,4,3
43316,61337,443,54439,443,31111,6287,24824,62,247,25,37
43317,37533,443,8271,443,5516,1774,3742,21,46,13,8
43318,62900,993,6178,993,12900,4980,7920,91,117,51,40
43319,50501,80,58618,80,318,192,126,6,25,4,2
43320,50503,443,63118,443,5987,1085,4902,15,25,8,7
43321,50502,80,37094,80,318,192,126,6,25,4,2
43322,59684,443,44849,443,5173,860,4313,16,15,9,7
43323,50492,80,56917,80,318,192,126,6,25,4,2
43324,65025,443,1842,443,2227,1018,1209,17,16,8,9
43325,38476,161,0,0,3304,1560,1744,18,30,9,9
43326,52042,53,52042,53,81,81,0,1,30,1,0
43327,44032,161,0,0,4491,2143,2348,24,30,12,12
43328,27005,27050,14571,27050,1684,126,1558,4,31,2,2
43329,61339,443,59710,443,31648,6288,25360,62,247,25,37
43330,61336,443,63223,443,34919,6979,27940,68,247,27,41
43331,40811,80,13530,80,31286,2032,29254,50,30,26,24
43332,50491,80,59883,80,318,192,126,6,25,4,2
43333,27005,30003,56044,30003,1640,126,1514,4,30,2,2
43334,57161,53,1657,53,711,87,624,2,30,1,1
43335,51566,443,47460,443,9451,3719,5732,45,76,25,20
43336,52537,443,37723,443,132577,21019,111558,348,236,142,206
43337,8889,16991,8889,16991,124,60,64,2,31,1,1
43338,27005,27019,21783,27019,1648,126,1522,4,31,2,2
43339,55958,53,60321,53,170,87,83,2,31,1,1
43340,56351,53,13734,53,306,99,207,2,31,1,1
43341,49302,443,8225,443,3182,1568,1614,8,120,4,4
43342,65487,443,51445,443,3641,886,2755,13,136,6,7
43343,50701,443,1473,443,45394,5743,39651,133,233,49,84
43344,27005,27022,12480,27022,1882,378,1504,6,31,4,2
43345,50164,443,9375,443,3312,1098,2214,19,137,10,9
43346,5757,80,5757,80,104444,4047,100397,122,126,52,70
43347,53548,443,53548,443,1386,751,635,15,181,8,7
43348,62299,53,62299,53,259,108,151,2,31,1,1
43349,42870,443,3034,443,20248,1033,19215,28,3620,9,19
43350,63927,50265,0,0,62,62,0,1,0,1,0
43351,58574,21247,0,0,66,66,0,1,0,1,0
43352,63445,64631,0,0,66,66,0,1,0,1,0
43353,35460,35440,0,0,146,146,0,1,0,1,0
43354,56119,445,0,0,70,70,0,1,0,1,0
43355,27773,56205,0,0,146,146,0,1,0,1,0
43356,45908,33330,0,0,60,60,0,1,0,1,0
43357,22275,51505,0,0,62,62,0,1,0,1,0
43358,61057,445,0,0,70,70,0,1,0,1,0
43359,61055,445,0,0,70,70,0,1,0,1,0
43360,61051,445,0,0,70,70,0,1,0,1,0
43361,9283,57470,0,0,66,66,0,1,0,1,0
43362,63768,53,12206,53,298,102,196,2,30,1,1
43363,64133,53,32044,53,216,102,114,2,30,1,1
43364,16387,3655,0,0,60,60,0,1,0,1,0
43365,56112,445,0,0,70,70,0,1,0,1,0
43366,16387,22272,0,0,60,60,0,1,0,1,0
43367,16387,20045,0,0,60,60,0,1,0,1,0
43368,56111,445,0,0,70,70,0,1,0,1,0
43369,56436,445,0,0,66,66,0,1,0,1,0
43370,56434,445,0,0,66,66,0,1,0,1,0
43371,56435,445,0,0,66,66,0,1,0,1,0
43372,16387,44427,0,0,60,60,0,1,0,1,0
43373,16387,7205,0,0,60,60,0,1,0,1,0
43374,16387,63752,0,0,60,60,0,1,0,1,0
43375,16387,35583,0,0,60,60,0,1,0,1,0
43376,16387,16862,0,0,60,60,0,1,0,1,0
43377,16387,64075,0,0,60,60,0,1,0,1,0
43378,61041,445,0,0,70,70,0,1,0,1,0
43379,33193,50584,0,0,62,62,0,1,0,1,0
43380,13281,51050,0,0,66,66,0,1,0,1,0
43381,46839,51050,0,0,146,146,0,1,0,1,0
43382,51324,11392,0,0,66,66,0,1,0,1,0
43383,56106,445,0,0,70,70,0,1,0,1,0
43384,54210,36237,0,0,62,62,0,1,0,1,0
43385,61039,445,0,0,70,70,0,1,0,1,0
43386,56104,445,0,0,70,70,0,1,0,1,0
43387,2918,37965,0,0,62,62,0,1,0,1,0
43388,61033,445,0,0,70,70,0,1,0,1,0
43389,61031,445,0,0,70,70,0,1,0,1,0
43390,61029,445,0,0,70,70,0,1,0,1,0
43391,56256,62413,0,0,66,66,0,1,0,1,0
43392,35120,26467,0,0,62,62,0,1,0,1,0
43393,63447,44847,0,0,66,66,0,1,0,1,0
43394,13462,35440,0,0,66,66,0,1,0,1,0
43395,443,20087,0,0,83,83,0,1,0,1,0
43396,56653,22114,0,0,66,66,0,1,0,1,0
43397,56100,445,0,0,70,70,0,1,0,1,0
43398,52430,35440,0,0,62,62,0,1,0,1,0
43399,27785,37965,0,0,66,66,0,1,0,1,0
43400,56099,445,0,0,70,70,0,1,0,1,0
43401,39056,22114,0,0,62,62,0,1,0,1,0
43402,61020,445,0,0,70,70,0,1,0,1,0
43403,61017,445,0,0,70,70,0,1,0,1,0
43404,61016,445,0,0,70,70,0,1,0,1,0
43405,56094,445,0,0,70,70,0,1,0,1,0
43406,50496,80,19242,80,318,192,126,6,25,4,2
43407,50480,80,36021,80,318,192,126,6,25,4,2
43408,55496,80,55496,80,1099,578,521,10,15,6,4
43409,58556,80,23584,80,884,529,355,10,255,6,4
43410,53709,443,33210,443,7356,1014,6342,20,75,10,10
43411,49710,53,28433,53,480,93,387,4,50,2,2
43412,60796,53,56563,53,296,94,202,2,29,1,1
43413,56659,443,25934,443,1579,988,591,13,24,7,6
43414,56653,443,38474,443,8059,2039,6020,20,15,11,9
43415,50497,80,3021,80,19946,10573,9373,29,25,14,15
43416,40919,443,40161,443,12243,6818,5425,30,314,16,14
43417,62778,443,47503,443,6676,2316,4360,34,318,16,18
43418,39107,443,62182,443,692830,23263,669567,784,114,306,478
43419,57429,443,7406,443,15017,8283,6734,47,18,24,23
43420,27005,27016,13972,27016,1656,126,1530,4,30,2,2
43421,63938,53,63032,53,385,110,275,2,30,1,1
43422,49172,53,32719,53,227,102,125,2,29,1,1
43423,65352,53,63363,53,321,102,219,2,29,1,1
43424,52042,53,52042,53,478,292,186,5,30,3,2
43425,55640,54435,42654,54435,70,70,0,1,5,1,0
43426,50482,80,36252,80,314,192,122,6,25,4,2
43427,41911,443,53613,443,9499,3786,5713,31,315,16,15
43428,42767,443,1762,443,8995,2498,6497,40,256,19,21
43429,62139,53,5028,53,298,102,196,2,30,1,1
43430,64845,53,4147,53,289,110,179,2,30,1,1
43431,55234,443,6100,443,9176,2226,6950,28,31,16,12
43432,56336,53,52213,53,196,102,94,2,35,1,1
43433,64514,53,39075,53,437,88,349,4,41,2,2
43434,50498,80,12035,80,312,192,120,6,25,4,2
43435,50490,80,51282,80,318,192,126,6,25,4,2
43436,56630,443,17918,443,6156,918,5238,18,26,10,8
43437,57232,443,17235,443,51152,3321,47831,81,100,38,43
43438,27176,53,64798,53,396,257,139,3,30,2,1
43439,36008,443,16915,443,5378,1423,3955,19,56,11,8
43440,58851,443,28195,443,344,130,214,6,77,3,3
43441,21544,41599,31043,41599,70,70,0,1,5,1,0
43442,56651,443,21328,443,8058,2038,6020,20,15,11,9
43443,47640,443,10100,443,1058,571,487,10,38,6,4
43444,56724,53,0,0,86,86,0,1,30,1,0
43445,65207,53,42618,53,277,110,167,2,30,1,1
43446,57092,53,43166,53,270,102,168,2,30,1,1
43447,5588,5588,0,0,3562,1936,1626,48,195,24,24
43448,50489,80,24870,80,318,192,126,6,25,4,2
43449,57942,443,1661,443,2791,1800,991,26,185,15,11
43450,62894,993,44411,993,8840,4151,4689,80,190,41,39
43451,50505,80,62173,80,318,192,126,6,25,4,2
43452,57386,443,57835,443,1056,569,487,10,38,6,4
43453,47638,443,5364,443,1056,569,487,10,38,6,4
43454,49932,443,32840,443,8428,1889,6539,25,16,13,12
43455,46531,123,21322,123,184,94,90,2,30,1,1
43456,60379,443,13895,443,9593,3182,6411,19,23,8,11
43457,6881,6881,5588,6881,324,150,174,2,1203,1,1
43458,62765,443,43288,443,52223,3318,48905,75,321,30,45
43459,65428,53,65157,53,516,86,430,4,32,2,2
43460,50493,80,1565,80,318,192,126,6,25,4,2
43461,62899,993,51481,993,9385,3246,6139,53,118,31,22
43462,5588,5588,0,0,3562,1936,1626,48,194,24,24
43463,39101,443,49967,443,201217,15748,185469,327,207,163,164
43464,49159,53,48232,53,213,102,111,2,29,1,1
43465,52523,443,12913,443,4307,2005,2302,37,18,20,17
43466,58039,161,0,0,11672,5710,5962,60,29,30,30
43467,27005,27015,18996,27015,1618,126,1492,4,30,2,2
43468,53664,13701,26986,13701,70,70,0,1,4,1,0
43469,56395,443,25199,443,7018,2751,4267,24,39,11,13
43470,57470,32348,51610,32348,527,166,361,2,1199,1,1
43471,50481,80,4638,80,318,192,126,6,25,4,2
43472,55270,443,14179,443,6098,778,5320,17,15,8,9
43473,37855,443,39398,443,25928,15100,10828,59,39,37,22
43474,35098,161,0,0,15190,7454,7736,78,30,39,39
43475,56652,443,7084,443,8006,1986,6020,20,15,11,9
43476,57372,53,20962,53,177,94,83,2,30,1,1
43477,65481,443,11803,443,138507,5990,132517,156,16,60,96
43478,33882,80,63489,80,1454,866,588,11,58,7,4
43479,35716,53,38842,53,168,78,90,2,30,1,1
43480,55153,443,47094,443,5897,1982,3915,20,18,11,9
43481,49771,53,64611,53,272,110,162,2,30,1,1
43482,56341,53,28637,53,213,102,111,2,29,1,1
43483,51667,25826,12114,25826,9434,9434,0,11,30,11,0
43484,64791,53,19786,53,526,197,329,6,49,3,3
43485,55917,53,58501,53,371,109,262,4,59,2,2
43486,64209,53,40539,53,291,94,197,2,29,1,1
43487,57370,53,22264,53,347,110,237,2,30,1,1
43488,34891,53,37025,53,396,257,139,3,30,2,1
43489,54052,443,54052,443,1386,751,635,15,181,8,7
43490,57470,53756,4202,53756,132,132,0,3,1199,3,0
43491,48817,51413,48817,51413,460,150,310,2,1200,1,1
43492,55877,38597,28809,38597,481,150,331,2,1200,1,1
43493,53130,443,53130,443,3121,1764,1357,19,181,10,9
43494,54053,443,54053,443,1468,763,705,16,181,8,8
43495,53591,443,53591,443,1468,763,705,16,181,8,8
43496,57470,23848,47855,23848,545,166,379,2,1199,1,1
43497,51868,30305,49639,30305,70,70,0,2,8,2,0
43498,63981,53,39748,53,329,86,243,4,42,2,2
43499,54842,443,49660,443,5860,1151,4709,18,283,10,8
43500,57384,443,57610,443,1054,567,487,10,38,6,4
43501,62888,993,63963,993,8786,4118,4668,80,200,41,39
43502,14914,443,14914,443,16960,1347,15613,28,17,10,18
43503,57372,53,54871,53,177,94,83,2,30,1,1
43504,36765,443,20693,443,27557,20627,6930,89,5581,44,45
43505,37621,80,10654,80,350,210,140,6,15,4,2
43506,59863,443,54710,443,12809,7765,5044,95,84,55,40
43507,57729,443,45932,443,12689,5742,6947,26,43,14,12
43508,54966,53,44405,53,171,88,83,3,33,2,1
43509,51869,25355,58736,25355,70,70,0,2,8,2,0
43510,10035,443,49026,443,7915,1634,6281,25,315,11,14
43511,64268,53,45536,53,334,103,231,4,54,2,2
43512,50018,53,44491,53,270,102,168,2,30,1,1
43513,8282,39458,7982,39458,78,78,0,1,30,1,0
43514,56233,53,2635,53,399,97,302,4,59,2,2
43515,65073,53,40365,53,293,102,191,2,30,1,1
43516,55958,53,40832,53,177,94,83,2,30,1,1
43517,58869,443,38937,443,4657,2146,2511,14,135,7,7
43518,44847,17977,12872,17977,502,150,352,2,1200,1,1
43519,50506,80,64243,80,318,192,126,6,25,4,2
43520,50488,80,56611,80,318,192,126,6,25,4,2
43521,50495,80,9941,80,312,192,120,6,25,4,2
43522,50483,80,35746,80,374,192,182,7,25,4,3
43523,51641,443,64110,443,4692,2882,1810,32,80,14,18
43524,56198,443,56198,443,27729,5508,22221,60,18,31,29
43525,51867,48059,33998,48059,258,70,188,4,8,2,2
43526,39616,443,20055,443,60,60,0,2,5,2,0
43527,49761,53,36428,53,373,99,274,4,41,2,2
43528,50477,80,59736,80,648,256,392,8,25,5,3
43529,56654,443,53376,443,4972,2136,2836,21,24,12,9
43530,65482,443,24363,443,92212,4799,87413,107,16,43,64
43531,55004,53,63304,53,270,102,168,2,30,1,1
43532,44169,443,53615,443,12098,5328,6770,25,121,12,13
43533,35212,443,26645,443,4477,2350,2127,16,135,8,8
43534,5819,53,5819,53,197,90,107,2,30,1,1
43535,27005,27016,54268,27016,1642,126,1516,4,31,2,2
43536,25504,53,50116,53,311,86,225,2,30,1,1
43537,49818,53,37745,53,86,86,0,1,30,1,0
43538,49301,443,34200,443,7616,3064,4552,14,120,6,8
43539,36762,443,56086,443,13119,3359,9760,39,120,19,20
43540,64537,443,9854,443,3182,1568,1614,8,120,4,4
43541,6882,6999,21724,6999,228,118,110,2,1200,1,1
43542,30188,41184,4045,41184,509,150,359,2,1200,1,1
43543,56888,443,32016,443,15807,12220,3587,44,242,18,26
43544,52038,80,51825,80,70,70,0,1,5,1,0
43545,51846,41510,42814,41510,70,70,0,1,5,1,0
43546,64753,53,63867,53,94,94,0,1,30,1,0
43547,49622,53,58073,53,244,94,150,2,30,1,1
43548,50098,443,16798,443,12942,3659,9283,66,217,36,30
43549,62887,993,3389,993,8921,4675,4246,77,200,47,30
43550,51866,23431,38401,23431,70,70,0,2,8,2,0
43551,51467,443,51893,443,194,70,124,3,11,1,2
43552,49406,443,41618,443,7808,2879,4929,36,186,19,17
43553,64191,53,1179,53,212,102,110,2,30,1,1
43554,64164,53,32232,53,229,102,127,2,30,1,1
43555,55498,53,0,0,86,86,0,1,30,1,0
43556,443,20087,0,0,83,83,0,1,0,1,0
43557,10916,44847,0,0,62,62,0,1,0,1,0
43558,49717,57470,0,0,62,62,0,1,0,1,0
43559,52575,22114,0,0,62,62,0,1,0,1,0
43560,47256,37807,0,0,146,146,0,1,0,1,0
43561,52720,35894,0,0,62,62,0,1,0,1,0
43562,15341,23,0,0,60,60,0,1,0,1,0
43563,29000,48817,0,0,148,148,0,1,0,1,0
43564,28897,35440,0,0,66,66,0,1,0,1,0
43565,50637,44847,0,0,66,66,0,1,0,1,0
43566,56410,445,0,0,66,66,0,1,0,1,0
43567,56835,35894,0,0,66,66,0,1,0,1,0
43568,61013,445,0,0,70,70,0,1,0,1,0
43569,61012,445,0,0,70,70,0,1,0,1,0
43570,14059,21247,0,0,62,62,0,1,0,1,0
43571,43540,1433,0,0,60,60,0,1,0,1,0
43572,40474,23117,0,0,62,62,0,1,0,1,0
43573,50716,50584,0,0,74,74,0,1,0,1,0
43574,736,23,0,0,60,60,0,1,0,1,0
43575,7273,64147,0,0,66,66,0,1,0,1,0
43576,56081,445,0,0,70,70,0,1,0,1,0
43577,60646,11392,0,0,66,66,0,1,0,1,0
43578,58131,42416,0,0,146,146,0,1,0,1,0
43579,59739,35253,0,0,62,62,0,1,0,1,0
43580,60126,35440,0,0,66,66,0,1,0,1,0
43581,56406,445,0,0,66,66,0,1,0,1,0
43582,45964,3111,0,0,60,60,0,1,0,1,0
43583,56078,445,0,0,70,70,0,1,0,1,0
43584,27783,57470,0,0,62,62,0,1,0,1,0
43585,56404,445,0,0,66,66,0,1,0,1,0
43586,60999,445,0,0,70,70,0,1,0,1,0
43587,60997,445,0,0,70,70,0,1,0,1,0
43588,60994,445,0,0,70,70,0,1,0,1,0
43589,60993,445,0,0,70,70,0,1,0,1,0
43590,64903,51050,0,0,66,66,0,1,0,1,0
43591,23770,50584,0,0,66,66,0,1,0,1,0
43592,56400,445,0,0,66,66,0,1,0,1,0
43593,58382,50584,0,0,146,146,0,1,0,1,0
43594,59564,57470,0,0,66,66,0,1,0,1,0
43595,35163,30188,0,0,62,62,0,1,0,1,0
43596,443,20087,0,0,83,83,0,1,0,1,0
43597,56073,445,0,0,70,70,0,1,0,1,0
43598,59937,37965,0,0,66,66,0,1,0,1,0
43599,20400,64147,0,0,62,62,0,1,0,1,0
43600,1334,8497,0,0,148,148,0,1,0,1,0
43601,56072,445,0,0,70,70,0,1,0,1,0
43602,60987,445,0,0,70,70,0,1,0,1,0
43603,56070,445,0,0,70,70,0,1,0,1,0
43604,60984,445,0,0,70,70,0,1,0,1,0
43605,60982,445,0,0,70,70,0,1,0,1,0
43606,60980,445,0,0,70,70,0,1,0,1,0
43607,53090,59356,0,0,66,66,0,1,0,1,0
43608,41220,59356,0,0,62,62,0,1,0,1,0
43609,10775,35440,0,0,66,66,0,1,0,1,0
43610,56395,445,0,0,66,66,0,1,0,1,0
43611,56392,445,0,0,66,66,0,1,0,1,0
43612,6666,50070,0,0,60,60,0,1,0,1,0
43613,56391,445,0,0,66,66,0,1,0,1,0
43614,56386,445,0,0,66,66,0,1,0,1,0
43615,40185,64147,0,0,66,66,0,1,0,1,0
43616,44496,57470,0,0,66,66,0,1,0,1,0
43617,56384,445,0,0,66,66,0,1,0,1,0
43618,56385,445,0,0,66,66,0,1,0,1,0
43619,56383,445,0,0,66,66,0,1,0,1,0
43620,3996,57470,0,0,62,62,0,1,0,1,0
43621,65526,28793,0,0,66,66,0,1,0,1,0
43622,61902,22114,0,0,66,66,0,1,0,1,0
43623,17534,50584,0,0,146,146,0,1,0,1,0
43624,56063,445,0,0,70,70,0,1,0,1,0
43625,60978,445,0,0,70,70,0,1,0,1,0
43626,60977,445,0,0,70,70,0,1,0,1,0
43627,50052,65008,0,0,60,60,0,1,0,1,0
43628,60972,445,0,0,70,70,0,1,0,1,0
43629,56381,445,0,0,66,66,0,1,0,1,0
43630,56061,445,0,0,70,70,0,1,0,1,0
43631,60971,445,0,0,70,70,0,1,0,1,0
43632,56377,445,0,0,66,66,0,1,0,1,0
43633,58131,1,0,0,146,146,0,1,0,1,0
43634,56060,445,0,0,70,70,0,1,0,1,0
43635,56375,445,0,0,66,66,0,1,0,1,0
43636,56373,445,0,0,66,66,0,1,0,1,0
43637,56059,445,0,0,70,70,0,1,0,1,0
43638,56058,445,0,0,70,70,0,1,0,1,0
43639,56371,445,0,0,66,66,0,1,0,1,0
43640,56053,445,0,0,70,70,0,1,0,1,0
43641,56052,445,0,0,70,70,0,1,0,1,0
43642,55678,5618,0,0,145,145,0,1,0,1,0
43643,48258,37965,0,0,62,62,0,1,0,1,0
43644,43584,24748,0,0,156,156,0,1,0,1,0
43645,43584,24748,0,0,156,156,0,1,0,1,0
43646,0,0,0,0,480,244,236,4,0,2,2
43647,1972,57470,0,0,78,78,0,1,0,1,0
43648,60965,445,0,0,70,70,0,1,0,1,0
43649,57612,28793,0,0,66,66,0,1,0,1,0
43650,63621,30188,0,0,62,62,0,1,0,1,0
43651,56040,445,0,0,70,70,0,1,0,1,0
43652,56039,445,0,0,70,70,0,1,0,1,0
43653,59435,37807,0,0,66,66,0,1,0,1,0
43654,51032,30188,0,0,62,62,0,1,0,1,0
43655,56035,445,0,0,70,70,0,1,0,1,0
43656,60959,445,0,0,70,70,0,1,0,1,0
43657,60957,445,0,0,70,70,0,1,0,1,0
43658,45099,57470,0,0,62,62,0,1,0,1,0
43659,56030,445,0,0,70,70,0,1,0,1,0
43660,56029,445,0,0,70,70,0,1,0,1,0
43661,63867,64147,0,0,62,62,0,1,0,1,0
43662,24236,8055,0,0,148,148,0,1,0,1,0
43663,56360,445,0,0,66,66,0,1,0,1,0
43664,5285,64147,0,0,145,145,0,1,0,1,0
43665,15641,26467,0,0,62,62,0,1,0,1,0
43666,50901,26467,0,0,66,66,0,1,0,1,0
43667,55311,44847,0,0,62,62,0,1,0,1,0
43668,22835,51221,0,0,62,62,0,1,0,1,0
43669,58398,44847,0,0,62,62,0,1,0,1,0
43670,54028,37965,0,0,66,66,0,1,0,1,0
43671,56018,445,0,0,70,70,0,1,0,1,0
43672,56353,445,0,0,66,66,0,1,0,1,0
43673,60943,445,0,0,70,70,0,1,0,1,0
43674,1040,37965,0,0,62,62,0,1,0,1,0
43675,20608,28189,0,0,60,60,0,1,0,1,0
43676,36034,35440,0,0,62,62,0,1,0,1,0
43677,19875,30170,0,0,145,145,0,1,0,1,0
43678,56752,44847,0,0,66,66,0,1,0,1,0
43679,56350,445,0,0,66,66,0,1,0,1,0
43680,58381,57470,0,0,66,66,0,1,0,1,0
43681,60398,46776,0,0,74,74,0,1,0,1,0
43682,32968,43890,0,0,146,146,0,1,0,1,0
43683,33354,10387,0,0,148,148,0,1,0,1,0
43684,56014,445,0,0,70,70,0,1,0,1,0
43685,56343,445,0,0,66,66,0,1,0,1,0
43686,53625,64147,0,0,66,66,0,1,0,1,0
43687,56341,445,0,0,66,66,0,1,0,1,0
43688,65289,46776,0,0,66,66,0,1,0,1,0
43689,58369,443,14100,443,155345,11568,143777,195,195,73,122
43690,59112,443,3834,443,7174,1831,5343,31,110,17,14
43691,59117,443,59117,443,4659,1752,2907,19,30,11,8
43692,49653,443,56043,443,8915,2193,6722,22,46,13,9
43693,58999,53,58999,53,825,99,726,2,30,1,1
43694,8978,53,8978,53,1415,689,726,3,30,2,1
43695,59733,443,53510,443,7165,2077,5088,22,105,12,10
43696,55158,443,7666,443,7963,2657,5306,29,333,13,16
43697,52814,53,53198,53,578,286,292,9,15,5,4
43698,37390,80,51104,80,234,234,0,4,12,4,0
43699,53376,443,49944,443,4814,1207,3607,17,75,10,7
43700,27005,27015,26613,27015,1664,126,1538,4,30,2,2
43701,63015,53,58315,53,303,85,218,2,31,1,1
43702,63016,443,62521,443,303,85,218,2,31,1,1
43703,63024,53,42862,53,569,164,405,2,30,1,1
43704,27005,27020,51720,27020,1626,126,1500,4,30,2,2
43705,27005,27011,25017,27011,1622,126,1496,4,31,2,2
43706,27005,27024,9068,27024,1760,252,1508,5,31,3,2
43707,51631,443,52849,443,36602,1919,34683,58,80,19,39
43708,27005,27020,2257,27020,1622,126,1496,4,31,2,2
43709,43435,5228,26335,5228,6668,1369,5299,20,3600,10,10
43710,63023,443,14505,443,382,164,218,2,30,1,1
43711,38815,53,38815,53,230,99,131,2,30,1,1
43712,37132,443,37132,443,4381,1474,2907,19,27,11,8
43713,37836,443,46026,443,4647,1536,3111,25,40,12,13
43714,48238,443,41856,443,2227,1018,1209,17,15,8,9
43715,56627,443,41594,443,4499,947,3552,14,25,8,6
43716,63835,30794,25747,30794,66,66,0,1,5,1,0
43717,63849,16632,35962,16632,66,66,0,2,8,2,0
43718,60421,6882,25350,6882,70,70,0,1,5,1,0
43719,59259,80,59259,80,101244,15308,85936,165,15,53,112
43720,50324,443,9934,443,8725,2284,6441,17,120,8,9
43721,26050,22448,0,0,62,62,0,1,60,1,0
43722,53377,443,17654,443,4814,1207,3607,17,75,10,7
43723,49450,443,58155,443,8411,2042,6369,25,251,13,12
43724,57932,443,47126,443,29612,2205,27407,53,186,21,32
43725,64080,443,11837,443,75064,64938,10126,147,277,71,76
43726,27005,27015,57738,27015,1638,126,1512,4,30,2,2
43727,50119,443,44388,443,10557,2063,8494,40,144,22,18
43728,38436,5222,53562,5222,7338,3611,3727,74,616,37,37
43729,59128,443,26405,443,92207,5395,86812,130,88,58,72
43730,27005,27018,56521,27018,1672,126,1546,4,30,2,2
43731,57470,47191,13630,47191,528,528,0,9,1200,9,0
43732,27005,27019,64712,27019,1624,126,1498,4,31,2,2
43733,27005,27017,53801,27017,1634,126,1508,4,31,2,2
43734,47595,33437,0,0,106,106,0,1,61,1,0
43735,51221,51413,6783,51413,459,149,310,2,1201,1,1
43736,65160,443,49536,443,1786,172,1614,7,120,3,4
43737,56005,445,0,0,70,70,0,1,0,1,0
43738,56003,445,0,0,70,70,0,1,0,1,0
43739,54520,1433,0,0,60,60,0,1,0,1,0
43740,56001,445,0,0,70,70,0,1,0,1,0
43741,56000,445,0,0,70,70,0,1,0,1,0
43742,61085,37965,0,0,62,62,0,1,0,1,0
43743,55997,445,0,0,70,70,0,1,0,1,0
43744,64997,51221,0,0,66,66,0,1,0,1,0
43745,33801,62413,0,0,66,66,0,1,0,1,0
43746,26180,35440,0,0,66,66,0,1,0,1,0
43747,59352,37965,0,0,66,66,0,1,0,1,0
43748,34306,37965,0,0,62,62,0,1,0,1,0
43749,50481,443,29111,443,16160,13969,2191,42,80,23,19
43750,41981,443,19357,443,5164,2984,2180,42,1285,26,16
43751,64363,53,54171,53,212,102,110,2,30,1,1
43752,50127,80,7047,80,164773,6196,158577,200,135,83,117
43753,63785,55255,57684,55255,3706,2125,1581,18,33,10,8
43754,43223,443,31934,443,836939,25380,811559,864,64,302,562
43755,56838,35124,44520,35124,70,70,0,1,5,1,0
43756,43487,443,46134,443,10015,3476,6539,30,28,19,11
43757,60433,123,65242,123,184,94,90,2,29,1,1
43758,55624,53,62232,53,244,94,150,2,29,1,1
43759,62895,993,31409,993,10457,4879,5578,98,186,50,48
43760,62893,993,15179,993,8883,4621,4262,76,191,47,29
43761,56837,53,27740,53,195,102,93,2,32,1,1
43762,26783,443,21530,443,22489,15918,6571,39,26,21,18
43763,60287,80,62692,80,1052,612,440,10,15,5,5
43764,62889,993,15893,993,9608,4549,5059,88,199,45,43
43765,56650,443,37147,443,8008,1988,6020,20,15,11,9
43766,63848,48560,48756,48560,66,66,0,2,7,2,0
43767,63850,6881,54520,6881,66,66,0,2,7,2,0
43768,62892,993,17111,993,9588,4811,4777,85,193,49,36
43769,49931,443,45441,443,3278,1835,1443,22,16,13,9
43770,55193,53,55120,53,200,102,98,2,33,1,1
43771,56837,53,4890,53,195,102,93,2,29,1,1
43772,65106,53,17651,53,354,94,260,2,29,1,1
43773,57831,443,53060,443,1320606,47731,1272875,1454,294,552,902
43774,39978,443,51684,443,6834,2189,4645,40,29,26,14
43775,56649,443,38913,443,8060,2040,6020,20,15,11,9
43776,58679,53,27207,53,298,102,196,2,29,1,1
43777,55958,53,62913,53,177,94,83,2,29,1,1
43778,56346,53,56346,53,262,106,156,2,32,1,1
43779,54703,53,49581,53,168,78,90,2,30,1,1
43780,38771,443,39867,443,7407,3501,3906,18,15,10,8
43781,63021,443,34609,443,512,166,346,2,30,1,1
43782,63830,15847,65256,15847,1592,1044,548,15,15,9,6
43783,56648,443,26064,443,8007,1987,6020,20,15,11,9
43784,38871,80,51643,80,2057,1263,794,10,15,6,4
43785,50120,443,33702,443,23870,3485,20385,55,143,29,26
43786,56839,49949,49715,49949,70,70,0,1,5,1,0
43787,59258,80,59258,80,107904,4143,103761,179,15,59,120
43788,56658,443,12805,443,1560,988,572,13,23,7,6
43789,42522,443,26969,443,7352,1592,5760,25,16,15,10
43790,49408,443,47633,443,4728,2928,1800,28,95,15,13
43791,64047,53,55544,53,604,89,515,4,45,2,2
43792,58481,53,42506,53,290,110,180,2,30,1,1
43793,35722,123,29832,123,94,94,0,1,30,1,0
43794,63027,443,10834,443,384,166,218,2,30,1,1
43795,64338,53,41701,53,200,102,98,2,30,1,1
43796,65188,53,34848,53,213,102,111,2,30,1,1
43797,39615,443,17497,443,130,70,60,3,5,2,1
43798,49166,443,10443,443,70,70,0,1,5,1,0
43799,44034,80,44034,80,18510,706,17804,22,16,6,16
43800,49250,53,62470,53,298,87,211,4,48,2,2
43801,35321,443,13287,443,9675,2671,7004,36,262,18,18
43802,58558,53,58236,53,268,86,182,2,30,1,1
43803,51497,443,14907,443,8939,3462,5477,25,263,12,13
43804,56630,80,55230,80,234,234,0,4,12,4,0
43805,46460,443,35545,443,5117,3501,1616,29,80,15,14
43806,65282,53,57609,53,522,91,431,4,49,2,2
43807,37900,53,2466,53,78,78,0,1,30,1,0
43808,55958,53,14434,53,177,94,83,2,30,1,1
43809,55995,443,59419,443,7563,2253,5310,20,157,11,9
43810,53819,443,53819,443,1386,751,635,15,180,8,7
43811,63020,443,53282,443,512,166,346,2,30,1,1
43812,57476,443,16400,443,10068,3304,6764,28,36,17,11
43813,52069,443,58319,443,8593,2221,6372,31,232,17,14
43814,34083,443,2580,443,7510,2040,5470,24,210,13,11
43815,50222,443,19718,443,9582,2201,7381,28,99,14,14
43816,62886,993,19324,993,9557,4773,4784,84,199,48,36
43817,62890,993,29471,993,9624,4559,5065,88,196,45,43
43818,51871,23801,64442,23801,316,136,180,6,6,3,3
43819,63837,14023,26076,14023,70,70,0,1,4,1,0
43820,54966,53,59029,53,255,88,167,4,32,2,2
43821,63836,14791,37606,14791,70,70,0,1,4,1,0
43822,49995,53,53855,53,303,98,205,4,40,2,2
43823,51865,14732,26909,14732,70,70,0,2,7,2,0
43824,37356,443,58036,443,1842,1134,708,14,315,8,6
43825,65465,53,18720,53,293,102,191,2,29,1,1
43826,49684,53,21165,53,305,94,211,2,29,1,1
43827,50118,443,10177,443,125395,8711,116684,178,143,83,95
43828,50129,443,15530,443,9199,2329,6870,30,133,17,13
43829,52072,443,62613,443,7737,6531,1206,21,16,12,9
43830,49497,53,38810,53,297,102,195,2,29,1,1
43831,55600,53,56237,53,168,78,90,2,30,1,1
43832,55762,53,8136,53,196,86,110,2,29,1,1
43833,55762,53,54612,53,184,102,82,2,29,1,1
43834,65212,53,14498,53,273,118,155,2,30,1,1
43835,65093,53,16648,53,266,118,148,2,29,1,1
43836,57065,53,34013,53,272,110,162,2,29,1,1
43837,65389,53,51653,53,94,94,0,1,30,1,0
43838,39814,53,58386,53,168,78,90,2,30,1,1
43839,55193,53,45543,53,200,102,98,2,30,1,1
43840,49378,53,56071,53,268,94,174,2,30,1,1
43841,64512,53,55792,53,244,118,126,2,30,1,1
43842,34531,443,54332,443,135231,5033,130198,149,216,55,94
43843,57996,53,57996,53,265,114,151,2,30,1,1
43844,56663,443,26392,443,9691,2221,7470,16,120,8,8
43845,55308,443,1473,443,4981,943,4038,20,360,10,10
43846,42861,443,12903,443,2337,1394,943,17,275,9,8
43847,63013,443,17200,443,304,86,218,2,30,1,1
43848,58259,53,23484,53,168,78,90,2,30,1,1
43849,50503,443,44653,443,9295,3094,6201,24,82,12,12
43850,42115,53,42115,53,262,106,156,2,32,1,1
43851,10060,443,49510,443,293424,16379,277045,410,93,193,217
43852,38770,443,2311,443,7431,3525,3906,18,15,10,8
43853,63028,53,16966,53,384,166,218,2,30,1,1
43854,63025,443,40805,443,304,86,218,2,30,1,1
43855,11076,53,11076,53,832,106,726,2,30,1,1
43856,56129,53,60836,53,94,94,0,1,30,1,0
43857,53761,123,54980,123,184,94,90,2,30,1,1
43858,55484,443,11193,443,5039,2002,3037,14,120,7,7
43859,60874,443,51364,443,1706,169,1537,6,121,3,3
43860,61231,443,59948,443,1864,250,1614,8,121,4,4
43861,57586,443,39129,443,3724,1963,1761,24,95,13,11
43862,64069,443,44966,443,11223,3362,7861,62,280,27,35
43863,49187,80,38831,80,1213,471,742,10,111,6,4
43864,57827,443,29156,443,912754,34972,877782,1035,294,410,625
43865,49288,53,48281,53,322,102,220,2,30,1,1
43866,49273,53,17508,53,342,110,232,2,30,1,1
43867,64875,53,51837,53,211,102,109,2,30,1,1
43868,44976,53,45616,53,86,86,0,1,30,1,0
43869,49995,53,30507,53,197,102,95,2,33,1,1
43870,33852,443,7849,443,3419,2241,1178,16,16,8,8
43871,26869,53,19844,53,290,110,180,2,30,1,1
43872,55228,53,59087,53,212,102,110,2,30,1,1
43873,63980,53,48933,53,225,102,123,2,30,1,1
43874,63026,53,55076,53,304,86,218,2,30,1,1
43875,62329,53,9486,53,268,86,182,2,30,1,1
43876,60920,53,22139,53,268,86,182,2,30,1,1
43877,49161,53,1492,53,385,102,283,2,30,1,1
43878,51933,53,51933,53,253,106,147,2,30,1,1
43879,38334,53,4428,53,168,78,90,2,31,1,1
43880,64724,443,50877,443,8602,1050,7552,16,121,7,9
43881,15503,38120,41177,38120,481,150,331,2,1200,1,1
43882,57470,48622,44893,48622,166,166,0,1,1200,1,0
43883,57510,443,62415,443,16532,2229,14303,26,133,11,15
43884,53678,31592,2735,31592,70,70,0,2,8,2,0
43885,56802,80,23332,80,1559,762,797,14,30,7,7
43886,64467,80,64467,80,5570,699,4871,14,22,7,7
43887,64361,53,32766,53,228,110,118,2,30,1,1
43888,58875,53,56659,53,370,86,284,2,30,1,1
43889,49954,53,40035,53,211,102,109,2,31,1,1
43890,54827,443,62409,443,11291,2426,8865,21,121,10,11
43891,52401,443,47720,443,12402,3972,8430,46,138,26,20
43892,38768,443,45644,443,7380,3474,3906,18,16,10,8
43893,53677,10657,26875,10657,70,70,0,2,8,2,0
43894,52705,80,52705,80,7237,2578,4659,19,16,9,10
43895,57583,443,11570,443,6150,4180,1970,21,95,13,8
43896,53481,443,12218,443,5913,4482,1431,30,30,20,10
43897,19372,443,19372,443,10461,1417,9044,23,16,10,13
43898,56647,443,45722,443,8059,2039,6020,20,15,11,9
43899,38769,443,3016,443,7352,3452,3900,18,15,10,8
43900,34709,443,21963,443,2119,1310,809,21,27,12,9
43901,63012,53,5232,53,304,86,218,2,30,1,1
43902,63011,443,30939,443,304,86,218,2,30,1,1
43903,64076,53,18119,53,353,118,235,2,30,1,1
43904,61510,37965,0,0,66,66,0,1,0,1,0
43905,60936,445,0,0,70,70,0,1,0,1,0
43906,60932,445,0,0,70,70,0,1,0,1,0
43907,60931,445,0,0,70,70,0,1,0,1,0
43908,44208,26467,0,0,62,62,0,1,0,1,0
43909,56325,445,0,0,66,66,0,1,0,1,0
43910,56326,445,0,0,66,66,0,1,0,1,0
43911,56324,445,0,0,66,66,0,1,0,1,0
43912,56320,445,0,0,66,66,0,1,0,1,0
43913,56322,445,0,0,66,66,0,1,0,1,0
43914,56323,445,0,0,66,66,0,1,0,1,0
43915,56321,445,0,0,66,66,0,1,0,1,0
43916,56319,445,0,0,66,66,0,1,0,1,0
43917,15403,51505,0,0,66,66,0,1,0,1,0
43918,46945,64147,0,0,62,62,0,1,0,1,0
43919,57433,21247,0,0,66,66,0,1,0,1,0
43920,6889,45129,0,0,159,159,0,1,0,1,0
43921,55992,445,0,0,70,70,0,1,0,1,0
43922,53227,64097,0,0,62,62,0,1,0,1,0
43923,55459,50584,0,0,66,66,0,1,0,1,0
43924,27679,37965,0,0,62,62,0,1,0,1,0
43925,61002,37965,0,0,145,145,0,1,0,1,0
43926,55984,445,0,0,70,70,0,1,0,1,0
43927,60923,445,0,0,70,70,0,1,0,1,0
43928,60922,445,0,0,70,70,0,1,0,1,0
43929,60915,445,0,0,70,70,0,1,0,1,0
43930,55981,445,0,0,70,70,0,1,0,1,0
43931,50784,50584,0,0,62,62,0,1,0,1,0
43932,56369,22114,0,0,62,62,0,1,0,1,0
43933,56369,22114,0,0,146,146,0,1,0,1,0
43934,56307,445,0,0,66,66,0,1,0,1,0
43935,56306,445,0,0,66,66,0,1,0,1,0
43936,56304,445,0,0,66,66,0,1,0,1,0
43937,60913,445,0,0,70,70,0,1,0,1,0
43938,26699,35253,0,0,62,62,0,1,0,1,0
43939,52150,39109,0,0,66,66,0,1,0,1,0
43940,55978,445,0,0,70,70,0,1,0,1,0
43941,48980,11119,0,0,146,146,0,1,0,1,0
43942,16387,3655,0,0,60,60,0,1,0,1,0
43943,16387,22272,0,0,60,60,0,1,0,1,0
43944,49197,30188,0,0,62,62,0,1,0,1,0
43945,16387,20045,0,0,60,60,0,1,0,1,0
43946,55976,445,0,0,70,70,0,1,0,1,0
43947,12107,22114,0,0,66,66,0,1,0,1,0
43948,60911,445,0,0,70,70,0,1,0,1,0
43949,4427,50584,0,0,62,62,0,1,0,1,0
43950,16387,44427,0,0,60,60,0,1,0,1,0
43951,16387,7205,0,0,60,60,0,1,0,1,0
43952,16387,16862,0,0,60,60,0,1,0,1,0
43953,60909,445,0,0,70,70,0,1,0,1,0
43954,60908,445,0,0,70,70,0,1,0,1,0
43955,60900,445,0,0,70,70,0,1,0,1,0
43956,34146,51221,0,0,62,62,0,1,0,1,0
43957,51313,64147,0,0,66,66,0,1,0,1,0
43958,55972,445,0,0,70,70,0,1,0,1,0
43959,16387,63752,0,0,60,60,0,1,0,1,0
43960,16387,35583,0,0,60,60,0,1,0,1,0
43961,16387,64075,0,0,60,60,0,1,0,1,0
43962,2876,35440,0,0,62,62,0,1,0,1,0
43963,64283,37965,0,0,74,74,0,1,0,1,0
43964,55971,445,0,0,70,70,0,1,0,1,0
43965,28370,35440,0,0,66,66,0,1,0,1,0
43966,11344,42873,0,0,62,62,0,1,0,1,0
43967,1790,48817,0,0,62,62,0,1,0,1,0
43968,8080,37965,0,0,62,62,0,1,0,1,0
43969,53781,37965,0,0,66,66,0,1,0,1,0
43970,34809,57470,0,0,66,66,0,1,0,1,0
43971,59772,62413,0,0,66,66,0,1,0,1,0
43972,60892,445,0,0,70,70,0,1,0,1,0
43973,60891,445,0,0,70,70,0,1,0,1,0
43974,60888,445,0,0,70,70,0,1,0,1,0
43975,55966,445,0,0,70,70,0,1,0,1,0
43976,29787,37965,0,0,62,62,0,1,0,1,0
43977,62625,37965,0,0,66,66,0,1,0,1,0
43978,27443,23,0,0,60,60,0,1,0,1,0
43979,62725,51221,0,0,62,62,0,1,0,1,0
43980,64693,26467,0,0,62,62,0,1,0,1,0
43981,34499,8497,0,0,148,148,0,1,0,1,0
43982,61195,56205,0,0,66,66,0,1,0,1,0
43983,56281,445,0,0,66,66,0,1,0,1,0
43984,55238,21247,0,0,62,62,0,1,0,1,0
43985,60885,445,0,0,70,70,0,1,0,1,0
43986,60884,445,0,0,70,70,0,1,0,1,0
43987,13970,42873,0,0,62,62,0,1,0,1,0
43988,55953,445,0,0,70,70,0,1,0,1,0
43989,59724,64147,0,0,66,66,0,1,0,1,0
43990,55950,445,0,0,70,70,0,1,0,1,0
43991,58334,5223,0,0,148,148,0,1,0,1,0
43992,56277,445,0,0,66,66,0,1,0,1,0
43993,52410,8604,0,0,66,66,0,1,0,1,0
43994,56275,445,0,0,66,66,0,1,0,1,0
43995,60873,445,0,0,70,70,0,1,0,1,0
43996,65495,11392,0,0,66,66,0,1,0,1,0
43997,12087,59033,0,0,148,148,0,1,0,1,0
43998,60868,445,0,0,70,70,0,1,0,1,0
43999,60866,445,0,0,70,70,0,1,0,1,0
44000,60865,445,0,0,70,70,0,1,0,1,0
44001,7978,50584,0,0,66,66,0,1,0,1,0
44002,56274,445,0,0,66,66,0,1,0,1,0
44003,52870,22197,0,0,66,66,0,1,0,1,0
44004,55945,445,0,0,70,70,0,1,0,1,0
44005,55944,445,0,0,70,70,0,1,0,1,0
44006,59889,30188,0,0,66,66,0,1,0,1,0
44007,63740,64147,0,0,66,66,0,1,0,1,0
44008,14924,44847,0,0,62,62,0,1,0,1,0
44009,49248,35993,0,0,66,66,0,1,0,1,0
44010,55942,445,0,0,70,70,0,1,0,1,0
44011,60859,445,0,0,70,70,0,1,0,1,0
44012,42968,56205,0,0,146,146,0,1,0,1,0
44013,60856,445,0,0,70,70,0,1,0,1,0
44014,60855,445,0,0,70,70,0,1,0,1,0
44015,60852,445,0,0,70,70,0,1,0,1,0
44016,56265,445,0,0,66,66,0,1,0,1,0
44017,43584,24748,0,0,156,156,0,1,0,1,0
44018,43584,24748,0,0,156,156,0,1,0,1,0
44019,57131,35776,0,0,145,145,0,1,0,1,0
44020,43584,24748,0,0,156,156,0,1,0,1,0
44021,43584,24748,0,0,156,156,0,1,0,1,0
44022,59965,36237,0,0,66,66,0,1,0,1,0
44023,43584,24748,0,0,156,156,0,1,0,1,0
44024,56263,445,0,0,66,66,0,1,0,1,0
44025,56260,445,0,0,66,66,0,1,0,1,0
44026,56258,445,0,0,66,66,0,1,0,1,0
44027,443,2629,0,0,135,135,0,1,0,1,0
44028,443,46223,0,0,66,66,0,1,0,1,0
44029,56256,445,0,0,66,66,0,1,0,1,0
44030,56255,445,0,0,66,66,0,1,0,1,0
44031,56253,445,0,0,66,66,0,1,0,1,0
44032,54530,35440,0,0,66,66,0,1,0,1,0
44033,56376,44847,0,0,66,66,0,1,0,1,0
44034,52724,64147,0,0,62,62,0,1,0,1,0
44035,55935,445,0,0,70,70,0,1,0,1,0
44036,0,0,0,0,2000,1020,980,20,0,10,10
44037,57472,44847,0,0,66,66,0,1,0,1,0
44038,14255,2767,0,0,146,146,0,1,0,1,0
44039,55933,445,0,0,70,70,0,1,0,1,0
44040,60849,445,0,0,70,70,0,1,0,1,0
44041,60850,445,0,0,70,70,0,1,0,1,0
44042,60848,445,0,0,70,70,0,1,0,1,0
44043,10348,25604,0,0,66,66,0,1,0,1,0
44044,54636,26467,0,0,62,62,0,1,0,1,0
44045,26921,57470,0,0,62,62,0,1,0,1,0
44046,10028,25604,0,0,62,62,0,1,0,1,0
44047,23383,64147,0,0,62,62,0,1,0,1,0
44048,51093,57470,0,0,66,66,0,1,0,1,0
44049,38383,51221,0,0,62,62,0,1,0,1,0
44050,64387,37965,0,0,62,62,0,1,0,1,0
44051,56252,445,0,0,66,66,0,1,0,1,0
44052,60843,445,0,0,70,70,0,1,0,1,0
44053,55932,445,0,0,70,70,0,1,0,1,0
44054,56247,445,0,0,66,66,0,1,0,1,0
44055,57969,42873,0,0,66,66,0,1,0,1,0
44056,55931,445,0,0,70,70,0,1,0,1,0
44057,55930,445,0,0,70,70,0,1,0,1,0
44058,55926,445,0,0,70,70,0,1,0,1,0
44059,55927,445,0,0,70,70,0,1,0,1,0
44060,56246,445,0,0,66,66,0,1,0,1,0
44061,56244,445,0,0,66,66,0,1,0,1,0
44062,3117,37965,0,0,62,62,0,1,0,1,0
44063,6824,26467,0,0,66,66,0,1,0,1,0
44064,54854,19847,0,0,62,62,0,1,0,1,0
44065,43657,50011,0,0,62,62,0,1,0,1,0
44066,50095,30188,0,0,62,62,0,1,0,1,0
44067,57114,35440,0,0,62,62,0,1,0,1,0
44068,55912,445,0,0,70,70,0,1,0,1,0
44069,1972,57470,0,0,78,78,0,1,0,1,0
44070,55911,445,0,0,70,70,0,1,0,1,0
44071,55907,445,0,0,70,70,0,1,0,1,0
44072,55902,445,0,0,70,70,0,1,0,1,0
44073,52459,5555,0,0,60,60,0,1,0,1,0
44074,55901,445,0,0,70,70,0,1,0,1,0
44075,60838,445,0,0,70,70,0,1,0,1,0
44076,28124,37965,0,0,62,62,0,1,0,1,0
44077,16086,6881,0,0,146,146,0,1,0,1,0
44078,20608,28189,0,0,60,60,0,1,0,1,0
44079,6881,6881,0,0,146,146,0,1,0,1,0
44080,60830,445,0,0,70,70,0,1,0,1,0
44081,60825,445,0,0,70,70,0,1,0,1,0
44082,55600,22,0,0,60,60,0,1,0,1,0
44083,54047,50011,0,0,66,66,0,1,0,1,0
44084,55145,11392,0,0,66,66,0,1,0,1,0
44085,16944,50584,0,0,62,62,0,1,0,1,0
44086,16944,50584,0,0,146,146,0,1,0,1,0
44087,35849,30188,0,0,62,62,0,1,0,1,0
44088,56231,445,0,0,66,66,0,1,0,1,0
44089,55890,445,0,0,70,70,0,1,0,1,0
44090,29300,35440,0,0,62,62,0,1,0,1,0
44091,1821,64147,0,0,66,66,0,1,0,1,0
44092,56224,445,0,0,66,66,0,1,0,1,0
44093,60815,445,0,0,70,70,0,1,0,1,0
44094,443,62451,0,0,199,199,0,1,0,1,0
44095,51283,80,60981,80,1114,534,580,12,16,7,5
44096,60419,33709,17912,33709,504,318,186,8,16,5,3
44097,49487,443,25025,443,72073,12550,59523,78,45,25,53
44098,37098,443,22843,443,1835,1190,645,17,26,10,7
44099,55631,16191,24420,16191,504,318,186,8,16,5,3
44100,51842,27665,45700,27665,66,66,0,1,5,1,0
44101,54213,443,30339,443,7498,2799,4699,24,17,13,11
44102,49295,443,9529,443,4179,2599,1580,27,75,13,14
44103,27005,27025,48292,27025,1774,252,1522,5,31,3,2
44104,56677,443,37200,443,6313,2068,4245,21,20,12,9
44105,53645,62348,1333,62348,2395,1145,1250,13,16,6,7
44106,60347,80,6401,80,2018,1704,314,16,15,11,5
44107,48643,80,57942,80,1912,1464,448,14,16,7,7
44108,57470,1028,19810,1028,350,163,187,2,1200,1,1
44109,37095,443,45405,443,1835,1190,645,17,26,10,7
44110,37097,443,17597,443,1835,1190,645,17,26,10,7
44111,45132,443,57235,443,5398,3277,2121,30,80,16,14
44112,37096,443,33249,443,1753,1108,645,16,26,9,7
44113,38365,15000,43140,15000,130,70,60,2,6,1,1
44114,48710,22,48710,22,11002,3445,7557,60,42,26,34
44115,63214,53,63214,53,261,103,158,2,30,1,1
44116,27005,27023,4968,27023,1640,126,1514,4,30,2,2
44117,35123,443,15419,443,17656,4044,13612,30,122,13,17
44118,60875,443,10095,443,1786,172,1614,7,120,3,4
44119,52662,443,35849,443,5382,1353,4029,19,135,10,9
44120,33356,80,44491,80,1658,1344,314,10,15,5,5
44121,39328,80,54036,80,78,78,0,1,5,1,0
44122,53656,58624,54901,58624,70,70,0,1,5,1,0
44123,60417,443,24567,443,8590,1987,6603,23,86,12,11
44124,27005,27017,60411,27017,1644,126,1518,4,30,2,2
44125,55592,53,16143,53,817,98,719,2,30,1,1
44126,49396,53,24683,53,170,87,83,2,30,1,1
44127,55274,53,15789,53,711,87,624,2,30,1,1
44128,61232,443,38058,443,1786,172,1614,7,120,3,4
44129,61234,443,50660,443,1786,172,1614,7,120,3,4
44130,50584,6881,56597,6881,161,161,0,1,1201,1,0
44131,50584,44816,28229,44816,161,161,0,1,1201,1,0
44132,53765,443,24226,443,16482,9312,7170,39,141,19,20
44133,50265,21544,58613,21544,390,266,124,6,1200,4,2
44134,49224,53,6029,53,170,87,83,2,31,1,1
44135,30960,45718,62760,45718,330,330,0,6,3609,6,0
44136,57277,5223,45346,5223,4339,1521,2818,23,3002,14,9
44137,1024,21247,0,0,62,62,0,1,0,1,0
44138,40322,23,0,0,60,60,0,1,0,1,0
44139,7109,64147,0,0,62,62,0,1,0,1,0
44140,56221,445,0,0,66,66,0,1,0,1,0
44141,60222,22114,0,0,66,66,0,1,0,1,0
44142,30913,33876,0,0,145,145,0,1,0,1,0
44143,55886,445,0,0,70,70,0,1,0,1,0
44144,56214,445,0,0,66,66,0,1,0,1,0
44145,55877,445,0,0,70,70,0,1,0,1,0
44146,55876,445,0,0,70,70,0,1,0,1,0
44147,51164,64147,0,0,66,66,0,1,0,1,0
44148,1024,64147,0,0,62,62,0,1,0,1,0
44149,55872,445,0,0,70,70,0,1,0,1,0
44150,55874,445,0,0,70,70,0,1,0,1,0
44151,56211,445,0,0,66,66,0,1,0,1,0
44152,55869,445,0,0,70,70,0,1,0,1,0
44153,13663,23,0,0,60,60,0,1,0,1,0
44154,52754,26467,0,0,66,66,0,1,0,1,0
44155,57093,26467,0,0,66,66,0,1,0,1,0
44156,25565,20455,0,0,60,60,0,1,0,1,0
44157,4772,37965,0,0,66,66,0,1,0,1,0
44158,60803,445,0,0,70,70,0,1,0,1,0
44159,60805,445,0,0,70,70,0,1,0,1,0
44160,60804,445,0,0,70,70,0,1,0,1,0
44161,39452,123,25633,123,184,94,90,2,30,1,1
44162,37653,5223,9635,5223,417,417,0,4,13,4,0
44163,65352,443,3902,443,12690,1918,10772,39,195,19,20
44164,49396,53,21722,53,177,94,83,2,30,1,1
44165,46582,80,45383,80,540,540,0,10,194,10,0
44166,49989,53,42243,53,677,217,460,6,74,3,3
44167,9555,80,9555,80,6893,704,6189,14,15,6,8
44168,64202,53,3004,53,316,89,227,4,50,2,2
44169,63022,53,50452,53,384,166,218,2,29,1,1
44170,63014,53,26673,53,304,86,218,2,29,1,1
44171,61233,443,12202,443,1775,169,1606,7,120,3,4
44172,51825,80,15500,80,540,540,0,10,194,10,0
44173,49507,53,65329,53,177,94,83,2,30,1,1
44174,53674,31724,4834,31724,70,70,0,2,7,2,0
44175,60827,53,38613,53,224,86,138,2,29,1,1
44176,63018,53,50611,53,384,166,218,2,29,1,1
44177,63010,53,14322,53,304,86,218,2,29,1,1
44178,65442,53,44743,53,262,102,160,2,29,1,1
44179,49396,53,32920,53,177,94,83,2,29,1,1
44180,54044,53,15773,53,224,86,138,2,29,1,1
44181,51862,27758,32851,27758,70,70,0,2,7,2,0
44182,39807,443,25771,443,1684,1031,653,16,92,9,7
44183,34715,443,46649,443,584,370,214,9,26,6,3
44184,64765,53,50725,53,177,94,83,2,30,1,1
44185,34391,443,18031,443,80160,3527,76633,98,76,38,60
44186,53652,57503,44187,57503,492,306,186,8,15,5,3
44187,51861,23919,9665,23919,70,70,0,2,7,2,0
44188,53647,80,49783,80,1962,1287,675,13,27,7,6
44189,51841,21960,6708,21960,136,136,0,3,14,3,0
44190,56837,46790,59586,46790,70,70,0,1,5,1,0
44191,58870,443,45632,443,1411,921,490,12,15,7,5
44192,55245,443,9754,443,6799,1581,5218,27,25,14,13
44193,50086,80,23658,80,3148,687,2461,12,15,7,5
44194,49606,53,55555,53,328,94,234,4,43,2,2
44195,50084,80,12971,80,2173,616,1557,10,15,6,4
44196,49640,443,55755,443,2809,1729,1080,18,80,10,8
44197,26849,443,35279,443,20979,15982,4997,38,36,22,16
44198,26854,53,44108,53,222,86,136,2,30,1,1
44199,64608,53,19709,53,718,94,624,2,30,1,1
44200,8283,52443,24980,52443,70,70,0,1,30,1,0
44201,65081,443,33904,443,5291,339,4952,11,120,5,6
44202,64670,53,49938,53,228,94,134,2,30,1,1
44203,49507,53,33142,53,177,94,83,2,30,1,1
44204,51863,22038,18854,22038,70,70,0,2,7,2,0
44205,51486,4545,51486,4545,156,156,0,3,8,3,0
44206,49334,53,5617,53,300,99,201,4,38,2,2
44207,55327,443,55327,443,16304,2069,14235,39,17,19,20
44208,64828,53,23782,53,372,94,278,2,30,1,1
44209,64230,53,48297,53,193,94,99,2,30,1,1
44210,51844,12471,8982,12471,70,70,0,1,5,1,0
44211,51789,80,62386,80,28433,1668,26765,39,20,18,21
44212,51787,80,42388,80,26626,1555,25071,36,20,16,20
44213,34490,443,47026,443,584,370,214,9,26,6,3
44214,56644,443,57838,443,7862,1873,5989,20,15,11,9
44215,55217,443,42611,443,8690,4119,4571,26,31,14,12
44216,19962,53,19962,53,832,106,726,2,30,1,1
44217,10151,11809,51182,11809,481,150,331,2,1200,1,1
44218,48285,80,8478,80,6713,1736,4977,24,1130,8,16
44219,38010,443,65428,443,5474,2239,3235,31,80,14,17
44220,45359,443,22644,443,10480,4949,5531,22,15,12,10
44221,50085,80,7079,80,3326,684,2642,12,15,7,5
44222,56646,443,12579,443,7862,1873,5989,20,15,11,9
44223,48742,443,3234,443,4801,2138,2663,23,15,12,11
44224,45360,443,43206,443,10280,6167,4113,20,15,12,8
44225,52292,80,52292,80,1914,1302,612,11,14,5,6
44226,36532,6555,55068,6555,922,428,494,10,14,5,5
44227,52661,80,52661,80,1950,1338,612,11,14,5,6
44228,53676,3678,29317,3678,70,70,0,2,7,2,0
44229,34787,80,1192,80,2989,813,2176,15,166,8,7
44230,39570,443,62469,443,70,70,0,1,5,1,0
44231,41431,443,28233,443,1843,996,847,17,275,8,9
44232,19125,80,19125,80,12650,889,11761,20,16,9,11
44233,27005,27016,57250,27016,1784,252,1532,5,31,3,2
44234,33165,443,61975,443,7442,1260,6182,19,15,10,9
44235,55206,443,55206,443,18965,2061,16904,35,17,18,17
44236,63019,53,40745,53,512,166,346,2,29,1,1
44237,51791,80,21497,80,1934,1083,851,9,15,5,4
44238,64542,53,47604,53,234,94,140,2,29,1,1
44239,49474,53,54970,53,224,86,138,2,29,1,1
44240,63017,443,7644,443,571,166,405,2,29,1,1
44241,53290,443,5427,443,494,288,206,8,26,5,3
44242,63009,443,26712,443,304,86,218,2,29,1,1
44243,53649,26085,23135,26085,612,306,306,10,15,5,5
44244,49396,53,18429,53,177,94,83,2,29,1,1
44245,64966,53,26229,53,376,126,250,2,29,1,1
44246,65197,53,14120,53,177,86,91,2,30,1,1
44247,50059,53,45752,53,718,94,624,2,30,1,1
44248,27005,27015,22209,27015,1654,126,1528,4,30,2,2
44249,64722,443,16301,443,61890,2830,59060,73,120,27,46
44250,65167,53,20946,53,219,94,125,2,30,1,1
44251,49758,53,63769,53,243,102,141,2,30,1,1
44252,46671,53,46671,53,832,106,726,2,30,1,1
44253,64765,53,64580,53,177,94,83,2,30,1,1
44254,50265,37711,22022,37711,132,132,0,3,1200,3,0
44255,6881,55085,23823,55085,509,150,359,2,1199,1,1
44256,50584,13560,50803,13560,166,166,0,1,1200,1,0
44257,57470,24907,9136,24907,1386,1386,0,22,1544,22,0
44258,57470,6881,62721,6881,150,150,0,1,1200,1,0
44259,39820,443,15397,443,2642442,95056,2547386,2730,3629,999,1731
44260,33850,443,55796,443,6987,2005,4982,18,16,9,9
44261,51790,80,59266,80,1936,1085,851,9,15,5,4
44262,56645,443,46847,443,7914,1925,5989,20,15,11,9
44263,34392,443,49266,443,1820,1101,719,18,76,10,8
44264,55808,53,55808,53,257,106,151,2,30,1,1
44265,46887,443,50848,443,118,118,0,1,30,1,0
44266,49338,53,20545,53,368,94,274,2,30,1,1
44267,64561,53,17308,53,461,91,370,4,60,2,2
44268,49559,443,1739,443,3641,1047,2594,14,120,7,7
44269,47377,443,54637,443,2725,1153,1572,19,208,8,11
44270,45275,443,51304,443,9908271,123308,9784963,8531,359,1708,6823
44271,65105,80,65105,80,23382,3770,19612,48,45,24,24
44272,39762,123,46956,123,184,94,90,2,30,1,1
44273,64360,53,15501,53,350,88,262,4,31,2,2
44274,44353,443,12767,443,15234,2503,12731,45,135,20,25
44275,58004,443,48941,443,13206,7781,5425,29,253,15,14
44276,63832,6969,32926,6969,70,70,0,1,5,1,0
44277,56786,443,56786,443,4381,1474,2907,19,27,11,8
44278,51788,80,12159,80,35407,1784,33623,46,20,20,26
44279,50265,24387,44902,24387,330,330,0,6,1200,6,0
44280,50584,51651,64737,51651,166,166,0,1,1200,1,0
44281,41762,443,13178,443,2306249,52358,2253891,2041,239,447,1594
44282,50584,49001,15411,49001,889,161,728,3,1200,2,1
44283,33200,443,11701,443,67123,10708,56415,100,124,41,59
44284,47089,443,11846,443,172,172,0,2,5,2,0
44285,53654,8100,50250,8100,70,70,0,1,5,1,0
44286,35168,443,20668,443,7447,2133,5314,27,348,14,13
44287,49640,443,44264,443,12619,3258,9361,33,47,19,14
44288,58440,53,59026,53,305,102,203,2,31,1,1
44289,49746,53,24579,53,479,88,391,4,58,2,2
44290,49293,80,54518,80,75982,15645,60337,88,158,31,57
44291,53670,32016,15273,32016,70,70,0,2,8,2,0
44292,64157,53,49752,53,370,126,244,2,30,1,1
44293,64951,53,60545,53,230,102,128,2,30,1,1
44294,49948,53,19107,53,380,110,270,2,30,1,1
44295,56660,53,3127,53,338,110,228,2,30,1,1
44296,27005,27025,58786,27025,1634,126,1508,4,31,2,2
44297,56621,443,14784,443,1327,918,409,10,26,6,4
44298,58866,443,52755,443,2353,1453,900,16,15,8,8
44299,11324,443,11324,443,6981,948,6033,17,28,10,7
44300,27005,27052,57707,27052,1948,378,1570,6,33,4,2
44301,47528,8080,0,0,184,78,106,3,10,2,1
44302,49649,443,20901,443,10099,1721,8378,27,46,14,13
44303,57580,443,3612,443,4049,1992,2057,23,96,13,10
44304,27005,27015,32114,27015,1634,126,1508,4,31,2,2
44305,56197,445,0,0,66,66,0,1,0,1,0
44306,56193,445,0,0,66,66,0,1,0,1,0
44307,56192,445,0,0,66,66,0,1,0,1,0
44308,56198,445,0,0,66,66,0,1,0,1,0
44309,56194,445,0,0,66,66,0,1,0,1,0
44310,56196,445,0,0,66,66,0,1,0,1,0
44311,56195,445,0,0,66,66,0,1,0,1,0
44312,56190,445,0,0,66,66,0,1,0,1,0
44313,2370,23,0,0,60,60,0,1,0,1,0
44314,37343,21247,0,0,146,146,0,1,0,1,0
44315,55864,445,0,0,70,70,0,1,0,1,0
44316,44129,64147,0,0,145,145,0,1,0,1,0
44317,54868,1433,0,0,60,60,0,1,0,1,0
44318,65492,2323,0,0,60,60,0,1,0,1,0
44319,30783,51505,0,0,62,62,0,1,0,1,0
44320,10252,11392,0,0,62,62,0,1,0,1,0
44321,10331,6881,0,0,146,146,0,1,0,1,0
44322,55856,445,0,0,70,70,0,1,0,1,0
44323,6655,2323,0,0,60,60,0,1,0,1,0
44324,55855,445,0,0,70,70,0,1,0,1,0
44325,3436,46783,0,0,62,62,0,1,0,1,0
44326,60802,445,0,0,70,70,0,1,0,1,0
44327,60789,445,0,0,70,70,0,1,0,1,0
44328,60788,445,0,0,70,70,0,1,0,1,0
44329,25857,57354,0,0,145,145,0,1,0,1,0
44330,11030,37965,0,0,62,62,0,1,0,1,0
44331,56178,445,0,0,66,66,0,1,0,1,0
44332,56177,445,0,0,66,66,0,1,0,1,0
44333,56175,445,0,0,66,66,0,1,0,1,0
44334,55850,445,0,0,70,70,0,1,0,1,0
44335,52563,17235,0,0,70,70,0,1,0,1,0
44336,55848,445,0,0,70,70,0,1,0,1,0
44337,60786,445,0,0,70,70,0,1,0,1,0
44338,47803,64147,0,0,145,145,0,1,0,1,0
44339,63213,15503,0,0,66,66,0,1,0,1,0
44340,58550,21247,0,0,66,66,0,1,0,1,0
44341,60783,445,0,0,70,70,0,1,0,1,0
44342,56148,37965,0,0,66,66,0,1,0,1,0
44343,55844,445,0,0,70,70,0,1,0,1,0
44344,60776,445,0,0,70,70,0,1,0,1,0
44345,60779,445,0,0,70,70,0,1,0,1,0
44346,60778,445,0,0,70,70,0,1,0,1,0
44347,19632,37965,0,0,62,62,0,1,0,1,0
44348,16387,3655,0,0,60,60,0,1,0,1,0
44349,16387,22272,0,0,60,60,0,1,0,1,0
44350,16387,20045,0,0,60,60,0,1,0,1,0
44351,55981,31573,0,0,146,146,0,1,0,1,0
44352,53543,44847,0,0,62,62,0,1,0,1,0
44353,55843,445,0,0,70,70,0,1,0,1,0
44354,16387,44427,0,0,60,60,0,1,0,1,0
44355,16387,7205,0,0,60,60,0,1,0,1,0
44356,16387,16862,0,0,60,60,0,1,0,1,0
44357,16387,63752,0,0,60,60,0,1,0,1,0
44358,16387,35583,0,0,60,60,0,1,0,1,0
44359,16387,64075,0,0,60,60,0,1,0,1,0
44360,3980,63710,0,0,66,66,0,1,0,1,0
44361,20198,17372,0,0,62,62,0,1,0,1,0
44362,51910,37965,0,0,62,62,0,1,0,1,0
44363,56127,35440,0,0,62,62,0,1,0,1,0
44364,1117,37965,0,0,62,62,0,1,0,1,0
44365,55838,445,0,0,70,70,0,1,0,1,0
44366,19096,64147,0,0,62,62,0,1,0,1,0
44367,60766,445,0,0,70,70,0,1,0,1,0
44368,60765,445,0,0,70,70,0,1,0,1,0
44369,60764,445,0,0,70,70,0,1,0,1,0
44370,56380,36829,0,0,66,66,0,1,0,1,0
44371,38758,23,0,0,60,60,0,1,0,1,0
44372,58286,37965,0,0,66,66,0,1,0,1,0
44373,56153,445,0,0,66,66,0,1,0,1,0
44374,55825,445,0,0,70,70,0,1,0,1,0
44375,50713,57470,0,0,66,66,0,1,0,1,0
44376,51745,57470,0,0,62,62,0,1,0,1,0
44377,60758,445,0,0,70,70,0,1,0,1,0
44378,55968,56205,0,0,66,66,0,1,0,1,0
44379,57131,26296,0,0,145,145,0,1,0,1,0
44380,3730,37965,0,0,62,62,0,1,0,1,0
44381,60248,30188,0,0,66,66,0,1,0,1,0
44382,55822,445,0,0,70,70,0,1,0,1,0
44383,57499,80,58855,80,30979,1798,29181,46,14,23,23
44384,51172,44847,0,0,62,62,0,1,0,1,0
44385,51676,23718,0,0,66,66,0,1,0,1,0
44386,56148,445,0,0,66,66,0,1,0,1,0
44387,56146,445,0,0,66,66,0,1,0,1,0
44388,60745,445,0,0,70,70,0,1,0,1,0
44389,55817,445,0,0,70,70,0,1,0,1,0
44390,60741,445,0,0,70,70,0,1,0,1,0
44391,60740,445,0,0,70,70,0,1,0,1,0
44392,60735,445,0,0,70,70,0,1,0,1,0
44393,53003,11392,0,0,66,66,0,1,0,1,0
44394,55816,445,0,0,70,70,0,1,0,1,0
44395,56143,445,0,0,66,66,0,1,0,1,0
44396,0,0,0,0,320,320,0,5,0,5,0
44397,55814,445,0,0,70,70,0,1,0,1,0
44398,17781,50265,0,0,145,145,0,1,0,1,0
44399,52282,37965,0,0,66,66,0,1,0,1,0
44400,45832,51050,0,0,66,66,0,1,0,1,0
44401,50881,50584,0,0,66,66,0,1,0,1,0
44402,60730,445,0,0,70,70,0,1,0,1,0
44403,64294,64147,0,0,62,62,0,1,0,1,0
44404,60728,445,0,0,70,70,0,1,0,1,0
44405,60725,445,0,0,70,70,0,1,0,1,0
44406,60724,445,0,0,70,70,0,1,0,1,0
44407,56137,445,0,0,66,66,0,1,0,1,0
44408,56131,445,0,0,66,66,0,1,0,1,0
44409,56128,445,0,0,66,66,0,1,0,1,0
44410,56130,445,0,0,66,66,0,1,0,1,0
44411,55807,445,0,0,70,70,0,1,0,1,0
44412,56127,445,0,0,66,66,0,1,0,1,0
44413,56125,445,0,0,66,66,0,1,0,1,0
44414,56126,445,0,0,66,66,0,1,0,1,0
44415,2432,11392,0,0,146,146,0,1,0,1,0
44416,55805,445,0,0,70,70,0,1,0,1,0
44417,27300,36237,0,0,146,146,0,1,0,1,0
44418,55804,445,0,0,70,70,0,1,0,1,0
44419,20608,28189,0,0,60,60,0,1,0,1,0
44420,60723,445,0,0,70,70,0,1,0,1,0
44421,60720,445,0,0,70,70,0,1,0,1,0
44422,60717,445,0,0,70,70,0,1,0,1,0
44423,21641,51505,0,0,62,62,0,1,0,1,0
44424,55803,445,0,0,70,70,0,1,0,1,0
44425,55802,445,0,0,70,70,0,1,0,1,0
44426,56123,445,0,0,66,66,0,1,0,1,0
44427,26502,64147,0,0,62,62,0,1,0,1,0
44428,62688,32480,0,0,109,109,0,1,0,1,0
44429,55798,445,0,0,70,70,0,1,0,1,0
44430,55799,445,0,0,70,70,0,1,0,1,0
44431,60715,445,0,0,70,70,0,1,0,1,0
44432,56118,445,0,0,66,66,0,1,0,1,0
44433,48676,53395,0,0,60,60,0,1,0,1,0
44434,36566,37965,0,0,62,62,0,1,0,1,0
44435,60398,46776,0,0,74,74,0,1,0,1,0
44436,30015,36237,0,0,66,66,0,1,0,1,0
44437,56117,445,0,0,66,66,0,1,0,1,0
44438,56115,445,0,0,66,66,0,1,0,1,0
44439,56113,445,0,0,66,66,0,1,0,1,0
44440,55784,445,0,0,70,70,0,1,0,1,0
44441,55782,445,0,0,70,70,0,1,0,1,0
44442,55777,445,0,0,70,70,0,1,0,1,0
44443,59699,55783,0,0,62,62,0,1,0,1,0
44444,51858,44647,64567,44647,70,70,0,2,8,2,0
44445,53669,59056,24869,59056,70,70,0,2,7,2,0
44446,10167,80,10167,80,450,246,204,8,25,5,3
44447,59200,53,0,0,82,82,0,1,30,1,0
44448,53126,47035,20200,47035,70,70,0,1,5,1,0
44449,49639,443,59144,443,13604,1980,11624,33,46,18,15
44450,27005,27018,26444,27018,1634,126,1508,4,30,2,2
44451,61736,443,61172,443,148467,8298,140169,192,17,93,99
44452,5588,5588,0,0,3354,1792,1562,46,192,23,23
44453,58961,80,54182,80,1674,1360,314,11,15,6,5
44454,54966,53,23127,53,170,87,83,3,32,2,1
44455,55082,443,25259,443,8944,4006,4938,31,16,18,13
44456,48617,443,54481,443,10802,2841,7961,29,21,14,15
44457,64367,443,64367,443,4347,1440,2907,19,26,11,8
44458,47401,80,21233,80,3158,1159,1999,14,16,8,6
44459,11044,443,11044,443,6981,948,6033,17,27,10,7
44460,11139,443,11139,443,6981,948,6033,17,27,10,7
44461,55642,26872,53975,26872,70,70,0,2,8,2,0
44462,57670,80,41385,80,2274,1660,614,21,15,11,10
44463,53668,50678,24375,50678,70,70,0,2,7,2,0
44464,56612,443,14658,443,4378,1140,3238,14,26,9,5
44465,46669,80,58799,80,1802,1488,314,11,16,6,5
44466,49228,53,49228,53,825,99,726,2,30,1,1
44467,55859,53,0,0,82,82,0,1,30,1,0
44468,50584,49533,38774,49533,161,161,0,1,1200,1,0
44469,53129,38413,48065,38413,70,70,0,2,8,2,0
44470,53646,16561,53092,16561,422,140,282,6,15,3,3
44471,35078,443,8054,443,234,234,0,4,12,4,0
44472,56613,443,45386,443,4378,1140,3238,14,26,9,5
44473,27005,27021,13743,27021,1616,126,1490,4,30,2,2
44474,64915,53,33891,53,170,87,83,2,31,1,1
44475,49844,53,1140,53,762,98,664,2,31,1,1
44476,42971,3478,43871,3478,452,280,172,5,31,3,2
44477,56837,53,17666,53,190,97,93,2,31,1,1
44478,65483,53,14095,53,701,88,613,2,31,1,1
44479,54666,123,26890,123,184,94,90,2,31,1,1
44480,64968,53,11084,53,87,87,0,1,31,1,0
44481,53432,53,53432,53,197,76,121,2,31,1,1
44482,54712,8080,31768,8080,110,110,0,1,31,1,0
44483,29486,53,29486,53,825,99,726,2,31,1,1
44484,36749,443,54855,443,487330,18074,469256,508,122,148,360
44485,50584,39812,60344,39812,161,161,0,1,1200,1,0
44486,45562,5228,50425,5228,29298,3627,25671,67,5346,25,42
44487,55727,53,65316,53,711,87,624,2,31,1,1
44488,49707,53,6726,53,733,85,648,2,31,1,1
44489,57008,443,25539,443,10572,5109,5463,24,122,12,12
44490,6881,5903,6718,5903,501,150,351,2,1200,1,1
44491,53404,443,43178,443,4972,1547,3425,22,149,10,12
44492,51221,31285,26575,31285,2274,924,1350,30,3293,15,15
44493,42463,56205,0,0,62,62,0,1,0,1,0
44494,55773,445,0,0,70,70,0,1,0,1,0
44495,55774,445,0,0,70,70,0,1,0,1,0
44496,11988,48817,0,0,66,66,0,1,0,1,0
44497,60714,445,0,0,70,70,0,1,0,1,0
44498,60702,445,0,0,70,70,0,1,0,1,0
44499,60701,445,0,0,70,70,0,1,0,1,0
44500,45363,23,0,0,60,60,0,1,0,1,0
44501,62682,23,0,0,60,60,0,1,0,1,0
44502,1024,44847,0,0,146,146,0,1,0,1,0
44503,3818,37965,0,0,66,66,0,1,0,1,0
44504,48706,23393,0,0,60,60,0,1,0,1,0
44505,60363,443,34155,443,2962,796,2166,10,120,5,5
44506,56102,445,0,0,66,66,0,1,0,1,0
44507,9327,57470,0,0,62,62,0,1,0,1,0
44508,9283,57470,0,0,66,66,0,1,0,1,0
44509,28194,32468,0,0,62,62,0,1,0,1,0
44510,55762,445,0,0,70,70,0,1,0,1,0
44511,23296,23,0,0,60,60,0,1,0,1,0
44512,62872,50584,0,0,66,66,0,1,0,1,0
44513,25469,57470,0,0,62,62,0,1,0,1,0
44514,56094,445,0,0,66,66,0,1,0,1,0
44515,13281,51050,0,0,66,66,0,1,0,1,0
44516,22619,10214,0,0,66,66,0,1,0,1,0
44517,60688,445,0,0,70,70,0,1,0,1,0
44518,61053,44847,0,0,66,66,0,1,0,1,0
44519,51324,11392,0,0,66,66,0,1,0,1,0
44520,26408,64147,0,0,66,66,0,1,0,1,0
44521,10000,10214,0,0,62,62,0,1,0,1,0
44522,43725,54532,0,0,109,109,0,1,0,1,0
44523,56256,62413,0,0,66,66,0,1,0,1,0
44524,63447,44847,0,0,66,66,0,1,0,1,0
44525,55758,445,0,0,70,70,0,1,0,1,0
44526,13462,35440,0,0,66,66,0,1,0,1,0
44527,56092,445,0,0,66,66,0,1,0,1,0
44528,2422,50584,0,0,66,66,0,1,0,1,0
44529,27785,37965,0,0,66,66,0,1,0,1,0
44530,48557,37965,0,0,62,62,0,1,0,1,0
44531,1695,30349,0,0,148,148,0,1,0,1,0
44532,55747,445,0,0,70,70,0,1,0,1,0
44533,55748,445,0,0,70,70,0,1,0,1,0
44534,54210,36237,0,0,62,62,0,1,0,1,0
44535,50798,36237,0,0,62,62,0,1,0,1,0
44536,49635,443,49110,443,54634,6944,47690,99,47,47,52
44537,57504,443,39017,443,5238,695,4543,14,25,8,6
44538,51046,443,28730,443,17469,2444,15025,39,207,17,22
44539,57592,443,17732,443,2614,1689,925,18,19,10,8
44540,10168,80,10168,80,450,246,204,8,24,5,3
44541,57370,6969,42046,6969,70,70,0,2,8,2,0
44542,50644,5222,32859,5222,11661,4442,7219,87,71,41,46
44543,56301,443,56301,443,4378,1471,2907,19,30,11,8
44544,57236,443,10665,443,225524,59002,166522,402,78,192,210
44545,57441,53,16567,53,177,94,83,2,29,1,1
44546,50584,64027,41636,64027,166,166,0,1,1199,1,0
44547,8464,3389,8464,3389,3910,1805,2105,20,18,12,8
44548,50139,5228,61271,5228,7727,2172,5555,44,104,23,21
44549,56643,443,54840,443,7914,1925,5989,20,15,11,9
44550,53671,60416,42593,60416,70,70,0,2,7,2,0
44551,56620,443,2901,443,1327,918,409,10,25,6,4
44552,62737,443,7478,443,35936,2741,33195,62,15,30,32
44553,60762,40010,40997,40010,316,136,180,6,6,3,3
44554,60426,25988,19003,25988,70,70,0,2,8,2,0
44555,65110,53,12122,53,754,191,563,6,51,3,3
44556,64974,53,51198,53,493,111,382,4,57,2,2
44557,63930,53,2970,53,377,94,283,2,29,1,1
44558,63762,123,63358,123,184,94,90,2,29,1,1
44559,58440,53,26101,53,305,102,203,2,30,1,1
44560,27005,27017,8108,27017,1658,126,1532,4,30,2,2
44561,49469,443,43348,443,8779,3672,5107,17,119,8,9
44562,64429,53,41917,53,217,94,123,2,30,1,1
44563,58509,443,26840,443,13973721,436876,13536845,14039,1629,4929,9110
44564,51860,53854,28127,53854,70,70,0,2,7,2,0
44565,65175,53,18597,53,269,94,175,2,30,1,1
44566,56629,80,58427,80,234,234,0,4,12,4,0
44567,51839,27256,49193,27256,70,70,0,1,5,1,0
44568,56617,443,38005,443,5325,1074,4251,18,25,10,8
44569,56641,443,17125,443,7942,1953,5989,20,15,11,9
44570,38941,443,53715,443,4613,2811,1802,27,95,14,13
44571,45354,443,16907,443,81504,6111,75393,108,20,53,55
44572,55217,53,39301,53,210,102,108,2,30,1,1
44573,57238,443,50721,443,7549,2807,4742,42,78,22,20
44574,49325,443,64992,443,6141,949,5192,17,21,9,8
44575,34076,53,22329,53,168,78,90,2,30,1,1
44576,65268,53,12409,53,395,107,288,4,46,2,2
44577,52935,443,46702,443,1769338,65258,1704080,1935,1200,735,1200
44578,38295,443,36563,443,5247,3662,1585,21,310,11,10
44579,49224,53,17208,53,185,102,83,2,30,1,1
44580,49648,443,58904,443,11011,4522,6489,35,45,17,18
44581,27005,27015,55025,27015,1624,126,1498,4,31,2,2
44582,27005,50002,4449,50002,1642,126,1516,4,31,2,2
44583,60517,53,31898,53,198,86,112,2,30,1,1
44584,60427,61137,3652,61137,70,70,0,2,8,2,0
44585,55641,61762,32816,61762,70,70,0,2,8,2,0
44586,51834,30309,10825,30309,70,70,0,1,5,1,0
44587,54350,443,59930,443,15567,5964,9603,27,21,14,13
44588,34424,443,56503,443,773546,29906,743640,881,1166,350,531
44589,65211,53,49175,53,216,102,114,2,30,1,1
44590,64915,53,11027,53,177,94,83,2,30,1,1
44591,56336,53,12124,53,196,102,94,2,30,1,1
44592,46703,443,29330,443,4589,2090,2499,15,120,7,8
44593,51517,443,20075,443,590874,19818,571056,669,42,271,398
44594,51859,35365,47948,35365,70,70,0,2,7,2,0
44595,57245,443,39703,443,170452,9659,160793,224,68,97,127
44596,59841,80,53537,80,711697,18422,693275,716,50,253,463
44597,12656,53,33403,53,211,86,125,2,30,1,1
44598,56921,443,49898,443,8416,2142,6274,25,330,12,13
44599,62288,443,20087,443,1638,776,862,22,120,11,11
44600,58814,443,50784,443,1549485,41822,1507663,1612,179,520,1092
44601,27005,50001,15883,50001,1656,126,1530,4,31,2,2
44602,56642,443,62625,443,7890,1901,5989,20,15,11,9
44603,50584,16526,25996,16526,166,166,0,1,1199,1,0
44604,12011,443,12011,443,6981,948,6033,17,27,10,7
44605,51324,443,31259,443,2359,1283,1076,17,17,9,8
44606,10166,80,10166,80,450,246,204,8,24,5,3
44607,10169,80,10169,80,450,246,204,8,24,5,3
44608,53177,443,2633,443,6512167,186944,6325223,6347,1216,2089,4258
44609,49432,80,52783,80,2231,899,1332,15,92,8,7
44610,64930,443,64930,443,4596,1689,2907,19,27,11,8
44611,56336,53,53884,53,196,102,94,2,35,1,1
44612,12150,443,12150,443,6981,948,6033,17,27,10,7
44613,49444,53,42796,53,401,88,313,4,38,2,2
44614,53672,20380,35772,20380,70,70,0,2,7,2,0
44615,49756,53,16127,53,396,94,302,4,41,2,2
44616,52931,80,27397,80,78,78,0,1,4,1,0
44617,57247,443,40506,443,93673,74276,19397,194,67,111,83
44618,64575,443,61163,443,24686,1935,22751,36,16,17,19
44619,49633,53,1926,53,245,94,151,2,29,1,1
44620,57246,443,63215,443,360050,17258,342792,432,68,185,247
44621,64252,53,63103,53,350,94,256,2,29,1,1
44622,57244,443,45761,443,230914,10401,220513,290,76,121,169
44623,65377,443,4212,443,4864,2496,2368,33,121,17,16
44624,31574,53,31574,53,213,90,123,2,29,1,1
44625,5588,5588,0,0,3562,1936,1626,48,193,24,24
44626,27005,27017,62934,27017,1658,126,1532,4,30,2,2
44627,57441,53,9760,53,177,94,83,2,29,1,1
44628,63008,53,31909,53,183,86,97,2,30,1,1
44629,64873,53,26833,53,380,110,270,2,30,1,1
44630,27005,27016,51582,27016,1626,126,1500,4,30,2,2
44631,39624,53,30103,53,168,78,90,2,30,1,1
44632,55631,443,48681,443,17521,3850,13671,30,121,13,17
44633,31593,53,31593,53,832,106,726,2,30,1,1
44634,49369,53,33288,53,232,110,122,2,30,1,1
44635,49835,53,27246,53,214,94,120,2,30,1,1
44636,50584,56221,62822,56221,166,166,0,1,1199,1,0
44637,51835,29778,40587,29778,70,70,0,1,5,1,0
44638,57242,443,22643,443,291104,18601,272503,413,77,186,227
44639,65520,56330,49409,56330,558,318,240,9,143,5,4
44640,55773,53,28630,53,102,102,0,1,60,1,0
44641,50045,443,64654,443,4551,2388,2163,16,120,8,8
44642,10164,80,10164,80,7351,803,6548,16,24,7,9
44643,51857,40561,9754,40561,70,70,0,2,8,2,0
44644,56222,443,56222,443,4378,1471,2907,19,27,11,8
44645,56611,443,65034,443,1473,868,605,10,25,6,4
44646,43719,53,43719,53,295,90,205,2,30,1,1
44647,64367,53,24939,53,257,110,147,2,30,1,1
44648,55625,53,6982,53,94,94,0,1,30,1,0
44649,55633,54638,31495,54638,504,318,186,8,15,5,3
44650,51585,80,50569,80,3192,624,2568,10,155,5,5
44651,51840,34678,44195,34678,70,70,0,1,5,1,0
44652,35203,443,62498,443,232,172,60,3,5,2,1
44653,64482,53,36400,53,322,95,227,4,39,2,2
44654,57248,443,32420,443,1021056,38101,982955,1183,64,501,682
44655,36313,443,38446,443,55608,48375,7233,140,95,81,59
44656,64716,53,33097,53,385,134,251,2,30,1,1
44657,56777,53,34621,53,210,94,116,2,30,1,1
44658,64758,443,35347,443,5066,2558,2508,26,127,13,13
44659,49987,53,51873,53,253,86,167,2,30,1,1
44660,27005,27027,58259,27027,1654,126,1528,4,31,2,2
44661,27005,27019,28663,27019,1652,126,1526,4,31,2,2
44662,58809,443,38293,443,4055,1295,2760,11,121,6,5
44663,65453,53,50552,53,242,94,148,2,30,1,1
44664,49855,53,11171,53,290,102,188,2,30,1,1
44665,50584,26301,47178,26301,161,161,0,2,1199,2,0
44666,57470,1337,56441,1337,792,792,0,13,1199,13,0
44667,64915,53,41416,53,177,94,83,2,31,1,1
44668,19473,6881,30849,6881,491,150,341,2,1200,1,1
44669,57470,49001,13810,49001,166,166,0,1,1200,1,0
44670,50584,50901,9302,50901,166,166,0,1,1199,1,0
44671,46991,53,46991,53,262,106,156,2,31,1,1
44672,52354,443,50559,443,10417,5338,5079,22,135,11,11
44673,50584,32808,19666,32808,166,166,0,1,1199,1,0
44674,50584,1283,8544,1283,1617,161,1456,4,1199,2,2
44675,54145,443,52108,443,118,118,0,1,120,1,0
44676,53651,47758,11315,47758,70,70,0,1,5,1,0
44677,42971,3478,30951,3478,312,140,172,4,30,2,2
44678,60049,443,35659,443,10124,2145,7979,24,156,11,13
44679,56639,443,28147,443,7849,1860,5989,20,16,11,9
44680,55744,445,0,0,70,70,0,1,0,1,0
44681,55745,445,0,0,70,70,0,1,0,1,0
44682,56085,445,0,0,66,66,0,1,0,1,0
44683,55742,445,0,0,70,70,0,1,0,1,0
44684,60350,51505,0,0,66,66,0,1,0,1,0
44685,56082,445,0,0,66,66,0,1,0,1,0
44686,25565,62144,0,0,60,60,0,1,0,1,0
44687,57564,56205,0,0,62,62,0,1,0,1,0
44688,55736,445,0,0,70,70,0,1,0,1,0
44689,60678,445,0,0,70,70,0,1,0,1,0
44690,60677,445,0,0,70,70,0,1,0,1,0
44691,60675,445,0,0,70,70,0,1,0,1,0
44692,56067,445,0,0,66,66,0,1,0,1,0
44693,56069,445,0,0,66,66,0,1,0,1,0
44694,56066,445,0,0,66,66,0,1,0,1,0
44695,56063,445,0,0,66,66,0,1,0,1,0
44696,56065,445,0,0,66,66,0,1,0,1,0
44697,56061,445,0,0,66,66,0,1,0,1,0
44698,56062,445,0,0,66,66,0,1,0,1,0
44699,52720,35894,0,0,62,62,0,1,0,1,0
44700,56835,35894,0,0,66,66,0,1,0,1,0
44701,60168,35440,0,0,66,66,0,1,0,1,0
44702,14059,21247,0,0,62,62,0,1,0,1,0
44703,49616,30188,0,0,62,62,0,1,0,1,0
44704,50637,44847,0,0,66,66,0,1,0,1,0
44705,65064,30188,0,0,66,66,0,1,0,1,0
44706,6931,55108,0,0,139,139,0,1,0,1,0
44707,55728,445,0,0,70,70,0,1,0,1,0
44708,55727,445,0,0,70,70,0,1,0,1,0
44709,50716,50584,0,0,74,74,0,1,0,1,0
44710,17579,57470,0,0,62,62,0,1,0,1,0
44711,40474,23117,0,0,62,62,0,1,0,1,0
44712,60671,445,0,0,70,70,0,1,0,1,0
44713,60661,445,0,0,70,70,0,1,0,1,0
44714,60660,445,0,0,70,70,0,1,0,1,0
44715,55722,445,0,0,70,70,0,1,0,1,0
44716,55720,445,0,0,70,70,0,1,0,1,0
44717,56047,445,0,0,66,66,0,1,0,1,0
44718,56049,445,0,0,66,66,0,1,0,1,0
44719,56046,445,0,0,66,66,0,1,0,1,0
44720,3883,50265,0,0,66,66,0,1,0,1,0
44721,60657,445,0,0,70,70,0,1,0,1,0
44722,56582,37965,0,0,62,62,0,1,0,1,0
44723,23770,50584,0,0,66,66,0,1,0,1,0
44724,59564,57470,0,0,66,66,0,1,0,1,0
44725,27783,57470,0,0,62,62,0,1,0,1,0
44726,64903,51050,0,0,66,66,0,1,0,1,0
44727,55716,445,0,0,70,70,0,1,0,1,0
44728,60655,445,0,0,70,70,0,1,0,1,0
44729,19610,55839,0,0,137,137,0,1,0,1,0
44730,65518,5710,0,0,62,62,0,1,0,1,0
44731,55714,445,0,0,70,70,0,1,0,1,0
44732,60654,445,0,0,70,70,0,1,0,1,0
44733,60652,445,0,0,70,70,0,1,0,1,0
44734,60650,445,0,0,70,70,0,1,0,1,0
44735,20400,64147,0,0,62,62,0,1,0,1,0
44736,20400,64147,0,0,145,145,0,1,0,1,0
44737,11023,51505,0,0,62,62,0,1,0,1,0
44738,43916,21,0,0,60,60,0,1,0,1,0
44739,42252,33303,0,0,60,60,0,1,0,1,0
44740,16387,3655,0,0,60,60,0,1,0,1,0
44741,16387,22272,0,0,60,60,0,1,0,1,0
44742,16387,20045,0,0,60,60,0,1,0,1,0
44743,55710,445,0,0,70,70,0,1,0,1,0
44744,16387,44427,0,0,60,60,0,1,0,1,0
44745,20005,37965,0,0,62,62,0,1,0,1,0
44746,16387,7205,0,0,60,60,0,1,0,1,0
44747,16387,16862,0,0,60,60,0,1,0,1,0
44748,16387,35583,0,0,60,60,0,1,0,1,0
44749,16387,63752,0,0,60,60,0,1,0,1,0
44750,16387,64075,0,0,60,60,0,1,0,1,0
44751,13980,23,0,0,60,60,0,1,0,1,0
44752,60637,445,0,0,70,70,0,1,0,1,0
44753,60635,445,0,0,70,70,0,1,0,1,0
44754,60632,445,0,0,70,70,0,1,0,1,0
44755,3996,57470,0,0,62,62,0,1,0,1,0
44756,61002,37965,0,0,145,145,0,1,0,1,0
44757,63779,26467,0,0,66,66,0,1,0,1,0
44758,26536,53,62994,53,306,99,207,2,0,1,1
44759,55697,445,0,0,70,70,0,1,0,1,0
44760,56025,445,0,0,66,66,0,1,0,1,0
44761,60628,445,0,0,70,70,0,1,0,1,0
44762,60629,445,0,0,70,70,0,1,0,1,0
44763,52837,35440,0,0,66,66,0,1,0,1,0
44764,55694,445,0,0,70,70,0,1,0,1,0
44765,34808,22114,0,0,62,62,0,1,0,1,0
44766,63621,30188,0,0,62,62,0,1,0,1,0
44767,48016,57470,0,0,62,62,0,1,0,1,0
44768,1024,50265,0,0,62,62,0,1,0,1,0
44769,26391,44847,0,0,146,146,0,1,0,1,0
44770,56020,445,0,0,66,66,0,1,0,1,0
44771,45682,1,0,0,62,62,0,1,0,1,0
44772,55690,445,0,0,70,70,0,1,0,1,0
44773,56017,445,0,0,66,66,0,1,0,1,0
44774,55688,445,0,0,70,70,0,1,0,1,0
44775,60617,445,0,0,70,70,0,1,0,1,0
44776,8889,10794,0,0,60,60,0,1,0,1,0
44777,60614,445,0,0,70,70,0,1,0,1,0
44778,60612,445,0,0,70,70,0,1,0,1,0
44779,60607,445,0,0,70,70,0,1,0,1,0
44780,55686,445,0,0,70,70,0,1,0,1,0
44781,56013,445,0,0,66,66,0,1,0,1,0
44782,20608,28189,0,0,60,60,0,1,0,1,0
44783,45912,44847,0,0,146,146,0,1,0,1,0
44784,49160,57470,0,0,146,146,0,1,0,1,0
44785,1024,45129,0,0,145,145,0,1,0,1,0
44786,60603,445,0,0,70,70,0,1,0,1,0
44787,30114,65151,0,0,60,60,0,1,0,1,0
44788,60398,46776,0,0,74,74,0,1,0,1,0
44789,60600,445,0,0,70,70,0,1,0,1,0
44790,60599,445,0,0,70,70,0,1,0,1,0
44791,60598,445,0,0,70,70,0,1,0,1,0
44792,58381,57470,0,0,66,66,0,1,0,1,0
44793,56008,445,0,0,66,66,0,1,0,1,0
44794,55679,445,0,0,70,70,0,1,0,1,0
44795,56003,445,0,0,66,66,0,1,0,1,0
44796,56005,445,0,0,66,66,0,1,0,1,0
44797,56004,445,0,0,66,66,0,1,0,1,0
44798,55677,445,0,0,70,70,0,1,0,1,0
44799,55998,445,0,0,66,66,0,1,0,1,0
44800,55997,445,0,0,66,66,0,1,0,1,0
44801,1081,1970,0,0,146,146,0,1,0,1,0
44802,53625,64147,0,0,66,66,0,1,0,1,0
44803,63867,64147,0,0,62,62,0,1,0,1,0
44804,49915,35440,0,0,62,62,0,1,0,1,0
44805,55676,445,0,0,70,70,0,1,0,1,0
44806,63421,53,63421,53,223,86,137,2,30,1,1
44807,57289,443,13366,443,2693,1361,1332,17,19,10,7
44808,57285,443,38646,443,21198,9647,11551,97,20,52,45
44809,49181,2710,53031,2710,70,70,0,2,8,2,0
44810,60115,443,39754,443,268,120,148,5,10,3,2
44811,53776,53,0,0,82,82,0,2,40,2,0
44812,57251,443,64913,443,54515,20774,33741,167,36,88,79
44813,49499,443,5486,443,8848,4908,3940,23,42,12,11
44814,64411,443,21450,443,23357,2589,20768,33,120,13,20
44815,50949,443,50949,443,4453,1546,2907,19,29,11,8
44816,45340,443,58208,443,2504,1442,1062,22,29,12,10
44817,49632,443,35637,443,5598,1185,4413,24,80,13,11
44818,56552,53,56552,53,223,86,137,2,30,1,1
44819,62466,53,62466,53,194,87,107,2,30,1,1
44820,40334,53,40334,53,213,87,126,2,30,1,1
44821,55220,53,55080,53,758,96,662,2,30,1,1
44822,57996,53,57996,53,847,110,737,2,30,1,1
44823,55215,443,18070,443,3717,2233,1484,34,80,20,14
44824,60900,443,51308,443,7426,1877,5549,22,81,13,9
44825,57273,443,35041,443,10926,3915,7011,50,33,28,22
44826,49628,443,15510,443,5600,1187,4413,24,80,13,11
44827,56039,53,8952,53,762,98,664,2,30,1,1
44828,60109,443,54198,443,268,120,148,5,10,3,2
44829,56536,443,5996,443,6044,3444,2600,49,501,25,24
44830,49629,443,16590,443,5600,1187,4413,24,80,13,11
44831,42971,3478,56626,3478,452,280,172,5,30,3,2
44832,60944,443,23317,443,8264,4269,3995,17,31,9,8
44833,50382,80,4705,80,1369,799,570,13,77,7,6
44834,42971,3478,30766,3478,312,140,172,4,30,2,2
44835,46000,443,62571,443,2583,334,2249,7,90,3,4
44836,56664,443,31995,443,7561,2483,5078,26,20,13,13
44837,55193,53,9970,53,200,102,98,2,30,1,1
44838,56836,1,16144,1,130,70,60,2,5,1,1
44839,57892,443,5458,443,6845,1743,5102,22,81,13,9
44840,61589,443,61589,443,4672,1765,2907,19,28,11,8
44841,53653,17436,61017,17436,70,70,0,1,5,1,0
44842,57287,443,20277,443,8960,2778,6182,31,20,16,15
44843,57292,443,37855,443,18591,5839,12752,78,18,44,34
44844,57322,443,7352,443,8237,2784,5453,35,16,21,14
44845,57352,53,30931,53,711,87,624,2,31,1,1
44846,49622,443,43494,443,15336,2803,12533,47,202,24,23
44847,49615,443,24939,443,48705,7643,41062,146,256,77,69
44848,57252,443,17744,443,12683,4753,7930,59,36,33,26
44849,56828,53156,57681,53156,70,70,0,2,8,2,0
44850,57254,443,23704,443,6000,1578,4422,22,36,12,10
44851,51832,40607,33466,40607,66,66,0,1,5,1,0
44852,60365,443,2645,443,130,70,60,2,15,1,1
44853,59773,443,43322,443,165464,10322,155142,189,71,69,120
44854,57291,443,9776,443,2685,1353,1332,17,19,10,7
44855,57290,443,45371,443,2693,1361,1332,17,19,10,7
44856,53650,37096,27046,37096,70,70,0,1,5,1,0
44857,53647,16194,38859,16194,70,70,0,1,5,1,0
44858,51220,443,53814,443,7647,1917,5730,22,80,13,9
44859,49556,443,16559,443,8602,2308,6294,23,82,13,10
44860,33166,53,0,0,82,82,0,2,40,2,0
44861,65027,53,8113,53,758,96,662,2,30,1,1
44862,35747,443,32307,443,8676,3499,5177,31,373,17,14
44863,40127,53,0,0,82,82,0,1,31,1,0
44864,55104,53,12993,53,733,85,648,2,31,1,1
44865,55733,53,35309,53,170,87,83,2,31,1,1
44866,56720,53,21366,53,170,87,83,2,31,1,1
44867,56747,443,3267,443,19030,7323,11707,51,122,23,28
44868,56045,53,44616,53,754,94,660,2,31,1,1
44869,54654,443,37432,443,4869,1016,3853,18,121,9,9
44870,58278,443,36015,443,3581,1045,2536,10,122,5,5
44871,41164,443,62496,443,8582,4759,3823,29,135,14,15
44872,55675,445,0,0,70,70,0,1,0,1,0
44873,51412,51505,0,0,66,66,0,1,0,1,0
44874,35065,23,0,0,60,60,0,1,0,1,0
44875,55674,445,0,0,70,70,0,1,0,1,0
44876,55672,445,0,0,70,70,0,1,0,1,0
44877,55668,445,0,0,70,70,0,1,0,1,0
44878,60594,445,0,0,70,70,0,1,0,1,0
44879,60593,445,0,0,70,70,0,1,0,1,0
44880,60589,445,0,0,70,70,0,1,0,1,0
44881,50341,37965,0,0,66,66,0,1,0,1,0
44882,52144,49344,0,0,62,62,0,1,0,1,0
44883,55991,445,0,0,66,66,0,1,0,1,0
44884,60587,445,0,0,70,70,0,1,0,1,0
44885,33801,62413,0,0,66,66,0,1,0,1,0
44886,55988,445,0,0,66,66,0,1,0,1,0
44887,26180,35440,0,0,66,66,0,1,0,1,0
44888,49191,35440,0,0,66,66,0,1,0,1,0
44889,41794,41794,0,0,308,308,0,1,0,1,0
44890,57282,443,46130,443,11721,2230,9491,39,31,22,17
44891,53238,443,61389,443,13597,1371,12226,26,323,11,15
44892,42644,443,8391,443,8384,2161,6223,24,255,12,12
44893,50236,443,15469,443,5858,791,5067,19,22,10,9
44894,27005,28018,47944,28018,1640,126,1514,4,30,2,2
44895,27005,27017,53303,27017,1634,126,1508,4,30,2,2
44896,27005,32030,25176,32030,1796,252,1544,5,31,3,2
44897,35486,443,63942,443,4630,2803,1827,29,80,14,15
44898,50543,443,30180,443,38667,3344,35323,56,210,24,32
44899,50201,80,38325,80,5015,2123,2892,25,96,14,11
44900,50486,80,43523,80,378,192,186,7,21,4,3
44901,51457,443,1251,443,334,70,264,5,17,1,4
44902,60423,52001,49584,52001,260,140,120,5,9,3,2
44903,50116,22,50116,22,184,120,64,4,4,3,1
44904,64780,53,56336,53,203,86,117,2,29,1,1
44905,50002,53,23419,53,183,102,81,2,30,1,1
44906,64915,53,19337,53,177,94,83,2,29,1,1
44907,48151,123,24928,123,184,94,90,2,30,1,1
44908,52417,443,14213,443,8376,6877,1499,27,31,15,12
44909,37774,443,33221,443,282171,13444,268727,377,201,175,202
44910,41959,443,65186,443,5838,1840,3998,20,80,12,8
44911,51833,47388,62543,47388,70,70,0,1,5,1,0
44912,53248,443,27776,443,41125,3625,37500,62,323,25,37
44913,53242,443,60207,443,42135,4098,38037,64,323,25,39
44914,53256,443,59014,443,29039,3057,25982,46,323,19,27
44915,53252,443,27483,443,31843,2847,28996,50,323,20,30
44916,64745,3389,64745,3389,3413,1458,1955,16,18,8,8
44917,50020,53,1594,53,210,102,108,2,30,1,1
44918,56835,27582,44303,27582,130,70,60,2,5,1,1
44919,60719,443,32077,443,71523,19991,51532,112,41,59,53
44920,55193,53,3630,53,533,102,431,4,42,2,2
44921,42820,443,41684,443,8155,1999,6156,22,81,13,9
44922,52657,53,48551,53,302,210,92,3,30,2,1
44923,53258,443,42318,443,31919,3528,28391,49,323,19,30
44924,49619,443,17429,443,46202,8086,38116,131,243,69,62
44925,49623,443,29272,443,36302,2869,33433,67,180,32,35
44926,52217,80,27362,80,1074,565,509,11,16,6,5
44927,33257,443,43255,443,19341,4612,14729,38,21,19,19
44928,59403,443,58702,443,5853,2409,3444,35,80,16,19
44929,49623,443,17482,443,3972,2532,1440,18,80,10,8
44930,56637,443,26633,443,7907,1918,5989,20,15,11,9
44931,63826,80,41744,80,314,192,122,6,15,4,2
44932,53241,443,7784,443,24835,2671,22164,42,323,17,25
44933,59731,443,62257,443,7236,827,6409,17,25,8,9
44934,56670,443,55495,443,8308,3589,4719,25,19,15,10
44935,53251,443,22293,443,24116,2677,21439,42,323,17,25
44936,59732,443,8520,443,7310,967,6343,18,25,10,8
44937,47325,443,49234,443,130,70,60,2,15,1,1
44938,56593,443,58940,443,1165,662,503,11,25,6,5
44939,59844,80,25773,80,397391,8624,388767,380,49,118,262
44940,64153,53,31839,53,213,94,119,2,30,1,1
44941,50368,53,59190,53,70,70,0,1,30,1,0
44942,57829,443,7967,443,981499,39775,941724,1109,291,439,670
44943,49289,53,43256,53,177,94,83,2,30,1,1
44944,61015,443,14729,443,7863,1962,5901,29,270,16,13
44945,64656,53,38366,53,718,94,624,2,30,1,1
44946,49767,53,47243,53,185,102,83,2,30,1,1
44947,49817,53,12075,53,167,86,81,2,30,1,1
44948,65299,53,37280,53,177,94,83,2,30,1,1
44949,36287,443,35494,443,6419,2962,3457,25,148,12,13
44950,60163,443,56805,443,8929,3204,5725,25,80,14,11
44951,53369,80,53369,80,81339,4340,76999,84,57,22,62
44952,53268,443,17713,443,22541,2143,20398,38,322,16,22
44953,59733,443,63033,443,7310,967,6343,18,25,10,8
44954,64224,53,56405,53,280,94,186,2,30,1,1
44955,55275,53,25486,53,213,94,119,2,30,1,1
44956,50734,443,16701,443,1726,668,1058,13,2033,4,9
44957,50172,443,42288,443,152228,30166,122062,215,153,92,123
44958,53282,443,19856,443,13300,1695,11605,27,321,12,15
44959,53260,443,22555,443,23664,2213,21451,41,323,17,24
44960,56643,443,24007,443,1560,988,572,13,21,7,6
44961,57276,443,44097,443,14236,2699,11537,51,31,27,24
44962,63843,53603,44636,53603,312,132,180,6,6,3,3
44963,42618,443,18541,443,4694,2432,2262,34,81,16,18
44964,51169,443,30146,443,975832,29038,946794,991,51,341,650
44965,56572,443,48876,443,10325,2594,7731,28,27,16,12
44966,43920,443,54926,443,12666,4180,8486,37,504,20,17
44967,60228,443,13572,443,1058,641,417,10,50,6,4
44968,58692,53,28574,53,199,94,105,2,30,1,1
44969,64238,53,60413,53,213,102,111,2,30,1,1
44970,49767,53,2563,53,177,94,83,2,30,1,1
44971,65053,53,62092,53,197,94,103,2,30,1,1
44972,49620,443,27552,443,13241,2865,10376,60,242,26,34
44973,60848,443,33330,443,6513,1863,4650,28,255,15,13
44974,57283,443,46704,443,7792,2318,5474,38,27,22,16
44975,53246,443,34451,443,30174,2792,27382,47,323,19,28
44976,54966,53,31791,53,254,87,167,4,31,2,2
44977,53278,443,20618,443,12634,1635,10999,26,322,11,15
44978,49505,443,2441,443,35158,5065,30093,53,42,18,35
44979,57250,443,30751,443,345315,16365,328950,459,36,206,253
44980,50386,80,26554,80,6718,3126,3592,16,77,8,8
44981,42971,3478,49754,3478,312,140,172,4,29,2,2
44982,36435,443,62505,443,7046,3518,3528,66,612,35,31
44983,50475,80,52145,80,2669,1434,1235,11,21,6,5
44984,53270,443,48173,443,21684,2143,19541,38,322,16,22
44985,56640,443,64695,443,7797,1808,5989,20,14,11,9
44986,50487,80,25708,80,378,192,186,7,21,4,3
44987,53266,443,29507,443,30264,2794,27470,47,322,19,28
44988,64644,53,30010,53,364,89,275,4,33,2,2
44989,47002,53,47002,53,244,98,146,2,31,1,1
44990,53272,443,47485,443,20745,2083,18662,36,322,15,21
44991,56837,53,14391,53,195,102,93,2,33,1,1
44992,51831,26270,17546,26270,70,70,0,1,5,1,0
44993,51855,23268,62200,23268,70,70,0,2,7,2,0
44994,60114,443,25008,443,268,120,148,5,10,3,2
44995,53706,80,53481,80,1398,590,808,9,111,6,3
44996,49930,443,7030,443,7934,1836,6098,23,15,13,10
44997,50478,80,37121,80,2869,1173,1696,11,21,6,5
44998,50472,80,63342,80,12222,3865,8357,23,22,11,12
44999,60428,55172,58181,55172,320,140,180,6,7,3,3
45000,12064,53,12064,53,244,98,146,2,33,1,1
45001,56638,443,63919,443,7855,1866,5989,20,15,11,9
45002,51836,37753,57785,37753,70,70,0,1,4,1,0
45003,57299,443,9312,443,23282,4482,18800,67,17,35,32
45004,59735,443,11468,443,7310,967,6343,18,25,10,8
45005,57293,443,65420,443,7057,2815,4242,37,18,21,16
45006,55629,36190,12886,36190,504,318,186,8,16,5,3
45007,59134,443,19073,443,6857,1727,5130,23,316,13,10
45008,55634,58846,20945,58846,70,70,0,1,5,1,0
45009,43518,443,23490,443,10265,2118,8147,23,81,13,10
45010,5588,5588,0,0,3354,1792,1562,46,194,23,23
45011,52407,443,53495,443,100194,6406,93788,171,24,85,86
45012,64459,53,56371,53,251,94,157,2,29,1,1
45013,62736,80,60766,80,1516,481,1035,11,15,6,5
45014,54447,53,9967,53,199,94,105,2,29,1,1
45015,45701,80,26870,80,1579,1217,362,8,15,5,3
45016,39850,53,3565,53,199,94,105,2,29,1,1
45017,27005,27015,29834,27015,1634,126,1508,4,30,2,2
45018,46455,53,32632,53,168,78,90,2,30,1,1
45019,50659,53,45075,53,168,78,90,2,30,1,1
45020,49289,53,16244,53,177,94,83,2,30,1,1
45021,5588,5588,0,0,3354,1792,1562,46,192,23,23
45022,32742,53,46400,53,207,86,121,2,30,1,1
45023,56345,53,18764,53,199,94,105,2,30,1,1
45024,54147,443,52345,443,3334,331,3003,10,120,5,5
45025,50287,53,28262,53,781,94,687,2,30,1,1
45026,50239,53,31652,53,183,94,89,2,31,1,1
45027,27005,50003,20006,50003,887,126,761,2,31,1,1
45028,49562,443,59931,443,3380,346,3034,12,120,5,7
45029,38700,443,53165,443,40207,7892,32315,59,152,23,36
45030,57470,58753,38248,58753,166,166,0,1,1199,1,0
45031,57271,443,34428,443,7155,2151,5004,34,33,20,14
45032,57274,443,44033,443,11536,2572,8964,41,33,24,17
45033,55635,38649,44116,38649,70,70,0,1,5,1,0
45034,50721,443,49373,443,5828,1439,4389,16,75,9,7
45035,55628,13343,19881,13343,634,388,246,10,18,6,4
45036,46328,443,26248,443,446664,48034,398630,698,223,326,372
45037,37759,53,22729,53,164,78,86,2,30,1,1
45038,27005,50003,10902,50003,1636,126,1510,4,31,2,2
45039,57288,443,58142,443,116807,21042,95765,315,19,161,154
45040,64749,3389,64749,3389,3347,1458,1889,15,18,8,7
45041,57284,443,12442,443,1402,917,485,12,27,7,5
45042,51838,29448,59159,29448,70,70,0,1,5,1,0
45043,51830,32787,57258,32787,70,70,0,1,5,1,0
45044,54100,80,44998,80,78,78,0,1,5,1,0
45045,62952,38741,48558,38741,18963,9580,9383,211,348,109,102
45046,52218,80,8584,80,2373,614,1759,11,15,6,5
45047,50318,53,54870,53,94,94,0,1,30,1,0
45048,65299,53,60442,53,177,94,83,2,30,1,1
45049,59486,443,24695,443,9161,2202,6959,28,374,14,14
45050,53245,443,1855,443,28206,2737,25469,45,323,18,27
45051,57272,443,35317,443,6445,2145,4300,29,33,17,12
45052,57275,443,6369,443,22074,3005,19069,58,31,31,27
45053,54101,80,21675,80,78,78,0,1,5,1,0
45054,55632,45682,33177,45682,70,70,0,1,5,1,0
45055,56671,443,62348,443,8300,3581,4719,25,19,15,10
45056,43762,443,5128,443,7775,1963,5812,22,77,13,9
45057,57327,443,38850,443,5613,733,4880,16,15,9,7
45058,49943,53,18559,53,718,94,624,2,30,1,1
45059,43851,53,43851,53,227,90,137,2,30,1,1
45060,48737,53,48737,53,227,90,137,2,30,1,1
45061,49872,53,36268,53,331,126,205,2,30,1,1
45062,49995,53,57379,53,197,102,95,2,30,1,1
45063,56006,53,33224,53,183,102,81,2,30,1,1
45064,55261,53,37106,53,177,94,83,2,30,1,1
45065,64902,53,39715,53,231,110,121,2,30,1,1
45066,6881,6881,48403,6881,502,150,352,2,1200,1,1
45067,55619,53,59792,53,241,78,163,2,30,1,1
45068,57364,53,64164,53,177,94,83,2,30,1,1
45069,55757,53,48609,53,177,94,83,2,30,1,1
45070,35041,443,38147,443,16010,4754,11256,47,130,20,27
45071,21133,6889,63864,6889,481,150,331,2,1199,1,1
45072,57470,43836,52896,43836,402,132,270,6,1209,3,3
45073,42288,443,48757,443,16985,7850,9135,39,121,19,20
45074,52317,5223,5494,5223,6070,1779,4291,17,3600,8,9
45075,51860,443,38045,443,6577,1938,4639,14,121,7,7
45076,50265,13826,10952,13826,330,330,0,6,1200,6,0
45077,62704,443,4818,443,6805,3445,3360,31,121,15,16
45078,36732,443,61155,443,7449,2359,5090,15,120,7,8
45079,40183,443,34811,443,6065,2277,3788,17,135,8,9
45080,57470,49160,41673,49160,132,132,0,3,1199,3,0
45081,53667,49160,27701,49160,320,140,180,6,7,3,3
45082,57308,443,32709,443,8837,3033,5804,44,16,24,20
45083,64968,53,21697,53,250,102,148,2,31,1,1
45084,53128,29593,28307,29593,70,70,0,2,9,2,0
45085,38681,443,38681,443,3028,1828,1200,19,21,11,8
45086,65521,53,52937,53,167,86,81,2,30,1,1
45087,53643,8118,59357,8118,2104,1209,895,15,16,7,8
45088,49528,53,57566,53,177,94,83,2,30,1,1
45089,55009,53,51311,53,241,78,163,2,30,1,1
45090,55987,445,0,0,66,66,0,1,0,1,0
45091,55985,445,0,0,66,66,0,1,0,1,0
45092,55656,445,0,0,70,70,0,1,0,1,0
45093,55655,445,0,0,70,70,0,1,0,1,0
45094,22683,39210,0,0,60,60,0,1,0,1,0
45095,55651,445,0,0,70,70,0,1,0,1,0
45096,55984,445,0,0,66,66,0,1,0,1,0
45097,55645,445,0,0,70,70,0,1,0,1,0
45098,55646,445,0,0,70,70,0,1,0,1,0
45099,57433,21247,0,0,66,66,0,1,0,1,0
45100,60586,445,0,0,70,70,0,1,0,1,0
45101,54545,49344,0,0,66,66,0,1,0,1,0
45102,22275,51505,0,0,62,62,0,1,0,1,0
45103,60573,445,0,0,70,70,0,1,0,1,0
45104,60569,445,0,0,70,70,0,1,0,1,0
45105,55514,1604,0,0,84,84,0,1,0,1,0
45106,55632,445,0,0,70,70,0,1,0,1,0
45107,64990,55442,0,0,66,66,0,1,0,1,0
45108,55973,445,0,0,66,66,0,1,0,1,0
45109,55373,1,0,0,66,66,0,1,0,1,0
45110,63194,50265,0,0,62,62,0,1,0,1,0
45111,28370,35440,0,0,66,66,0,1,0,1,0
45112,50280,57470,0,0,78,78,0,1,0,1,0
45113,46362,35440,0,0,66,66,0,1,0,1,0
45114,45941,23386,0,0,60,60,0,1,0,1,0
45115,27641,39004,0,0,62,62,0,1,0,1,0
45116,55965,445,0,0,66,66,0,1,0,1,0
45117,54989,50265,0,0,66,66,0,1,0,1,0
45118,12107,22114,0,0,66,66,0,1,0,1,0
45119,60560,445,0,0,70,70,0,1,0,1,0
45120,49197,30188,0,0,62,62,0,1,0,1,0
45121,55628,445,0,0,70,70,0,1,0,1,0
45122,26699,35253,0,0,62,62,0,1,0,1,0
45123,55963,445,0,0,66,66,0,1,0,1,0
45124,55618,445,0,0,70,70,0,1,0,1,0
45125,55619,445,0,0,70,70,0,1,0,1,0
45126,55616,445,0,0,70,70,0,1,0,1,0
45127,55614,445,0,0,70,70,0,1,0,1,0
45128,11136,15503,0,0,62,62,0,1,0,1,0
45129,55611,445,0,0,70,70,0,1,0,1,0
45130,55955,445,0,0,66,66,0,1,0,1,0
45131,55952,445,0,0,66,66,0,1,0,1,0
45132,58497,39004,0,0,66,66,0,1,0,1,0
45133,59772,62413,0,0,66,66,0,1,0,1,0
45134,64693,26467,0,0,62,62,0,1,0,1,0
45135,36034,35440,0,0,62,62,0,1,0,1,0
45136,55605,445,0,0,70,70,0,1,0,1,0
45137,45908,33330,0,0,60,60,0,1,0,1,0
45138,60548,445,0,0,70,70,0,1,0,1,0
45139,60547,445,0,0,70,70,0,1,0,1,0
45140,60549,445,0,0,70,70,0,1,0,1,0
45141,4257,35440,0,0,62,62,0,1,0,1,0
45142,55937,445,0,0,66,66,0,1,0,1,0
45143,55940,445,0,0,66,66,0,1,0,1,0
45144,55934,445,0,0,66,66,0,1,0,1,0
45145,55935,445,0,0,66,66,0,1,0,1,0
45146,55939,445,0,0,66,66,0,1,0,1,0
45147,55933,445,0,0,66,66,0,1,0,1,0
45148,55938,445,0,0,66,66,0,1,0,1,0
45149,55932,445,0,0,66,66,0,1,0,1,0
45150,59312,22,59312,22,327,140,187,4,0,2,2
45151,57174,57470,0,0,66,66,0,1,0,1,0
45152,55598,445,0,0,70,70,0,1,0,1,0
45153,55596,445,0,0,70,70,0,1,0,1,0
45154,55238,21247,0,0,62,62,0,1,0,1,0
45155,48706,23394,0,0,60,60,0,1,0,1,0
45156,55591,445,0,0,70,70,0,1,0,1,0
45157,46292,42873,0,0,72,72,0,1,0,1,0
45158,55590,445,0,0,70,70,0,1,0,1,0
45159,59724,64147,0,0,66,66,0,1,0,1,0
45160,60544,445,0,0,70,70,0,1,0,1,0
45161,60540,445,0,0,70,70,0,1,0,1,0
45162,46945,64147,0,0,62,62,0,1,0,1,0
45163,60533,445,0,0,70,70,0,1,0,1,0
45164,443,52504,0,0,97,97,0,1,0,1,0
45165,55920,445,0,0,66,66,0,1,0,1,0
45166,55919,445,0,0,66,66,0,1,0,1,0
45167,55917,445,0,0,66,66,0,1,0,1,0
45168,65495,11392,0,0,66,66,0,1,0,1,0
45169,55586,445,0,0,70,70,0,1,0,1,0
45170,62740,44847,0,0,146,146,0,1,0,1,0
45171,60530,445,0,0,70,70,0,1,0,1,0
45172,7978,50584,0,0,66,66,0,1,0,1,0
45173,58213,37807,0,0,66,66,0,1,0,1,0
45174,55585,445,0,0,70,70,0,1,0,1,0
45175,60527,445,0,0,70,70,0,1,0,1,0
45176,32707,11392,0,0,62,62,0,1,0,1,0
45177,52870,22197,0,0,66,66,0,1,0,1,0
45178,60519,445,0,0,70,70,0,1,0,1,0
45179,60516,445,0,0,70,70,0,1,0,1,0
45180,60515,445,0,0,70,70,0,1,0,1,0
45181,47037,1,0,0,62,62,0,1,0,1,0
45182,51818,37965,0,0,66,66,0,1,0,1,0
45183,50784,50584,0,0,62,62,0,1,0,1,0
45184,55580,445,0,0,70,70,0,1,0,1,0
45185,50914,51505,0,0,66,66,0,1,0,1,0
45186,54530,35440,0,0,66,66,0,1,0,1,0
45187,60510,445,0,0,70,70,0,1,0,1,0
45188,60508,445,0,0,70,70,0,1,0,1,0
45189,60504,445,0,0,70,70,0,1,0,1,0
45190,57472,44847,0,0,66,66,0,1,0,1,0
45191,46495,4607,0,0,60,60,0,1,0,1,0
45192,57969,42873,0,0,66,66,0,1,0,1,0
45193,55567,445,0,0,70,70,0,1,0,1,0
45194,59994,11446,0,0,66,66,0,1,0,1,0
45195,57114,35440,0,0,62,62,0,1,0,1,0
45196,55564,445,0,0,70,70,0,1,0,1,0
45197,62438,37807,0,0,66,66,0,1,0,1,0
45198,55898,445,0,0,66,66,0,1,0,1,0
45199,51183,56205,0,0,66,66,0,1,0,1,0
45200,60501,445,0,0,70,70,0,1,0,1,0
45201,60498,445,0,0,70,70,0,1,0,1,0
45202,45472,8168,0,0,62,62,0,1,0,1,0
45203,58110,23,0,0,60,60,0,1,0,1,0
45204,19875,30170,0,0,145,145,0,1,0,1,0
45205,50438,50584,0,0,146,146,0,1,0,1,0
45206,55560,445,0,0,70,70,0,1,0,1,0
45207,54047,50011,0,0,66,66,0,1,0,1,0
45208,43657,50011,0,0,62,62,0,1,0,1,0
45209,55558,445,0,0,70,70,0,1,0,1,0
45210,55891,445,0,0,66,66,0,1,0,1,0
45211,60970,20541,0,0,66,66,0,1,0,1,0
45212,55888,445,0,0,66,66,0,1,0,1,0
45213,55556,445,0,0,70,70,0,1,0,1,0
45214,16285,23,0,0,60,60,0,1,0,1,0
45215,60489,445,0,0,70,70,0,1,0,1,0
45216,14252,35993,0,0,62,62,0,1,0,1,0
45217,60482,445,0,0,70,70,0,1,0,1,0
45218,60481,445,0,0,70,70,0,1,0,1,0
45219,60479,445,0,0,70,70,0,1,0,1,0
45220,54210,64097,0,0,66,66,0,1,0,1,0
45221,55884,445,0,0,66,66,0,1,0,1,0
45222,1821,64147,0,0,66,66,0,1,0,1,0
45223,52724,64147,0,0,62,62,0,1,0,1,0
45224,28124,37965,0,0,62,62,0,1,0,1,0
45225,64589,53,29733,53,742,88,654,2,30,1,1
45226,55547,53,56945,53,738,86,652,2,30,1,1
45227,38085,443,38085,443,1452,817,635,16,20,9,7
45228,38464,443,38464,443,33734,3007,30727,53,90,29,24
45229,41919,53,41919,53,223,86,137,2,30,1,1
45230,49528,53,46480,53,170,87,83,2,30,1,1
45231,65414,443,41456,443,2494,1643,851,17,25,9,8
45232,137,137,40295,137,114,114,0,2,32,2,0
45233,53479,80,7819,80,3307,937,2370,17,16,10,7
45234,61500,443,52553,443,14738,2175,12563,24,16,10,14
45235,44455,53,21066,53,221,75,146,2,30,1,1
45236,59403,443,14686,443,30995,9655,21340,65,121,27,38
45237,58649,443,35795,443,7701,2215,5486,28,373,14,14
45238,56834,46513,28288,46513,70,70,0,1,5,1,0
45239,38508,443,38508,443,279067,22871,256196,327,90,145,182
45240,38144,443,38144,443,14849,2263,12586,29,90,17,12
45241,46741,53,52840,53,221,75,146,2,30,1,1
45242,64614,53,3783,53,168,86,82,2,30,1,1
45243,50314,31652,0,0,66,66,0,1,90,1,0
45244,57424,53,20131,53,170,87,83,2,31,1,1
45245,38409,443,38409,443,1452,817,635,16,20,9,7
45246,45339,443,35795,443,2312,1382,930,19,34,11,8
45247,55940,53,24862,53,168,86,82,2,30,1,1
45248,56143,3389,56143,3389,4365,2581,1784,20,32,11,9
45249,45338,443,42439,443,2719,1454,1265,22,34,12,10
45250,48981,15000,58211,15000,130,70,60,2,5,1,1
45251,56717,53,9802,53,711,87,624,2,30,1,1
45252,58280,443,25550,443,1786,172,1614,7,121,3,4
45253,51690,443,24259,443,9320,4615,4705,25,120,12,13
45254,50178,53,43275,53,172,88,84,2,31,1,1
45255,9087,53,9087,53,215,80,135,2,33,1,1
45256,49450,443,32537,443,9704,2335,7369,20,26,10,10
45257,55782,53,3411,53,238,87,151,2,30,1,1
45258,44847,51365,14892,51365,509,150,359,2,1200,1,1
45259,50584,49647,42268,49647,523,161,362,2,1200,1,1
45260,54522,443,63026,443,4728282,133897,4594385,4756,80,1650,3106
45261,61719,80,27024,80,32457,1499,30958,42,50,16,26
45262,58701,80,43595,80,12499310,161518,12337792,10496,70,2325,8171
45263,50972,3544,16024,3544,258,107,151,2,30,1,1
45264,61734,443,59784,443,231110,14545,216565,307,18,154,153
45265,56336,53,18502,53,192,98,94,2,30,1,1
45266,56131,53,17639,53,238,87,151,2,30,1,1
45267,42959,443,5921,443,795,795,0,2,154,2,0
45268,50584,48493,7175,48493,161,161,0,1,1200,1,0
45269,50584,10312,63675,10312,161,161,0,2,1200,2,0
45270,57000,53,25419,53,188,96,92,2,31,1,1
45271,27005,30009,8020,30009,889,126,763,3,31,2,1
45272,53810,443,53810,443,7656,4622,3034,24,139,12,12
45273,56625,53,10109,53,711,87,624,2,31,1,1
45274,55664,53,52942,53,711,87,624,2,31,1,1
45275,57073,53,4074,53,99,99,0,1,31,1,0
45276,38770,443,52968,443,140155,6367,133788,173,145,62,111
45277,50584,63591,44593,63591,161,161,0,2,1200,2,0
45278,50203,443,50531,443,3792,871,2921,16,121,7,9
45279,50584,1070,63097,1070,161,161,0,2,1200,2,0
45280,37371,5228,12391,5228,3277,1954,1323,27,3600,14,13
45281,50584,16453,1503,16453,161,161,0,2,1200,2,0
45282,50584,6889,32589,6889,311,311,0,3,1200,3,0
45283,30960,45713,7044,45713,330,330,0,6,3610,6,0
45284,53043,51050,0,0,62,62,0,1,0,1,0
45285,21674,28189,0,0,60,60,0,1,0,1,0
45286,1035,26467,0,0,62,62,0,1,0,1,0
45287,5179,50265,0,0,62,62,0,1,0,1,0
45288,60476,445,0,0,70,70,0,1,0,1,0
45289,55549,445,0,0,70,70,0,1,0,1,0
45290,58455,80,58455,80,348,132,216,6,15,3,3
45291,60470,445,0,0,70,70,0,1,0,1,0
45292,60471,445,0,0,70,70,0,1,0,1,0
45293,60469,445,0,0,70,70,0,1,0,1,0
45294,55877,445,0,0,66,66,0,1,0,1,0
45295,55547,445,0,0,70,70,0,1,0,1,0
45296,22971,50584,0,0,62,62,0,1,0,1,0
45297,18623,1,0,0,66,66,0,1,0,1,0
45298,55869,445,0,0,66,66,0,1,0,1,0
45299,55875,445,0,0,66,66,0,1,0,1,0
45300,55872,445,0,0,66,66,0,1,0,1,0
45301,55866,445,0,0,66,66,0,1,0,1,0
45302,55868,445,0,0,66,66,0,1,0,1,0
45303,55865,445,0,0,66,66,0,1,0,1,0
45304,55546,445,0,0,70,70,0,1,0,1,0
45305,29989,26467,0,0,66,66,0,1,0,1,0
45306,55545,445,0,0,70,70,0,1,0,1,0
45307,55544,445,0,0,70,70,0,1,0,1,0
45308,55542,445,0,0,70,70,0,1,0,1,0
45309,55540,445,0,0,70,70,0,1,0,1,0
45310,57093,26467,0,0,66,66,0,1,0,1,0
45311,52526,30188,0,0,62,62,0,1,0,1,0
45312,52754,26467,0,0,66,66,0,1,0,1,0
45313,60466,445,0,0,70,70,0,1,0,1,0
45314,60465,445,0,0,70,70,0,1,0,1,0
45315,60464,445,0,0,70,70,0,1,0,1,0
45316,55864,445,0,0,66,66,0,1,0,1,0
45317,60459,445,0,0,70,70,0,1,0,1,0
45318,55526,445,0,0,70,70,0,1,0,1,0
45319,55525,445,0,0,70,70,0,1,0,1,0
45320,443,21717,0,0,97,97,0,1,0,1,0
45321,55859,445,0,0,66,66,0,1,0,1,0
45322,55519,445,0,0,70,70,0,1,0,1,0
45323,55515,445,0,0,70,70,0,1,0,1,0
45324,55516,445,0,0,70,70,0,1,0,1,0
45325,55858,445,0,0,66,66,0,1,0,1,0
45326,55856,445,0,0,66,66,0,1,0,1,0
45327,53661,34967,21536,34967,70,70,0,2,8,2,0
45328,57307,443,21158,443,8407,3013,5394,43,15,24,19
45329,33040,443,3946,443,118,118,0,1,30,1,0
45330,54087,443,2699,443,2637658,83234,2554424,2794,140,929,1865
45331,27005,30006,10243,30006,888,126,762,3,31,2,1
45332,37854,443,37854,443,1452,817,635,16,20,9,7
45333,57324,443,38455,443,5612,733,4879,16,14,9,7
45334,58706,80,52999,80,4175,3452,723,14,15,7,7
45335,55261,53,19096,53,177,94,83,2,29,1,1
45336,55010,53,1751,53,245,94,151,2,29,1,1
45337,55782,53,43309,53,245,94,151,2,29,1,1
45338,55757,53,56073,53,177,94,83,2,29,1,1
45339,49646,443,27491,443,12279,4202,8077,33,43,16,17
45340,57000,53,24193,53,194,102,92,2,30,1,1
45341,40025,443,22559,443,10012,3016,6996,40,133,19,21
45342,55844,443,40826,443,6881,2073,4808,37,255,18,19
45343,38534,443,44926,443,8918,730,8188,20,72,7,13
45344,38143,443,38143,443,36902,3203,33699,57,90,31,26
45345,51091,80,6090,80,3324,663,2661,12,15,7,5
45346,37628,443,37628,443,1452,817,635,16,20,9,7
45347,57326,443,4725,443,5613,733,4880,16,14,9,7
45348,57325,443,9317,443,5613,733,4880,16,14,9,7
45349,51025,443,40011,443,6999,2523,4476,22,80,13,9
45350,55195,53,34217,53,969,86,883,2,29,1,1
45351,38049,80,38049,80,2180,1555,625,9,86,6,3
45352,58554,443,5045,443,8626,2156,6470,24,81,14,10
45353,49349,53,12679,53,405,110,295,4,38,2,2
45354,50042,53,35274,53,738,86,652,2,29,1,1
45355,49929,443,23324,443,7298,2303,4995,22,16,12,10
45356,49912,53,4964,53,733,94,639,2,29,1,1
45357,55733,53,46336,53,177,94,83,2,29,1,1
45358,57364,53,42885,53,177,94,83,2,29,1,1
45359,52202,443,56757,443,3036,818,2218,12,119,6,6
45360,28010,443,22569,443,5515,1388,4127,18,15,9,9
45361,65521,53,38042,53,167,86,81,2,29,1,1
45362,55782,53,22320,53,245,94,151,2,29,1,1
45363,55734,53,29847,53,733,94,639,2,30,1,1
45364,57396,53,31064,53,183,94,89,2,30,1,1
45365,27005,33059,58962,33059,900,126,774,3,30,2,1
45366,27005,33052,31448,33052,873,126,747,2,30,1,1
45367,60769,443,60769,443,13423,1386,12037,33,17,14,19
45368,60373,443,19425,443,3875761,85491,3790270,3838,89,1315,2523
45369,52924,443,13021,443,5583,1390,4193,19,15,9,10
45370,56131,53,29991,53,245,94,151,2,30,1,1
45371,56720,53,20064,53,177,94,83,2,30,1,1
45372,57396,53,6439,53,183,94,89,2,30,1,1
45373,55940,53,15244,53,168,86,82,2,30,1,1
45374,50124,443,33361,443,24329,7675,16654,47,16,25,22
45375,52923,443,55900,443,5581,1388,4193,19,15,9,10
45376,56581,443,17747,443,4884,1015,3869,17,25,9,8
45377,57424,53,34088,53,177,94,83,2,30,1,1
45378,47971,443,21107,443,9021,1511,7510,21,121,11,10
45379,55223,53,34886,53,168,86,82,2,31,1,1
45380,12532,80,12532,80,6215,769,5446,14,16,7,7
45381,50273,53,27219,53,718,94,624,2,30,1,1
45382,59282,123,52231,123,184,94,90,2,30,1,1
45383,58132,80,58132,80,348,132,216,6,15,3,3
45384,56131,53,25151,53,245,94,151,2,30,1,1
45385,50239,53,39194,53,183,94,89,2,30,1,1
45386,50642,53,60676,53,173,94,79,2,30,1,1
45387,55122,53,24716,53,173,94,79,2,30,1,1
45388,64752,53,32902,53,186,102,84,2,30,1,1
45389,54930,443,22759,443,2349,258,2091,10,120,4,6
45390,49501,443,27772,443,1882,1108,774,17,135,10,7
45391,63064,443,24318,443,12008,2367,9641,32,151,18,14
45392,56134,53,19695,53,167,86,81,2,30,1,1
45393,57000,53,6517,53,194,102,92,2,30,1,1
45394,57396,53,65107,53,183,94,89,2,30,1,1
45395,60760,20010,54790,20010,70,70,0,2,8,2,0
45396,64879,53,23535,53,173,94,79,2,30,1,1
45397,65436,53,10665,53,102,102,0,1,30,1,0
45398,50972,3544,63114,3544,409,107,302,4,30,2,2
45399,52054,443,46268,443,9339,4411,4928,20,135,10,10
45400,57318,443,48526,443,5612,733,4879,16,15,9,7
45401,55112,53,21380,53,245,94,151,2,30,1,1
45402,64879,53,13290,53,165,86,79,2,30,1,1
45403,56720,53,7909,53,177,94,83,2,30,1,1
45404,57470,6969,29118,6969,528,528,0,9,1199,9,0
45405,42841,53,47596,53,168,78,90,2,30,1,1
45406,50584,62758,61935,62758,161,161,0,2,1199,2,0
45407,40107,53,34833,53,168,78,90,2,30,1,1
45408,57321,443,61348,443,5613,733,4880,16,14,9,7
45409,27005,32063,39805,32063,889,126,763,2,30,1,1
45410,37580,443,37580,443,1452,817,635,16,20,9,7
45411,53130,10168,25089,10168,320,140,180,6,5,3,3
45412,49277,53,3822,53,821,102,719,2,30,1,1
45413,57316,443,30855,443,5613,733,4880,16,15,9,7
45414,55730,8060,61259,8060,70,70,0,1,4,1,0
45415,57317,443,9547,443,5614,733,4881,16,15,9,7
45416,38095,443,38095,443,247172,58810,188362,325,90,174,151
45417,57323,443,4968,443,5613,733,4880,16,14,9,7
45418,57320,443,20383,443,5989,926,5063,19,14,10,9
45419,56394,443,3047,443,5019,946,4073,19,34,9,10
45420,33967,5222,10318,5222,74654,9673,64981,221,616,106,115
45421,55733,53,30284,53,177,94,83,2,30,1,1
45422,50239,53,26724,53,183,94,89,2,30,1,1
45423,56134,53,7161,53,167,86,81,2,30,1,1
45424,49216,53,26832,53,401,142,259,2,30,1,1
45425,56006,53,57116,53,183,102,81,2,29,1,1
45426,27005,32078,22538,32078,871,126,745,2,30,1,1
45427,55782,53,15555,53,245,94,151,2,29,1,1
45428,56759,53,4446,53,177,94,83,2,30,1,1
45429,49528,53,36226,53,177,94,83,2,29,1,1
45430,27005,33076,26025,33076,889,126,763,2,31,1,1
45431,63758,443,30040,443,3263,1643,1620,9,119,5,4
45432,57470,13244,33439,13244,166,166,0,1,1199,1,0
45433,50584,6881,19659,6881,161,161,0,2,1200,2,0
45434,50584,9301,1872,9301,498,150,348,4,2396,2,2
45435,56272,53,49117,53,235,86,149,2,30,1,1
45436,49594,53,57290,53,301,102,199,2,30,1,1
45437,56459,53,5237,53,177,94,83,2,30,1,1
45438,27005,32028,64745,32028,900,126,774,2,31,1,1
45439,49171,443,51614,443,7966,2735,5231,22,120,10,12
45440,50584,42504,10356,42504,161,161,0,2,1199,2,0
45441,57306,443,21388,443,8699,3391,5308,40,15,24,16
45442,65480,443,49360,443,310863,9840,301023,323,16,115,208
45443,65047,53,53893,53,196,86,110,2,30,1,1
45444,65530,53,42402,53,194,102,92,2,30,1,1
45445,49528,53,13440,53,177,94,83,2,30,1,1
45446,55770,53,54138,53,167,86,81,2,30,1,1
45447,51966,443,55026,443,35199,15909,19290,70,152,34,36
45448,62377,443,62377,443,4378,1471,2907,19,27,11,8
45449,53664,13701,27246,13701,70,70,0,2,8,2,0
45450,53665,29135,50493,29135,70,70,0,2,8,2,0
45451,49900,4500,63369,4500,78,78,0,1,5,1,0
45452,56759,53,10512,53,177,94,83,2,30,1,1
45453,57424,53,65254,53,177,94,83,2,30,1,1
45454,50584,6881,59238,6881,901,166,735,2,1200,1,1
45455,51850,11981,61118,11981,316,136,180,6,7,3,3
45456,45457,443,33286,443,11989,7908,4081,61,120,31,30
45457,49723,53,39151,53,427,90,337,4,41,2,2
45458,28011,443,11393,443,5577,1390,4187,19,15,9,10
45459,56429,80,57755,80,17188,1559,15629,25,25,10,15
45460,42156,80,50916,80,1323,335,988,10,15,5,5
45461,56131,53,31536,53,245,94,151,2,30,1,1
45462,64531,53,13391,53,754,94,660,2,30,1,1
45463,64614,53,55438,53,168,86,82,2,30,1,1
45464,65047,53,60656,53,184,102,82,2,30,1,1
45465,49431,53,38249,53,767,102,665,2,30,1,1
45466,50642,53,41798,53,165,86,79,2,30,1,1
45467,50584,50545,46451,50545,166,166,0,1,1199,1,0
45468,50265,51413,14137,51413,460,150,310,2,1200,1,1
45469,49557,53,33015,53,211,102,109,2,30,1,1
45470,64286,53,59300,53,274,94,180,2,30,1,1
45471,55910,53,42664,53,183,94,89,2,30,1,1
45472,33288,53,0,0,86,86,0,1,30,1,0
45473,55910,53,63749,53,183,94,89,2,31,1,1
45474,56893,53,20902,53,177,94,83,2,31,1,1
45475,27005,32055,61239,32055,878,126,752,2,31,1,1
45476,55479,53,50336,53,184,94,90,2,31,1,1
45477,64751,53,58884,53,178,94,84,2,31,1,1
45478,45742,443,8175,443,8471,3275,5196,21,120,11,10
45479,46641,443,43427,443,8471,3278,5193,21,120,11,10
45480,58281,443,12495,443,4039,805,3234,17,120,8,9
45481,27005,33035,34801,33035,864,126,738,2,31,1,1
45482,65206,443,20256,443,7525,3267,4258,36,120,17,19
45483,27005,33051,7331,33051,887,126,761,2,31,1,1
45484,27005,32066,2938,32066,881,126,755,2,31,1,1
45485,50584,8999,32902,8999,311,311,0,3,1199,3,0
45486,50584,17991,30598,17991,161,161,0,2,1199,2,0
45487,57470,13332,8538,13332,166,166,0,1,1199,1,0
45488,50584,61421,62887,61421,166,166,0,1,1199,1,0
45489,50584,8999,33361,8999,1237,369,868,6,1199,3,3
45490,50584,64368,19845,64368,161,161,0,2,1200,2,0
45491,50584,49001,14591,49001,166,166,0,1,1199,1,0
45492,50584,18066,56366,18066,1705,536,1169,5,1200,4,1
45493,57470,24451,64687,24451,166,166,0,1,1200,1,0
45494,50584,6882,59204,6882,371,311,60,4,1199,3,1
45495,6882,41923,41297,41923,492,150,342,2,1200,1,1
45496,50584,40926,15001,40926,166,166,0,1,1199,1,0
45497,30188,64511,50224,64511,854,150,704,4,1200,2,2
45498,50584,6881,41717,6881,1357,369,988,6,1200,3,3
45499,36488,443,36488,443,8448,2150,6298,39,98,21,18
45500,65479,443,61050,443,92397,4379,88018,102,16,37,65
45501,49495,443,44088,443,9037,3596,5441,36,321,19,17
45502,55037,443,6546,443,130,70,60,3,5,2,1
45503,50608,443,5976,443,5039,2265,2774,21,30,11,10
45504,36067,443,36067,443,228681,29484,199197,303,110,149,154
45505,56985,53,39491,53,165,86,79,2,30,1,1
45506,50589,53,3456,53,177,94,83,2,30,1,1
45507,35240,443,35240,443,24155,3115,21040,55,98,27,28
45508,61355,443,38386,443,17666,3045,14621,52,213,21,31
45509,52216,80,58055,80,15824,805,15019,25,18,9,16
45510,40547,443,6575,443,4916,2083,2833,24,43,13,11
45511,53208,80,52746,80,2953,785,2168,12,116,8,4
45512,55842,443,52718,443,8661,2036,6625,40,256,19,21
45513,56120,443,26246,443,551795,18805,532990,603,43,220,383
45514,55122,53,17738,53,173,94,79,2,30,1,1
45515,49647,443,38723,443,11011,4522,6489,35,43,17,18
45516,38450,443,40244,443,9299,2445,6854,25,81,14,11
45517,49451,443,61379,443,12802,1977,10825,32,25,14,18
45518,57188,443,33520,443,7162,1731,5431,29,32,14,15
45519,55854,445,0,0,66,66,0,1,0,1,0
45520,51620,56205,0,0,62,62,0,1,0,1,0
45521,60455,445,0,0,70,70,0,1,0,1,0
45522,60444,445,0,0,70,70,0,1,0,1,0
45523,60441,445,0,0,70,70,0,1,0,1,0
45524,55504,445,0,0,70,70,0,1,0,1,0
45525,24853,39828,0,0,60,60,0,1,0,1,0
45526,58550,21247,0,0,66,66,0,1,0,1,0
45527,55844,445,0,0,66,66,0,1,0,1,0
45528,45908,33330,0,0,60,60,0,1,0,1,0
45529,59210,8168,0,0,66,66,0,1,0,1,0
45530,56578,64147,0,0,66,66,0,1,0,1,0
45531,53156,35993,0,0,66,66,0,1,0,1,0
45532,63731,26467,0,0,62,62,0,1,0,1,0
45533,51244,57587,0,0,100,100,0,1,0,1,0
45534,13973,50584,0,0,146,146,0,1,0,1,0
45535,55500,445,0,0,70,70,0,1,0,1,0
45536,443,20550,0,0,97,97,0,1,0,1,0
45537,55836,445,0,0,66,66,0,1,0,1,0
45538,60432,445,0,0,70,70,0,1,0,1,0
45539,56148,37965,0,0,66,66,0,1,0,1,0
45540,55490,445,0,0,70,70,0,1,0,1,0
45541,55491,445,0,0,70,70,0,1,0,1,0
45542,11030,37965,0,0,62,62,0,1,0,1,0
45543,55488,445,0,0,70,70,0,1,0,1,0
45544,55487,445,0,0,70,70,0,1,0,1,0
45545,55834,445,0,0,66,66,0,1,0,1,0
45546,55483,445,0,0,70,70,0,1,0,1,0
45547,53543,44847,0,0,62,62,0,1,0,1,0
45548,1070,26467,0,0,62,62,0,1,0,1,0
45549,54858,51505,0,0,62,62,0,1,0,1,0
45550,55827,445,0,0,66,66,0,1,0,1,0
45551,2440,37807,0,0,66,66,0,1,0,1,0
45552,55820,445,0,0,66,66,0,1,0,1,0
45553,29300,35440,0,0,62,62,0,1,0,1,0
45554,57070,30170,0,0,146,146,0,1,0,1,0
45555,5664,36237,0,0,62,62,0,1,0,1,0
45556,55478,445,0,0,70,70,0,1,0,1,0
45557,17873,23117,0,0,62,62,0,1,0,1,0
45558,56380,36829,0,0,66,66,0,1,0,1,0
45559,55986,26467,0,0,62,62,0,1,0,1,0
45560,3980,63710,0,0,66,66,0,1,0,1,0
45561,60422,445,0,0,70,70,0,1,0,1,0
45562,60420,445,0,0,70,70,0,1,0,1,0
45563,60419,445,0,0,70,70,0,1,0,1,0
45564,43916,21,0,0,60,60,0,1,0,1,0
45565,55470,445,0,0,70,70,0,1,0,1,0
45566,55811,445,0,0,66,66,0,1,0,1,0
45567,55810,445,0,0,66,66,0,1,0,1,0
45568,55808,445,0,0,66,66,0,1,0,1,0
45569,55809,445,0,0,66,66,0,1,0,1,0
45570,55807,445,0,0,66,66,0,1,0,1,0
45571,55806,445,0,0,66,66,0,1,0,1,0
45572,55804,445,0,0,66,66,0,1,0,1,0
45573,55803,445,0,0,66,66,0,1,0,1,0
45574,55469,445,0,0,70,70,0,1,0,1,0
45575,15922,44847,0,0,66,66,0,1,0,1,0
45576,60129,55442,0,0,62,62,0,1,0,1,0
45577,55463,445,0,0,70,70,0,1,0,1,0
45578,55462,445,0,0,70,70,0,1,0,1,0
45579,53490,62413,0,0,62,62,0,1,0,1,0
45580,8889,16520,0,0,60,60,0,1,0,1,0
45581,50878,23,0,0,60,60,0,1,0,1,0
45582,56491,56205,0,0,146,146,0,1,0,1,0
45583,51676,23718,0,0,66,66,0,1,0,1,0
45584,60413,445,0,0,70,70,0,1,0,1,0
45585,60405,445,0,0,70,70,0,1,0,1,0
45586,60404,445,0,0,70,70,0,1,0,1,0
45587,55458,445,0,0,70,70,0,1,0,1,0
45588,47814,51505,0,0,66,66,0,1,0,1,0
45589,55791,445,0,0,66,66,0,1,0,1,0
45590,55790,445,0,0,66,66,0,1,0,1,0
45591,55789,445,0,0,66,66,0,1,0,1,0
45592,58966,30188,0,0,62,62,0,1,0,1,0
45593,60401,445,0,0,70,70,0,1,0,1,0
45594,55457,445,0,0,70,70,0,1,0,1,0
45595,53003,11392,0,0,66,66,0,1,0,1,0
45596,45832,51050,0,0,66,66,0,1,0,1,0
45597,0,0,0,0,98,98,0,1,0,1,0
45598,0,0,0,0,156,156,0,2,0,2,0
45599,0,0,0,0,98,98,0,1,0,1,0
45600,0,0,0,0,98,98,0,1,0,1,0
45601,0,0,0,0,244,244,0,2,0,2,0
45602,0,0,0,0,98,98,0,1,0,1,0
45603,60399,445,0,0,70,70,0,1,0,1,0
45604,60392,445,0,0,70,70,0,1,0,1,0
45605,60391,445,0,0,70,70,0,1,0,1,0
45606,60387,445,0,0,70,70,0,1,0,1,0
45607,50881,50584,0,0,66,66,0,1,0,1,0
45608,55452,445,0,0,70,70,0,1,0,1,0
45609,54742,50584,0,0,66,66,0,1,0,1,0
45610,20198,17372,0,0,62,62,0,1,0,1,0
45611,13907,57470,0,0,62,62,0,1,0,1,0
45612,3803,51505,0,0,62,62,0,1,0,1,0
45613,60382,445,0,0,70,70,0,1,0,1,0
45614,60380,445,0,0,70,70,0,1,0,1,0
45615,60376,445,0,0,70,70,0,1,0,1,0
45616,43104,26467,0,0,62,62,0,1,0,1,0
45617,55439,445,0,0,70,70,0,1,0,1,0
45618,55436,445,0,0,70,70,0,1,0,1,0
45619,23089,48817,0,0,62,62,0,1,0,1,0
45620,16221,50584,0,0,146,146,0,1,0,1,0
45621,1663,30188,0,0,66,66,0,1,0,1,0
45622,55769,445,0,0,66,66,0,1,0,1,0
45623,60374,445,0,0,70,70,0,1,0,1,0
45624,54219,443,4743,443,10323,2834,7489,44,256,21,23
45625,41114,53,0,0,82,82,0,1,30,1,0
45626,55897,53,59750,53,733,85,648,2,30,1,1
45627,55426,53,8033,53,181,98,83,2,30,1,1
45628,55910,53,5285,53,182,93,89,2,30,1,1
45629,56437,53,9819,53,749,94,655,2,30,1,1
45630,33399,443,27816,443,3603,2013,1590,21,42,12,9
45631,34873,80,34873,80,2148,918,1230,10,20,6,4
45632,61497,443,26455,443,15302,2355,12947,30,32,14,16
45633,41626,15000,7526,15000,130,70,60,2,5,1,1
45634,34365,443,34038,443,223826,45909,177917,356,44,176,180
45635,35271,443,35271,443,134405,6968,127437,187,97,85,102
45636,55841,443,33701,443,9333,2019,7314,41,255,19,22
45637,5588,5588,0,0,3562,1936,1626,48,194,24,24
45638,36622,443,36622,443,16116,3253,12863,52,97,29,23
45639,55131,53,48118,53,744,95,649,2,30,1,1
45640,55180,53,64280,53,780,93,687,2,31,1,1
45641,41524,443,23023,443,3976,2652,1324,20,312,11,9
45642,38017,7275,45146,7275,4615,664,3951,15,15,9,6
45643,55164,53,9551,53,170,87,83,2,31,1,1
45644,56141,53,2789,53,184,94,90,2,31,1,1
45645,50306,53,23964,53,814,110,704,2,30,1,1
45646,40768,443,17418,443,3287,2049,1238,12,32,7,5
45647,55630,43736,8013,43736,70,70,0,1,5,1,0
45648,33397,443,15065,443,1348,687,661,14,42,8,6
45649,46219,53,46219,53,237,91,146,2,33,1,1
45650,19698,502,19698,502,60,60,0,1,5,1,0
45651,55840,443,56226,443,9374,2150,7224,42,255,19,23
45652,51272,12210,15332,12210,70,70,0,1,5,1,0
45653,56504,443,16127,443,4467051,102279,4364772,4340,46,1452,2888
45654,55839,443,48499,443,13469,2007,11462,44,256,19,25
45655,57209,53,54053,53,764,99,665,2,30,1,1
45656,38056,443,15075,443,9528,2738,6790,27,81,15,12
45657,55148,53,64223,53,711,87,624,2,30,1,1
45658,55223,53,54493,53,168,86,82,2,31,1,1
45659,13868,53,13868,53,215,80,135,2,34,1,1
45660,55087,443,24413,443,101356,10743,90613,178,31,90,88
45661,55479,53,40449,53,184,94,90,2,31,1,1
45662,54975,443,15865,443,441892,86941,354951,716,73,343,373
45663,33404,443,64550,443,4152,2734,1418,24,40,14,10
45664,38057,443,24418,443,9486,2668,6818,26,81,14,12
45665,36053,443,36053,443,79562,17054,62508,111,109,54,57
45666,51829,46209,24768,46209,66,66,0,1,5,1,0
45667,50669,53,9177,53,578,286,292,9,16,5,4
45668,58886,15000,23434,15000,138,78,60,2,5,1,1
45669,55471,53,27819,53,256,93,163,2,30,1,1
45670,52385,53,0,0,138,69,69,2,30,1,1
45671,55770,53,35170,53,166,85,81,2,30,1,1
45672,56956,53,28771,53,182,93,89,2,30,1,1
45673,65021,53,29006,53,256,93,163,2,30,1,1
45674,49867,53,44107,53,170,87,83,2,30,1,1
45675,50313,53,2331,53,744,95,649,2,30,1,1
45676,57166,53,41004,53,170,87,83,2,30,1,1
45677,51594,53,51594,53,219,92,127,2,30,1,1
45678,58688,53,58688,53,235,92,143,2,30,1,1
45679,34240,53,34240,53,229,89,140,2,31,1,1
45680,55727,53,47747,53,701,88,613,2,31,1,1
45681,60781,443,56303,443,5964,3582,2382,17,136,8,9
45682,49160,40527,18392,40527,854,150,704,4,1201,2,2
45683,30960,45714,65388,45714,330,330,0,6,3609,6,0
45684,55253,53,63534,53,754,94,660,2,31,1,1
45685,27005,27023,64597,27023,875,126,749,2,31,1,1
45686,57020,53,49369,53,738,86,652,2,31,1,1
45687,49168,53,10918,53,192,98,94,2,31,1,1
45688,33571,443,51011,443,4281,1160,3121,12,122,6,6
45689,60701,443,27691,443,5166,1989,3177,15,122,7,8
45690,60373,445,0,0,70,70,0,1,0,1,0
45691,52633,30188,0,0,62,62,0,1,0,1,0
45692,11988,48817,0,0,66,66,0,1,0,1,0
45693,21674,28189,0,0,60,60,0,1,0,1,0
45694,3730,37965,0,0,62,62,0,1,0,1,0
45695,42252,33306,0,0,60,60,0,1,0,1,0
45696,55431,445,0,0,70,70,0,1,0,1,0
45697,55430,445,0,0,70,70,0,1,0,1,0
45698,3818,37965,0,0,66,66,0,1,0,1,0
45699,55428,445,0,0,70,70,0,1,0,1,0
45700,55760,445,0,0,66,66,0,1,0,1,0
45701,55759,445,0,0,66,66,0,1,0,1,0
45702,54619,80,53235,80,2269,1579,690,10,77,6,4
45703,56956,53,61460,53,183,94,89,2,30,1,1
45704,10701,11392,0,0,62,62,0,1,0,1,0
45705,60362,445,0,0,70,70,0,1,0,1,0
45706,62029,36237,0,0,62,62,0,1,0,1,0
45707,62872,50584,0,0,66,66,0,1,0,1,0
45708,60358,445,0,0,70,70,0,1,0,1,0
45709,60354,445,0,0,70,70,0,1,0,1,0
45710,60351,445,0,0,70,70,0,1,0,1,0
45711,22619,10214,0,0,66,66,0,1,0,1,0
45712,10000,10214,0,0,62,62,0,1,0,1,0
45713,7892,50584,0,0,62,62,0,1,0,1,0
45714,55755,445,0,0,66,66,0,1,0,1,0
45715,43260,41615,0,0,145,145,0,1,0,1,0
45716,61053,44847,0,0,66,66,0,1,0,1,0
45717,55421,445,0,0,70,70,0,1,0,1,0
45718,60347,445,0,0,70,70,0,1,0,1,0
45719,55419,445,0,0,70,70,0,1,0,1,0
45720,2422,50584,0,0,66,66,0,1,0,1,0
45721,60344,445,0,0,70,70,0,1,0,1,0
45722,56715,53,50292,53,807,94,713,2,30,1,1
45723,48521,53,27557,53,78,78,0,1,30,1,0
45724,64566,53,24742,53,194,102,92,2,30,1,1
45725,65000,53,35253,53,184,102,82,2,30,1,1
45726,55426,53,25381,53,177,94,83,2,30,1,1
45727,62546,443,43210,443,7740,2603,5137,13,120,7,6
45728,56113,443,21683,443,103486,7416,96070,161,42,82,79
45729,47330,443,38110,443,9297,2727,6570,27,80,15,12
45730,45414,443,2299,443,2215,1412,803,19,38,10,9
45731,44870,80,28005,80,1119,1045,74,7,14,6,1
45732,56635,443,56247,443,8654,2150,6504,20,15,11,9
45733,50589,53,31342,53,177,94,83,2,29,1,1
45734,57424,53,34696,53,177,94,83,2,30,1,1
45735,49867,53,10689,53,177,94,83,2,30,1,1
45736,49867,53,63133,53,177,94,83,2,30,1,1
45737,56119,443,4138,443,144290,9387,134903,217,42,110,107
45738,57470,51413,47712,51413,543,166,377,2,1199,1,1
45739,60927,443,47688,443,3642,606,3036,13,119,6,7
45740,57305,443,15646,443,1574,1089,485,13,15,8,5
45741,34257,7275,41230,7275,2845,419,2426,12,15,7,5
45742,59861,443,36199,443,2128,828,1300,19,40,8,11
45743,35292,443,36726,443,4866,3323,1543,25,94,14,11
45744,57300,443,65390,443,8979,3093,5886,43,15,24,19
45745,40549,443,43115,443,1352,691,661,14,42,8,6
45746,57298,443,20012,443,8313,2850,5463,42,15,24,18
45747,52437,443,30974,443,384,384,0,7,33,7,0
45748,36144,443,36144,443,170890,13800,157090,246,97,123,123
45749,63927,53,2248,53,374,101,273,4,33,2,2
45750,41230,443,4213,443,234,234,0,4,11,4,0
45751,35449,443,35449,443,157435,9243,148192,220,97,101,119
45752,56628,80,40894,80,234,234,0,4,11,4,0
45753,123,123,24489,123,184,94,90,2,29,1,1
45754,50159,53,16650,53,94,94,0,1,29,1,0
45755,53261,12348,58794,12348,552,306,246,9,142,5,4
45756,56985,53,40638,53,165,86,79,2,29,1,1
45757,50178,53,59652,53,178,94,84,2,29,1,1
45758,55244,53,54182,53,186,102,84,2,30,1,1
45759,57000,53,32346,53,194,102,92,2,30,1,1
45760,55770,53,28096,53,167,86,81,2,29,1,1
45761,49867,53,7070,53,177,94,83,2,29,1,1
45762,27005,33038,17485,33038,892,126,766,2,30,1,1
45763,65221,53,41318,53,199,102,97,2,30,1,1
45764,55479,53,22790,53,184,94,90,2,30,1,1
45765,43347,7275,22003,7275,3299,665,2634,18,16,10,8
45766,54985,443,28045,443,23913,3495,20418,50,48,24,26
45767,42117,80,40456,80,1056,682,374,10,15,6,4
45768,56893,53,7619,53,177,94,83,2,30,1,1
45769,49718,53,50641,53,184,94,90,2,30,1,1
45770,64016,53,54267,53,183,94,89,2,30,1,1
45771,56292,53,23956,53,197,102,95,2,30,1,1
45772,55164,53,14668,53,177,94,83,2,30,1,1
45773,35596,5228,54963,5228,3235,1448,1787,26,811,8,18
45774,53141,443,52504,443,37389,3972,33417,69,133,32,37
45775,54620,80,5302,80,14855,1611,13244,26,77,14,12
45776,56688,443,37544,443,32780,6864,25916,142,345,57,85
45777,56694,53,57041,53,196,102,94,2,30,1,1
45778,60892,443,56728,443,22772,8095,14677,46,54,24,22
45779,56634,443,30287,443,8654,2150,6504,20,15,11,9
45780,57073,53,22592,53,197,102,95,2,33,1,1
45781,64867,53,27823,53,765,102,663,2,30,1,1
45782,52793,443,27629,443,1942,1281,661,22,228,16,6
45783,54978,443,60259,443,225539,162879,62660,476,70,262,214
45784,56472,53,44784,53,177,94,83,2,30,1,1
45785,54986,443,39292,443,5684,3042,2642,32,46,18,14
45786,56991,443,56991,443,6305,1352,4953,19,16,10,9
45787,56715,53,19827,53,184,94,90,2,30,1,1
45788,56568,443,49242,443,1277,705,572,13,25,7,6
45789,64052,53,43180,53,211,102,109,2,30,1,1
45790,56141,53,19077,53,184,94,90,2,30,1,1
45791,56571,53,44608,53,211,102,109,2,30,1,1
45792,65221,53,47234,53,199,102,97,2,30,1,1
45793,55770,53,17489,53,167,86,81,2,30,1,1
45794,55820,53,26876,53,184,94,90,2,30,1,1
45795,55264,53,44429,53,177,94,83,2,30,1,1
45796,58744,80,31824,80,4635,1572,3063,12,15,7,5
45797,60894,443,20427,443,34862,6364,28498,64,54,31,33
45798,51500,443,57250,443,7211,823,6388,16,15,10,6
45799,57166,53,28476,53,177,94,83,2,30,1,1
45800,64710,53,46845,53,393,110,283,2,30,1,1
45801,53227,443,46822,443,5430,687,4743,15,73,6,9
45802,53210,80,7510,80,1726,940,786,8,51,5,3
45803,56956,53,13948,53,183,94,89,2,30,1,1
45804,60608,53,20949,53,199,94,105,2,30,1,1
45805,57155,53,11661,53,396,102,294,2,30,1,1
45806,39068,443,31079,443,10831,1381,9450,22,20,12,10
45807,56118,443,45922,443,187927,12115,175812,276,42,137,139
45808,54454,5222,49306,5222,9568,1982,7586,44,345,17,27
45809,46277,443,48047,443,15670,12575,3095,51,37,30,21
45810,41474,443,44338,443,190,70,120,4,15,2,2
45811,57606,443,40796,443,11986,3075,8911,60,4981,31,29
45812,57302,443,55784,443,5614,733,4881,16,15,9,7
45813,51984,80,5183,80,48285,2659,45626,65,15,32,33
45814,57303,443,1835,443,5612,733,4879,16,15,9,7
45815,59860,443,59422,443,2165,987,1178,17,40,8,9
45816,40333,80,15004,80,1049,975,74,6,15,5,1
45817,43274,443,35686,443,6645,1668,4977,21,31,12,9
45818,58600,443,58600,443,4398,1491,2907,19,28,11,8
45819,54981,443,51323,443,36008,2548,33460,55,69,26,29
45820,53209,8081,13912,8081,5349,1928,3421,17,114,10,7
45821,49173,80,62950,80,254,128,126,5,15,3,2
45822,55079,443,57713,443,7156,1187,5969,20,16,10,10
45823,64934,53,52297,53,197,102,95,2,33,1,1
45824,52035,80,61330,80,4185,3462,723,14,15,7,7
45825,35063,443,32697,443,7105,1924,5181,20,25,10,10
45826,58286,20,58286,20,100132,17467,82665,325,619,168,157
45827,53328,443,21893,443,4670,2814,1856,33,81,15,18
45828,53642,39344,30760,39344,612,306,306,10,15,5,5
45829,55244,53,5418,53,186,102,84,2,29,1,1
45830,64800,53,3701,53,343,92,251,4,50,2,2
45831,34305,80,22535,80,2443,1794,649,11,76,6,5
45832,36811,53,36811,53,227,90,137,2,29,1,1
45833,60632,53,3971,53,179,86,93,2,29,1,1
45834,65239,53,28035,53,757,102,655,2,29,1,1
45835,64046,53,35754,53,259,110,149,2,29,1,1
45836,39927,443,15384,443,7787,2370,5417,23,242,11,12
45837,64752,53,22741,53,178,94,84,2,29,1,1
45838,64935,53,42263,53,313,94,219,2,29,1,1
45839,56720,53,11601,53,177,94,83,2,29,1,1
45840,56459,53,48405,53,177,94,83,2,30,1,1
45841,56141,53,30553,53,184,94,90,2,30,1,1
45842,50000,53,56621,53,216,102,114,2,29,1,1
45843,38936,53,29060,53,215,86,129,2,30,1,1
45844,49718,53,42238,53,807,94,713,2,30,1,1
45845,49793,53,43171,53,718,94,624,2,30,1,1
45846,65325,53,48288,53,216,110,106,2,30,1,1
45847,56717,53,10005,53,183,94,89,2,30,1,1
45848,54179,443,27953,443,5037,2002,3035,14,120,7,7
45849,56736,443,56736,443,120441,7846,112595,167,61,76,91
45850,59099,443,44771,443,7066,1861,5205,32,1262,17,15
45851,21544,41599,59404,41599,70,70,0,2,8,2,0
45852,51848,28960,25741,28960,70,70,0,2,9,2,0
45853,39543,7276,23316,7276,1142,558,584,16,16,8,8
45854,65324,53,6556,53,749,94,655,2,30,1,1
45855,65221,53,62850,53,199,102,97,2,30,1,1
45856,64016,53,50450,53,183,94,89,2,30,1,1
45857,49913,53,16997,53,216,110,106,2,31,1,1
45858,55919,53,44823,53,177,94,83,2,30,1,1
45859,57301,443,1829,443,5614,733,4881,16,15,9,7
45860,55640,54435,47783,54435,70,70,0,2,8,2,0
45861,53478,443,15802,443,7692,2183,5509,24,224,14,10
45862,53211,80,10536,80,194,128,66,4,51,3,1
45863,34219,53,25349,53,199,94,105,2,30,1,1
45864,65000,53,40784,53,168,86,82,2,30,1,1
45865,56956,53,49926,53,183,94,89,2,30,1,1
45866,55164,53,64984,53,177,94,83,2,30,1,1
45867,64493,53,11797,53,199,102,97,2,30,1,1
45868,55223,53,62144,53,168,86,82,2,30,1,1
45869,59214,443,59214,443,27659,5508,22151,59,47,31,28
45870,54976,443,13251,443,8156,3281,4875,43,71,21,22
45871,51847,32112,38487,32112,70,70,0,2,9,2,0
45872,56832,23900,53161,23900,130,70,60,2,5,1,1
45873,56831,10434,25973,10434,70,70,0,1,5,1,0
45874,60893,443,5461,443,46690,9390,37300,77,54,36,41
45875,56563,443,19548,443,4528,884,3644,15,26,9,6
45876,56472,53,22766,53,177,94,83,2,30,1,1
45877,49642,443,30931,443,17163,6197,10966,44,43,22,22
45878,53588,8999,41805,8999,1268,960,308,9,32,5,4
45879,57166,53,13391,53,177,94,83,2,30,1,1
45880,55910,53,26815,53,183,94,89,2,30,1,1
45881,46965,443,48357,443,1786,172,1614,7,120,3,4
45882,36857,80,4468,80,11216,2684,8532,28,163,11,17
45883,57470,49160,27757,49160,402,132,270,6,1209,3,3
45884,55479,53,23646,53,184,94,90,2,31,1,1
45885,27005,33026,18106,33026,879,126,753,2,31,1,1
45886,27005,32065,28721,32065,877,126,751,2,31,1,1
45887,57342,53,55197,53,167,86,81,2,31,1,1
45888,27005,33055,54134,33055,888,126,762,2,31,1,1
45889,27005,32039,29232,32039,883,126,757,2,31,1,1
45890,51821,443,38521,443,3002,258,2744,9,119,4,5
45891,57470,9273,56118,9273,491,150,341,2,1199,1,1
45892,55919,53,46329,53,177,94,83,2,31,1,1
45893,27005,33060,25157,33060,928,126,802,2,31,1,1
45894,49923,443,47836,443,7759,2264,5495,19,120,9,10
45895,53863,443,64176,443,13492,3615,9877,42,120,20,22
45896,57470,6881,22501,6881,353,166,187,2,1199,1,1
45897,53350,443,13931,443,5987,2780,3207,21,140,10,11
45898,37965,21859,39298,21859,481,150,331,2,1199,1,1
45899,26467,6969,46826,6969,192,192,0,4,1200,4,0
45900,56550,53,64220,53,183,94,89,2,31,1,1
45901,60761,40010,63900,40010,316,136,180,6,6,3,3
45902,64555,53,10175,53,469,97,372,4,49,2,2
45903,60424,6881,10732,6881,320,140,180,6,7,3,3
45904,64751,53,57978,53,178,94,84,2,30,1,1
45905,57166,53,52593,53,177,94,83,2,30,1,1
45906,50718,80,3998,80,620,320,300,11,166,6,5
45907,61718,443,31970,443,21125,2413,18712,42,49,20,22
45908,61703,80,42538,80,1494,954,540,13,51,8,5
45909,63837,14023,10553,14023,66,66,0,2,8,2,0
45910,54987,443,13107,443,7502,2299,5203,37,18,21,16
45911,55264,53,25192,53,177,94,83,2,30,1,1
45912,46726,53,27470,53,168,78,90,2,30,1,1
45913,49903,53,65277,53,231,110,121,2,30,1,1
45914,55043,53,37629,53,167,86,81,2,30,1,1
45915,55164,53,26323,53,177,94,83,2,30,1,1
45916,56785,443,18418,443,288525,15601,272924,383,33,193,190
45917,56586,53,63496,53,177,94,83,2,31,1,1
45918,64588,53,41773,53,173,94,79,2,31,1,1
45919,27005,27999,21376,27999,913,126,787,2,31,1,1
45920,60341,445,0,0,70,70,0,1,0,1,0
45921,60340,445,0,0,70,70,0,1,0,1,0
45922,55749,445,0,0,66,66,0,1,0,1,0
45923,55418,445,0,0,70,70,0,1,0,1,0
45924,55745,445,0,0,66,66,0,1,0,1,0
45925,55744,445,0,0,66,66,0,1,0,1,0
45926,55741,445,0,0,66,66,0,1,0,1,0
45927,55417,445,0,0,70,70,0,1,0,1,0
45928,50798,36237,0,0,62,62,0,1,0,1,0
45929,55416,445,0,0,70,70,0,1,0,1,0
45930,55411,445,0,0,70,70,0,1,0,1,0
45931,55412,445,0,0,70,70,0,1,0,1,0
45932,55739,445,0,0,66,66,0,1,0,1,0
45933,55738,445,0,0,66,66,0,1,0,1,0
45934,55736,445,0,0,66,66,0,1,0,1,0
45935,23936,35440,0,0,62,62,0,1,0,1,0
45936,39119,44847,0,0,62,62,0,1,0,1,0
45937,60338,445,0,0,70,70,0,1,0,1,0
45938,55398,445,0,0,70,70,0,1,0,1,0
45939,60337,445,0,0,70,70,0,1,0,1,0
45940,60335,445,0,0,70,70,0,1,0,1,0
45941,55397,445,0,0,70,70,0,1,0,1,0
45942,55392,445,0,0,70,70,0,1,0,1,0
45943,55733,445,0,0,66,66,0,1,0,1,0
45944,2918,37965,0,0,62,62,0,1,0,1,0
45945,48676,53393,0,0,60,60,0,1,0,1,0
45946,55388,445,0,0,70,70,0,1,0,1,0
45947,55387,445,0,0,70,70,0,1,0,1,0
45948,60331,445,0,0,70,70,0,1,0,1,0
45949,64294,64147,0,0,62,62,0,1,0,1,0
45950,55730,445,0,0,66,66,0,1,0,1,0
45951,55728,445,0,0,66,66,0,1,0,1,0
45952,55727,445,0,0,66,66,0,1,0,1,0
45953,55725,445,0,0,66,66,0,1,0,1,0
45954,10916,44847,0,0,66,66,0,1,0,1,0
45955,52575,22114,0,0,66,66,0,1,0,1,0
45956,60312,57470,0,0,74,74,0,1,0,1,0
45957,60168,35440,0,0,66,66,0,1,0,1,0
45958,63791,48817,0,0,145,145,0,1,0,1,0
45959,65064,30188,0,0,66,66,0,1,0,1,0
45960,11402,11119,0,0,145,145,0,1,0,1,0
45961,60328,445,0,0,70,70,0,1,0,1,0
45962,55376,445,0,0,70,70,0,1,0,1,0
45963,49717,57470,0,0,62,62,0,1,0,1,0
45964,60313,445,0,0,70,70,0,1,0,1,0
45965,14059,21247,0,0,146,146,0,1,0,1,0
45966,59739,35253,0,0,62,62,0,1,0,1,0
45967,55713,445,0,0,66,66,0,1,0,1,0
45968,55372,445,0,0,70,70,0,1,0,1,0
45969,42463,56205,0,0,62,62,0,1,0,1,0
45970,6882,64147,0,0,146,146,0,1,0,1,0
45971,30306,23,0,0,60,60,0,1,0,1,0
45972,55706,445,0,0,66,66,0,1,0,1,0
45973,35163,30188,0,0,66,66,0,1,0,1,0
45974,60303,445,0,0,70,70,0,1,0,1,0
45975,55363,445,0,0,70,70,0,1,0,1,0
45976,55361,445,0,0,70,70,0,1,0,1,0
45977,55360,445,0,0,70,70,0,1,0,1,0
45978,55358,445,0,0,70,70,0,1,0,1,0
45979,55355,445,0,0,70,70,0,1,0,1,0
45980,59937,37965,0,0,66,66,0,1,0,1,0
45981,23006,48817,0,0,62,62,0,1,0,1,0
45982,55704,445,0,0,66,66,0,1,0,1,0
45983,58398,44847,0,0,66,66,0,1,0,1,0
45984,20168,81,0,0,60,60,0,1,0,1,0
45985,55695,445,0,0,66,66,0,1,0,1,0
45986,55691,445,0,0,66,66,0,1,0,1,0
45987,55349,445,0,0,70,70,0,1,0,1,0
45988,61902,22114,0,0,66,66,0,1,0,1,0
45989,44849,46478,0,0,74,74,0,1,0,1,0
45990,44981,57470,0,0,66,66,0,1,0,1,0
45991,63779,26467,0,0,66,66,0,1,0,1,0
45992,52282,37965,0,0,66,66,0,1,0,1,0
45993,51910,37965,0,0,62,62,0,1,0,1,0
45994,53774,51505,0,0,62,62,0,1,0,1,0
45995,55342,445,0,0,70,70,0,1,0,1,0
45996,55339,445,0,0,70,70,0,1,0,1,0
45997,60292,445,0,0,70,70,0,1,0,1,0
45998,60293,445,0,0,70,70,0,1,0,1,0
45999,60291,445,0,0,70,70,0,1,0,1,0
46000,13285,29892,0,0,145,145,0,1,0,1,0
46001,55674,445,0,0,66,66,0,1,0,1,0
46002,55677,445,0,0,66,66,0,1,0,1,0
46003,55679,445,0,0,66,66,0,1,0,1,0
46004,55680,445,0,0,66,66,0,1,0,1,0
46005,55681,445,0,0,66,66,0,1,0,1,0
46006,55678,445,0,0,66,66,0,1,0,1,0
46007,55675,445,0,0,66,66,0,1,0,1,0
46008,55673,445,0,0,66,66,0,1,0,1,0
46009,45941,23386,0,0,60,60,0,1,0,1,0
46010,44203,8055,0,0,159,159,0,1,0,1,0
46011,64898,35993,0,0,74,74,0,1,0,1,0
46012,55335,445,0,0,70,70,0,1,0,1,0
46013,30879,35440,0,0,146,146,0,1,0,1,0
46014,55334,445,0,0,70,70,0,1,0,1,0
46015,13285,29892,0,0,145,145,0,1,0,1,0
46016,0,0,0,0,70,70,0,1,0,1,0
46017,51032,30188,0,0,66,66,0,1,0,1,0
46018,11937,35440,0,0,146,146,0,1,0,1,0
46019,55330,445,0,0,70,70,0,1,0,1,0
46020,61257,56448,0,0,146,146,0,1,0,1,0
46021,60288,445,0,0,70,70,0,1,0,1,0
46022,60282,445,0,0,70,70,0,1,0,1,0
46023,60276,445,0,0,70,70,0,1,0,1,0
46024,54196,11392,0,0,66,66,0,1,0,1,0
46025,43129,15503,0,0,62,62,0,1,0,1,0
46026,443,62451,0,0,199,199,0,1,0,1,0
46027,55329,445,0,0,70,70,0,1,0,1,0
46028,55311,44847,0,0,66,66,0,1,0,1,0
46029,55658,445,0,0,66,66,0,1,0,1,0
46030,55661,445,0,0,66,66,0,1,0,1,0
46031,60273,445,0,0,70,70,0,1,0,1,0
46032,52696,21247,0,0,62,62,0,1,0,1,0
46033,22835,51221,0,0,62,62,0,1,0,1,0
46034,443,5705,0,0,60,60,0,1,0,1,0
46035,60271,445,0,0,70,70,0,1,0,1,0
46036,38653,21247,0,0,62,62,0,1,0,1,0
46037,60267,445,0,0,70,70,0,1,0,1,0
46038,60266,445,0,0,70,70,0,1,0,1,0
46039,60263,445,0,0,70,70,0,1,0,1,0
46040,55324,445,0,0,70,70,0,1,0,1,0
46041,59563,56205,0,0,66,66,0,1,0,1,0
46042,17579,57470,0,0,62,62,0,1,0,1,0
46043,24174,57470,0,0,62,62,0,1,0,1,0
46044,62549,53733,0,0,66,66,0,1,0,1,0
46045,49915,35440,0,0,62,62,0,1,0,1,0
46046,30246,51050,0,0,146,146,0,1,0,1,0
46047,17453,35440,0,0,62,62,0,1,0,1,0
46048,59845,44847,0,0,66,66,0,1,0,1,0
46049,60254,445,0,0,70,70,0,1,0,1,0
46050,60251,445,0,0,70,70,0,1,0,1,0
46051,64021,53,21293,53,190,97,93,2,30,1,1
46052,55985,53,10494,53,711,87,624,2,30,1,1
46053,49517,80,14591,80,6123,3105,3018,16,38,8,8
46054,61700,443,65174,443,12613,2946,9667,38,50,18,20
46055,59769,443,37962,443,8432,1967,6465,35,68,17,18
46056,50574,443,59952,443,5870,1785,4085,21,80,12,9
46057,49144,443,40050,443,130,70,60,3,5,2,1
46058,44129,53,44129,53,182,81,101,2,30,1,1
46059,33842,53,33842,53,1415,689,726,3,31,2,1
46060,61698,80,14302,80,7712,4248,3464,23,51,12,11
46061,59857,443,40076,443,2118,1093,1025,22,44,9,13
46062,36357,443,35351,443,14614,1935,12679,36,16,20,16
46063,56445,53,12217,53,711,87,624,2,30,1,1
46064,56292,53,41121,53,194,99,95,2,30,1,1
46065,49845,53,6637,53,188,96,92,2,31,1,1
46066,55912,53,3506,53,184,94,90,2,30,1,1
46067,55620,53,14188,53,170,87,83,2,30,1,1
46068,50572,443,24489,443,5867,1782,4085,21,80,12,9
46069,59843,443,50473,443,1427,726,701,17,46,8,9
46070,65251,53,48559,53,198,101,97,2,30,1,1
46071,56968,80,44242,80,53181,50384,2797,75,20,39,36
46072,49515,80,17973,80,5101,2867,2234,15,38,8,7
46073,57342,53,37406,53,166,85,81,2,31,1,1
46074,50569,443,18328,443,5941,1856,4085,22,81,13,9
46075,50567,443,16036,443,5866,1781,4085,21,81,12,9
46076,49106,53,49106,53,1415,689,726,3,30,2,1
46077,61733,443,10616,443,168812,5693,163119,186,21,68,118
46078,63815,11372,42999,11372,504,382,122,8,16,6,2
46079,59858,443,47016,443,2069,1044,1025,22,44,9,13
46080,59848,443,53182,443,2431,1164,1267,27,46,11,16
46081,55820,53,49464,53,184,94,90,2,30,1,1
46082,56472,53,12167,53,711,87,624,2,30,1,1
46083,55851,53,15581,53,749,94,655,2,30,1,1
46084,45663,53,45663,53,507,129,378,2,30,1,1
46085,55264,53,35896,53,170,87,83,2,30,1,1
46086,64566,53,1628,53,188,96,92,2,30,1,1
46087,49825,53,46479,53,793,101,692,2,30,1,1
46088,64535,53,14565,53,763,101,662,2,30,1,1
46089,62230,443,57839,443,3709,1176,2533,14,135,7,7
46090,55267,53,18171,53,168,86,82,2,31,1,1
46091,27328,443,23617,443,3751,1007,2744,35,473,11,24
46092,49913,53,50642,53,216,110,106,2,31,1,1
46093,55640,53,50783,53,742,88,654,2,31,1,1
46094,57009,53,27487,53,1435,98,1337,4,34,2,2
46095,50568,443,35404,443,5877,1792,4085,21,81,12,9
46096,59842,443,63853,443,1307,666,641,15,46,7,8
46097,53663,17904,16406,17904,320,140,180,6,7,3,3
46098,63835,30794,60469,30794,66,66,0,2,8,2,0
46099,65107,53,44757,53,266,87,179,4,33,2,2
46100,51825,25501,31893,25501,66,66,0,1,5,1,0
46101,59826,443,57652,443,7284,1079,6205,29,53,13,16
46102,60421,6882,64164,6882,70,70,0,2,8,2,0
46103,52658,80,12733,80,214,140,74,4,15,3,1
46104,55208,80,41287,80,1638,1324,314,10,15,5,5
46105,56694,53,29552,53,192,98,94,2,30,1,1
46106,49483,80,60356,80,318,192,126,6,40,4,2
46107,64751,53,29777,53,172,88,84,2,30,1,1
46108,55838,443,19179,443,7034,2039,4995,37,255,18,19
46109,56100,53,43759,53,701,88,613,2,30,1,1
46110,50134,53,12196,53,768,99,669,2,30,1,1
46111,64493,53,45305,53,198,101,97,2,30,1,1
46112,56850,53,62960,53,763,101,662,2,31,1,1
46113,56889,53,34055,53,170,87,83,2,31,1,1
46114,50233,53,55519,53,756,95,661,2,31,1,1
46115,56550,53,60039,53,182,93,89,2,31,1,1
46116,55142,53,21559,53,770,101,669,2,31,1,1
46117,54973,53,47397,53,731,91,640,2,31,1,1
46118,56374,53,38425,53,770,102,668,2,31,1,1
46119,55368,53,50855,53,760,97,663,2,31,1,1
46120,49459,443,42939,443,2572,330,2242,12,135,5,7
46121,57470,47004,40280,47004,152,152,0,2,1200,2,0
46122,49166,53,45421,53,770,101,669,2,31,1,1
46123,27005,27027,32399,27027,880,126,754,2,31,1,1
46124,56757,53,3651,53,783,96,687,2,31,1,1
46125,64791,53,42823,53,184,94,90,2,31,1,1
46126,57100,53,41347,53,192,90,102,2,31,1,1
46127,56612,53,36295,53,184,94,90,2,31,1,1
46128,55105,53,18912,53,747,93,654,2,31,1,1
46129,64766,53,59121,53,212,108,104,2,31,1,1
46130,47493,53,47493,53,227,92,135,2,31,1,1
46131,50196,53,48778,53,756,95,661,2,31,1,1
46132,56484,443,15925,443,2948,782,2166,10,121,5,5
46133,59651,60038,0,0,66,66,0,1,90,1,0
46134,37587,5228,8359,5228,5509,2203,3306,22,3600,10,12
46135,56623,443,24976,443,8963,2190,6773,18,138,8,10
46136,56308,53,54603,53,184,94,90,2,31,1,1
46137,35713,443,23137,443,5315,2861,2454,16,135,8,8
46138,30960,45705,10345,45705,396,396,0,7,3617,7,0
46139,60247,445,0,0,70,70,0,1,0,1,0
46140,51412,51505,0,0,66,66,0,1,0,1,0
46141,55539,57470,0,0,66,66,0,1,0,1,0
46142,55311,445,0,0,70,70,0,1,0,1,0
46143,21674,28189,0,0,60,60,0,1,0,1,0
46144,20005,37965,0,0,62,62,0,1,0,1,0
46145,64997,51221,0,0,66,66,0,1,0,1,0
46146,50341,37965,0,0,66,66,0,1,0,1,0
46147,6713,2222,0,0,60,60,0,1,0,1,0
46148,49191,35440,0,0,66,66,0,1,0,1,0
46149,55308,445,0,0,70,70,0,1,0,1,0
46150,2541,51505,0,0,62,62,0,1,0,1,0
46151,42110,80,55658,80,1056,682,374,10,15,6,4
46152,55743,53,57939,53,165,86,79,2,30,1,1
46153,50281,53,4430,53,767,102,665,2,30,1,1
46154,55937,443,21508,443,3363,797,2566,14,135,7,7
46155,55636,445,0,0,66,66,0,1,0,1,0
46156,60243,445,0,0,70,70,0,1,0,1,0
46157,60241,445,0,0,70,70,0,1,0,1,0
46158,55303,445,0,0,70,70,0,1,0,1,0
46159,54545,49344,0,0,66,66,0,1,0,1,0
46160,32388,26467,0,0,66,66,0,1,0,1,0
46161,55302,445,0,0,70,70,0,1,0,1,0
46162,52144,49344,0,0,62,62,0,1,0,1,0
46163,53227,64097,0,0,66,66,0,1,0,1,0
46164,50577,23,0,0,60,60,0,1,0,1,0
46165,55300,445,0,0,70,70,0,1,0,1,0
46166,19885,64147,0,0,145,145,0,1,0,1,0
46167,55267,53,21533,53,168,86,82,2,30,1,1
46168,51827,48432,31400,48432,160,70,90,2,4,1,1
46169,57372,443,37935,443,4612,700,3912,12,15,8,4
46170,64021,53,18880,53,195,102,93,2,29,1,1
46171,64188,53,49847,53,216,94,122,2,29,1,1
46172,65325,53,33633,53,216,110,106,2,29,1,1
46173,55264,53,48968,53,177,94,83,2,30,1,1
46174,27005,26258,35412,26258,886,126,760,2,30,1,1
46175,56141,53,40551,53,713,94,619,4,54,2,2
46176,50019,80,29484,80,814,674,140,6,28,4,2
46177,50717,80,38874,80,3317,2376,941,17,165,9,8
46178,61711,80,55600,80,4448,2223,2225,18,49,10,8
46179,65107,53,56824,53,266,87,179,4,32,2,2
46180,51846,41510,18249,41510,70,70,0,2,8,2,0
46181,53644,58085,53471,58085,70,70,0,1,4,1,0
46182,56829,33418,63291,33418,316,136,180,6,5,3,3
46183,56292,443,38026,443,162,102,60,2,5,1,1
46184,64554,53,30164,53,94,94,0,1,29,1,0
46185,55820,53,22468,53,184,94,90,2,29,1,1
46186,64493,53,42355,53,199,102,97,2,29,1,1
46187,49771,53,57877,53,177,94,83,2,29,1,1
46188,56717,53,4326,53,183,94,89,2,29,1,1
46189,50320,53,19368,53,754,94,660,2,29,1,1
46190,64566,53,26350,53,194,102,92,2,29,1,1
46191,56717,53,57782,53,183,94,89,2,29,1,1
46192,56694,53,47429,53,196,102,94,2,29,1,1
46193,39444,53,0,0,86,86,0,1,29,1,0
46194,64021,53,54662,53,195,102,93,2,30,1,1
46195,46176,53,12412,53,168,78,90,2,30,1,1
46196,53124,52917,26989,52917,70,70,0,1,5,1,0
46197,50232,443,24591,443,7292,950,6342,19,75,9,10
46198,60786,3389,60786,3389,4226,2201,2025,19,18,10,9
46199,49406,80,24541,80,32206,1049,31157,37,89,11,26
46200,49235,80,47953,80,1783342,58977,1724365,1613,162,445,1168
46201,49523,80,32458,80,1399,826,573,11,38,6,5
46202,52223,443,45658,443,6710,4371,2339,33,109,18,15
46203,56506,53,39583,53,807,94,713,2,30,1,1
46204,55912,53,46949,53,184,94,90,2,30,1,1
46205,59325,53,7735,53,211,78,133,2,30,1,1
46206,55223,53,31444,53,168,86,82,2,30,1,1
46207,55738,53,4750,53,309,94,215,2,30,1,1
46208,49913,53,47185,53,216,110,106,2,30,1,1
46209,49168,53,14343,53,196,102,94,2,30,1,1
46210,55912,53,61558,53,184,94,90,2,30,1,1
46211,64722,53,58551,53,214,110,104,2,30,1,1
46212,56308,53,37236,53,184,94,90,2,31,1,1
46213,49713,53,55679,53,734,94,640,2,30,1,1
46214,64751,53,33597,53,178,94,84,2,30,1,1
46215,49925,80,49556,80,1126,609,517,11,15,6,5
46216,65201,53,45437,53,334,94,240,2,30,1,1
46217,60398,443,27669,443,2847,1797,1050,24,85,13,11
46218,65439,53,54009,53,168,86,82,2,30,1,1
46219,56586,53,7181,53,177,94,83,2,30,1,1
46220,57342,53,19842,53,167,86,81,2,30,1,1
46221,49891,53,62229,53,822,102,720,2,30,1,1
46222,35266,53,50904,53,164,78,86,2,30,1,1
46223,49525,80,7498,80,454,262,192,8,38,5,3
46224,55625,10480,18268,10480,564,318,246,9,15,5,4
46225,53639,15079,39945,15079,546,306,240,9,15,5,4
46226,49701,53,61542,53,197,102,95,2,30,1,1
46227,59714,3389,59714,3389,4134,2109,2025,18,17,9,9
46228,49236,80,22987,80,1904818,59945,1844873,1747,162,498,1249
46229,55620,53,23313,53,177,94,83,2,30,1,1
46230,60544,53,63580,53,211,78,133,2,30,1,1
46231,65251,53,53427,53,199,102,97,2,30,1,1
46232,64588,53,47202,53,165,86,79,2,30,1,1
46233,49202,53,58969,53,295,86,209,2,30,1,1
46234,64722,53,36705,53,214,110,104,2,30,1,1
46235,65473,53,40939,53,309,94,215,2,30,1,1
46236,56292,53,4815,53,197,102,95,2,30,1,1
46237,57294,443,36134,443,5614,733,4881,16,15,9,7
46238,49478,80,36631,80,28629,4862,23767,33,39,13,20
46239,56786,443,61415,443,238132,13988,224144,317,32,161,156
46240,55896,53,29667,53,733,94,639,2,30,1,1
46241,49168,53,25368,53,196,102,94,2,30,1,1
46242,49971,53,19251,53,779,110,669,2,30,1,1
46243,56966,53,53823,53,177,94,83,2,30,1,1
46244,65251,53,42946,53,199,102,97,2,30,1,1
46245,49269,53,8382,53,198,110,88,2,30,1,1
46246,59977,53,61405,53,168,78,90,2,30,1,1
46247,50430,53,3410,53,789,102,687,2,30,1,1
46248,57297,443,9892,443,5614,733,4881,16,15,9,7
46249,49260,80,56058,80,2013987,64000,1949987,1818,160,504,1314
46250,49891,53,46766,53,199,102,97,2,30,1,1
46251,51490,5223,60793,5223,9801,5352,4449,28,473,16,12
46252,55743,53,47802,53,165,86,79,2,30,1,1
46253,55620,53,48166,53,177,94,83,2,30,1,1
46254,56889,53,24379,53,177,94,83,2,30,1,1
46255,49179,443,25006,443,686176,17574,668602,702,18,252,450
46256,53332,443,6381,443,23215,18990,4225,44,405,24,20
46257,48354,5222,3961,5222,7786,1403,6383,44,434,15,29
46258,49446,443,57880,443,1280822,27768,1253054,1241,40,365,876
46259,40452,1488,40452,1488,156,156,0,3,8,3,0
46260,57295,443,4265,443,5614,733,4881,16,15,9,7
46261,42166,443,46667,443,162,102,60,2,5,1,1
46262,21017,3389,21017,3389,4085,1916,2169,21,18,12,9
46263,46360,443,51396,443,1053,566,487,10,16,6,4
46264,65107,53,20258,53,266,87,179,4,32,2,2
46265,50335,80,17897,80,3855,828,3027,11,15,5,6
46266,49471,80,33120,80,10175,1359,8816,18,78,7,11
46267,49519,80,21026,80,2981,1514,1467,12,38,7,5
46268,61687,80,48451,80,11437,2775,8662,32,53,15,17
46269,64638,53,33072,53,215,102,113,2,29,1,1
46270,63836,14791,9109,14791,66,66,0,2,7,2,0
46271,57161,53,42229,53,224,102,122,2,29,1,1
46272,53692,53,53692,53,262,82,180,2,29,1,1
46273,49379,80,26229,80,6307,2851,3456,18,150,9,9
46274,49524,80,21220,80,1401,828,573,11,38,6,5
46275,64493,53,5722,53,353,101,252,4,54,2,2
46276,49771,53,28192,53,177,94,83,2,29,1,1
46277,56292,53,5398,53,197,102,95,2,29,1,1
46278,49484,80,60761,80,318,192,126,6,39,4,2
46279,65325,53,57020,53,216,110,106,2,29,1,1
46280,49237,80,10310,80,1934086,60476,1873610,1754,162,493,1261
46281,27005,33070,2152,33070,883,126,757,2,30,1,1
46282,49051,443,25390,443,7683,1817,5866,42,3089,15,27
46283,55043,53,56883,53,167,86,81,2,29,1,1
46284,60792,53,38025,53,168,78,90,2,29,1,1
46285,49168,53,56952,53,196,102,94,2,30,1,1
46286,64733,53,63976,53,889,404,485,10,30,5,5
46287,55820,53,12238,53,184,94,90,2,30,1,1
46288,64650,53,46019,53,193,94,99,2,30,1,1
46289,49432,53,34624,53,812,110,702,2,30,1,1
46290,50545,53,44269,53,765,102,663,2,30,1,1
46291,55123,53,24178,53,295,86,209,2,30,1,1
46292,49797,53,57522,53,306,94,212,2,30,1,1
46293,50289,53,1310,53,189,102,87,2,30,1,1
46294,64791,53,7738,53,184,94,90,2,30,1,1
46295,64722,53,55455,53,214,110,104,2,30,1,1
46296,55235,53,63921,53,178,94,84,2,30,1,1
46297,64592,53,65035,53,209,110,99,2,31,1,1
46298,57362,53,9411,53,346,102,244,2,31,1,1
46299,56612,53,64503,53,184,94,90,2,31,1,1
46300,57188,443,9507,443,20317684,620294,19697390,20965,186,6716,14249
46301,56986,53,21320,53,177,94,83,2,31,1,1
46302,64021,53,7172,53,402,97,305,4,31,2,2
46303,52998,443,2559,443,190,70,120,4,15,2,2
46304,56624,443,23164,443,8536,3817,4719,25,20,15,10
46305,57296,443,59127,443,5613,733,4880,16,15,9,7
46306,56548,443,12998,443,4145,1069,3076,14,25,8,6
46307,49482,80,62281,80,378,192,186,7,39,4,3
46308,37004,80,37004,80,13825,1203,12622,22,29,9,13
46309,49514,80,16033,80,1352,832,520,12,38,7,5
46310,56966,53,65099,53,177,94,83,2,30,1,1
46311,52266,53,15275,53,168,78,90,2,30,1,1
46312,56139,53,55354,53,306,94,212,2,30,1,1
46313,55229,53,33453,53,173,94,79,2,30,1,1
46314,50072,53,22723,53,779,86,693,2,30,1,1
46315,51849,21091,51027,21091,316,136,180,6,7,3,3
46316,49927,80,35490,80,1126,609,517,11,15,6,5
46317,49926,80,8028,80,1126,609,517,11,15,6,5
46318,60767,443,60767,443,2406,1218,1188,21,16,11,10
46319,49234,80,29641,80,1103248,36317,1066931,1001,162,276,725
46320,49701,53,61488,53,197,102,95,2,30,1,1
46321,56986,53,63697,53,177,94,83,2,30,1,1
46322,55229,53,8520,53,173,94,79,2,30,1,1
46323,53662,55043,16806,55043,320,140,180,6,6,3,3
46324,50116,22,50116,22,152,66,86,2,9,1,1
46325,49928,80,49356,80,1270,679,591,13,15,7,6
46326,59715,3389,59715,3389,3331,1442,1889,15,17,8,7
46327,52215,80,59875,80,1009,506,503,10,16,5,5
46328,49512,80,18348,80,2225,1649,576,10,38,6,4
46329,65355,53,46648,53,592,105,487,4,50,2,2
46330,56506,53,3362,53,184,94,90,2,30,1,1
46331,65129,53,27603,53,213,102,111,2,30,1,1
46332,56618,443,44259,443,22938,14436,8502,43,41,23,20
46333,56889,53,34075,53,177,94,83,2,30,1,1
46334,64389,53,21920,53,244,94,150,2,30,1,1
46335,65218,443,1874,443,2767,681,2086,10,120,5,5
46336,49663,53,27941,53,168,86,82,2,31,1,1
46337,49936,53,50715,53,152,78,74,2,31,1,1
46338,27005,33111,35417,33111,895,126,769,2,31,1,1
46339,6881,37232,47143,37232,502,150,352,2,1199,1,1
46340,55877,22374,2922,22374,150,150,0,1,1200,1,0
46341,64766,53,62502,53,214,110,104,2,31,1,1
46342,42989,443,61280,443,9878,1936,7942,36,121,18,18
46343,64766,53,32517,53,214,110,104,2,30,1,1
46344,56667,53,18172,53,199,102,97,2,30,1,1
46345,64686,53,28216,53,811,94,717,2,30,1,1
46346,55912,53,21691,53,184,94,90,2,31,1,1
46347,55431,53,2541,53,196,102,94,2,31,1,1
46348,50017,53,58091,53,195,102,93,2,31,1,1
46349,42764,53,15953,53,164,78,86,2,31,1,1
46350,27005,32073,48886,32073,884,126,758,2,31,1,1
46351,57342,53,16666,53,167,86,81,2,31,1,1
46352,27005,27057,3516,27057,917,126,791,2,31,1,1
46353,27005,27091,19292,27091,883,126,757,2,31,1,1
46354,38566,443,54032,443,4108,1272,2836,11,121,5,6
46355,48817,30201,48817,30201,469,150,319,2,1200,1,1
46356,65077,443,2224,443,6118,5698,420,12,123,6,6
46357,42225,443,6040,443,8962,1601,7361,26,186,14,12
46358,51982,443,54748,443,9010,2779,6231,30,361,15,15
46359,33059,58962,0,0,774,774,0,1,0,1,0
46360,55631,445,0,0,66,66,0,1,0,1,0
46361,5227,50584,0,0,146,146,0,1,0,1,0
46362,34936,30188,0,0,62,62,0,1,0,1,0
46363,45682,1,0,0,62,62,0,1,0,1,0
46364,55373,1,0,0,66,66,0,1,0,1,0
46365,49687,53,60160,53,197,102,95,2,31,1,1
46366,58074,443,57514,443,2974,408,2566,13,135,6,7
46367,64364,53,21283,53,193,94,99,2,31,1,1
46368,27005,32025,48806,32025,887,126,761,2,31,1,1
46369,49480,53,38554,53,428,96,332,4,52,2,2
46370,60718,443,23092,443,71105,20647,50458,107,38,53,54
46371,56626,80,44276,80,234,234,0,4,12,4,0
46372,64658,53,8151,53,195,102,93,2,30,1,1
46373,56889,53,35698,53,177,94,83,2,30,1,1
46374,27005,27111,16900,27111,913,126,787,2,31,1,1
46375,51767,80,59527,80,2169,1263,906,13,75,8,5
46376,56067,53,11884,53,189,102,87,2,31,1,1
46377,49206,53,42939,53,179,94,85,2,31,1,1
46378,50413,123,48114,123,184,94,90,2,31,1,1
46379,57100,53,28423,53,180,94,86,2,31,1,1
46380,49996,53,3311,53,458,188,270,6,31,3,3
46381,51690,80,52942,80,21064,2772,18292,38,175,18,20
46382,65107,53,22367,53,266,87,179,4,35,2,2
46383,57030,53,7649,53,283,101,182,4,39,2,2
46384,32787,80,54491,80,1412,848,564,14,316,8,6
46385,39423,443,60458,443,121145,3578,117567,128,77,39,89
46386,57283,53,15261,53,185,102,83,2,30,1,1
46387,55482,53,16639,53,822,102,720,2,30,1,1
46388,50500,53,25369,53,166,86,80,2,30,1,1
46389,55628,445,0,0,66,66,0,1,0,1,0
46390,18650,23718,0,0,62,62,0,1,0,1,0
46391,60233,445,0,0,70,70,0,1,0,1,0
46392,1025,46232,0,0,145,145,0,1,0,1,0
46393,60230,445,0,0,70,70,0,1,0,1,0
46394,60228,445,0,0,70,70,0,1,0,1,0
46395,60222,445,0,0,70,70,0,1,0,1,0
46396,49479,56205,0,0,62,62,0,1,0,1,0
46397,55625,445,0,0,66,66,0,1,0,1,0
46398,52150,39109,0,0,66,66,0,1,0,1,0
46399,55293,445,0,0,70,70,0,1,0,1,0
46400,55291,445,0,0,70,70,0,1,0,1,0
46401,54989,50265,0,0,66,66,0,1,0,1,0
46402,60218,445,0,0,70,70,0,1,0,1,0
46403,64283,37965,0,0,74,74,0,1,0,1,0
46404,57633,50584,0,0,62,62,0,1,0,1,0
46405,55290,445,0,0,70,70,0,1,0,1,0
46406,60216,445,0,0,70,70,0,1,0,1,0
46407,60212,445,0,0,70,70,0,1,0,1,0
46408,60213,445,0,0,70,70,0,1,0,1,0
46409,4427,50584,0,0,62,62,0,1,0,1,0
46410,55289,445,0,0,70,70,0,1,0,1,0
46411,44208,26467,0,0,62,62,0,1,0,1,0
46412,55617,445,0,0,66,66,0,1,0,1,0
46413,55288,445,0,0,70,70,0,1,0,1,0
46414,55286,445,0,0,70,70,0,1,0,1,0
46415,55282,445,0,0,70,70,0,1,0,1,0
46416,34146,51221,0,0,62,62,0,1,0,1,0
46417,55614,445,0,0,66,66,0,1,0,1,0
46418,55616,445,0,0,66,66,0,1,0,1,0
46419,55610,445,0,0,66,66,0,1,0,1,0
46420,13985,34159,0,0,62,62,0,1,0,1,0
46421,2876,35440,0,0,62,62,0,1,0,1,0
46422,55609,445,0,0,66,66,0,1,0,1,0
46423,55608,445,0,0,66,66,0,1,0,1,0
46424,55606,445,0,0,66,66,0,1,0,1,0
46425,55270,445,0,0,70,70,0,1,0,1,0
46426,55268,445,0,0,70,70,0,1,0,1,0
46427,55267,445,0,0,70,70,0,1,0,1,0
46428,55259,445,0,0,70,70,0,1,0,1,0
46429,55260,445,0,0,70,70,0,1,0,1,0
46430,60210,445,0,0,70,70,0,1,0,1,0
46431,60209,445,0,0,70,70,0,1,0,1,0
46432,60206,445,0,0,70,70,0,1,0,1,0
46433,62725,51221,0,0,66,66,0,1,0,1,0
46434,55604,445,0,0,66,66,0,1,0,1,0
46435,1790,48817,0,0,66,66,0,1,0,1,0
46436,60203,445,0,0,70,70,0,1,0,1,0
46437,4257,35440,0,0,62,62,0,1,0,1,0
46438,55600,445,0,0,66,66,0,1,0,1,0
46439,80,57411,0,0,1514,1514,0,1,0,1,0
46440,46518,44847,0,0,146,146,0,1,0,1,0
46441,55598,445,0,0,66,66,0,1,0,1,0
46442,55594,445,0,0,66,66,0,1,0,1,0
46443,80,36466,0,0,1514,1514,0,1,0,1,0
46444,57174,57470,0,0,66,66,0,1,0,1,0
46445,11344,42873,0,0,62,62,0,1,0,1,0
46446,55248,445,0,0,70,70,0,1,0,1,0
46447,48706,23393,0,0,60,60,0,1,0,1,0
46448,60198,445,0,0,70,70,0,1,0,1,0
46449,13970,42873,0,0,66,66,0,1,0,1,0
46450,60191,445,0,0,70,70,0,1,0,1,0
46451,60186,445,0,0,70,70,0,1,0,1,0
46452,55583,445,0,0,66,66,0,1,0,1,0
46453,46292,42873,0,0,72,72,0,1,0,1,0
46454,55244,445,0,0,70,70,0,1,0,1,0
46455,443,24425,0,0,151,151,0,1,0,1,0
46456,55235,445,0,0,70,70,0,1,0,1,0
46457,55233,445,0,0,70,70,0,1,0,1,0
46458,64387,37965,0,0,66,66,0,1,0,1,0
46459,14924,44847,0,0,66,66,0,1,0,1,0
46460,55232,445,0,0,70,70,0,1,0,1,0
46461,55230,445,0,0,70,70,0,1,0,1,0
46462,55576,445,0,0,66,66,0,1,0,1,0
46463,55228,445,0,0,70,70,0,1,0,1,0
46464,60175,445,0,0,70,70,0,1,0,1,0
46465,55573,445,0,0,66,66,0,1,0,1,0
46466,11136,15503,0,0,62,62,0,1,0,1,0
46467,1162,57470,0,0,62,62,0,1,0,1,0
46468,20108,64147,0,0,62,62,0,1,0,1,0
46469,57410,37965,0,0,66,66,0,1,0,1,0
46470,55221,445,0,0,70,70,0,1,0,1,0
46471,55567,445,0,0,66,66,0,1,0,1,0
46472,55561,445,0,0,66,66,0,1,0,1,0
46473,55214,445,0,0,70,70,0,1,0,1,0
46474,38383,51221,0,0,66,66,0,1,0,1,0
46475,54636,26467,0,0,66,66,0,1,0,1,0
46476,55211,445,0,0,70,70,0,1,0,1,0
46477,60165,445,0,0,70,70,0,1,0,1,0
46478,60164,445,0,0,70,70,0,1,0,1,0
46479,60163,445,0,0,70,70,0,1,0,1,0
46480,55550,445,0,0,66,66,0,1,0,1,0
46481,55546,445,0,0,66,66,0,1,0,1,0
46482,55545,445,0,0,66,66,0,1,0,1,0
46483,55548,445,0,0,66,66,0,1,0,1,0
46484,55551,445,0,0,66,66,0,1,0,1,0
46485,55544,445,0,0,66,66,0,1,0,1,0
46486,55549,445,0,0,66,66,0,1,0,1,0
46487,55543,445,0,0,66,66,0,1,0,1,0
46488,55207,445,0,0,70,70,0,1,0,1,0
46489,54898,36237,0,0,66,66,0,1,0,1,0
46490,55206,445,0,0,70,70,0,1,0,1,0
46491,54854,19847,0,0,66,66,0,1,0,1,0
46492,51183,56205,0,0,66,66,0,1,0,1,0
46493,3117,37965,0,0,62,62,0,1,0,1,0
46494,50095,30188,0,0,66,66,0,1,0,1,0
46495,55202,445,0,0,70,70,0,1,0,1,0
46496,60161,445,0,0,70,70,0,1,0,1,0
46497,60158,445,0,0,70,70,0,1,0,1,0
46498,60148,445,0,0,70,70,0,1,0,1,0
46499,55201,445,0,0,70,70,0,1,0,1,0
46500,55145,11392,0,0,66,66,0,1,0,1,0
46501,50116,22,0,0,60,60,0,1,0,1,0
46502,55531,445,0,0,66,66,0,1,0,1,0
46503,55529,445,0,0,66,66,0,1,0,1,0
46504,55528,445,0,0,66,66,0,1,0,1,0
46505,33370,22,0,0,60,60,0,1,0,1,0
46506,62438,37807,0,0,66,66,0,1,0,1,0
46507,60145,445,0,0,70,70,0,1,0,1,0
46508,54210,64097,0,0,66,66,0,1,0,1,0
46509,45908,33330,0,0,60,60,0,1,0,1,0
46510,1081,64910,0,0,146,146,0,1,0,1,0
46511,55196,445,0,0,70,70,0,1,0,1,0
46512,41801,53,41801,53,213,87,126,2,30,1,1
46513,55651,53,6764,53,760,97,663,2,30,1,1
46514,48972,443,48972,443,4657,1750,2907,19,31,11,8
46515,56120,53,56120,53,237,91,146,2,33,1,1
46516,50734,80,51242,80,1114,534,580,12,16,7,5
46517,51807,443,51807,443,1466,856,610,13,27,6,7
46518,51076,80,51076,80,8170,844,7326,17,42,7,10
46519,57746,15000,19364,15000,130,70,60,2,6,1,1
46520,53972,443,53972,443,4380,1473,2907,19,29,11,8
46521,50951,80,50951,80,514,246,268,9,42,5,4
46522,65378,53,28736,53,770,102,668,2,30,1,1
46523,49983,53,51189,53,749,89,660,2,30,1,1
46524,56227,53,8068,53,188,96,92,2,30,1,1
46525,56526,443,53927,443,1560,988,572,13,25,7,6
46526,53656,58624,15076,58624,70,70,0,2,8,2,0
46527,50883,80,50883,80,514,246,268,9,42,5,4
46528,55871,53,11606,53,711,87,624,2,30,1,1
46529,49762,53,23081,53,760,97,663,2,30,1,1
46530,49837,53,39920,53,212,108,104,2,30,1,1
46531,53575,53,50120,53,198,93,105,2,30,1,1
46532,60945,443,60945,443,4680,1773,2907,19,29,11,8
46533,62738,443,30177,443,126,60,66,3,10,2,1
46534,38386,80,38386,80,6261,833,5428,15,20,8,7
46535,44258,443,15237,443,14478,1815,12663,30,170,14,16
46536,54990,80,38273,80,9054746,285623,8769123,10474,214,4673,5801
46537,53880,443,53880,443,4686,1779,2907,19,30,11,8
46538,57030,53,58226,53,283,101,182,4,38,2,2
46539,56541,443,2047,443,1560,988,572,13,25,7,6
46540,50757,80,50757,80,514,246,268,9,42,5,4
46541,51140,80,51140,80,514,246,268,9,42,5,4
46542,51810,443,51810,443,1536,856,680,14,27,6,8
46543,53835,7000,53835,7000,2099,676,1423,13,15,7,6
46544,56242,53,42071,53,711,87,624,2,30,1,1
46545,49192,53,18280,53,747,93,654,2,30,1,1
46546,64592,53,37714,53,202,103,99,2,31,1,1
46547,55129,53,28774,53,754,94,660,2,31,1,1
46548,51798,443,51798,443,14904,6448,8456,33,30,18,15
46549,10099,80,20785,80,130,70,60,2,15,1,1
46550,55237,53,13670,53,259,87,172,4,56,2,2
46551,53354,80,22791,80,2722,1530,1192,12,316,7,5
46552,50500,53,52272,53,164,84,80,2,30,1,1
46553,57067,53,64624,53,172,88,84,2,30,1,1
46554,56765,53,52854,53,711,87,624,2,30,1,1
46555,27005,27019,17502,27019,873,126,747,2,30,1,1
46556,64949,53,27237,53,744,89,655,2,30,1,1
46557,56986,53,24262,53,170,87,83,2,30,1,1
46558,55141,53,48144,53,744,89,655,2,30,1,1
46559,65328,53,16469,53,174,89,85,2,30,1,1
46560,56589,53,53742,53,711,87,624,2,30,1,1
46561,55759,53,54947,53,756,95,661,2,30,1,1
46562,27005,27017,50516,27017,873,126,747,2,30,1,1
46563,55877,53,16386,53,164,84,80,2,30,1,1
46564,56553,53,14002,53,198,101,97,2,30,1,1
46565,49206,53,61280,53,174,89,85,2,31,1,1
46566,65370,53,4186,53,778,103,675,2,31,1,1
46567,56334,53,41390,53,767,102,665,2,31,1,1
46568,39703,443,48474,443,4719,2313,2406,15,132,7,8
46569,15503,6881,37170,6881,490,149,341,2,1200,1,1
46570,52028,53,52028,53,194,87,107,2,31,1,1
46571,50017,53,55318,53,190,97,93,2,31,1,1
46572,59893,53,45221,53,198,93,105,2,30,1,1
46573,64560,53,23612,53,802,104,698,2,30,1,1
46574,49513,53,13327,53,200,102,98,2,31,1,1
46575,55533,53,30263,53,816,97,719,2,31,1,1
46576,27005,30005,39246,30005,890,126,764,2,31,1,1
46577,56342,53,27382,53,733,93,640,2,31,1,1
46578,57470,40870,29859,40870,535,163,372,2,1200,1,1
46579,56633,53,17988,53,194,99,95,2,31,1,1
46580,56250,53,20280,53,802,104,698,2,31,1,1
46581,64790,53,49419,53,182,93,89,2,31,1,1
46582,64934,53,46124,53,194,99,95,2,31,1,1
46583,47595,33436,0,0,106,106,0,1,60,1,0
46584,36228,80,25190,80,1114,540,574,17,191,10,7
46585,56076,443,18045,443,1786,172,1614,7,120,3,4
46586,56000,53,40530,53,170,87,83,2,31,1,1
46587,53635,22383,54338,22383,492,306,186,8,17,5,3
46588,49687,53,12525,53,194,99,95,2,31,1,1
46589,56380,53,55619,53,170,87,83,2,31,1,1
46590,56693,53,6310,53,756,95,661,2,31,1,1
46591,65516,53,45586,53,749,94,655,2,31,1,1
46592,64053,53,7121,53,186,95,91,2,31,1,1
46593,64257,53,54453,53,168,86,82,2,31,1,1
46594,65171,53,47372,53,760,97,663,2,31,1,1
46595,55680,53,52561,53,749,94,655,2,31,1,1
46596,55027,53,18379,53,168,86,82,2,31,1,1
46597,27005,30008,53621,30008,890,126,764,2,31,1,1
46598,49157,53,58041,53,184,94,90,2,31,1,1
46599,33949,80,17456,80,1360,540,820,20,191,10,10
46600,56511,53,19992,53,200,102,98,2,31,1,1
46601,41284,443,45151,443,7252,2147,5105,18,136,8,10
46602,57256,53,42871,53,771,101,670,2,31,1,1
46603,57470,59216,60669,59216,594,594,0,10,1200,10,0
46604,55994,53,19158,53,182,93,89,2,31,1,1
46605,41694,443,48276,443,16107,3200,12907,35,362,17,18
46606,64983,53,38581,53,777,87,690,2,31,1,1
46607,55179,53,42268,53,172,88,84,2,31,1,1
46608,55902,53,9062,53,178,91,87,2,31,1,1
46609,49936,53,59450,53,216,110,106,2,31,1,1
46610,57106,53,8204,53,760,97,663,2,31,1,1
46611,64825,53,5593,53,728,96,632,2,31,1,1
46612,55031,443,25745,443,3625,1378,2247,14,135,7,7
46613,52170,443,36243,443,7228,1589,5639,22,362,11,11
46614,6881,6881,43192,6881,150,150,0,1,1200,1,0
46615,60143,445,0,0,70,70,0,1,0,1,0
46616,8239,37965,0,0,146,146,0,1,0,1,0
46617,52323,44847,0,0,146,146,0,1,0,1,0
46618,1081,59353,0,0,146,146,0,1,0,1,0
46619,60142,445,0,0,70,70,0,1,0,1,0
46620,60138,445,0,0,70,70,0,1,0,1,0
46621,60135,445,0,0,70,70,0,1,0,1,0
46622,21674,28189,0,0,60,60,0,1,0,1,0
46623,29263,50939,0,0,148,148,0,1,0,1,0
46624,51446,57587,0,0,100,100,0,1,0,1,0
46625,1081,21162,0,0,146,146,0,1,0,1,0
46626,443,64347,0,0,131,131,0,1,0,1,0
46627,53652,1900,0,0,139,139,0,1,0,1,0
46628,23383,64147,0,0,62,62,0,1,0,1,0
46629,7109,64147,0,0,66,66,0,1,0,1,0
46630,5179,50265,0,0,62,62,0,1,0,1,0
46631,1081,43109,0,0,146,146,0,1,0,1,0
46632,1081,14984,0,0,146,146,0,1,0,1,0
46633,56550,53,61639,53,183,94,89,2,30,1,1
46634,44246,80,45320,80,5584,2543,3041,20,27,11,9
46635,47037,1,0,0,62,62,0,1,0,1,0
46636,13795,2323,0,0,60,60,0,1,0,1,0
46637,18623,1,0,0,66,66,0,1,0,1,0
46638,51197,57470,0,0,62,62,0,1,0,1,0
46639,29989,26467,0,0,66,66,0,1,0,1,0
46640,55183,445,0,0,70,70,0,1,0,1,0
46641,43260,41615,0,0,145,145,0,1,0,1,0
46642,60126,445,0,0,70,70,0,1,0,1,0
46643,60123,445,0,0,70,70,0,1,0,1,0
46644,60119,445,0,0,70,70,0,1,0,1,0
46645,32707,11392,0,0,62,62,0,1,0,1,0
46646,51446,3033,0,0,100,100,0,1,0,1,0
46647,31035,23,0,0,60,60,0,1,0,1,0
46648,51446,3855,0,0,100,100,0,1,0,1,0
46649,51446,17500,0,0,100,100,0,1,0,1,0
46650,55180,445,0,0,70,70,0,1,0,1,0
46651,51742,30317,0,0,66,66,0,1,0,1,0
46652,39920,22114,0,0,146,146,0,1,0,1,0
46653,27005,27018,61508,27018,252,252,0,3,2,3,0
46654,4772,37965,0,0,66,66,0,1,0,1,0
46655,62888,23,0,0,60,60,0,1,0,1,0
46656,39548,8696,0,0,60,60,0,1,0,1,0
46657,55176,445,0,0,70,70,0,1,0,1,0
46658,22971,50584,0,0,62,62,0,1,0,1,0
46659,55504,445,0,0,66,66,0,1,0,1,0
46660,55992,53,33542,53,194,94,100,2,30,1,1
46661,50091,53,37575,53,183,94,89,2,30,1,1
46662,56000,53,49191,53,177,94,83,2,30,1,1
46663,38111,443,61640,443,566856,28278,538578,737,37,351,386
46664,39416,443,22181,443,621104,12188,608916,575,78,149,426
46665,50076,443,58457,443,9920,5013,4907,41,15,25,16
46666,56353,53,32385,53,216,102,114,2,29,1,1
46667,65439,53,5065,53,198,94,104,2,30,1,1
46668,65414,53,56360,53,216,102,114,2,30,1,1
46669,64541,53,6698,53,363,94,269,2,30,1,1
46670,56380,53,5120,53,177,94,83,2,30,1,1
46671,39422,443,26393,443,557795,16003,541792,528,76,139,389
46672,57429,80,55023,80,1056,682,374,10,15,6,4
46673,51765,80,50481,80,5569,3270,2299,21,74,13,8
46674,51691,80,8687,80,19384,2720,16664,36,174,18,18
46675,51763,80,41535,80,3830,2255,1575,16,74,10,6
46676,51764,80,40729,80,5605,3306,2299,21,74,13,8
46677,55627,26192,18323,26192,70,70,0,1,5,1,0
46678,50929,443,35060,443,9571,2966,6605,52,35,29,23
46679,57422,80,40149,80,10454,4931,5523,21,30,10,11
46680,57117,53,45575,53,366,102,264,4,46,2,2
46681,55837,443,59967,443,39628,2279,37349,63,255,23,40
46682,55475,53,28600,53,757,102,655,2,29,1,1
46683,59368,53,55998,53,241,118,123,2,29,1,1
46684,56550,53,48765,53,183,94,89,2,29,1,1
46685,64658,53,60447,53,195,102,93,2,29,1,1
46686,56369,53,50667,53,168,86,82,2,29,1,1
46687,65439,53,2036,53,168,86,82,2,29,1,1
46688,56667,53,55956,53,199,102,97,2,29,1,1
46689,55235,53,18331,53,178,94,84,2,29,1,1
46690,64332,53,12232,53,195,102,93,2,30,1,1
46691,49646,53,5301,53,199,102,97,2,30,1,1
46692,49687,53,16473,53,197,102,95,2,29,1,1
46693,57258,53,4190,53,177,94,83,2,29,1,1
46694,55027,53,13864,53,168,86,82,2,30,1,1
46695,55933,53,32005,53,177,94,83,2,30,1,1
46696,56612,53,46131,53,184,94,90,2,29,1,1
46697,50289,53,8502,53,189,102,87,2,30,1,1
46698,57258,53,16585,53,177,94,83,2,30,1,1
46699,60638,53,31002,53,337,86,251,2,29,1,1
46700,22013,53,22013,53,198,90,108,2,30,1,1
46701,64792,53,34890,53,338,110,228,2,30,1,1
46702,56626,443,50553,443,8240,3521,4719,25,18,15,10
46703,49211,80,44277,80,8971,1094,7877,17,15,7,10
46704,36172,443,19620,443,6295,1324,4971,22,983,10,12
46705,54348,443,26587,443,12594,5098,7496,32,35,17,15
46706,40273,53,38821,53,164,78,86,2,30,1,1
46707,49837,53,42825,53,214,110,104,2,30,1,1
46708,56242,53,30808,53,231,86,145,2,30,1,1
46709,64882,53,8935,53,246,94,152,2,30,1,1
46710,57135,53,40947,53,443,182,261,6,30,3,3
46711,50819,443,23164,443,1663508,63528,1599980,1853,251,692,1161
46712,60420,2924,28301,2924,320,140,180,6,7,3,3
46713,53633,443,6086,443,8473,1099,7374,20,18,9,11
46714,50200,53,14002,53,758,102,656,2,30,1,1
46715,55295,53,52273,53,779,86,693,2,30,1,1
46716,10001,443,23014,443,8370,2798,5572,31,315,15,16
46717,55439,53,44673,53,177,94,83,2,30,1,1
46718,56825,16648,32548,16648,164,70,94,2,7,1,1
46719,64620,53,50964,53,166,86,80,2,30,1,1
46720,45157,7,33504,7,138,78,60,2,5,1,1
46721,56628,443,13354,443,8240,3521,4719,25,18,15,10
46722,56000,53,42944,53,177,94,83,2,30,1,1
46723,54989,80,38298,80,8159037,271621,7887416,9644,214,4424,5220
46724,56553,53,56242,53,199,102,97,2,30,1,1
46725,46872,80,56165,80,29218,27458,1760,36,22,24,12
46726,51510,7000,51510,7000,3490,1923,1567,14,16,7,7
46727,55675,53,10351,53,195,102,93,2,30,1,1
46728,49329,53,8761,53,258,102,156,2,30,1,1
46729,49646,53,18495,53,199,102,97,2,30,1,1
46730,49837,53,47456,53,214,110,104,2,30,1,1
46731,64591,53,55985,53,179,86,93,2,30,1,1
46732,53868,53,38630,53,164,78,86,2,30,1,1
46733,44409,53,42084,53,199,94,105,2,30,1,1
46734,43770,53,60550,53,199,94,105,2,30,1,1
46735,49889,53,4477,53,338,110,228,2,30,1,1
46736,47483,53,19312,53,164,78,86,2,30,1,1
46737,38732,443,56897,443,9217,1548,7669,25,50,13,12
46738,33846,443,41735,443,7760,2646,5114,24,16,13,11
46739,61455,443,28409,443,8947,1130,7817,28,124,13,15
46740,60432,80,60432,80,19915,764,19151,23,16,7,16
46741,10090,443,45576,443,20612,7872,12740,57,643,21,36
46742,55933,53,58575,53,177,94,83,2,30,1,1
46743,50456,53,42563,53,754,94,660,2,30,1,1
46744,64332,53,56016,53,195,102,93,2,30,1,1
46745,56928,53,57142,53,178,94,84,2,30,1,1
46746,56421,53,5669,53,350,94,256,2,30,1,1
46747,49708,53,14475,53,185,102,83,2,30,1,1
46748,56668,53,12015,53,199,94,105,2,30,1,1
46749,56989,53,25786,53,168,94,74,2,30,1,1
46750,51806,443,51806,443,1466,856,610,13,27,6,7
46751,38733,443,28389,443,9058,1542,7516,25,50,13,12
46752,63964,53,22176,53,323,85,238,4,34,2,2
46753,55237,53,6417,53,259,87,172,4,56,2,2
46754,56553,53,8293,53,199,102,97,2,30,1,1
46755,49936,53,17708,53,168,94,74,2,30,1,1
46756,57288,53,1558,53,354,94,260,2,30,1,1
46757,56950,53,2496,53,183,94,89,2,30,1,1
46758,50236,443,16316,443,4954,1768,3186,18,143,9,9
46759,55237,53,24870,53,259,87,172,4,56,2,2
46760,63832,6969,23907,6969,66,66,0,2,8,2,0
46761,37991,49152,57920,49152,156,156,0,3,7,3,0
46762,51762,80,41389,80,3945,2315,1630,18,74,11,7
46763,56826,31310,8679,31310,70,70,0,1,5,1,0
46764,44545,443,4712,443,546,280,266,9,26,5,4
46765,51809,443,51809,443,1466,856,610,13,27,6,7
46766,57368,443,57368,443,4401,1494,2907,19,28,11,8
46767,51844,12471,17127,12471,70,70,0,2,8,2,0
46768,50331,80,36568,80,1677,862,815,10,15,5,5
46769,37992,49152,18454,49152,156,156,0,3,7,3,0
46770,51766,80,8995,80,2190,1284,906,13,74,8,5
46771,55626,63805,23725,63805,70,70,0,1,5,1,0
46772,51826,58925,47237,58925,70,70,0,1,4,1,0
46773,49891,80,30734,80,1694,666,1028,10,75,6,4
46774,56602,53,56281,53,423,102,321,4,38,2,2
46775,63822,14382,38807,14382,70,70,0,1,4,1,0
46776,53284,80,44514,80,6995,783,6212,14,317,7,7
46777,49212,80,10274,80,912,410,502,10,15,5,5
46778,50330,80,61342,80,736,670,66,6,15,5,1
46779,64791,53,16107,53,184,94,90,2,29,1,1
46780,27450,443,32260,443,10099,1635,8464,31,83,14,17
46781,61453,443,29702,443,8052,1307,6745,27,125,16,11
46782,65251,53,12989,53,199,102,97,2,29,1,1
46783,56986,53,31308,53,177,94,83,2,29,1,1
46784,49269,53,5251,53,198,110,88,2,29,1,1
46785,55620,53,11702,53,177,94,83,2,29,1,1
46786,57089,53,22992,53,239,94,145,2,29,1,1
46787,56633,53,19316,53,197,102,95,2,30,1,1
46788,56667,53,35653,53,199,102,97,2,29,1,1
46789,56996,53,30047,53,177,94,83,2,29,1,1
46790,57283,53,20762,53,185,102,83,2,29,1,1
46791,55482,53,39470,53,199,102,97,2,30,1,1
46792,56996,53,54322,53,177,94,83,2,30,1,1
46793,56574,53,4025,53,198,94,104,2,30,1,1
46794,57067,53,26997,53,178,94,84,2,30,1,1
46795,49845,53,33096,53,194,102,92,2,30,1,1
46796,64168,53,53054,53,306,94,212,2,30,1,1
46797,65359,53,4725,53,443,182,261,6,30,3,3
46798,56369,53,3400,53,168,86,82,2,30,1,1
46799,65067,53,58003,53,214,110,104,2,30,1,1
46800,16403,16385,35308,16385,308,128,180,6,30,3,3
46801,65067,53,2919,53,214,110,104,2,30,1,1
46802,65328,53,23014,53,179,94,85,2,30,1,1
46803,50827,443,7368,443,388366,15919,372447,435,219,158,277
46804,56821,53,11694,53,235,94,141,2,30,1,1
46805,49913,53,6290,53,216,110,106,2,30,1,1
46806,58087,123,31892,123,184,94,90,2,30,1,1
46807,55877,53,52511,53,166,86,80,2,30,1,1
46808,50017,53,60474,53,195,102,93,2,30,1,1
46809,56067,53,20488,53,189,102,87,2,30,1,1
46810,64804,53,31085,53,182,102,80,2,30,1,1
46811,56612,53,50823,53,184,94,90,2,30,1,1
46812,64257,53,1307,53,168,86,82,2,30,1,1
46813,64257,53,50451,53,168,86,82,2,31,1,1
46814,57394,53,17167,53,193,102,91,2,31,1,1
46815,65007,53,7048,53,165,86,79,2,30,1,1
46816,49744,53,33458,53,193,102,91,2,30,1,1
46817,49157,53,4191,53,184,94,90,2,30,1,1
46818,56155,53,9599,53,199,102,97,2,30,1,1
46819,49206,53,44411,53,179,94,85,2,30,1,1
46820,60613,443,54092,443,154465,11473,142992,244,212,101,143
46821,56928,53,51278,53,178,94,84,2,30,1,1
46822,53532,53,52838,53,329,102,227,2,30,1,1
46823,56196,53,38043,53,214,110,104,2,30,1,1
46824,49964,53,63838,53,380,110,270,2,31,1,1
46825,64959,53,63198,53,245,102,143,2,31,1,1
46826,55199,53,53506,53,214,110,104,2,31,1,1
46827,49936,53,6002,53,216,110,106,2,31,1,1
46828,56548,53,54465,53,199,102,97,2,31,1,1
46829,56553,53,46585,53,199,102,97,2,30,1,1
46830,56827,18318,42346,18318,70,70,0,1,5,1,0
46831,47147,443,62760,443,70,70,0,1,5,1,0
46832,63940,3389,63940,3389,3347,1458,1889,15,17,8,7
46833,50072,443,58353,443,827,484,343,8,15,5,3
46834,37248,80,37248,80,7850,1208,6642,16,20,8,8
46835,49882,53,52287,53,441,104,337,4,48,2,2
46836,50091,53,60727,53,183,94,89,2,30,1,1
46837,49845,53,47352,53,194,102,92,2,30,1,1
46838,56219,53,21871,53,211,102,109,2,30,1,1
46839,57018,53,10253,53,177,94,83,2,30,1,1
46840,55983,53,48141,53,255,102,153,2,30,1,1
46841,56041,53,6902,53,185,102,83,2,30,1,1
46842,61456,443,24877,443,9577,1475,8102,30,124,14,16
46843,50818,80,50818,80,514,246,268,9,42,5,4
46844,53634,443,2193,443,2005,1100,905,16,17,9,7
46845,47982,443,20773,443,83558,8567,74991,180,171,92,88
46846,63939,3389,63939,3389,4134,2109,2025,18,17,9,9
46847,51997,53,57972,53,164,78,86,2,30,1,1
46848,56308,53,13825,53,184,94,90,2,30,1,1
46849,55439,53,11568,53,177,94,83,2,30,1,1
46850,64592,53,31524,53,209,110,99,2,30,1,1
46851,56155,53,9723,53,199,102,97,2,30,1,1
46852,45394,53,64814,53,199,94,105,2,30,1,1
46853,55497,53,48989,53,168,86,82,2,30,1,1
46854,65419,53,59811,53,200,102,98,2,30,1,1
46855,49744,53,14742,53,816,102,714,2,30,1,1
46856,49687,53,13204,53,197,102,95,2,31,1,1
46857,60612,443,17628,443,117190,11380,105810,171,212,67,104
46858,56812,49600,3950,49600,3060,1569,1491,12,16,7,5
46859,61454,443,53913,443,8673,1722,6951,30,125,18,12
46860,35372,443,41929,443,269750,10062,259688,285,152,92,193
46861,51808,443,51808,443,1466,856,610,13,27,6,7
46862,57030,53,12910,53,283,101,182,4,38,2,2
46863,56644,443,53305,443,3079,1895,1184,18,16,10,8
46864,49636,53,5352,53,790,110,680,2,30,1,1
46865,49663,53,41171,53,184,102,82,2,30,1,1
46866,50829,443,2487,443,1445207,43930,1401277,1562,219,556,1006
46867,56190,53,16437,53,196,94,102,2,30,1,1
46868,49603,53,17814,53,766,102,664,2,30,1,1
46869,64620,53,58577,53,166,86,80,2,30,1,1
46870,57319,53,46855,53,353,94,259,2,30,1,1
46871,56799,53,3973,53,353,94,259,2,30,1,1
46872,56633,53,60296,53,197,102,95,2,30,1,1
46873,56380,53,35466,53,177,94,83,2,30,1,1
46874,65007,53,25899,53,165,86,79,2,30,1,1
46875,16403,16386,26193,16386,308,128,180,6,30,3,3
46876,47463,53,25330,53,167,78,89,2,30,1,1
46877,51150,53,51368,53,167,78,89,2,30,1,1
46878,55336,53,18020,53,308,94,214,2,30,1,1
46879,49708,53,2580,53,177,94,83,2,30,1,1
46880,55027,53,18719,53,168,86,82,2,30,1,1
46881,49837,53,16345,53,214,110,104,2,30,1,1
46882,50082,53,51299,53,199,94,105,2,30,1,1
46883,58852,443,26155,443,3723,1793,1930,21,69,10,11
46884,57617,53,32772,53,164,78,86,2,30,1,1
46885,45103,80,17939,80,1748,716,1032,19,409,6,13
46886,49513,53,36009,53,200,102,98,2,30,1,1
46887,27005,32036,64099,32036,876,126,750,2,31,1,1
46888,27005,33086,32717,33086,877,126,751,2,31,1,1
46889,6881,32056,50769,32056,509,150,359,2,1199,1,1
46890,56989,53,15263,53,152,78,74,2,30,1,1
46891,39094,443,9909,443,350650,19028,331622,494,83,251,243
46892,57018,53,57758,53,177,94,83,2,30,1,1
46893,49714,53,21823,53,767,102,665,2,30,1,1
46894,56227,53,19451,53,194,102,92,2,30,1,1
46895,55534,53,6633,53,86,86,0,1,30,1,0
46896,56950,53,53864,53,183,94,89,2,30,1,1
46897,50108,53,30433,53,969,86,883,2,30,1,1
46898,55675,53,24009,53,195,102,93,2,30,1,1
46899,64804,53,26105,53,182,102,80,2,30,1,1
46900,56512,53,17535,53,166,86,80,2,30,1,1
46901,65143,53,18193,53,184,94,90,2,30,1,1
46902,56728,53,16534,53,166,86,80,2,30,1,1
46903,64257,53,2954,53,168,86,82,2,30,1,1
46904,49316,53,24928,53,184,94,90,2,31,1,1
46905,57157,53,38785,53,173,94,79,2,30,1,1
46906,50213,53,31929,53,774,102,672,2,30,1,1
46907,56266,53,40991,53,166,86,80,2,31,1,1
46908,56183,53,29912,53,179,94,85,2,31,1,1
46909,55902,53,8610,53,181,94,87,2,31,1,1
46910,49825,53,30889,53,336,110,226,2,31,1,1
46911,56041,53,39211,53,185,102,83,2,31,1,1
46912,27005,32038,32589,32038,868,126,742,2,31,1,1
46913,57018,53,23896,53,177,94,83,2,31,1,1
46914,65143,53,4098,53,184,94,90,2,31,1,1
46915,27005,50019,8990,50019,877,126,751,2,31,1,1
46916,60813,443,34578,443,658,140,518,10,3632,3,7
46917,60027,443,59128,443,25215,5119,20096,55,144,26,29
46918,65122,443,26133,443,5500,1277,4223,17,180,8,9
46919,56710,53,40167,53,195,102,93,2,31,1,1
46920,65235,53,33492,53,209,110,99,2,31,1,1
46921,64332,53,56454,53,195,102,93,2,31,1,1
46922,56728,53,8699,53,166,86,80,2,31,1,1
46923,55325,53,11184,53,210,110,100,2,31,1,1
46924,43560,443,3098,443,8964,2125,6839,34,120,18,16
46925,57470,49294,38558,49294,132,132,0,3,1199,3,0
46926,57470,44046,49985,44046,166,166,0,1,1199,1,0
46927,57470,44172,25895,44172,353,166,187,2,1199,1,1
46928,52936,5228,12223,5228,9201,2130,7071,41,5528,21,20
46929,27005,33084,40774,33084,906,126,780,2,31,1,1
46930,55237,53,51535,53,259,87,172,4,56,2,2
46931,56633,53,46953,53,342,99,243,4,32,2,2
46932,63814,12906,14738,12906,70,70,0,1,5,1,0
46933,56308,53,53406,53,700,282,418,8,81,4,4
46934,27005,32056,54567,32056,886,126,760,2,31,1,1
46935,63813,53455,10491,53455,70,70,0,1,5,1,0
46936,49225,443,49225,443,854266,56622,797644,969,98,420,549
46937,54706,443,10559,443,5612,1051,4561,20,16,11,9
46938,56928,53,11160,53,178,94,84,2,31,1,1
46939,55431,53,1200,53,196,102,94,2,31,1,1
46940,55179,53,2667,53,178,94,84,2,31,1,1
46941,64381,53,50743,53,198,102,96,2,31,1,1
46942,60292,8630,2625,8630,324,250,74,5,3605,4,1
46943,48941,443,29294,443,7437,2128,5309,22,33,13,9
46944,53654,8100,3351,8100,70,70,0,2,8,2,0
46945,53641,16605,52302,16605,70,70,0,1,5,1,0
46946,50017,53,24863,53,300,97,203,4,36,2,2
46947,56391,443,8649,443,13706,5958,7748,78,202,42,36
46948,55174,445,0,0,70,70,0,1,0,1,0
46949,60117,445,0,0,70,70,0,1,0,1,0
46950,60115,445,0,0,70,70,0,1,0,1,0
46951,10216,11392,0,0,66,66,0,1,0,1,0
46952,41447,64147,0,0,62,62,0,1,0,1,0
46953,55172,445,0,0,70,70,0,1,0,1,0
46954,24838,39828,0,0,60,60,0,1,0,1,0
46955,14309,56205,0,0,146,146,0,1,0,1,0
46956,55502,445,0,0,66,66,0,1,0,1,0
46957,55498,445,0,0,66,66,0,1,0,1,0
46958,60106,445,0,0,70,70,0,1,0,1,0
46959,56578,64147,0,0,66,66,0,1,0,1,0
46960,53156,35993,0,0,66,66,0,1,0,1,0
46961,52563,17235,0,0,74,74,0,1,0,1,0
46962,60102,445,0,0,70,70,0,1,0,1,0
46963,60099,445,0,0,70,70,0,1,0,1,0
46964,60096,445,0,0,70,70,0,1,0,1,0
46965,55165,445,0,0,70,70,0,1,0,1,0
46966,55497,445,0,0,66,66,0,1,0,1,0
46967,53020,61903,0,0,159,159,0,1,0,1,0
46968,55163,445,0,0,70,70,0,1,0,1,0
46969,3436,46783,0,0,62,62,0,1,0,1,0
46970,64240,50584,0,0,62,62,0,1,0,1,0
46971,55162,445,0,0,70,70,0,1,0,1,0
46972,55161,445,0,0,70,70,0,1,0,1,0
46973,60093,445,0,0,70,70,0,1,0,1,0
46974,55160,445,0,0,70,70,0,1,0,1,0
46975,55158,445,0,0,70,70,0,1,0,1,0
46976,55156,445,0,0,70,70,0,1,0,1,0
46977,19632,37965,0,0,62,62,0,1,0,1,0
46978,1035,26467,0,0,62,62,0,1,0,1,0
46979,60084,445,0,0,70,70,0,1,0,1,0
46980,60086,445,0,0,70,70,0,1,0,1,0
46981,51424,30188,0,0,62,62,0,1,0,1,0
46982,55489,445,0,0,66,66,0,1,0,1,0
46983,55485,445,0,0,66,66,0,1,0,1,0
46984,55484,445,0,0,66,66,0,1,0,1,0
46985,55481,445,0,0,66,66,0,1,0,1,0
46986,542,46783,0,0,62,62,0,1,0,1,0
46987,63814,81,0,0,60,60,0,1,0,1,0
46988,6881,6881,0,0,146,146,0,1,0,1,0
46989,55478,445,0,0,66,66,0,1,0,1,0
46990,38338,443,60739,443,499,425,74,4,0,3,1
46991,53853,443,38658,443,499,425,74,4,0,3,1
46992,53852,443,26865,443,499,425,74,4,0,3,1
46993,38337,443,4269,443,499,425,74,4,1,3,1
46994,55479,445,0,0,66,66,0,1,0,1,0
46995,55476,445,0,0,66,66,0,1,0,1,0
46996,55142,445,0,0,70,70,0,1,0,1,0
46997,55141,445,0,0,70,70,0,1,0,1,0
46998,55137,445,0,0,70,70,0,1,0,1,0
46999,2440,37807,0,0,66,66,0,1,0,1,0
47000,64940,26467,0,0,62,62,0,1,0,1,0
47001,55132,445,0,0,70,70,0,1,0,1,0
47002,55131,445,0,0,70,70,0,1,0,1,0
47003,58687,12883,0,0,143,143,0,1,0,1,0
47004,60079,445,0,0,70,70,0,1,0,1,0
47005,60077,445,0,0,70,70,0,1,0,1,0
47006,60076,445,0,0,70,70,0,1,0,1,0
47007,21844,50584,0,0,146,146,0,1,0,1,0
47008,55473,445,0,0,66,66,0,1,0,1,0
47009,60075,445,0,0,70,70,0,1,0,1,0
47010,32424,50584,0,0,146,146,0,1,0,1,0
47011,58286,37965,0,0,66,66,0,1,0,1,0
47012,55470,445,0,0,66,66,0,1,0,1,0
47013,52699,26467,0,0,62,62,0,1,0,1,0
47014,55469,445,0,0,66,66,0,1,0,1,0
47015,43916,21,0,0,60,60,0,1,0,1,0
47016,55466,445,0,0,66,66,0,1,0,1,0
47017,55120,445,0,0,70,70,0,1,0,1,0
47018,45964,5333,0,0,60,60,0,1,0,1,0
47019,26851,59858,0,0,146,146,0,1,0,1,0
47020,57853,64147,0,0,62,62,0,1,0,1,0
47021,23531,31573,0,0,146,146,0,1,0,1,0
47022,55968,56205,0,0,66,66,0,1,0,1,0
47023,60074,445,0,0,70,70,0,1,0,1,0
47024,60064,445,0,0,70,70,0,1,0,1,0
47025,60059,445,0,0,70,70,0,1,0,1,0
47026,443,10010,0,0,60,60,0,1,0,1,0
47027,44098,1433,0,0,60,60,0,1,0,1,0
47028,55116,445,0,0,70,70,0,1,0,1,0
47029,51172,44847,0,0,66,66,0,1,0,1,0
47030,55454,445,0,0,66,66,0,1,0,1,0
47031,47814,51505,0,0,66,66,0,1,0,1,0
47032,55106,445,0,0,70,70,0,1,0,1,0
47033,55107,445,0,0,70,70,0,1,0,1,0
47034,55102,445,0,0,70,70,0,1,0,1,0
47035,55101,445,0,0,70,70,0,1,0,1,0
47036,59459,37807,0,0,66,66,0,1,0,1,0
47037,55099,445,0,0,70,70,0,1,0,1,0
47038,6666,2222,0,0,60,60,0,1,0,1,0
47039,55447,445,0,0,66,66,0,1,0,1,0
47040,60048,445,0,0,70,70,0,1,0,1,0
47041,17027,1,0,0,62,62,0,1,0,1,0
47042,0,0,0,0,320,320,0,5,0,5,0
47043,0,0,0,0,70,70,0,1,0,1,0
47044,57131,7774,0,0,145,145,0,1,0,1,0
47045,50624,26467,0,0,66,66,0,1,0,1,0
47046,55445,445,0,0,66,66,0,1,0,1,0
47047,60133,1,0,0,62,62,0,1,0,1,0
47048,55093,445,0,0,70,70,0,1,0,1,0
47049,63956,44512,0,0,145,145,0,1,0,1,0
47050,55437,445,0,0,66,66,0,1,0,1,0
47051,56966,35440,0,0,62,62,0,1,0,1,0
47052,55427,445,0,0,66,66,0,1,0,1,0
47053,57943,1433,0,0,60,60,0,1,0,1,0
47054,55086,445,0,0,70,70,0,1,0,1,0
47055,55084,445,0,0,70,70,0,1,0,1,0
47056,1025,35447,0,0,62,62,0,1,0,1,0
47057,19875,30170,0,0,145,145,0,1,0,1,0
47058,52618,23718,0,0,146,146,0,1,0,1,0
47059,42034,28189,0,0,145,145,0,1,0,1,0
47060,55079,445,0,0,70,70,0,1,0,1,0
47061,26048,21,0,0,60,60,0,1,0,1,0
47062,60038,445,0,0,70,70,0,1,0,1,0
47063,60036,445,0,0,70,70,0,1,0,1,0
47064,60035,445,0,0,70,70,0,1,0,1,0
47065,55078,445,0,0,70,70,0,1,0,1,0
47066,55422,445,0,0,66,66,0,1,0,1,0
47067,55419,445,0,0,66,66,0,1,0,1,0
47068,55417,445,0,0,66,66,0,1,0,1,0
47069,55416,445,0,0,66,66,0,1,0,1,0
47070,55420,445,0,0,66,66,0,1,0,1,0
47071,55421,445,0,0,66,66,0,1,0,1,0
47072,55418,445,0,0,66,66,0,1,0,1,0
47073,55415,445,0,0,66,66,0,1,0,1,0
47074,50419,26467,0,0,62,62,0,1,0,1,0
47075,59833,48817,0,0,107,107,0,1,0,1,0
47076,62649,48817,0,0,148,148,0,1,0,1,0
47077,20894,51505,0,0,62,62,0,1,0,1,0
47078,45941,23386,0,0,60,60,0,1,0,1,0
47079,1663,30188,0,0,66,66,0,1,0,1,0
47080,51823,15843,53132,15843,66,66,0,2,9,2,0
47081,51822,12637,54729,12637,136,136,0,3,14,3,0
47082,50409,53,47032,53,731,85,646,2,30,1,1
47083,55771,80,55771,80,3538,701,2837,11,20,6,5
47084,55002,80,41422,80,10872190,337459,10534731,12500,208,5532,6968
47085,59985,443,16838,443,25649,1485,24164,36,144,14,22
47086,34628,443,42980,443,6392,1025,5367,18,27,9,9
47087,45119,15000,61352,15000,130,70,60,2,5,1,1
47088,53640,28937,28393,28937,70,70,0,1,5,1,0
47089,43972,80,64832,80,1894,1520,374,15,15,9,6
47090,49420,443,13090,443,5241,1194,4047,19,40,9,10
47091,48272,15000,32471,15000,130,70,60,2,5,1,1
47092,61412,443,58094,443,4934,771,4163,18,28,8,10
47093,34625,443,10799,443,6393,1025,5368,18,27,9,9
47094,60039,80,53912,80,3431,2292,1139,17,142,10,7
47095,60053,443,33088,443,3190,1599,1591,17,142,9,8
47096,60023,443,8218,443,9660,4678,4982,30,144,15,15
47097,56710,53,43417,53,190,97,93,2,31,1,1
47098,65143,53,7897,53,184,94,90,2,30,1,1
47099,56811,44008,31634,44008,3034,1547,1487,12,16,7,5
47100,53126,47035,16520,47035,70,70,0,2,8,2,0
47101,61413,443,10754,443,4933,771,4162,18,28,8,10
47102,49921,53,38148,53,212,108,104,2,31,1,1
47103,10077,443,21308,443,10940,4625,6315,36,347,19,17
47104,57394,53,16872,53,186,95,91,2,31,1,1
47105,54962,53,32571,53,188,96,92,2,30,1,1
47106,50311,80,32414,80,366,180,186,7,57,4,3
47107,55656,53,20503,53,760,96,664,2,30,1,1
47108,64381,53,47350,53,196,100,96,2,30,1,1
47109,51615,15000,33004,15000,130,70,60,2,5,1,1
47110,58172,443,58172,443,4526,1619,2907,19,26,11,8
47111,47165,15000,50664,15000,130,70,60,2,5,1,1
47112,61423,443,8022,443,1113,589,524,12,28,6,6
47113,60051,80,25182,80,1327,839,488,10,142,6,4
47114,60418,39537,10622,39537,70,70,0,1,5,1,0
47115,50403,8080,50403,8080,2203,575,1628,10,15,6,4
47116,53835,15000,42611,15000,130,70,60,2,5,1,1
47117,52544,443,52544,443,4487,1580,2907,19,26,11,8
47118,59983,80,41468,80,1745,779,966,12,144,7,5
47119,55484,53,28906,53,711,87,624,2,30,1,1
47120,59997,443,62198,443,3063,1395,1668,16,144,8,8
47121,60022,443,54871,443,4962,2551,2411,19,144,10,9
47122,56548,53,6954,53,198,101,97,2,31,1,1
47123,56728,53,35265,53,164,84,80,2,31,1,1
47124,56183,53,46991,53,174,89,85,2,31,1,1
47125,61431,443,2753,443,1401,940,461,11,28,7,4
47126,47088,15000,21651,15000,138,78,60,2,6,1,1
47127,41543,443,50786,443,78,78,0,1,5,1,0
47128,61424,443,36108,443,1119,589,530,12,28,6,6
47129,60049,443,36353,443,23967,5983,17984,40,142,17,23
47130,59999,443,56048,443,3047,1277,1770,16,144,8,8
47131,52028,53,0,0,354,81,273,2,30,1,1
47132,55580,53,22194,53,788,108,680,2,30,1,1
47133,60012,443,29771,443,6438,2599,3839,21,144,10,11
47134,57005,53,24332,53,762,98,664,2,30,1,1
47135,56262,53,49362,53,701,88,613,2,30,1,1
47136,60000,443,1189,443,34450,1943,32507,47,144,16,31
47137,49995,53,4642,53,99,99,0,1,30,1,0
47138,36453,443,24873,443,7298,2661,4637,21,18,11,10
47139,50310,80,55858,80,7979,802,7177,17,57,8,9
47140,52606,53,0,0,223,91,132,2,30,1,1
47141,55431,53,28791,53,192,98,94,2,30,1,1
47142,56928,53,33620,53,172,88,84,2,30,1,1
47143,57018,53,1950,53,170,87,83,2,30,1,1
47144,64790,53,30667,53,182,93,89,2,30,1,1
47145,57281,53,42469,53,172,88,84,2,30,1,1
47146,55534,53,23781,53,168,86,82,2,30,1,1
47147,57246,53,53043,53,182,93,89,2,31,1,1
47148,56767,53,17852,53,170,87,83,2,31,1,1
47149,59093,53,0,0,215,77,138,2,31,1,1
47150,65304,53,2754,53,202,103,99,2,31,1,1
47151,51909,443,57663,443,8801,2032,6769,28,361,14,14
47152,56562,53,8442,53,726,85,641,2,30,1,1
47153,56914,53,41623,53,731,85,646,2,30,1,1
47154,55666,53,48851,53,728,96,632,2,30,1,1
47155,64582,53,25024,53,202,103,99,2,30,1,1
47156,55994,53,14780,53,182,93,89,2,30,1,1
47157,57263,53,62100,53,166,85,81,2,30,1,1
47158,55205,53,36429,53,166,85,81,2,31,1,1
47159,49547,53,1649,53,186,95,91,2,31,1,1
47160,49242,53,7199,53,166,85,81,2,31,1,1
47161,28176,34021,0,0,66,66,0,1,90,1,0
47162,57470,6881,10120,6881,163,163,0,1,1200,1,0
47163,60814,443,39150,443,740,222,518,11,3631,4,7
47164,55199,53,58104,53,212,108,104,2,30,1,1
47165,59352,53,59352,53,283,114,169,2,31,1,1
47166,49707,53,0,0,82,82,0,1,31,1,0
47167,44967,53,51774,53,198,93,105,2,31,1,1
47168,49806,53,49806,53,229,89,140,2,31,1,1
47169,38910,53,21140,53,198,93,105,2,31,1,1
47170,64016,53,9177,53,93,93,0,1,31,1,0
47171,27005,30007,41112,30007,890,126,764,2,31,1,1
47172,55440,53,49182,53,752,93,659,2,31,1,1
47173,64074,53,3754,53,202,103,99,2,31,1,1
47174,64678,53,7690,53,758,93,665,2,31,1,1
47175,56729,53,56729,53,229,89,140,2,31,1,1
47176,50201,53,18513,53,751,95,656,2,31,1,1
47177,55937,53,44427,53,758,93,665,2,31,1,1
47178,55489,53,54406,53,186,95,91,2,31,1,1
47179,64761,53,64761,53,220,100,120,2,31,1,1
47180,55271,53,61756,53,751,95,656,2,31,1,1
47181,47787,53,24914,53,198,93,105,2,31,1,1
47182,56396,53,44233,53,182,93,89,2,31,1,1
47183,52377,53,52377,53,229,89,140,2,31,1,1
47184,41713,443,59804,443,61983,10061,51922,85,130,35,50
47185,20624,53,20624,53,229,89,140,2,31,1,1
47186,43927,443,42119,443,3410,1249,2161,16,136,8,8
47187,57470,16721,16664,16721,163,163,0,1,1200,1,0
47188,57146,53,31700,53,198,101,97,2,31,1,1
47189,64820,53,13245,53,190,97,93,2,31,1,1
47190,57346,53,4986,53,204,104,100,2,31,1,1
47191,27005,30006,32139,30006,890,126,764,3,31,2,1
47192,49157,53,49157,53,229,89,140,2,31,1,1
47193,39029,53,55192,53,198,93,105,2,31,1,1
47194,56487,53,29660,53,778,103,675,2,31,1,1
47195,59583,53,59583,53,229,89,140,2,31,1,1
47196,50298,443,51193,443,11984,6772,5212,52,222,30,22
47197,49334,53,23056,53,184,94,90,2,31,1,1
47198,57470,42329,52817,42329,1782,1782,0,28,1559,28,0
47199,59444,53,35195,53,489,114,375,2,31,1,1
47200,40159,53,40159,53,229,89,140,2,31,1,1
47201,55855,53,55855,53,221,89,132,2,31,1,1
47202,54786,30188,0,0,66,66,0,1,0,1,0
47203,46573,50584,0,0,62,62,0,1,0,1,0
47204,55074,445,0,0,70,70,0,1,0,1,0
47205,26502,64147,0,0,62,62,0,1,0,1,0
47206,443,3846,0,0,100,100,0,1,0,1,0
47207,47457,41615,0,0,145,145,0,1,0,1,0
47208,39313,37965,0,0,62,62,0,1,0,1,0
47209,26408,64147,0,0,66,66,0,1,0,1,0
47210,25536,50584,0,0,146,146,0,1,0,1,0
47211,36080,26467,0,0,62,62,0,1,0,1,0
47212,55072,445,0,0,70,70,0,1,0,1,0
47213,60026,445,0,0,70,70,0,1,0,1,0
47214,60021,445,0,0,70,70,0,1,0,1,0
47215,60019,445,0,0,70,70,0,1,0,1,0
47216,55401,445,0,0,66,66,0,1,0,1,0
47217,55402,445,0,0,66,66,0,1,0,1,0
47218,55400,445,0,0,66,66,0,1,0,1,0
47219,60018,445,0,0,70,70,0,1,0,1,0
47220,60073,80,45095,80,10676,6719,3957,23,141,12,11
47221,49767,53,52894,53,727,86,641,2,30,1,1
47222,38591,53,55685,53,391,102,289,2,30,1,1
47223,55325,53,50233,53,210,110,100,2,30,1,1
47224,57263,53,12000,53,167,86,81,2,30,1,1
47225,55489,53,32012,53,193,102,91,2,30,1,1
47226,60611,443,2263,443,478331,21023,457308,573,211,201,372
47227,61419,443,15902,443,6661,862,5799,18,28,9,9
47228,50324,80,23988,80,1083,653,430,8,15,5,3
47229,59982,80,63868,80,207418,4580,202838,194,143,50,144
47230,55600,53,57524,53,184,94,90,2,30,1,1
47231,50820,443,64516,443,2760048,78471,2681577,2863,250,962,1901
47232,60610,443,53274,443,187258,9720,177538,225,211,86,139
47233,55485,53,64726,53,212,102,110,2,30,1,1
47234,59324,53,10357,53,211,78,133,2,30,1,1
47235,54962,53,15807,53,194,102,92,2,30,1,1
47236,49226,443,49226,443,118943,24432,94511,156,96,79,77
47237,50688,5222,17560,5222,622,284,338,10,29,5,5
47238,63819,18445,34551,18445,70,70,0,1,4,1,0
47239,63820,27441,46760,27441,70,70,0,1,4,1,0
47240,44792,80,52125,80,1295,781,514,12,16,6,6
47241,56767,53,58838,53,177,94,83,2,30,1,1
47242,63817,50808,64390,50808,70,70,0,1,4,1,0
47243,63816,2073,59297,2073,70,70,0,1,4,1,0
47244,59944,80,15920,80,1052,612,440,10,15,5,5
47245,50826,443,44270,443,820870,30523,790347,918,218,337,581
47246,54705,443,23468,443,5411,851,4560,17,15,8,9
47247,60417,55100,62868,55100,164,70,94,2,5,1,1
47248,49513,53,63183,53,200,102,98,2,29,1,1
47249,55431,53,52036,53,196,102,94,2,29,1,1
47250,59878,53,26296,53,391,102,289,2,29,1,1
47251,65037,53,26531,53,210,110,100,2,29,1,1
47252,62330,443,31152,443,21361086,218978,21142108,16512,170,2203,14309
47253,49498,53,63118,53,734,94,640,2,29,1,1
47254,59010,53,59010,53,832,106,726,2,29,1,1
47255,39095,443,56882,443,310402,12194,298208,374,82,157,217
47256,56227,53,39156,53,194,102,92,2,30,1,1
47257,64592,53,58811,53,209,110,99,2,30,1,1
47258,56512,53,8579,53,166,86,80,2,29,1,1
47259,61420,443,13668,443,6327,1143,5184,18,28,9,9
47260,36785,443,22172,443,1799,1224,575,13,26,8,5
47261,57362,53,38084,53,177,94,83,2,30,1,1
47262,65304,53,18529,53,209,110,99,2,30,1,1
47263,56183,53,22164,53,179,94,85,2,30,1,1
47264,56710,53,13287,53,195,102,93,2,30,1,1
47265,57394,53,63615,53,193,102,91,2,30,1,1
47266,55199,53,63151,53,214,110,104,2,30,1,1
47267,50226,80,43900,80,9659,1454,8205,28,278,13,15
47268,51840,34678,2661,34678,70,70,0,2,8,2,0
47269,51824,53021,25345,53021,66,66,0,2,8,2,0
47270,61417,443,31390,443,4890,1219,3671,17,28,10,7
47271,61414,443,14574,443,5020,860,4160,18,28,9,9
47272,60033,443,16938,443,2845,1765,1080,15,142,8,7
47273,60045,80,49980,80,1455,965,490,10,142,6,4
47274,55410,53,52970,53,212,102,110,2,30,1,1
47275,54962,53,25167,53,194,102,92,2,30,1,1
47276,60095,443,60308,443,2357,1467,890,15,140,8,7
47277,56606,443,53334,443,9679,1633,8046,25,20,14,11
47278,59991,443,45209,443,5108,2834,2274,21,143,10,11
47279,60543,53,6634,53,211,78,133,2,30,1,1
47280,38639,80,55224,80,1013,504,509,10,15,6,4
47281,36786,443,50412,443,1798,1223,575,13,26,8,5
47282,60091,443,19389,443,2531,1288,1243,17,140,9,8
47283,55655,53,4325,53,524,214,310,6,57,3,3
47284,60061,443,58385,443,3195,1426,1769,15,141,8,7
47285,60011,443,19677,443,8413,3768,4645,25,143,12,13
47286,60063,443,64614,443,432803,9264,423539,427,141,135,292
47287,49991,53,12205,53,198,102,96,2,30,1,1
47288,60007,443,50307,443,2798,1652,1146,15,143,8,7
47289,64854,53,12372,53,1431,101,1330,4,50,2,2
47290,63811,80,47846,80,314,192,122,6,15,4,2
47291,55772,53,24055,53,269,110,159,2,30,1,1
47292,55771,53,21538,53,283,98,185,4,52,2,2
47293,49316,53,61603,53,184,94,90,2,30,1,1
47294,65446,53,11171,53,168,86,82,2,30,1,1
47295,57362,53,3531,53,177,94,83,2,30,1,1
47296,55027,53,65292,53,343,86,257,4,58,2,2
47297,65206,53,46359,53,167,86,81,2,30,1,1
47298,57281,53,14335,53,178,94,84,2,30,1,1
47299,57685,53,47518,53,275,86,189,2,30,1,1
47300,56767,53,32268,53,177,94,83,2,30,1,1
47301,56511,53,32498,53,200,102,98,2,30,1,1
47302,61700,53,0,0,202,86,116,2,30,1,1
47303,50067,53,31624,53,177,94,83,2,30,1,1
47304,64381,53,26257,53,198,102,96,2,30,1,1
47305,64582,53,17757,53,209,110,99,2,30,1,1
47306,55450,53,2536,53,102,102,0,1,30,1,0
47307,55475,53,23006,53,784,94,690,2,30,1,1
47308,47370,443,20985,443,350,210,140,6,75,4,2
47309,50315,80,20802,80,1030,310,720,11,56,6,5
47310,34331,443,8773,443,1717,1153,564,13,26,7,6
47311,34330,443,44282,443,1717,1153,564,13,26,7,6
47312,60055,443,24328,443,2314,1232,1082,15,141,8,7
47313,60065,443,12163,443,6395,2524,3871,18,141,10,8
47314,60367,443,45021,443,4847,963,3884,22,63,11,11
47315,60605,53,5384,53,275,86,189,2,30,1,1
47316,56533,53,11547,53,498,204,294,6,30,3,3
47317,56266,53,53849,53,182,102,80,2,30,1,1
47318,55199,53,8107,53,214,110,104,2,30,1,1
47319,56809,53,37625,53,167,86,81,2,30,1,1
47320,61411,443,46300,443,4775,894,3881,18,28,10,8
47321,60085,443,22950,443,1000,557,443,11,141,6,5
47322,60047,80,39100,80,2634,1780,854,14,142,8,6
47323,60067,443,11544,443,14085,1879,12206,27,141,12,15
47324,60003,443,18889,443,32538,7037,25501,49,143,20,29
47325,60060,443,7904,443,4648,1505,3143,17,141,9,8
47326,57281,53,55108,53,178,94,84,2,30,1,1
47327,49601,53,30637,53,178,94,84,2,30,1,1
47328,65235,53,42179,53,209,110,99,2,30,1,1
47329,16225,443,41335,443,13126,5105,8021,37,31,21,16
47330,64381,53,3642,53,198,102,96,2,30,1,1
47331,64934,53,64886,53,197,102,95,2,30,1,1
47332,64790,53,41786,53,183,94,89,2,30,1,1
47333,65087,53,12187,53,413,170,243,6,30,3,3
47334,65206,53,7977,53,167,86,81,2,30,1,1
47335,57246,53,12592,53,183,94,89,2,30,1,1
47336,65073,53,7816,53,195,102,93,2,30,1,1
47337,61433,443,18649,443,7796,766,7030,16,27,8,8
47338,55076,80,31296,80,1129,580,549,11,74,6,5
47339,61407,443,5972,443,6248,829,5419,17,29,9,8
47340,40432,443,35104,443,12022,2731,9291,53,20,26,27
47341,50928,443,1946,443,3347,2025,1322,31,34,18,13
47342,57030,53,42325,53,283,101,182,4,37,2,2
47343,39096,443,59336,443,1268772,32833,1235939,1288,81,409,879
47344,60019,443,11836,443,76774,9184,67590,104,143,41,63
47345,53234,443,19776,443,21571,8604,12967,38,34,19,19
47346,60088,443,5059,443,1000,557,443,11,141,6,5
47347,60727,443,60727,443,2169,1158,1011,20,15,11,9
47348,34332,443,1542,443,1717,1153,564,13,26,7,6
47349,60089,443,5576,443,1000,557,443,11,141,6,5
47350,63818,19291,22268,19291,70,70,0,1,4,1,0
47351,60093,443,46965,443,2090,1218,872,15,140,8,7
47352,60043,443,26610,443,1015,572,443,11,142,6,5
47353,60014,443,60627,443,4275,1488,2787,17,143,9,8
47354,55050,80,49586,80,246,120,126,5,15,3,2
47355,50309,80,22924,80,2481,723,1758,12,57,6,6
47356,50307,80,42606,80,3179,863,2316,13,57,7,6
47357,38640,80,6468,80,1013,504,509,10,15,6,4
47358,60069,443,38195,443,3045,1340,1705,16,141,8,8
47359,63808,40608,41042,40608,504,382,122,8,15,6,2
47360,60006,80,32015,80,1836,816,1020,12,143,7,5
47361,60890,443,40246,443,15081,6817,8264,31,34,14,17
47362,56196,53,30280,53,214,110,104,2,29,1,1
47363,60075,443,54321,443,6300,1427,4873,20,141,9,11
47364,55534,53,10719,53,168,86,82,2,29,1,1
47365,56380,53,36495,53,177,94,83,2,30,1,1
47366,49991,53,8139,53,198,102,96,2,30,1,1
47367,49936,53,39032,53,216,110,106,2,29,1,1
47368,56000,53,18353,53,177,94,83,2,29,1,1
47369,57157,53,8214,53,165,86,79,2,30,1,1
47370,49206,53,41774,53,301,89,212,4,48,2,2
47371,64598,53,18969,53,222,94,128,2,29,1,1
47372,55497,53,23337,53,184,102,82,2,29,1,1
47373,64053,53,35360,53,193,102,91,2,29,1,1
47374,64766,53,47744,53,214,110,104,2,29,1,1
47375,64053,53,10506,53,193,102,91,2,30,1,1
47376,65037,53,16035,53,210,110,100,2,29,1,1
47377,49601,53,44219,53,178,94,84,2,30,1,1
47378,64484,53,57722,53,168,86,82,2,30,1,1
47379,65037,53,41367,53,210,110,100,2,29,1,1
47380,57246,53,9725,53,183,94,89,2,30,1,1
47381,49157,53,42050,53,184,94,90,2,29,1,1
47382,55179,53,31015,53,178,94,84,2,30,1,1
47383,56548,53,18583,53,199,102,97,2,30,1,1
47384,64053,53,26364,53,193,102,91,2,30,1,1
47385,55994,53,14095,53,183,94,89,2,30,1,1
47386,65446,53,2812,53,184,102,82,2,30,1,1
47387,49730,53,34658,53,194,102,92,2,30,1,1
47388,57281,53,33051,53,178,94,84,2,30,1,1
47389,64582,53,29517,53,209,110,99,2,30,1,1
47390,49157,53,54699,53,184,94,90,2,30,1,1
47391,56629,53,37533,53,177,94,83,2,30,1,1
47392,49547,53,49951,53,193,102,91,2,30,1,1
47393,55205,53,50575,53,167,86,81,2,30,1,1
47394,64587,53,36595,53,167,86,81,2,31,1,1
47395,41085,443,36619,443,5553,1055,4498,19,121,9,10
47396,57470,44919,55339,44919,166,166,0,1,1199,1,0
47397,49921,53,27368,53,214,110,104,2,30,1,1
47398,57193,53,40448,53,229,110,119,2,30,1,1
47399,49730,53,40205,53,194,102,92,2,30,1,1
47400,49921,53,58309,53,214,110,104,2,30,1,1
47401,57263,53,19540,53,167,86,81,2,30,1,1
47402,55205,53,56363,53,167,86,81,2,30,1,1
47403,50034,53,15680,53,179,94,85,2,30,1,1
47404,55889,53,7976,53,168,86,82,2,30,1,1
47405,60542,53,46573,53,260,86,174,2,30,1,1
47406,10151,6881,7271,6881,490,150,340,2,1200,1,1
47407,61434,443,24839,443,8005,830,7175,19,27,9,10
47408,58600,53,58600,53,217,82,135,2,32,1,1
47409,60083,443,30237,443,490571,27526,463045,511,141,170,341
47410,60015,443,28429,443,6340,3788,2552,21,143,10,11
47411,60029,443,40871,443,1057,590,467,11,142,6,5
47412,60010,443,42426,443,4795,2875,1920,19,143,10,9
47413,55001,80,28763,80,9249354,297929,8951425,10789,208,4872,5917
47414,60898,443,32262,443,10104,1643,8461,28,46,15,13
47415,56609,443,13546,443,11061,1566,9495,25,19,13,12
47416,55250,443,44147,443,1271,918,353,9,15,6,3
47417,56511,53,50821,53,200,102,98,2,30,1,1
47418,55325,53,2560,53,210,110,100,2,30,1,1
47419,50067,53,8496,53,177,94,83,2,30,1,1
47420,57346,53,32731,53,210,110,100,2,30,1,1
47421,56548,53,28244,53,199,102,97,2,31,1,1
47422,56343,53,58460,53,194,102,92,2,31,1,1
47423,35888,443,35888,443,4481,1574,2907,19,26,11,8
47424,60416,55998,54141,55998,70,70,0,1,5,1,0
47425,60037,443,65363,443,4722,2945,1777,18,142,10,8
47426,50299,80,31739,80,2316,1206,1110,16,81,9,7
47427,33252,443,7874,443,89817,21083,68734,148,36,77,71
47428,55902,53,58638,53,181,94,87,2,30,1,1
47429,64582,53,64118,53,209,110,99,2,30,1,1
47430,55600,53,36294,53,184,94,90,2,30,1,1
47431,50034,53,21368,53,179,94,85,2,30,1,1
47432,55165,53,15099,53,199,102,97,2,30,1,1
47433,56090,53,62587,53,195,94,101,2,30,1,1
47434,56809,53,9821,53,167,86,81,2,30,1,1
47435,56511,53,55404,53,200,102,98,2,30,1,1
47436,55165,53,30043,53,199,102,97,2,30,1,1
47437,57246,53,49639,53,183,94,89,2,31,1,1
47438,50828,443,8189,443,178483,7778,170705,219,218,90,129
47439,60018,443,59209,443,117023,8825,108198,138,143,49,89
47440,60098,443,41490,443,1011,568,443,11,139,6,5
47441,36781,443,37104,443,1798,1223,575,13,26,8,5
47442,64934,53,51307,53,197,102,95,2,33,1,1
47443,60105,443,39991,443,4856,1587,3269,17,138,9,8
47444,60041,443,53446,443,1015,572,443,11,142,6,5
47445,55623,62853,62347,62853,504,318,186,8,15,5,3
47446,50314,80,10727,80,1030,310,720,11,56,6,5
47447,50317,80,30399,80,5438,2832,2606,18,56,10,8
47448,56608,443,21691,443,10062,1631,8431,25,19,14,11
47449,56413,53,29873,53,233,94,139,2,30,1,1
47450,56710,53,54162,53,355,97,258,4,60,2,2
47451,59925,443,55867,443,10302,3853,6449,27,61,16,11
47452,64820,53,3092,53,195,102,93,2,30,1,1
47453,57029,53,54997,53,413,170,243,6,30,3,3
47454,55266,53,20409,53,365,102,263,2,30,1,1
47455,55662,53,45972,53,212,102,110,2,30,1,1
47456,65304,53,46271,53,209,110,99,2,30,1,1
47457,55889,53,65516,53,168,86,82,2,30,1,1
47458,55179,53,47200,53,178,94,84,2,30,1,1
47459,65096,53,51459,53,216,94,122,2,30,1,1
47460,56629,53,33066,53,177,94,83,2,30,1,1
47461,65143,53,45277,53,184,94,90,2,30,1,1
47462,59323,53,1369,53,260,86,174,2,30,1,1
47463,65229,53,45181,53,195,102,93,2,31,1,1
47464,27005,27056,45270,27056,908,126,782,2,31,1,1
47465,57146,53,33353,53,199,102,97,2,31,1,1
47466,56704,53,8695,53,194,102,92,2,31,1,1
47467,49921,53,21465,53,214,110,104,2,31,1,1
47468,50438,53,15254,53,296,101,195,4,31,2,2
47469,50438,53,44786,53,296,101,195,4,31,2,2
47470,60811,443,53507,443,740,222,518,11,3631,4,7
47471,56767,53,44423,53,177,94,83,2,30,1,1
47472,56183,53,23444,53,179,94,85,2,30,1,1
47473,49513,53,20128,53,391,102,289,4,31,2,2
47474,65241,53,34581,53,198,102,96,2,30,1,1
47475,55955,53,56880,53,184,94,90,2,30,1,1
47476,49334,53,14859,53,184,94,90,2,30,1,1
47477,49265,53,12727,53,181,94,87,2,31,1,1
47478,65437,53,61379,53,195,102,93,2,31,1,1
47479,57394,53,39709,53,193,102,91,2,31,1,1
47480,55955,53,35067,53,184,94,90,2,31,1,1
47481,27005,27055,64070,27055,915,126,789,2,31,1,1
47482,65165,53,21302,53,200,102,98,2,31,1,1
47483,27005,28002,27297,28002,918,126,792,2,31,1,1
47484,65482,53,46055,53,179,94,85,2,31,1,1
47485,27005,27058,26884,27058,908,126,782,2,31,1,1
47486,49334,53,54606,53,184,94,90,2,31,1,1
47487,6881,6881,34489,6881,253,118,135,2,1199,1,1
47488,54644,443,43384,443,4679,3387,1292,18,304,10,8
47489,51835,443,19929,443,48635,5346,43289,83,151,38,45
47490,55902,53,57612,53,181,94,87,2,30,1,1
47491,56396,53,37010,53,183,94,89,2,30,1,1
47492,64074,53,54669,53,209,110,99,2,30,1,1
47493,55071,53,33464,53,177,94,83,2,31,1,1
47494,51221,57522,58823,57522,481,150,331,2,1200,1,1
47495,60759,40010,60253,40010,316,136,180,6,7,3,3
47496,2037,23,2037,23,152,66,86,2,10,1,1
47497,49843,80,51294,80,2901,1805,1096,17,108,13,4
47498,27005,27054,8800,27054,921,126,795,2,31,1,1
47499,27005,26259,57804,26259,889,126,763,2,31,1,1
47500,53534,443,20648,443,7639,1831,5808,29,76,15,14
47501,43314,443,48162,443,6102,782,5320,17,67,8,9
47502,14434,443,32675,443,2556,1470,1086,17,16,8,9
47503,40845,53,40845,53,210,98,112,2,31,1,1
47504,62311,443,60007,443,4778,1121,3657,15,280,8,7
47505,51845,11201,33761,11201,316,136,180,6,6,3,3
47506,49162,53,30620,53,401,94,307,4,32,2,2
47507,55068,445,0,0,70,70,0,1,0,1,0
47508,10701,11392,0,0,62,62,0,1,0,1,0
47509,7892,50584,0,0,62,62,0,1,0,1,0
47510,60015,445,0,0,70,70,0,1,0,1,0
47511,60013,445,0,0,70,70,0,1,0,1,0
47512,60009,445,0,0,70,70,0,1,0,1,0
47513,60004,445,0,0,70,70,0,1,0,1,0
47514,16948,990,0,0,60,60,0,1,0,1,0
47515,50631,23,0,0,60,60,0,1,0,1,0
47516,39548,8696,0,0,60,60,0,1,0,1,0
47517,55053,445,0,0,70,70,0,1,0,1,0
47518,39540,37965,0,0,66,66,0,1,0,1,0
47519,57768,37965,0,0,62,62,0,1,0,1,0
47520,443,62451,0,0,199,199,0,1,0,1,0
47521,63586,46824,0,0,62,62,0,1,0,1,0
47522,59995,445,0,0,70,70,0,1,0,1,0
47523,59998,445,0,0,70,70,0,1,0,1,0
47524,59993,445,0,0,70,70,0,1,0,1,0
47525,55050,445,0,0,70,70,0,1,0,1,0
47526,57564,56205,0,0,66,66,0,1,0,1,0
47527,55045,445,0,0,70,70,0,1,0,1,0
47528,10916,44847,0,0,66,66,0,1,0,1,0
47529,55044,445,0,0,70,70,0,1,0,1,0
47530,60350,51505,0,0,66,66,0,1,0,1,0
47531,52575,22114,0,0,66,66,0,1,0,1,0
47532,49616,30188,0,0,66,66,0,1,0,1,0
47533,55378,445,0,0,66,66,0,1,0,1,0
47534,58264,44847,0,0,66,66,0,1,0,1,0
47535,55042,445,0,0,70,70,0,1,0,1,0
47536,59989,445,0,0,70,70,0,1,0,1,0
47537,59988,445,0,0,70,70,0,1,0,1,0
47538,25469,57470,0,0,62,62,0,1,0,1,0
47539,55374,445,0,0,66,66,0,1,0,1,0
47540,59739,35253,0,0,62,62,0,1,0,1,0
47541,55035,445,0,0,70,70,0,1,0,1,0
47542,55370,445,0,0,66,66,0,1,0,1,0
47543,59977,445,0,0,70,70,0,1,0,1,0
47544,55033,445,0,0,70,70,0,1,0,1,0
47545,53459,37807,0,0,62,62,0,1,0,1,0
47546,59971,445,0,0,70,70,0,1,0,1,0
47547,59968,445,0,0,70,70,0,1,0,1,0
47548,59967,445,0,0,70,70,0,1,0,1,0
47549,55367,445,0,0,66,66,0,1,0,1,0
47550,4300,37838,0,0,146,146,0,1,0,1,0
47551,56582,37965,0,0,66,66,0,1,0,1,0
47552,55032,445,0,0,70,70,0,1,0,1,0
47553,3559,30188,0,0,62,62,0,1,0,1,0
47554,18246,64097,0,0,62,62,0,1,0,1,0
47555,55031,445,0,0,70,70,0,1,0,1,0
47556,55030,445,0,0,70,70,0,1,0,1,0
47557,35163,30188,0,0,66,66,0,1,0,1,0
47558,55921,43890,0,0,62,62,0,1,0,1,0
47559,55027,445,0,0,70,70,0,1,0,1,0
47560,55024,445,0,0,70,70,0,1,0,1,0
47561,59964,445,0,0,70,70,0,1,0,1,0
47562,59937,37965,0,0,66,66,0,1,0,1,0
47563,2918,37965,0,0,62,62,0,1,0,1,0
47564,59960,445,0,0,70,70,0,1,0,1,0
47565,59959,445,0,0,70,70,0,1,0,1,0
47566,59956,445,0,0,70,70,0,1,0,1,0
47567,55361,445,0,0,66,66,0,1,0,1,0
47568,65518,5710,0,0,62,62,0,1,0,1,0
47569,443,45940,0,0,85,85,0,1,0,1,0
47570,55012,445,0,0,70,70,0,1,0,1,0
47571,55011,445,0,0,70,70,0,1,0,1,0
47572,55358,445,0,0,66,66,0,1,0,1,0
47573,55355,445,0,0,66,66,0,1,0,1,0
47574,55352,445,0,0,66,66,0,1,0,1,0
47575,43916,21,0,0,60,60,0,1,0,1,0
47576,58481,37838,0,0,146,146,0,1,0,1,0
47577,55009,445,0,0,70,70,0,1,0,1,0
47578,58338,3369,0,0,60,60,0,1,0,1,0
47579,55001,445,0,0,70,70,0,1,0,1,0
47580,55002,445,0,0,70,70,0,1,0,1,0
47581,55351,445,0,0,66,66,0,1,0,1,0
47582,55350,445,0,0,66,66,0,1,0,1,0
47583,55349,445,0,0,66,66,0,1,0,1,0
47584,11023,51505,0,0,66,66,0,1,0,1,0
47585,61902,22114,0,0,66,66,0,1,0,1,0
47586,35421,30188,0,0,146,146,0,1,0,1,0
47587,33287,57354,0,0,145,145,0,1,0,1,0
47588,49717,57470,0,0,62,62,0,1,0,1,0
47589,59954,445,0,0,70,70,0,1,0,1,0
47590,59952,445,0,0,70,70,0,1,0,1,0
47591,59951,445,0,0,70,70,0,1,0,1,0
47592,44981,57470,0,0,66,66,0,1,0,1,0
47593,55346,445,0,0,66,66,0,1,0,1,0
47594,59947,445,0,0,70,70,0,1,0,1,0
47595,33948,15503,0,0,146,146,0,1,0,1,0
47596,55343,445,0,0,66,66,0,1,0,1,0
47597,49255,44847,0,0,62,62,0,1,0,1,0
47598,55341,445,0,0,66,66,0,1,0,1,0
47599,55339,445,0,0,66,66,0,1,0,1,0
47600,54990,445,0,0,70,70,0,1,0,1,0
47601,48629,63131,0,0,74,74,0,1,0,1,0
47602,55338,445,0,0,66,66,0,1,0,1,0
47603,46670,51505,0,0,146,146,0,1,0,1,0
47604,23936,35440,0,0,62,62,0,1,0,1,0
47605,52837,35440,0,0,66,66,0,1,0,1,0
47606,59941,445,0,0,70,70,0,1,0,1,0
47607,34808,22114,0,0,66,66,0,1,0,1,0
47608,56202,15503,0,0,146,146,0,1,0,1,0
47609,39119,44847,0,0,62,62,0,1,0,1,0
47610,59938,445,0,0,70,70,0,1,0,1,0
47611,59929,445,0,0,70,70,0,1,0,1,0
47612,54986,445,0,0,70,70,0,1,0,1,0
47613,51032,30188,0,0,66,66,0,1,0,1,0
47614,48016,57470,0,0,62,62,0,1,0,1,0
47615,58481,15503,0,0,146,146,0,1,0,1,0
47616,61838,37965,0,0,62,62,0,1,0,1,0
47617,54975,445,0,0,70,70,0,1,0,1,0
47618,54977,445,0,0,70,70,0,1,0,1,0
47619,55327,445,0,0,66,66,0,1,0,1,0
47620,1024,50265,0,0,62,62,0,1,0,1,0
47621,54971,445,0,0,70,70,0,1,0,1,0
47622,54974,445,0,0,70,70,0,1,0,1,0
47623,6666,50070,0,0,60,60,0,1,0,1,0
47624,54970,445,0,0,70,70,0,1,0,1,0
47625,55311,44847,0,0,66,66,0,1,0,1,0
47626,55319,445,0,0,66,66,0,1,0,1,0
47627,45964,3111,0,0,60,60,0,1,0,1,0
47628,59919,445,0,0,70,70,0,1,0,1,0
47629,38653,21247,0,0,62,62,0,1,0,1,0
47630,58398,44847,0,0,66,66,0,1,0,1,0
47631,55316,445,0,0,66,66,0,1,0,1,0
47632,54963,445,0,0,70,70,0,1,0,1,0
47633,30114,65151,0,0,60,60,0,1,0,1,0
47634,17579,57470,0,0,62,62,0,1,0,1,0
47635,55310,445,0,0,66,66,0,1,0,1,0
47636,54956,445,0,0,70,70,0,1,0,1,0
47637,55300,445,0,0,66,66,0,1,0,1,0
47638,25010,30188,0,0,146,146,0,1,0,1,0
47639,4515,37807,0,0,62,62,0,1,0,1,0
47640,54954,445,0,0,70,70,0,1,0,1,0
47641,36061,53,36061,53,220,100,120,2,30,1,1
47642,30478,53,30478,53,229,89,140,2,30,1,1
47643,63831,31539,8065,31539,312,132,180,6,7,3,3
47644,55771,53,58272,53,283,98,185,4,51,2,2
47645,15523,53,15523,53,227,88,139,2,30,1,1
47646,60373,80,60373,80,116680,5773,110907,126,21,46,80
47647,46633,53,46633,53,237,91,146,2,32,1,1
47648,53647,16194,65302,16194,70,70,0,2,8,2,0
47649,65497,53,35507,53,194,99,95,2,31,1,1
47650,64335,53,18778,53,186,95,91,2,30,1,1
47651,15239,53,15239,53,229,89,140,2,30,1,1
47652,56625,443,54912,443,6734,2065,4669,21,16,11,10
47653,49227,443,49227,443,155471,20626,134845,193,95,92,101
47654,57174,53,65010,53,755,94,661,2,30,1,1
47655,51230,80,8702,80,1594,1280,314,10,15,5,5
47656,56656,443,8282,443,7743,3072,4671,18,125,10,8
47657,49162,53,60010,53,182,93,89,2,31,1,1
47658,55955,53,59557,53,184,94,90,2,30,1,1
47659,61697,443,10867,443,9963,2631,7332,37,48,20,17
47660,53560,443,34440,443,10823,1626,9197,27,28,15,12
47661,61678,80,36347,80,79505,3799,75706,105,53,43,62
47662,55071,53,10472,53,170,87,83,2,31,1,1
47663,49265,53,7053,53,178,91,87,2,31,1,1
47664,53653,17436,48182,17436,70,70,0,2,8,2,0
47665,56695,53,57441,53,776,102,674,2,30,1,1
47666,57406,53,28886,53,761,100,661,2,30,1,1
47667,38678,443,31559,443,484,210,274,8,26,4,4
47668,65437,53,50016,53,190,97,93,2,30,1,1
47669,55450,53,15433,53,186,95,91,2,30,1,1
47670,53650,37096,53395,37096,70,70,0,2,8,2,0
47671,65241,53,65497,53,196,100,96,2,30,1,1
47672,51928,443,37238,443,18581,9681,8900,62,103,33,29
47673,59828,53,0,0,275,75,200,2,30,1,1
47674,65229,53,65354,53,190,97,93,2,31,1,1
47675,56704,53,19637,53,188,96,92,2,31,1,1
47676,65165,53,54019,53,200,102,98,2,31,1,1
47677,57072,53,1078,53,190,97,93,2,31,1,1
47678,53561,443,46196,443,4586,1216,3370,17,28,10,7
47679,48422,53,48422,53,229,89,140,2,30,1,1
47680,51819,59208,18687,59208,66,66,0,2,8,2,0
47681,50034,53,9396,53,174,89,85,2,30,1,1
47682,60796,80,60796,80,13869,3749,10120,28,26,15,13
47683,64587,53,28928,53,166,85,81,2,30,1,1
47684,40905,443,30832,443,6982,1535,5447,30,26,15,15
47685,27005,27021,33565,27021,879,126,753,2,30,1,1
47686,50584,6881,48204,6881,161,161,0,1,1200,1,0
47687,57470,6889,39885,6889,507,163,344,2,1200,1,1
47688,30960,45708,10232,45708,330,330,0,6,3609,6,0
47689,32390,53,32390,53,229,89,140,2,30,1,1
47690,38791,53,38791,53,229,89,140,2,30,1,1
47691,55032,53,0,0,288,79,209,2,31,1,1
47692,57275,53,1884,53,186,95,91,2,31,1,1
47693,55871,53,0,0,82,82,0,1,31,1,0
47694,49843,53,31745,53,186,95,91,2,31,1,1
47695,53546,443,23696,443,7268,3166,4102,19,136,10,9
47696,36306,53,36306,53,229,89,140,2,30,1,1
47697,5881,53,5881,53,231,90,141,2,31,1,1
47698,64999,53,11642,53,757,98,659,2,31,1,1
47699,50054,53,65410,53,775,103,672,2,31,1,1
47700,57266,53,10699,53,753,96,657,2,31,1,1
47701,48627,443,55025,443,638,70,568,10,207,2,8
47702,52280,5228,18366,5228,2147,1315,832,14,3601,7,7
47703,47163,53,47163,53,825,99,726,2,31,1,1
47704,42153,443,25509,443,12306,2097,10209,31,360,15,16
47705,50584,58516,43586,58516,161,161,0,1,1200,1,0
47706,57470,6881,14174,6881,490,163,327,2,1200,1,1
47707,57096,53,22814,53,196,100,96,2,31,1,1
47708,57296,53,12062,53,200,102,98,2,31,1,1
47709,64904,53,60868,53,198,101,97,2,31,1,1
47710,49654,53,58330,53,184,94,90,2,31,1,1
47711,50584,6881,21374,6881,161,161,0,1,1200,1,0
47712,57470,51413,13214,51413,490,163,327,2,1200,1,1
47713,49522,53,15202,53,753,96,657,2,31,1,1
47714,65439,53,55852,53,751,95,656,2,31,1,1
47715,64946,53,40387,53,202,95,107,2,31,1,1
47716,55481,53,52263,53,793,101,692,2,31,1,1
47717,26352,53,26352,53,231,90,141,2,31,1,1
47718,27005,37579,27251,37579,886,126,760,2,31,1,1
47719,49812,53,21383,53,164,84,80,2,31,1,1
47720,49159,53,33263,53,733,86,647,2,31,1,1
47721,65482,53,40607,53,174,89,85,2,31,1,1
47722,49761,53,10383,53,182,93,89,2,31,1,1
47723,56536,53,9836,53,202,103,99,2,31,1,1
47724,64559,53,44867,53,168,86,82,2,31,1,1
47725,56387,53,8885,53,757,98,659,2,31,1,1
47726,57470,51413,34257,51413,508,163,345,2,1200,1,1
47727,56783,53,31906,53,751,95,656,2,31,1,1
47728,56855,53,37174,53,775,103,672,2,31,1,1
47729,57109,53,37634,53,168,86,82,2,31,1,1
47730,65345,53,26359,53,782,105,677,2,31,1,1
47731,55062,53,13920,53,733,86,647,2,31,1,1
47732,48114,443,5239,443,4515,2193,2322,14,135,7,7
47733,50584,18047,33742,18047,851,369,482,5,1200,3,2
47734,19473,28109,14230,28109,468,149,319,2,1200,1,1
47735,50584,8999,10076,8999,161,161,0,1,1200,1,0
47736,57470,43259,40741,43259,517,163,354,2,1200,1,1
47737,19983,18242,0,0,146,146,0,1,0,1,0
47738,64997,51221,0,0,66,66,0,1,0,1,0
47739,22835,51221,0,0,62,62,0,1,0,1,0
47740,54950,445,0,0,70,70,0,1,0,1,0
47741,54948,445,0,0,70,70,0,1,0,1,0
47742,59909,445,0,0,70,70,0,1,0,1,0
47743,55489,53,26827,53,193,102,91,2,30,1,1
47744,55208,53,14602,53,177,94,83,2,30,1,1
47745,64587,53,13030,53,167,86,81,2,30,1,1
47746,49568,53,17593,53,214,102,112,2,30,1,1
47747,55771,53,45760,53,283,98,185,4,51,2,2
47748,59908,445,0,0,70,70,0,1,0,1,0
47749,59907,445,0,0,70,70,0,1,0,1,0
47750,55294,445,0,0,66,66,0,1,0,1,0
47751,55293,445,0,0,66,66,0,1,0,1,0
47752,55292,445,0,0,66,66,0,1,0,1,0
47753,55291,445,0,0,66,66,0,1,0,1,0
47754,55290,445,0,0,66,66,0,1,0,1,0
47755,55289,445,0,0,66,66,0,1,0,1,0
47756,55288,445,0,0,66,66,0,1,0,1,0
47757,55287,445,0,0,66,66,0,1,0,1,0
47758,19678,36237,0,0,146,146,0,1,0,1,0
47759,54944,445,0,0,70,70,0,1,0,1,0
47760,19361,37965,0,0,66,66,0,1,0,1,0
47761,54943,445,0,0,70,70,0,1,0,1,0
47762,43260,41615,0,0,145,145,0,1,0,1,0
47763,52643,15941,0,0,62,62,0,1,0,1,0
47764,22683,39210,0,0,60,60,0,1,0,1,0
47765,53227,64097,0,0,66,66,0,1,0,1,0
47766,53140,80,7682,80,9602,814,8788,19,129,10,9
47767,53648,31637,17348,31637,70,70,0,2,7,2,0
47768,51835,29778,4690,29778,70,70,0,2,7,2,0
47769,64820,53,5211,53,195,102,93,2,29,1,1
47770,56343,53,26376,53,194,102,92,2,29,1,1
47771,49242,53,1581,53,167,86,81,2,29,1,1
47772,56106,53,61650,53,816,102,714,2,30,1,1
47773,61702,80,48411,80,1553,953,600,14,47,8,6
47774,41420,443,4151,443,4858,855,4003,16,64,9,7
47775,43875,443,31372,443,18367,3429,14938,41,500,23,18
47776,56655,53,21531,53,209,110,99,2,30,1,1
47777,65482,53,50244,53,179,94,85,2,30,1,1
47778,65360,53,6269,53,763,102,661,2,30,1,1
47779,49186,53,28433,53,821,102,719,2,30,1,1
47780,56704,53,43778,53,194,102,92,2,29,1,1
47781,61701,80,22637,80,1495,954,541,13,47,8,5
47782,65437,53,38141,53,195,102,93,2,29,1,1
47783,54670,443,29364,443,18487,3434,15053,37,80,20,17
47784,37179,443,24898,443,7440,3165,4275,31,358,17,14
47785,57146,53,5349,53,199,102,97,2,29,1,1
47786,36541,443,3197,443,4322,797,3525,14,64,8,6
47787,50209,1688,16419,1688,70,70,0,1,4,1,0
47788,49547,53,33121,53,193,102,91,2,29,1,1
47789,49242,53,38872,53,167,86,81,2,29,1,1
47790,55450,53,40761,53,193,102,91,2,29,1,1
47791,57146,53,13566,53,199,102,97,2,29,1,1
47792,64335,53,30399,53,193,102,91,2,29,1,1
47793,56396,53,60964,53,183,94,89,2,30,1,1
47794,65073,53,50486,53,195,102,93,2,29,1,1
47795,57263,53,2666,53,167,86,81,2,29,1,1
47796,55571,53,22113,53,70,70,0,1,29,1,0
47797,54962,53,60392,53,194,102,92,2,29,1,1
47798,55205,53,45357,53,167,86,81,2,29,1,1
47799,64074,53,30034,53,209,110,99,2,29,1,1
47800,55858,53,14376,53,214,102,112,2,30,1,1
47801,61704,80,4261,80,1555,954,601,14,47,8,6
47802,60335,7010,60335,7010,6127,4018,2109,19,17,11,8
47803,49441,443,28685,443,2921276,89544,2831732,3090,63,1086,2004
47804,49242,53,5506,53,167,86,81,2,30,1,1
47805,49769,53,30329,53,785,110,675,2,30,1,1
47806,49169,53,65143,53,184,94,90,2,30,1,1
47807,49162,53,28701,53,183,94,89,2,30,1,1
47808,56010,53,24880,53,184,94,90,2,30,1,1
47809,64587,53,63035,53,167,86,81,2,30,1,1
47810,17752,53,17752,53,230,90,140,2,30,1,1
47811,56935,53,51699,53,821,102,719,2,30,1,1
47812,49337,53,44481,53,199,102,97,2,30,1,1
47813,51839,27256,26214,27256,70,70,0,2,7,2,0
47814,65229,53,47918,53,195,102,93,2,30,1,1
47815,49186,53,38504,53,198,102,96,2,30,1,1
47816,57162,443,26306,443,1798,1223,575,13,25,8,5
47817,39296,80,42810,80,740,452,288,11,17,7,4
47818,40705,443,7502,443,5721,3240,2481,35,147,14,21
47819,64922,53,63289,53,431,95,336,4,55,2,2
47820,57536,53,46039,53,199,94,105,2,30,1,1
47821,50179,80,50179,80,1473,920,553,9,137,6,3
47822,51424,53,58777,53,269,94,175,2,30,1,1
47823,50377,53,24974,53,753,94,659,2,30,1,1
47824,65478,443,30120,443,92279,4799,87480,107,16,43,64
47825,49773,53,17034,53,199,94,105,2,30,1,1
47826,49850,53,46784,53,166,86,80,2,30,1,1
47827,60211,443,55686,443,126490514,2726981,123763533,123275,553,41466,81809
47828,55095,53,28399,53,194,102,92,2,30,1,1
47829,49812,53,5502,53,166,86,80,2,30,1,1
47830,56441,80,22718,80,1272,389,883,16,394,4,12
47831,55972,53,29588,53,262,126,136,2,30,1,1
47832,64904,53,43718,53,199,102,97,2,30,1,1
47833,60732,443,1345,443,193520,11019,182501,280,276,140,140
47834,51820,53738,51101,53738,66,66,0,2,8,2,0
47835,53144,443,6960,443,7121,2564,4557,26,127,15,11
47836,50033,53,63649,53,533,184,349,6,76,3,3
47837,55771,53,49572,53,283,98,185,4,51,2,2
47838,65530,53,2612,53,102,102,0,1,30,1,0
47839,65443,53,19494,53,215,102,113,2,30,1,1
47840,49242,53,51879,53,183,94,89,2,30,1,1
47841,65005,53,27346,53,776,102,674,2,30,1,1
47842,64016,53,48329,53,183,94,89,2,30,1,1
47843,49518,443,56139,443,7834,1758,6076,26,171,13,13
47844,55635,38649,60618,38649,70,70,0,2,8,2,0
47845,51836,37753,15245,37753,70,70,0,2,7,2,0
47846,65477,443,34529,443,409770,12150,397620,421,16,148,273
47847,49327,53,15373,53,396,102,294,2,30,1,1
47848,49337,53,52249,53,199,102,97,2,30,1,1
47849,49242,53,36950,53,183,94,89,2,30,1,1
47850,64789,53,40256,53,193,102,91,2,30,1,1
47851,50354,53,23392,53,209,110,99,2,30,1,1
47852,56665,53,14967,53,223,86,137,2,30,1,1
47853,33473,443,49097,443,146684,25233,121451,183,189,75,108
47854,49730,443,40154,443,3233,1141,2092,14,135,7,7
47855,40488,443,48919,443,3635,2114,1521,22,515,13,9
47856,49936,53,34115,53,318,110,208,4,50,2,2
47857,35637,443,59473,443,5611,1559,4052,22,648,13,9
47858,60350,443,44026,443,5242,861,4381,17,16,9,8
47859,38405,443,30504,443,9876,1976,7900,27,27,13,14
47860,41322,443,26107,443,6332,944,5388,19,66,10,9
47861,51834,30309,65352,30309,70,70,0,2,7,2,0
47862,56625,80,20338,80,234,234,0,4,11,4,0
47863,56823,50291,65479,50291,316,136,180,6,6,3,3
47864,52585,53,6341,53,265,91,174,4,40,2,2
47865,64397,53,47942,53,658,186,472,6,51,3,3
47866,57188,8525,57188,8525,138,78,60,2,6,1,1
47867,50518,443,27027,443,1352,691,661,14,47,8,6
47868,55534,53,27868,53,168,86,82,2,29,1,1
47869,54835,443,59753,443,678,280,398,11,26,5,6
47870,38031,80,38031,80,37629,3025,34604,51,24,22,29
47871,55489,53,32876,53,193,102,91,2,29,1,1
47872,56344,443,64957,443,8111,1413,6698,21,28,12,9
47873,46596,443,51995,443,4146,2690,1456,31,37,16,15
47874,65497,53,55657,53,197,102,95,2,29,1,1
47875,56343,443,34805,443,350,210,140,6,27,4,2
47876,65241,53,47217,53,198,102,96,2,29,1,1
47877,56728,53,11841,53,166,86,80,2,30,1,1
47878,53651,47758,20351,47758,70,70,0,2,7,2,0
47879,55450,53,10732,53,193,102,91,2,29,1,1
47880,57072,53,9949,53,195,102,93,2,30,1,1
47881,56824,55829,39772,55829,70,70,0,1,5,1,0
47882,55208,53,2198,53,177,94,83,2,30,1,1
47883,49547,53,39009,53,193,102,91,2,30,1,1
47884,52405,443,45940,443,227267,18022,209245,424,38,239,185
47885,23997,53,23997,53,230,90,140,2,30,1,1
47886,60047,443,35596,443,1350,689,661,14,44,8,6
47887,60045,443,3000,443,1573,769,804,16,47,9,7
47888,48734,443,7322,443,256887,11565,245322,293,56,112,181
47889,60372,80,60372,80,186272,9792,176480,216,21,93,123
47890,50072,53,48106,53,172,94,78,2,30,1,1
47891,65497,53,26978,53,197,102,95,2,30,1,1
47892,55071,53,59621,53,177,94,83,2,30,1,1
47893,49928,53,49928,53,229,90,139,2,30,1,1
47894,57072,53,19221,53,195,102,93,2,30,1,1
47895,57346,53,23622,53,210,110,100,2,29,1,1
47896,57470,18531,64727,18531,166,166,0,1,1200,1,0
47897,50584,38496,45984,38496,166,166,0,1,1200,1,0
47898,57470,60560,62247,60560,527,166,361,2,1200,1,1
47899,64789,53,62569,53,816,102,714,2,30,1,1
47900,49843,53,13877,53,193,102,91,2,30,1,1
47901,50354,53,24829,53,209,110,99,2,30,1,1
47902,64335,53,25261,53,193,102,91,2,30,1,1
47903,49630,53,20567,53,374,126,248,2,30,1,1
47904,49812,53,4769,53,166,86,80,2,30,1,1
47905,57096,53,45247,53,198,102,96,2,30,1,1
47906,56322,53,19434,53,166,86,80,2,30,1,1
47907,50234,53,30924,53,775,102,673,2,30,1,1
47908,55810,53,5823,53,183,94,89,2,31,1,1
47909,6882,64287,36114,64287,228,118,110,2,1200,1,1
47910,55342,53,57972,53,994,86,908,2,30,1,1
47911,56616,53,31793,53,183,94,89,2,30,1,1
47912,64837,53,23710,53,196,94,102,2,30,1,1
47913,65012,53,58709,53,775,102,673,2,30,1,1
47914,56935,53,62999,53,198,102,96,2,30,1,1
47915,64719,53,54824,53,196,102,94,2,30,1,1
47916,56396,53,42377,53,183,94,89,2,30,1,1
47917,55071,53,51447,53,177,94,83,2,30,1,1
47918,55192,53,5787,53,178,94,84,2,31,1,1
47919,49162,53,41472,53,183,94,89,2,30,1,1
47920,49220,53,32308,53,755,94,661,2,30,1,1
47921,50072,53,26115,53,164,86,78,2,30,1,1
47922,44511,53,15897,53,199,94,105,2,30,1,1
47923,45872,53,25002,53,199,94,105,2,30,1,1
47924,65165,53,53498,53,200,102,98,2,30,1,1
47925,64414,53,3637,53,193,102,91,2,30,1,1
47926,57978,80,62070,80,4402,2878,1524,29,105,15,14
47927,39802,443,21011,443,3025,1958,1067,26,49,14,12
47928,23824,80,23824,80,24232,4550,19682,59,17,34,25
47929,55632,45682,28003,45682,70,70,0,2,8,2,0
47930,50516,443,44017,443,1575,771,804,16,47,9,7
47931,56622,443,50835,443,8302,3583,4719,24,17,14,10
47932,42446,123,14987,123,184,94,90,2,30,1,1
47933,63765,3389,63765,3389,3444,1730,1714,16,33,8,8
47934,47180,443,38596,443,6007,1727,4280,27,1128,15,12
47935,65304,53,61262,53,209,110,99,2,30,1,1
47936,7003,53,7003,53,229,90,139,2,30,1,1
47937,49265,53,37179,53,181,94,87,2,30,1,1
47938,56616,53,21461,53,183,94,89,2,30,1,1
47939,49850,53,15104,53,166,86,80,2,30,1,1
47940,49156,53,27997,53,304,118,186,2,30,1,1
47941,56106,53,18399,53,193,102,91,2,30,1,1
47942,4025,53,4025,53,230,90,140,2,30,1,1
47943,57275,53,22434,53,193,102,91,2,30,1,1
47944,53122,29070,40660,29070,758,320,438,11,16,6,5
47945,51838,29448,55370,29448,70,70,0,2,7,2,0
47946,55634,58846,18331,58846,70,70,0,2,8,2,0
47947,55624,80,56586,80,70,70,0,1,5,1,0
47948,51459,443,53569,443,202,70,132,3,11,1,2
47949,60897,443,29377,443,10706,1679,9027,27,46,15,12
47950,64074,53,19017,53,209,110,99,2,30,1,1
47951,65241,53,1849,53,198,102,96,2,30,1,1
47952,65216,53,15859,53,994,86,908,2,30,1,1
47953,50034,53,20576,53,179,94,85,2,30,1,1
47954,49337,53,49651,53,199,102,97,2,30,1,1
47955,64820,53,31810,53,195,102,93,2,30,1,1
47956,5773,53,5773,53,229,90,139,2,30,1,1
47957,49840,53,48921,53,277,102,175,2,30,1,1
47958,64137,53,61015,53,216,102,114,2,30,1,1
47959,49676,53,9085,53,200,94,106,2,30,1,1
47960,55786,53,42852,53,200,102,98,2,30,1,1
47961,14694,53,14694,53,230,90,140,2,30,1,1
47962,50257,53,13525,53,199,102,97,2,30,1,1
47963,49843,53,43292,53,193,102,91,2,30,1,1
47964,55955,53,53026,53,184,94,90,2,30,1,1
47965,56536,53,49265,53,209,110,99,2,30,1,1
47966,27005,33058,7981,33058,884,126,758,2,31,1,1
47967,57470,51413,27069,51413,807,275,532,4,1200,2,2
47968,50584,9045,4330,9045,166,166,0,1,1200,1,0
47969,57470,8999,29205,8999,863,363,500,4,1200,2,2
47970,57470,45340,41159,45340,527,166,361,2,1200,1,1
47971,57202,53,28601,53,184,94,90,2,30,1,1
47972,56409,53,35272,53,199,102,97,2,30,1,1
47973,56536,53,3128,53,209,110,99,2,31,1,1
47974,64719,53,44200,53,196,102,94,2,31,1,1
47975,65165,53,58294,53,200,102,98,2,31,1,1
47976,57275,53,13596,53,193,102,91,2,31,1,1
47977,27005,30008,41191,30008,881,126,755,2,31,1,1
47978,57494,443,51749,443,2435128,54736,2380392,2151,346,331,1820
47979,57470,6887,18117,6887,471,269,202,4,1199,2,2
47980,57470,44573,53035,44573,883,288,595,4,1200,2,2
47981,57470,65534,12773,65534,773,271,502,4,1200,2,2
47982,64461,53,47213,53,177,94,83,2,31,1,1
47983,57296,53,45722,53,200,102,98,2,30,1,1
47984,56086,53,3627,53,172,94,78,2,30,1,1
47985,57275,53,15169,53,193,102,91,2,30,1,1
47986,64917,53,1366,53,243,94,149,2,30,1,1
47987,56409,53,61903,53,199,102,97,2,31,1,1
47988,55192,53,55863,53,178,94,84,2,30,1,1
47989,64414,53,29559,53,193,102,91,2,31,1,1
47990,57150,53,61382,53,166,86,80,2,31,1,1
47991,64390,53,22708,53,225,110,115,2,30,1,1
47992,65487,53,64939,53,184,94,90,2,31,1,1
47993,32897,443,57512,443,3166,936,2230,18,120,9,9
47994,65074,443,20920,443,7584,7094,490,14,124,7,7
47995,50584,63015,51175,63015,166,166,0,1,1200,1,0
47996,57470,32517,51554,32517,166,166,0,1,1199,1,0
47997,50584,12899,63307,12899,166,166,0,1,1200,1,0
47998,50584,6889,59579,6889,161,161,0,2,1200,2,0
47999,57470,51413,6363,51413,493,166,327,2,1200,1,1
48000,50584,61867,27152,61867,166,166,0,1,1200,1,0
48001,57470,6881,5972,6881,755,275,480,4,1200,2,2
48002,57470,34590,16143,34590,527,166,361,2,1200,1,1
48003,57470,46487,30671,46487,527,166,361,2,1200,1,1
48004,27005,27015,8192,27015,912,126,786,2,31,1,1
48005,27005,33056,59284,33056,885,126,759,2,31,1,1
48006,54680,443,15778,443,1786,172,1614,7,120,3,4
48007,57470,46941,64707,46941,899,288,611,4,1199,2,2
48008,57470,11696,14471,11696,353,166,187,2,1199,1,1
48009,57470,51413,16094,51413,700,275,425,4,1200,2,2
48010,50584,28387,54140,28387,161,161,0,2,1200,2,0
48011,44847,51572,8318,51572,509,150,359,2,1200,1,1
48012,57470,6881,62748,6881,525,166,359,2,1200,1,1
48013,57470,43576,31912,43576,545,166,379,2,1200,1,1
48014,39338,443,58557,443,4362,1145,3217,17,26,9,8
48015,54830,443,23517,443,4478,1133,3345,13,26,8,5
48016,50384,443,12155,443,6147,911,5236,18,16,10,8
48017,27005,27015,19164,27015,871,126,745,2,31,1,1
48018,56308,443,13053,443,1622,1137,485,11,26,7,4
48019,56352,80,27612,80,1258,752,506,13,16,7,6
48020,56704,53,10036,53,194,102,92,2,31,1,1
48021,41439,443,30443,443,4370,1148,3222,17,26,9,8
48022,39337,443,52807,443,4362,1145,3217,17,26,9,8
48023,56342,443,42448,443,1463,988,475,12,27,7,5
48024,18767,35440,0,0,146,146,0,1,0,1,0
48025,59896,445,0,0,70,70,0,1,0,1,0
48026,59892,445,0,0,70,70,0,1,0,1,0
48027,59891,445,0,0,70,70,0,1,0,1,0
48028,64990,55442,0,0,66,66,0,1,0,1,0
48029,48640,47993,0,0,145,145,0,1,0,1,0
48030,39548,8696,0,0,60,60,0,1,0,1,0
48031,54938,445,0,0,70,70,0,1,0,1,0
48032,55272,445,0,0,66,66,0,1,0,1,0
48033,55274,445,0,0,66,66,0,1,0,1,0
48034,55271,445,0,0,66,66,0,1,0,1,0
48035,63194,50265,0,0,66,66,0,1,0,1,0
48036,48676,53392,0,0,60,60,0,1,0,1,0
48037,46670,51505,0,0,62,62,0,1,0,1,0
48038,52860,9694,0,0,146,146,0,1,0,1,0
48039,59890,445,0,0,70,70,0,1,0,1,0
48040,46362,35440,0,0,66,66,0,1,0,1,0
48041,52150,39109,0,0,66,66,0,1,0,1,0
48042,59887,445,0,0,70,70,0,1,0,1,0
48043,51525,35440,0,0,66,66,0,1,0,1,0
48044,38723,37838,0,0,146,146,0,1,0,1,0
48045,2876,35440,0,0,62,62,0,1,0,1,0
48046,2394,43890,0,0,62,62,0,1,0,1,0
48047,59883,445,0,0,70,70,0,1,0,1,0
48048,59882,445,0,0,70,70,0,1,0,1,0
48049,59884,445,0,0,70,70,0,1,0,1,0
48050,49197,30188,0,0,146,146,0,1,0,1,0
48051,61223,37965,0,0,62,62,0,1,0,1,0
48052,4427,50584,0,0,62,62,0,1,0,1,0
48053,46740,55108,0,0,148,148,0,1,0,1,0
48054,27679,37965,0,0,62,62,0,1,0,1,0
48055,64283,37965,0,0,74,74,0,1,0,1,0
48056,54925,445,0,0,70,70,0,1,0,1,0
48057,27641,39004,0,0,62,62,0,1,0,1,0
48058,59430,50584,0,0,66,66,0,1,0,1,0
48059,54922,445,0,0,70,70,0,1,0,1,0
48060,60312,57470,0,0,74,74,0,1,0,1,0
48061,58497,39004,0,0,66,66,0,1,0,1,0
48062,59868,445,0,0,70,70,0,1,0,1,0
48063,59867,445,0,0,70,70,0,1,0,1,0
48064,59864,445,0,0,70,70,0,1,0,1,0
48065,62725,51221,0,0,66,66,0,1,0,1,0
48066,30610,41615,0,0,145,145,0,1,0,1,0
48067,54918,445,0,0,70,70,0,1,0,1,0
48068,443,62451,0,0,199,199,0,1,0,1,0
48069,54916,445,0,0,70,70,0,1,0,1,0
48070,42798,26467,0,0,62,62,0,1,0,1,0
48071,6881,6881,0,0,62,62,0,1,0,1,0
48072,54914,445,0,0,70,70,0,1,0,1,0
48073,55249,445,0,0,66,66,0,1,0,1,0
48074,59861,445,0,0,70,70,0,1,0,1,0
48075,59862,445,0,0,70,70,0,1,0,1,0
48076,1790,48817,0,0,66,66,0,1,0,1,0
48077,13970,42873,0,0,66,66,0,1,0,1,0
48078,53840,443,34687,443,499,425,74,4,0,3,1
48079,53847,443,28382,443,499,425,74,4,0,3,1
48080,53841,443,33528,443,499,425,74,4,0,3,1
48081,11344,42873,0,0,62,62,0,1,0,1,0
48082,18713,40108,0,0,146,146,0,1,0,1,0
48083,6060,15503,0,0,146,146,0,1,0,1,0
48084,54907,445,0,0,70,70,0,1,0,1,0
48085,55246,445,0,0,66,66,0,1,0,1,0
48086,55396,26467,0,0,62,62,0,1,0,1,0
48087,53843,443,32315,443,499,425,74,4,0,3,1
48088,53844,443,56188,443,499,425,74,4,0,3,1
48089,53845,443,42345,443,499,425,74,4,0,3,1
48090,53846,443,62098,443,499,425,74,4,0,3,1
48091,53842,443,26608,443,499,425,74,4,0,3,1
48092,53839,443,31646,443,499,425,74,4,0,3,1
48093,53837,443,2999,443,499,425,74,4,0,3,1
48094,53836,443,61812,443,499,425,74,4,0,3,1
48095,53834,443,62616,443,499,425,74,4,0,3,1
48096,53838,443,50005,443,499,425,74,4,0,3,1
48097,53831,443,39132,443,499,425,74,4,0,3,1
48098,53832,443,1159,443,499,425,74,4,0,3,1
48099,54905,445,0,0,70,70,0,1,0,1,0
48100,55242,445,0,0,66,66,0,1,0,1,0
48101,43916,21,0,0,60,60,0,1,0,1,0
48102,59847,445,0,0,70,70,0,1,0,1,0
48103,42459,22114,0,0,62,62,0,1,0,1,0
48104,59844,445,0,0,70,70,0,1,0,1,0
48105,53829,443,25937,443,499,425,74,4,0,3,1
48106,53835,443,32854,443,499,425,74,4,0,3,1
48107,53823,443,24155,443,499,425,74,4,0,3,1
48108,53827,443,32061,443,499,425,74,4,0,3,1
48109,53830,443,40467,443,499,425,74,4,0,3,1
48110,53826,443,31854,443,499,425,74,4,0,3,1
48111,53825,443,49613,443,499,425,74,4,0,3,1
48112,53833,443,61114,443,499,425,74,4,0,3,1
48113,53822,443,12016,443,499,425,74,4,0,3,1
48114,53828,443,58283,443,499,425,74,4,0,3,1
48115,53824,443,33513,443,499,425,74,4,0,3,1
48116,53821,443,22487,443,499,425,74,4,0,3,1
48117,59845,445,0,0,70,70,0,1,0,1,0
48118,59843,445,0,0,70,70,0,1,0,1,0
48119,34129,19410,0,0,60,60,0,1,0,1,0
48120,54904,445,0,0,70,70,0,1,0,1,0
48121,55238,445,0,0,66,66,0,1,0,1,0
48122,9865,15503,0,0,146,146,0,1,0,1,0
48123,54903,445,0,0,70,70,0,1,0,1,0
48124,54902,445,0,0,70,70,0,1,0,1,0
48125,2077,45850,0,0,145,145,0,1,0,1,0
48126,58213,37807,0,0,66,66,0,1,0,1,0
48127,54897,445,0,0,70,70,0,1,0,1,0
48128,54896,445,0,0,70,70,0,1,0,1,0
48129,60152,26467,0,0,62,62,0,1,0,1,0
48130,44849,46478,0,0,74,74,0,1,0,1,0
48131,59834,445,0,0,70,70,0,1,0,1,0
48132,59832,445,0,0,70,70,0,1,0,1,0
48133,59828,445,0,0,70,70,0,1,0,1,0
48134,59830,445,0,0,70,70,0,1,0,1,0
48135,54884,445,0,0,70,70,0,1,0,1,0
48136,54883,445,0,0,70,70,0,1,0,1,0
48137,54880,445,0,0,70,70,0,1,0,1,0
48138,55233,445,0,0,66,66,0,1,0,1,0
48139,54874,445,0,0,70,70,0,1,0,1,0
48140,54873,445,0,0,70,70,0,1,0,1,0
48141,55675,53,17939,53,190,97,93,2,0,1,1
48142,48629,63131,0,0,74,74,0,1,0,1,0
48143,18650,23718,0,0,62,62,0,1,0,1,0
48144,55225,445,0,0,66,66,0,1,0,1,0
48145,55228,445,0,0,66,66,0,1,0,1,0
48146,55229,445,0,0,66,66,0,1,0,1,0
48147,50914,51505,0,0,66,66,0,1,0,1,0
48148,55222,445,0,0,66,66,0,1,0,1,0
48149,55223,445,0,0,66,66,0,1,0,1,0
48150,55221,445,0,0,66,66,0,1,0,1,0
48151,48388,44847,0,0,146,146,0,1,0,1,0
48152,64880,9694,0,0,66,66,0,1,0,1,0
48153,14924,44847,0,0,66,66,0,1,0,1,0
48154,0,0,0,0,110,110,0,1,0,1,0
48155,0,0,0,0,98,98,0,1,0,1,0
48156,0,0,0,0,480,244,236,4,0,2,2
48157,18203,23,0,0,60,60,0,1,0,1,0
48158,13285,29892,0,0,145,145,0,1,0,1,0
48159,38723,15503,0,0,146,146,0,1,0,1,0
48160,59824,445,0,0,70,70,0,1,0,1,0
48161,59822,445,0,0,70,70,0,1,0,1,0
48162,59820,445,0,0,70,70,0,1,0,1,0
48163,54636,26467,0,0,66,66,0,1,0,1,0
48164,44208,26467,0,0,62,62,0,1,0,1,0
48165,55217,445,0,0,66,66,0,1,0,1,0
48166,38383,51221,0,0,66,66,0,1,0,1,0
48167,19204,41864,0,0,159,159,0,1,0,1,0
48168,34146,51221,0,0,62,62,0,1,0,1,0
48169,59819,445,0,0,70,70,0,1,0,1,0
48170,54862,445,0,0,70,70,0,1,0,1,0
48171,57633,50584,0,0,62,62,0,1,0,1,0
48172,55215,445,0,0,66,66,0,1,0,1,0
48173,55213,445,0,0,66,66,0,1,0,1,0
48174,55211,445,0,0,66,66,0,1,0,1,0
48175,64387,37965,0,0,66,66,0,1,0,1,0
48176,55210,445,0,0,66,66,0,1,0,1,0
48177,59994,11446,0,0,66,66,0,1,0,1,0
48178,50095,30188,0,0,66,66,0,1,0,1,0
48179,46495,4607,0,0,60,60,0,1,0,1,0
48180,10354,81,0,0,60,60,0,1,0,1,0
48181,53833,26467,0,0,62,62,0,1,0,1,0
48182,54854,19847,0,0,66,66,0,1,0,1,0
48183,54858,445,0,0,70,70,0,1,0,1,0
48184,45941,23388,0,0,60,60,0,1,0,1,0
48185,48706,23393,0,0,60,60,0,1,0,1,0
48186,3911,50584,0,0,62,62,0,1,0,1,0
48187,59813,445,0,0,70,70,0,1,0,1,0
48188,22367,50584,0,0,146,146,0,1,0,1,0
48189,59807,445,0,0,70,70,0,1,0,1,0
48190,59802,445,0,0,70,70,0,1,0,1,0
48191,50052,65008,0,0,60,60,0,1,0,1,0
48192,54849,445,0,0,70,70,0,1,0,1,0
48193,54848,445,0,0,70,70,0,1,0,1,0
48194,54844,445,0,0,70,70,0,1,0,1,0
48195,54846,445,0,0,70,70,0,1,0,1,0
48196,49229,6921,0,0,145,145,0,1,0,1,0
48197,54841,445,0,0,70,70,0,1,0,1,0
48198,55199,445,0,0,66,66,0,1,0,1,0
48199,55145,11392,0,0,66,66,0,1,0,1,0
48200,11859,64147,0,0,62,62,0,1,0,1,0
48201,14252,35993,0,0,66,66,0,1,0,1,0
48202,27005,12345,54236,12345,898,126,772,2,30,1,1
48203,55192,53,45038,53,172,88,84,2,30,1,1
48204,11295,40033,39520,40033,213,89,124,4,49,2,2
48205,39983,80,29072,80,1614,1300,314,10,16,5,5
48206,50329,443,35211,443,12026,3494,8532,28,82,14,14
48207,51818,43942,60184,43942,156,66,90,2,5,1,1
48208,5588,5588,0,0,3354,1792,1562,46,192,23,23
48209,50759,53,62224,53,578,286,292,9,16,5,4
48210,37842,443,37842,443,109189,6692,102497,151,80,69,82
48211,55311,53,55274,53,298,101,197,4,31,2,2
48212,46404,53,46404,53,237,91,146,2,32,1,1
48213,65446,53,45033,53,204,104,100,2,30,1,1
48214,64461,53,10856,53,170,87,83,2,30,1,1
48215,64414,53,6612,53,186,95,91,2,30,1,1
48216,56788,53,36118,53,198,101,97,2,30,1,1
48217,38160,443,38160,443,11290,5394,5896,37,80,21,16
48218,45939,443,45939,443,4504,1597,2907,19,27,11,8
48219,37234,443,63563,443,1622,1137,485,11,26,7,4
48220,63807,38976,41497,38976,66,66,0,1,5,1,0
48221,49296,443,51414,443,7419,2173,5246,17,16,9,8
48222,51832,40607,46819,40607,70,70,0,2,7,2,0
48223,39582,80,57536,80,1614,1300,314,10,15,5,5
48224,33960,22,33960,22,5468,1991,3477,27,34,15,12
48225,64882,53,2357,53,176,90,86,2,30,1,1
48226,17018,53,17018,53,217,87,130,2,30,1,1
48227,50277,80,19151,80,12764,7749,5015,28,84,14,14
48228,54371,443,18994,443,11828,2811,9017,31,76,16,15
48229,50317,80,56458,80,3800,2776,1024,16,83,9,7
48230,49962,53,19275,53,184,94,90,2,31,1,1
48231,36236,443,36236,443,4625,1718,2907,19,31,11,8
48232,63809,45193,55077,45193,66,66,0,1,5,1,0
48233,49749,53,61513,53,200,102,98,2,30,1,1
48234,54370,443,2250,443,11876,2769,9107,30,76,15,15
48235,37977,443,37977,443,5763,2553,3210,24,80,14,10
48236,54124,80,4965,80,1594,1280,314,10,15,5,5
48237,51842,27665,50059,27665,70,70,0,1,5,1,0
48238,55810,53,12633,53,182,93,89,2,30,1,1
48239,59134,80,59134,80,104133,2163,101970,103,15,32,71
48240,38888,22,38888,22,5130,2103,3027,28,25,16,12
48241,56978,53,58165,53,774,101,673,2,30,1,1
48242,57202,53,47171,53,184,94,90,2,30,1,1
48243,55171,53,21824,53,198,101,97,2,31,1,1
48244,55788,53,13740,53,755,93,662,2,31,1,1
48245,64128,53,11418,53,186,95,91,2,31,1,1
48246,54356,80,42803,80,9608,746,8862,19,82,9,10
48247,54372,443,7862,443,11828,2811,9017,31,76,16,15
48248,32846,80,52606,80,1644,1324,320,10,15,5,5
48249,50316,80,40877,80,2062,872,1190,13,83,7,6
48250,18907,53,18907,53,237,91,146,2,32,1,1
48251,59298,443,18109,443,20971,2840,18131,52,89,24,28
48252,58077,36653,53473,36653,204,64,140,4,11,2,2
48253,50330,443,24584,443,9585,2138,7447,26,82,13,13
48254,53625,39198,33493,39198,552,306,246,9,16,5,4
48255,55095,53,24827,53,188,96,92,2,30,1,1
48256,27005,37569,49792,37569,892,126,766,2,30,1,1
48257,55042,53,54765,53,782,105,677,2,30,1,1
48258,65117,53,5041,53,196,100,96,2,31,1,1
48259,13257,53,13257,53,227,88,139,2,31,1,1
48260,27005,23333,15007,23333,890,126,764,2,30,1,1
48261,64719,53,59437,53,192,98,94,2,30,1,1
48262,65487,53,21256,53,184,94,90,2,30,1,1
48263,57150,53,55226,53,164,84,80,2,30,1,1
48264,55997,53,30863,53,716,95,621,2,30,1,1
48265,49263,53,22784,53,172,88,84,2,31,1,1
48266,60914,53,60914,53,220,100,120,2,31,1,1
48267,64266,53,49573,53,168,86,82,2,31,1,1
48268,57470,22070,58715,22070,559,198,361,5,1200,4,1
48269,56455,53,48314,53,182,93,89,2,31,1,1
48270,64538,53,28152,53,188,96,92,2,31,1,1
48271,57406,53,60835,53,188,96,92,2,30,1,1
48272,64169,53,10688,53,202,103,99,2,30,1,1
48273,56846,53,23614,53,192,98,94,2,31,1,1
48274,56837,53,43966,53,176,90,86,2,31,1,1
48275,55271,53,11109,53,168,86,82,2,31,1,1
48276,63964,53,46604,53,190,97,93,2,31,1,1
48277,64482,53,10257,53,192,98,94,2,31,1,1
48278,54976,443,15305,443,10335,2317,8018,24,188,13,11
48279,33967,80,35208,80,1836,662,1174,15,3826,6,9
48280,49317,53,61249,53,164,84,80,2,31,1,1
48281,27005,30010,6041,30010,887,126,761,2,31,1,1
48282,55066,53,18793,53,176,90,86,2,31,1,1
48283,39392,80,20430,80,1325,442,883,16,414,4,12
48284,56945,53,27105,53,176,90,86,2,31,1,1
48285,64695,53,9580,53,186,95,91,2,31,1,1
48286,54800,443,18015,443,18814,10011,8803,42,129,21,21
48287,57470,34879,21991,34879,1914,1914,0,30,1766,30,0
48288,35461,5228,26150,5228,8648,2111,6537,40,7038,21,19
48289,55191,445,0,0,66,66,0,1,0,1,0
48290,59792,445,0,0,70,70,0,1,0,1,0
48291,19698,502,0,0,60,60,0,1,0,1,0
48292,53043,51050,0,0,66,66,0,1,0,1,0
48293,46576,23718,0,0,62,62,0,1,0,1,0
48294,32768,22,0,0,60,60,0,1,0,1,0
48295,54836,445,0,0,70,70,0,1,0,1,0
48296,58343,23718,0,0,66,66,0,1,0,1,0
48297,55188,445,0,0,66,66,0,1,0,1,0
48298,58564,50432,0,0,66,66,0,1,0,1,0
48299,443,62451,0,0,199,199,0,1,0,1,0
48300,60970,20541,0,0,66,66,0,1,0,1,0
48301,37428,53,37182,53,168,78,90,2,30,1,1
48302,64169,53,8733,53,209,110,99,2,30,1,1
48303,49431,53,43013,53,194,102,92,2,30,1,1
48304,65331,53,36726,53,193,102,91,2,30,1,1
48305,45472,8168,0,0,62,62,0,1,0,1,0
48306,54828,445,0,0,70,70,0,1,0,1,0
48307,55182,445,0,0,66,66,0,1,0,1,0
48308,54827,445,0,0,70,70,0,1,0,1,0
48309,55174,445,0,0,66,66,0,1,0,1,0
48310,34731,22114,0,0,62,62,0,1,0,1,0
48311,52526,30188,0,0,66,66,0,1,0,1,0
48312,55075,8080,0,0,60,60,0,1,0,1,0
48313,43111,8080,0,0,60,60,0,1,0,1,0
48314,54822,445,0,0,70,70,0,1,0,1,0
48315,48929,62609,0,0,148,148,0,1,0,1,0
48316,54820,445,0,0,70,70,0,1,0,1,0
48317,4772,37965,0,0,66,66,0,1,0,1,0
48318,59782,445,0,0,70,70,0,1,0,1,0
48319,59779,445,0,0,70,70,0,1,0,1,0
48320,59780,445,0,0,70,70,0,1,0,1,0
48321,3117,37965,0,0,62,62,0,1,0,1,0
48322,59505,53733,0,0,62,62,0,1,0,1,0
48323,55163,445,0,0,66,66,0,1,0,1,0
48324,55164,445,0,0,66,66,0,1,0,1,0
48325,55162,445,0,0,66,66,0,1,0,1,0
48326,55166,445,0,0,66,66,0,1,0,1,0
48327,55165,445,0,0,66,66,0,1,0,1,0
48328,55159,445,0,0,66,66,0,1,0,1,0
48329,55158,445,0,0,66,66,0,1,0,1,0
48330,55161,445,0,0,66,66,0,1,0,1,0
48331,39548,8696,0,0,60,60,0,1,0,1,0
48332,54816,445,0,0,70,70,0,1,0,1,0
48333,52887,37807,0,0,62,62,0,1,0,1,0
48334,54815,445,0,0,70,70,0,1,0,1,0
48335,62566,35993,0,0,62,62,0,1,0,1,0
48336,6889,25975,0,0,143,143,0,1,0,1,0
48337,10216,11392,0,0,66,66,0,1,0,1,0
48338,51620,56205,0,0,66,66,0,1,0,1,0
48339,53453,2767,0,0,62,62,0,1,0,1,0
48340,1694,30188,0,0,62,62,0,1,0,1,0
48341,59770,445,0,0,70,70,0,1,0,1,0
48342,59765,445,0,0,70,70,0,1,0,1,0
48343,59763,445,0,0,70,70,0,1,0,1,0
48344,54810,445,0,0,70,70,0,1,0,1,0
48345,36943,10387,0,0,159,159,0,1,0,1,0
48346,55146,445,0,0,66,66,0,1,0,1,0
48347,50140,53,17472,53,209,110,99,2,30,1,1
48348,56536,53,64182,53,209,110,99,2,30,1,1
48349,49812,53,11228,53,166,86,80,2,30,1,1
48350,47866,53,1378,53,199,94,105,2,30,1,1
48351,65085,53,47896,53,196,94,102,2,30,1,1
48352,49843,53,21434,53,193,102,91,2,30,1,1
48353,65100,53,65386,53,720,94,626,2,30,1,1
48354,52319,443,62232,443,569666,25343,544323,721,46,320,401
48355,38701,443,3001,443,4478,1133,3345,13,27,8,5
48356,56312,443,54503,443,564,292,272,9,25,5,4
48357,52406,443,12118,443,11463,850,10613,23,25,7,16
48358,49662,443,52708,443,4353,1145,3208,17,25,9,8
48359,51439,443,29374,443,396,66,330,7,17,2,5
48360,54361,443,48340,443,12268,2979,9289,35,81,18,17
48361,52501,80,52501,80,79714,5592,74122,102,23,45,57
48362,54369,443,44287,443,11876,2769,9107,30,77,15,15
48363,49663,443,36491,443,4271,1075,3196,16,25,8,8
48364,52931,80,5991,80,234,234,0,4,11,4,0
48365,53123,59228,59037,59228,70,70,0,1,4,1,0
48366,50278,443,46463,443,6466,2862,3604,21,163,11,10
48367,50473,80,6625,80,1658,1247,411,8,15,5,3
48368,41440,443,30380,443,4370,1148,3222,17,25,9,8
48369,42557,443,48761,443,123082,8734,114348,200,84,101,99
48370,38700,443,59895,443,4478,1133,3345,13,27,8,5
48371,38406,443,5076,443,564,292,272,9,26,5,4
48372,50277,443,12688,443,3937,1191,2746,20,163,9,11
48373,56086,53,3323,53,172,94,78,2,29,1,1
48374,57202,53,54278,53,293,94,199,4,43,2,2
48375,55095,53,63653,53,194,102,92,2,29,1,1
48376,65487,53,58054,53,184,94,90,2,29,1,1
48377,55810,53,35208,53,183,94,89,2,29,1,1
48378,64559,53,60231,53,258,110,148,2,29,1,1
48379,58850,53,58850,53,231,90,141,2,29,1,1
48380,57150,53,42037,53,166,86,80,2,29,1,1
48381,49667,443,61228,443,334,140,194,6,25,3,3
48382,65446,53,26325,53,210,110,100,2,30,1,1
48383,56322,53,21211,53,166,86,80,2,29,1,1
48384,55786,53,41972,53,200,102,98,2,29,1,1
48385,49379,53,28766,53,199,102,97,2,30,1,1
48386,55627,53,60150,53,193,102,91,2,30,1,1
48387,57109,53,6255,53,168,86,82,2,30,1,1
48388,57120,443,27868,443,23906,9380,14526,40,16,24,16
48389,53631,43562,1567,43562,492,306,186,8,15,5,3
48390,51830,32787,47434,32787,70,70,0,2,6,2,0
48391,64942,53,20482,53,215,94,121,2,30,1,1
48392,57406,53,49515,53,194,102,92,2,30,1,1
48393,49749,53,60642,53,200,102,98,2,30,1,1
48394,54995,53,57538,53,199,102,97,2,30,1,1
48395,64461,53,2582,53,177,94,83,2,30,1,1
48396,39872,53,48299,53,78,78,0,1,30,1,0
48397,49962,53,48309,53,184,94,90,2,30,1,1
48398,57292,53,58837,53,395,102,293,2,30,1,1
48399,47136,53,53463,53,222,78,144,2,30,1,1
48400,56619,443,13998,443,6895,2273,4622,21,17,12,9
48401,55171,53,40871,53,199,102,97,2,30,1,1
48402,46848,80,53629,80,25162,23336,1826,34,19,21,13
48403,55271,53,6211,53,168,86,82,2,30,1,1
48404,46509,53,4834,53,168,78,90,2,30,1,1
48405,50468,80,2157,80,314,192,122,6,28,4,2
48406,57406,53,10288,53,194,102,92,2,30,1,1
48407,36042,53,8305,53,168,78,90,2,30,1,1
48408,51918,443,34743,443,28031,11553,16478,122,108,61,61
48409,51954,443,51642,443,2995,1894,1101,20,46,11,9
48410,49761,53,14047,53,183,94,89,2,30,1,1
48411,60340,80,29761,80,9406,1913,7493,14,16,7,7
48412,49006,443,37569,443,119425284,929428,118495856,93687,498,9675,84012
48413,65446,53,21925,53,210,110,100,2,30,1,1
48414,38576,443,38576,443,225915,9896,216019,283,80,128,155
48415,64719,53,8538,53,381,98,283,4,51,2,2
48416,64169,53,20022,53,209,110,99,2,30,1,1
48417,21082,53,21082,53,226,90,136,2,30,1,1
48418,54427,53,16738,53,199,94,105,2,30,1,1
48419,64559,53,43720,53,168,86,82,2,30,1,1
48420,54429,443,55314,443,9970,3706,6264,44,272,21,23
48421,49171,53,3246,53,199,102,97,2,30,1,1
48422,49654,53,49736,53,184,94,90,2,30,1,1
48423,56455,53,58599,53,183,94,89,2,30,1,1
48424,50290,53,2460,53,211,110,101,2,30,1,1
48425,55627,53,4823,53,193,102,91,2,30,1,1
48426,50321,443,43498,443,8156,1586,6570,24,82,11,13
48427,51833,47388,26582,47388,70,70,0,2,6,2,0
48428,49761,53,31558,53,183,94,89,2,30,1,1
48429,49654,53,26382,53,184,94,90,2,30,1,1
48430,46734,53,39721,53,168,78,90,2,30,1,1
48431,55849,53,3530,53,889,404,485,10,30,5,5
48432,56788,53,30869,53,199,102,97,2,30,1,1
48433,55935,53,36129,53,819,102,717,2,30,1,1
48434,55967,53,30635,53,209,110,99,2,30,1,1
48435,49787,53,35169,53,193,102,91,2,30,1,1
48436,56822,39352,35185,39352,70,70,0,1,5,1,0
48437,49475,53,56421,53,196,102,94,2,30,1,1
48438,56113,53,57844,53,194,102,92,2,30,1,1
48439,55935,53,44322,53,196,102,94,2,30,1,1
48440,65482,53,43448,53,179,94,85,2,30,1,1
48441,63964,53,35341,53,195,102,93,2,30,1,1
48442,56788,53,1582,53,199,102,97,2,30,1,1
48443,55192,53,17598,53,178,94,84,2,30,1,1
48444,65122,53,25897,53,410,110,300,2,30,1,1
48445,64904,53,63887,53,199,102,97,2,30,1,1
48446,64396,53,1161,53,211,102,109,2,30,1,1
48447,52320,443,52845,443,65770,4466,61304,94,46,44,50
48448,51691,993,8747,993,17462,4583,12879,93,19,47,46
48449,14433,443,47619,443,2589,1443,1146,18,15,8,10
48450,51689,993,61833,993,11580,4032,7548,79,19,40,39
48451,52191,443,40696,443,7018,1766,5252,23,19,13,10
48452,35610,80,8611,80,1970,977,993,12,61,7,5
48453,32729,3389,32729,3389,4021,1916,2105,20,18,12,8
48454,60720,443,36383,443,41921,15385,26536,69,34,37,32
48455,34613,80,39992,80,1013,504,509,10,17,6,4
48456,61694,443,25571,443,8696,3245,5451,36,47,16,20
48457,38672,443,23620,443,4478,1133,3345,13,35,8,5
48458,56614,443,7546,443,20451,1899,18552,33,17,14,19
48459,53621,443,63130,443,2005,1100,905,16,17,9,7
48460,61689,443,8639,443,8036,3293,4743,32,48,18,14
48461,22,37469,22,37469,178,118,60,2,4,1,1
48462,39336,443,13653,443,4362,1145,3217,17,25,9,8
48463,51828,11916,54336,11916,316,136,180,6,6,3,3
48464,53590,8999,22601,8999,1207,605,602,10,25,5,5
48465,55730,8060,62180,8060,70,70,0,2,7,2,0
48466,39340,443,15093,443,334,140,194,6,25,3,3
48467,38807,443,38807,443,5741,2532,3209,24,80,14,10
48468,28007,443,65025,443,10168,968,9200,19,15,9,10
48469,50319,443,50669,443,9933,2306,7627,27,82,13,14
48470,38573,443,38573,443,5744,2534,3210,24,80,14,10
48471,54959,53,54959,53,230,90,140,2,29,1,1
48472,50337,443,21907,443,9653,1740,7913,23,81,12,11
48473,64904,53,57832,53,199,102,97,2,29,1,1
48474,60761,53,45233,53,198,86,112,2,29,1,1
48475,56677,53,50989,53,286,103,183,4,49,2,2
48476,57202,53,37225,53,184,94,90,2,29,1,1
48477,55810,53,11576,53,183,94,89,2,29,1,1
48478,56655,53,57319,53,209,110,99,2,29,1,1
48479,49171,53,6707,53,199,102,97,2,30,1,1
48480,57346,53,18432,53,210,110,100,2,29,1,1
48481,50257,53,50801,53,199,102,97,2,29,1,1
48482,57096,53,11827,53,198,102,96,2,30,1,1
48483,123,123,8340,123,184,94,90,2,29,1,1
48484,49962,53,28111,53,184,94,90,2,30,1,1
48485,57072,53,14779,53,195,102,93,2,30,1,1
48486,57296,53,58059,53,200,102,98,2,29,1,1
48487,49265,53,28768,53,181,94,87,2,29,1,1
48488,56455,53,12391,53,183,94,89,2,30,1,1
48489,65229,53,24708,53,195,102,93,2,30,1,1
48490,50140,53,26490,53,209,110,99,2,30,1,1
48491,57296,53,48552,53,200,102,98,2,30,1,1
48492,65331,53,63156,53,816,102,714,2,30,1,1
48493,57096,53,39504,53,198,102,96,2,30,1,1
48494,55967,53,41577,53,209,110,99,2,30,1,1
48495,50629,53,6662,53,756,94,662,2,30,1,1
48496,64882,53,14352,53,180,94,86,2,30,1,1
48497,65342,53,59254,53,183,94,89,2,30,1,1
48498,56846,53,43478,53,196,102,94,2,30,1,1
48499,57095,53,22428,53,211,110,101,2,30,1,1
48500,63964,53,34726,53,195,102,93,2,30,1,1
48501,55066,53,62750,53,180,94,86,2,30,1,1
48502,56846,53,22209,53,196,102,94,2,31,1,1
48503,56907,53,11065,53,193,102,91,2,31,1,1
48504,57470,6890,10619,6890,520,166,354,2,1199,1,1
48505,32768,53,4546,53,86,86,0,1,30,1,0
48506,55095,53,40942,53,194,102,92,2,30,1,1
48507,64256,53,29163,53,244,94,150,2,30,1,1
48508,64634,53,16629,53,786,110,676,2,30,1,1
48509,41764,443,65468,443,9028,5092,3936,36,257,12,24
48510,64071,53,55557,53,194,102,92,2,31,1,1
48511,49317,53,16697,53,166,86,80,2,31,1,1
48512,49379,53,24029,53,199,102,97,2,30,1,1
48513,55025,443,34661,443,7654,2110,5544,21,46,13,8
48514,53620,443,60649,443,15422,1623,13799,34,18,14,20
48515,56583,443,5338,443,9416,2366,7050,25,19,14,11
48516,51831,26270,32908,26270,70,70,0,2,6,2,0
48517,8432,23,8432,23,130,66,64,2,5,1,1
48518,34896,53,34896,53,231,90,141,2,30,1,1
48519,65385,53,9523,53,227,110,117,2,30,1,1
48520,57352,53,35059,53,816,102,714,2,30,1,1
48521,56952,53,60759,53,193,102,91,2,30,1,1
48522,64260,53,40725,53,230,86,144,2,30,1,1
48523,49236,53,40534,53,723,102,621,2,30,1,1
48524,49544,53,31008,53,226,86,140,2,30,1,1
48525,64112,53,32226,53,281,94,187,2,30,1,1
48526,55311,53,15716,53,298,101,197,4,31,2,2
48527,55311,53,38927,53,298,101,197,4,31,2,2
48528,64439,53,35218,53,199,102,97,2,31,1,1
48529,55618,53,59211,53,255,102,153,2,30,1,1
48530,50899,80,61517,80,130,70,60,2,15,1,1
48531,51665,443,64553,443,8783,4321,4462,39,94,19,20
48532,49654,53,5508,53,184,94,90,2,30,1,1
48533,56113,53,19299,53,817,102,715,2,30,1,1
48534,57352,53,28583,53,193,102,91,2,30,1,1
48535,56846,53,45229,53,196,102,94,2,30,1,1
48536,23414,53,23414,53,197,90,107,2,30,1,1
48537,49749,53,2042,53,200,102,98,2,30,1,1
48538,49787,53,19694,53,193,102,91,2,30,1,1
48539,55171,53,44438,53,199,102,97,2,30,1,1
48540,56788,53,32214,53,199,102,97,2,30,1,1
48541,55050,443,45507,443,1480,1029,451,11,151,6,5
48542,55311,53,61632,53,298,101,197,4,31,2,2
48543,50326,443,7479,443,7819,2474,5345,25,82,13,12
48544,49431,53,39469,53,817,102,715,2,30,1,1
48545,49475,53,30283,53,819,102,717,2,30,1,1
48546,54995,53,9641,53,199,102,97,2,30,1,1
48547,59979,443,21635,443,30171,25514,4657,77,37,42,35
48548,54211,53,7944,53,339,94,245,2,30,1,1
48549,50290,53,11389,53,211,110,101,2,30,1,1
48550,65342,53,40557,53,183,94,89,2,30,1,1
48551,64128,53,37051,53,193,102,91,2,30,1,1
48552,65487,53,62444,53,184,94,90,2,30,1,1
48553,64169,53,31527,53,209,110,99,2,30,1,1
48554,56952,53,29584,53,193,102,91,2,30,1,1
48555,49263,53,43703,53,178,94,84,2,30,1,1
48556,56773,53,31138,53,183,94,89,2,30,1,1
48557,65117,53,17216,53,198,102,96,2,30,1,1
48558,56200,53,10019,53,211,110,101,2,30,1,1
48559,64565,53,48582,53,226,110,116,2,30,1,1
48560,57406,53,8433,53,194,102,92,2,31,1,1
48561,56769,53,51571,53,183,94,89,2,31,1,1
48562,55049,443,4491,443,1600,1089,511,13,151,7,6
48563,36262,53,36262,53,216,90,126,2,30,1,1
48564,64414,53,43076,53,193,102,91,2,30,1,1
48565,49472,53,42476,53,210,110,100,2,31,1,1
48566,56200,53,31034,53,211,110,101,2,31,1,1
48567,49962,53,58375,53,184,94,90,2,31,1,1
48568,27005,27015,60094,27015,876,126,750,2,31,1,1
48569,64128,53,2686,53,193,102,91,2,30,1,1
48570,55023,53,43972,53,216,102,114,2,30,1,1
48571,56907,53,52225,53,193,102,91,2,30,1,1
48572,49263,53,17752,53,178,94,84,2,30,1,1
48573,49749,53,47748,53,200,102,98,2,30,1,1
48574,65117,53,1871,53,198,102,96,2,30,1,1
48575,63981,53,11790,53,199,102,97,2,30,1,1
48576,48822,53,49162,53,168,78,90,2,30,1,1
48577,35218,53,23519,53,168,78,90,2,30,1,1
48578,56907,53,55203,53,193,102,91,2,30,1,1
48579,49472,53,37751,53,210,110,100,2,30,1,1
48580,56837,53,12687,53,180,94,86,2,30,1,1
48581,16857,53,16857,53,832,106,726,2,30,1,1
48582,55066,53,23255,53,180,94,86,2,31,1,1
48583,65446,53,24128,53,210,110,100,2,30,1,1
48584,56455,53,54287,53,183,94,89,2,31,1,1
48585,27005,27080,13244,27080,926,126,800,2,31,1,1
48586,27005,29999,13147,29999,876,126,750,2,31,1,1
48587,61745,443,5419,443,8123,5308,2815,18,134,9,9
48588,46129,443,13770,443,6255,1125,5130,26,413,9,17
48589,55048,443,61386,443,1600,1089,511,13,151,7,6
48590,49379,53,35998,53,199,102,97,2,31,1,1
48591,1100,27540,2700,27540,132,70,62,2,31,1,1
48592,21133,63622,33830,63622,150,150,0,1,1199,1,0
48593,57470,51413,18747,51413,604,275,329,4,1199,2,2
48594,27005,27001,28063,27001,887,126,761,2,31,1,1
48595,50470,80,36047,80,8593,2011,6582,17,23,8,9
48596,49354,443,56660,443,4379,2565,1814,24,81,11,13
48597,60371,443,40685,443,7202,2596,4606,24,83,12,12
48598,40103,443,5740,443,416,210,206,7,34,4,3
48599,60079,80,9698,80,31418,1784,29634,37,126,14,23
48600,41233,443,15671,443,1807,1048,759,16,26,8,8
48601,27005,29999,60743,29999,887,126,761,2,31,1,1
48602,50313,80,19871,80,3450,1386,2064,15,83,8,7
48603,54676,443,17245,443,5747,1892,3855,19,17,11,8
48604,60395,443,53609,443,10672,1729,8943,24,81,12,12
48605,41235,443,2013,443,1807,1048,759,16,26,8,8
48606,49349,53,37003,53,183,94,89,2,31,1,1
48607,27005,27015,35363,27015,884,126,758,2,31,1,1
48608,49735,443,60036,443,378,256,122,7,18,5,2
48609,39065,443,4463,443,3589,1251,2338,15,20,9,6
48610,50310,80,45251,80,2958,1116,1842,15,83,8,7
48611,56624,80,12583,80,234,234,0,4,12,4,0
48612,55143,445,0,0,66,66,0,1,0,1,0
48613,55145,445,0,0,66,66,0,1,0,1,0
48614,59210,8168,0,0,66,66,0,1,0,1,0
48615,52563,17235,0,0,74,74,0,1,0,1,0
48616,1070,26467,0,0,62,62,0,1,0,1,0
48617,55986,26467,0,0,66,66,0,1,0,1,0
48618,59761,445,0,0,70,70,0,1,0,1,0
48619,63731,26467,0,0,66,66,0,1,0,1,0
48620,35944,23,0,0,60,60,0,1,0,1,0
48621,28878,51505,0,0,146,146,0,1,0,1,0
48622,443,62451,0,0,199,199,0,1,0,1,0
48623,48692,57470,0,0,62,62,0,1,0,1,0
48624,59759,445,0,0,70,70,0,1,0,1,0
48625,59756,445,0,0,70,70,0,1,0,1,0
48626,59750,445,0,0,70,70,0,1,0,1,0
48627,59749,445,0,0,70,70,0,1,0,1,0
48628,33324,42873,0,0,62,62,0,1,0,1,0
48629,15296,37965,0,0,62,62,0,1,0,1,0
48630,10166,44847,0,0,62,62,0,1,0,1,0
48631,54797,445,0,0,70,70,0,1,0,1,0
48632,54790,1433,0,0,60,60,0,1,0,1,0
48633,63221,53436,0,0,62,62,0,1,0,1,0
48634,54794,445,0,0,70,70,0,1,0,1,0
48635,54858,51505,0,0,66,66,0,1,0,1,0
48636,49992,5900,0,0,60,60,0,1,0,1,0
48637,59740,445,0,0,70,70,0,1,0,1,0
48638,59736,445,0,0,70,70,0,1,0,1,0
48639,59737,445,0,0,70,70,0,1,0,1,0
48640,54789,445,0,0,70,70,0,1,0,1,0
48641,17873,23117,0,0,66,66,0,1,0,1,0
48642,54788,445,0,0,70,70,0,1,0,1,0
48643,58286,37965,0,0,66,66,0,1,0,1,0
48644,19632,37965,0,0,62,62,0,1,0,1,0
48645,4545,1900,0,0,136,136,0,1,0,1,0
48646,64066,23718,0,0,62,62,0,1,0,1,0
48647,5664,36237,0,0,66,66,0,1,0,1,0
48648,54786,445,0,0,70,70,0,1,0,1,0
48649,3504,23,0,0,60,60,0,1,0,1,0
48650,43916,21,0,0,60,60,0,1,0,1,0
48651,42532,22114,0,0,146,146,0,1,0,1,0
48652,57899,34317,0,0,145,145,0,1,0,1,0
48653,15922,44847,0,0,66,66,0,1,0,1,0
48654,55123,445,0,0,66,66,0,1,0,1,0
48655,59734,445,0,0,70,70,0,1,0,1,0
48656,59733,445,0,0,70,70,0,1,0,1,0
48657,60129,55442,0,0,66,66,0,1,0,1,0
48658,55968,56205,0,0,66,66,0,1,0,1,0
48659,60162,53436,0,0,66,66,0,1,0,1,0
48660,54779,445,0,0,70,70,0,1,0,1,0
48661,53490,62413,0,0,66,66,0,1,0,1,0
48662,55933,64097,0,0,62,62,0,1,0,1,0
48663,443,62451,0,0,199,199,0,1,0,1,0
48664,54777,445,0,0,70,70,0,1,0,1,0
48665,34083,22,0,0,60,60,0,1,0,1,0
48666,51172,44847,0,0,66,66,0,1,0,1,0
48667,55116,445,0,0,66,66,0,1,0,1,0
48668,57500,37965,0,0,62,62,0,1,0,1,0
48669,2021,44847,0,0,66,66,0,1,0,1,0
48670,55114,445,0,0,66,66,0,1,0,1,0
48671,54776,445,0,0,70,70,0,1,0,1,0
48672,59724,445,0,0,70,70,0,1,0,1,0
48673,54775,445,0,0,70,70,0,1,0,1,0
48674,54774,445,0,0,70,70,0,1,0,1,0
48675,59718,445,0,0,70,70,0,1,0,1,0
48676,59711,445,0,0,70,70,0,1,0,1,0
48677,59712,445,0,0,70,70,0,1,0,1,0
48678,54770,445,0,0,70,70,0,1,0,1,0
48679,54772,445,0,0,70,70,0,1,0,1,0
48680,63778,50584,0,0,146,146,0,1,0,1,0
48681,58966,30188,0,0,66,66,0,1,0,1,0
48682,55110,445,0,0,66,66,0,1,0,1,0
48683,3377,50584,0,0,62,62,0,1,0,1,0
48684,54756,445,0,0,70,70,0,1,0,1,0
48685,54755,445,0,0,70,70,0,1,0,1,0
48686,54749,445,0,0,70,70,0,1,0,1,0
48687,59709,445,0,0,70,70,0,1,0,1,0
48688,57325,37965,0,0,62,62,0,1,0,1,0
48689,54745,445,0,0,70,70,0,1,0,1,0
48690,54746,445,0,0,70,70,0,1,0,1,0
48691,59703,445,0,0,70,70,0,1,0,1,0
48692,59704,445,0,0,70,70,0,1,0,1,0
48693,59700,445,0,0,70,70,0,1,0,1,0
48694,55105,445,0,0,66,66,0,1,0,1,0
48695,54742,50584,0,0,66,66,0,1,0,1,0
48696,50727,57470,0,0,78,78,0,1,0,1,0
48697,55102,445,0,0,66,66,0,1,0,1,0
48698,55099,445,0,0,66,66,0,1,0,1,0
48699,55097,445,0,0,66,66,0,1,0,1,0
48700,55095,445,0,0,66,66,0,1,0,1,0
48701,55094,445,0,0,66,66,0,1,0,1,0
48702,55093,445,0,0,66,66,0,1,0,1,0
48703,53779,51505,0,0,66,66,0,1,0,1,0
48704,17226,35440,0,0,62,62,0,1,0,1,0
48705,43363,26467,0,0,66,66,0,1,0,1,0
48706,13907,57470,0,0,66,66,0,1,0,1,0
48707,3803,51505,0,0,66,66,0,1,0,1,0
48708,10319,42707,0,0,62,62,0,1,0,1,0
48709,54734,445,0,0,70,70,0,1,0,1,0
48710,59697,445,0,0,70,70,0,1,0,1,0
48711,59696,445,0,0,70,70,0,1,0,1,0
48712,55090,445,0,0,66,66,0,1,0,1,0
48713,59691,445,0,0,70,70,0,1,0,1,0
48714,46901,26672,0,0,60,60,0,1,0,1,0
48715,55087,445,0,0,66,66,0,1,0,1,0
48716,44822,40108,0,0,145,145,0,1,0,1,0
48717,55085,445,0,0,66,66,0,1,0,1,0
48718,55083,445,0,0,66,66,0,1,0,1,0
48719,45941,23388,0,0,60,60,0,1,0,1,0
48720,51026,37450,0,0,62,62,0,1,0,1,0
48721,60750,42707,0,0,62,62,0,1,0,1,0
48722,55082,445,0,0,66,66,0,1,0,1,0
48723,54730,445,0,0,70,70,0,1,0,1,0
48724,56078,22,0,0,60,60,0,1,0,1,0
48725,60772,36829,0,0,62,62,0,1,0,1,0
48726,11677,44847,0,0,146,146,0,1,0,1,0
48727,59685,445,0,0,70,70,0,1,0,1,0
48728,57038,53,13307,53,735,88,647,2,30,1,1
48729,64017,53,51575,53,202,103,99,2,30,1,1
48730,57452,53,64588,53,774,101,673,2,30,1,1
48731,56677,53,25915,53,286,103,183,4,48,2,2
48732,55630,43736,23766,43736,70,70,0,2,8,2,0
48733,60435,80,6093,80,1155,781,374,10,15,6,4
48734,27005,27015,44800,27015,858,126,732,2,30,1,1
48735,37138,80,13348,80,1658,1344,314,10,16,5,5
48736,60413,43555,1703,43555,70,70,0,1,5,1,0
48737,57614,80,57614,80,470276,8994,461282,388,25,75,313
48738,60407,443,16001,443,7298,1737,5561,21,79,11,10
48739,60408,443,33443,443,7282,1596,5686,21,79,11,10
48740,49754,80,3257,80,1793,634,1159,11,15,6,5
48741,51920,443,50819,443,98155,20830,77325,151,103,70,81
48742,56820,19562,44411,19562,316,136,180,6,6,3,3
48743,57617,80,57617,80,542818,11392,531426,466,25,106,360
48744,65477,53,60369,53,182,93,89,2,31,1,1
48745,51921,443,16602,443,7970,4154,3816,39,102,23,16
48746,64711,53,44473,53,206,105,101,2,31,1,1
48747,48064,443,60858,443,7358,2661,4697,22,17,11,11
48748,56952,53,7156,53,186,95,91,2,30,1,1
48749,49733,443,55919,443,7673,1637,6036,31,23,16,15
48750,49379,53,1311,53,198,101,97,2,30,1,1
48751,50166,80,59884,80,2181,849,1332,14,97,7,7
48752,51111,80,36793,80,1614,1300,314,10,15,5,5
48753,56200,53,9546,53,206,105,101,2,30,1,1
48754,53979,80,42117,80,64091,62467,1624,61,16,48,13
48755,56769,53,28212,53,182,93,89,2,30,1,1
48756,39039,443,4727,443,572,292,280,9,32,5,4
48757,6881,34190,52438,34190,509,150,359,2,1200,1,1
48758,50774,443,8773,443,6074,4349,1725,22,361,11,11
48759,54996,80,15340,80,1979,826,1153,13,17,9,4
48760,58996,443,63733,443,4979,1505,3474,21,40,11,10
48761,60400,443,24179,443,7073,1556,5517,21,80,11,10
48762,45409,80,10508,80,1155,781,374,10,15,6,4
48763,36404,443,36404,443,4651,1744,2907,19,28,11,8
48764,63981,53,63404,53,198,101,97,2,30,1,1
48765,51829,46209,37314,46209,70,70,0,2,6,2,0
48766,51272,12210,19987,12210,70,70,0,2,8,2,0
48767,56340,53,20646,53,780,104,676,2,30,1,1
48768,57615,80,57615,80,126266,7980,118286,126,25,37,89
48769,47193,443,47193,443,4555,1648,2907,19,30,11,8
48770,54994,53,46934,53,747,90,657,2,30,1,1
48771,49750,80,55648,80,1788,628,1160,11,15,6,5
48772,64439,53,21739,53,198,101,97,2,30,1,1
48773,56907,53,30481,53,186,95,91,2,30,1,1
48774,16994,53,0,0,300,90,210,2,30,1,1
48775,49270,53,41673,53,735,88,647,2,30,1,1
48776,45232,53,0,0,82,82,0,1,31,1,0
48777,50428,443,32117,443,9844,4554,5290,24,92,13,11
48778,34366,53,0,0,82,82,0,1,31,1,0
48779,50265,48982,51729,48982,480,149,331,2,1200,1,1
48780,49601,53,30079,53,88,88,0,1,31,1,0
48781,49323,53,32529,53,204,104,100,2,31,1,1
48782,64071,53,30972,53,188,96,92,2,31,1,1
48783,64756,53,52664,53,190,97,93,2,31,1,1
48784,52254,443,36907,443,13640,2316,11324,24,136,10,14
48785,49905,53,43598,53,176,90,86,2,31,1,1
48786,49926,53,49666,53,176,90,86,2,31,1,1
48787,55487,53,20467,53,198,101,97,2,31,1,1
48788,63962,53,53078,53,188,96,92,2,31,1,1
48789,27005,27016,39937,27016,914,126,788,2,31,1,1
48790,49349,53,29426,53,182,93,89,2,31,1,1
48791,49282,53,46163,53,172,88,84,2,31,1,1
48792,27005,27022,10825,27022,890,126,764,2,31,1,1
48793,64484,53,55455,53,168,86,82,2,31,1,1
48794,49365,443,8370,443,3598,1145,2453,15,120,7,8
48795,50265,65535,43978,65535,222,132,90,4,1210,3,1
48796,1046,48817,0,0,62,62,0,1,0,1,0
48797,52633,30188,0,0,66,66,0,1,0,1,0
48798,54720,445,0,0,70,70,0,1,0,1,0
48799,54719,445,0,0,70,70,0,1,0,1,0
48800,59679,445,0,0,70,70,0,1,0,1,0
48801,59676,445,0,0,70,70,0,1,0,1,0
48802,54716,445,0,0,70,70,0,1,0,1,0
48803,54717,445,0,0,70,70,0,1,0,1,0
48804,20894,51505,0,0,62,62,0,1,0,1,0
48805,54713,445,0,0,70,70,0,1,0,1,0
48806,50316,37965,0,0,66,66,0,1,0,1,0
48807,55070,445,0,0,66,66,0,1,0,1,0
48808,56834,53,25406,53,178,94,84,2,30,1,1
48809,26795,443,14434,443,21804,16558,5246,43,21,24,19
48810,60891,443,59680,443,4895,3822,1073,24,49,13,11
48811,23089,48817,0,0,62,62,0,1,0,1,0
48812,1024,6881,0,0,146,146,0,1,0,1,0
48813,62029,36237,0,0,66,66,0,1,0,1,0
48814,55063,445,0,0,66,66,0,1,0,1,0
48815,54707,445,0,0,70,70,0,1,0,1,0
48816,43260,41615,0,0,145,145,0,1,0,1,0
48817,59663,445,0,0,70,70,0,1,0,1,0
48818,26408,64147,0,0,66,66,0,1,0,1,0
48819,26502,64147,0,0,62,62,0,1,0,1,0
48820,63456,37965,0,0,62,62,0,1,0,1,0
48821,43104,26467,0,0,62,62,0,1,0,1,0
48822,58811,53976,0,0,62,62,0,1,0,1,0
48823,55061,445,0,0,66,66,0,1,0,1,0
48824,54700,445,0,0,70,70,0,1,0,1,0
48825,58562,57587,0,0,66,66,0,1,0,1,0
48826,54698,445,0,0,70,70,0,1,0,1,0
48827,52095,56079,0,0,62,62,0,1,0,1,0
48828,55054,445,0,0,66,66,0,1,0,1,0
48829,26494,26467,0,0,62,62,0,1,0,1,0
48830,55043,445,0,0,66,66,0,1,0,1,0
48831,8239,37965,0,0,146,146,0,1,0,1,0
48832,50280,57470,0,0,78,78,0,1,0,1,0
48833,54693,445,0,0,70,70,0,1,0,1,0
48834,54692,445,0,0,70,70,0,1,0,1,0
48835,5774,37965,0,0,66,66,0,1,0,1,0
48836,54688,445,0,0,70,70,0,1,0,1,0
48837,63030,2222,0,0,66,66,0,1,0,1,0
48838,59651,445,0,0,70,70,0,1,0,1,0
48839,59653,445,0,0,70,70,0,1,0,1,0
48840,59652,445,0,0,70,70,0,1,0,1,0
48841,64266,53,27142,53,168,86,82,2,30,1,1
48842,49555,53,21166,53,199,102,97,2,30,1,1
48843,57290,53,54259,53,178,94,84,2,30,1,1
48844,41232,443,32307,443,1807,1048,759,16,25,8,8
48845,49732,443,42008,443,27125,14251,12874,99,23,57,42
48846,60397,443,49717,443,7643,1678,5965,21,80,11,10
48847,60403,443,3192,443,5567,1589,3978,20,80,11,9
48848,15930,53,15930,53,244,98,146,2,31,1,1
48849,55636,25569,50876,25569,320,140,180,6,6,3,3
48850,49731,443,14153,443,13155,3815,9340,29,24,13,16
48851,60413,443,19866,443,9398,2320,7078,24,77,13,11
48852,60396,443,5888,443,5964,1586,4378,19,80,10,9
48853,50152,80,46738,80,731402,17622,713780,600,97,116,484
48854,64439,53,36450,53,199,102,97,2,30,1,1
48855,55927,53,41588,53,720,94,626,2,29,1,1
48856,54431,443,24894,443,9398,2027,7371,33,270,14,19
48857,41234,443,28858,443,1741,1048,693,15,25,8,7
48858,60368,443,34243,443,6041,1830,4211,21,82,10,11
48859,57095,53,1337,53,211,110,101,2,29,1,1
48860,60393,443,31011,443,8049,1805,6244,23,81,12,11
48861,49734,443,18197,443,7548,1543,6005,22,18,12,10
48862,60369,443,26606,443,6052,1841,4211,21,82,10,11
48863,60370,443,62763,443,6045,1834,4211,21,82,10,11
48864,60389,443,56749,443,8166,1734,6432,23,81,12,11
48865,51837,37610,19513,37610,316,136,180,6,5,3,3
48866,55271,53,23423,53,168,86,82,2,30,1,1
48867,46403,443,21158,443,6035,1758,4277,27,1169,15,12
48868,54518,7000,54518,7000,3518,1951,1567,15,15,8,7
48869,51443,443,35232,443,322,66,256,6,16,2,4
48870,63129,47117,14419,47117,574,448,126,10,25,8,2
48871,51919,443,36228,443,17595,8241,9354,80,106,43,37
48872,36692,443,41344,443,996,526,470,15,30,8,7
48873,54653,6881,28676,6881,658,412,246,9,15,5,4
48874,65300,53,17594,53,329,88,241,4,50,2,2
48875,49175,443,3024,443,4429,2593,1836,34,1126,18,16
48876,27005,27015,14590,27015,901,126,775,2,30,1,1
48877,64695,53,52435,53,193,102,91,2,30,1,1
48878,64711,53,17611,53,211,110,101,2,30,1,1
48879,55773,53,34274,53,199,102,97,2,30,1,1
48880,49905,53,29720,53,180,94,86,2,30,1,1
48881,51816,27721,15774,27721,70,70,0,1,5,1,0
48882,57613,80,57613,80,349583,9149,340434,298,25,62,236
48883,45239,443,9489,443,11147,3412,7735,36,458,20,16
48884,33409,53,6047,53,241272,234761,6511,2872,89,2833,39
48885,6437,53,6437,53,229,90,139,2,30,1,1
48886,65477,53,61765,53,183,94,89,2,30,1,1
48887,55487,53,40739,53,199,102,97,2,30,1,1
48888,49747,53,62194,53,355,102,253,2,30,1,1
48889,57207,53,1251,53,195,102,93,2,30,1,1
48890,64105,53,18897,53,182,86,96,2,30,1,1
48891,64017,53,3169,53,209,110,99,2,30,1,1
48892,60415,40829,46260,40829,70,70,0,1,5,1,0
48893,51441,443,28224,443,322,66,256,6,16,2,4
48894,64266,53,43619,53,168,86,82,2,30,1,1
48895,49751,80,48363,80,1876,998,878,12,15,7,5
48896,2437,53,2437,53,229,90,139,2,30,1,1
48897,49602,53,63187,53,178,94,84,2,30,1,1
48898,9708,53,0,0,304,94,210,2,30,1,1
48899,49981,53,37329,53,438,180,258,6,30,3,3
48900,56769,53,53195,53,183,94,89,2,30,1,1
48901,64439,53,3142,53,199,102,97,2,30,1,1
48902,49555,53,37709,53,199,102,97,2,30,1,1
48903,57290,53,13860,53,178,94,84,2,30,1,1
48904,49602,53,1592,53,178,94,84,2,30,1,1
48905,56945,53,62206,53,180,94,86,2,30,1,1
48906,43937,123,21193,123,184,94,90,2,30,1,1
48907,64538,53,37074,53,194,102,92,2,30,1,1
48908,64482,53,15277,53,196,102,94,2,30,1,1
48909,55538,53,48787,53,195,102,93,2,30,1,1
48910,55773,53,61209,53,199,102,97,2,30,1,1
48911,47905,443,5382,443,172,172,0,2,5,2,0
48912,52143,443,25458,443,712,452,260,8,25,4,4
48913,64017,53,64345,53,325,103,222,4,45,2,2
48914,65213,53,54852,53,298,94,204,2,30,1,1
48915,55859,53,59697,53,210,110,100,2,30,1,1
48916,64695,53,11927,53,193,102,91,2,30,1,1
48917,56677,53,32244,53,286,103,183,4,48,2,2
48918,60414,52559,6876,52559,70,70,0,1,5,1,0
48919,57616,80,57616,80,266789,7684,259105,234,25,54,180
48920,56677,53,36331,53,286,103,183,4,48,2,2
48921,63981,53,13175,53,199,102,97,2,29,1,1
48922,60502,443,31971,443,416,210,206,7,28,4,3
48923,23725,80,23725,80,1100980,31101,1069879,1210,19,462,748
48924,50307,80,5299,80,2840,1750,1090,13,82,7,6
48925,55171,53,9139,53,199,102,97,2,29,1,1
48926,65460,53,21678,53,387,102,285,2,29,1,1
48927,65117,53,55253,53,542,100,442,4,51,2,2
48928,41236,443,52117,443,1807,1048,759,16,25,8,8
48929,56769,53,31740,53,183,94,89,2,30,1,1
48930,50059,443,43913,443,8205,2989,5216,42,115,21,21
48931,60412,443,58640,443,7353,1573,5780,21,78,11,10
48932,64128,53,50271,53,606,182,424,6,71,3,3
48933,34733,80,35506,80,1056,682,374,10,15,6,4
48934,60353,80,51111,80,1679,1269,410,8,15,5,3
48935,65159,53,58481,53,500,204,296,6,75,3,3
48936,55271,53,59088,53,168,86,82,2,29,1,1
48937,27005,37569,24512,37569,880,126,754,2,30,1,1
48938,64482,53,47729,53,196,102,94,2,30,1,1
48939,56773,53,53330,53,183,94,89,2,29,1,1
48940,49263,53,54586,53,178,94,84,2,30,1,1
48941,45863,53,45863,53,229,90,139,2,30,1,1
48942,49464,53,1533,53,213,102,111,2,30,1,1
48943,65477,53,57278,53,183,94,89,2,30,1,1
48944,56945,53,11659,53,180,94,86,2,30,1,1
48945,64711,53,46738,53,211,110,101,2,30,1,1
48946,49198,443,22902,443,533813,25885,507928,678,50,308,370
48947,57207,53,55086,53,195,102,93,2,30,1,1
48948,49926,53,63439,53,180,94,86,2,30,1,1
48949,64484,53,23929,53,86,86,0,1,30,1,0
48950,48155,443,36559,443,7395,1514,5881,26,225,11,15
48951,35796,443,15213,443,664348,23858,640490,757,119,292,465
48952,36834,80,37812,80,12993,6920,6073,22,20,13,9
48953,5588,5588,0,0,3354,1792,1562,46,194,23,23
48954,49268,53,5165,53,353,118,235,2,30,1,1
48955,55859,53,29640,53,210,110,100,2,30,1,1
48956,50006,53,55896,53,378,94,284,2,30,1,1
48957,65187,53,19736,53,392,86,306,2,30,1,1
48958,56200,53,42161,53,211,110,101,2,30,1,1
48959,65477,53,48091,53,183,94,89,2,30,1,1
48960,56618,443,31063,443,3096,1882,1214,19,16,10,9
48961,57618,80,57618,80,265909,7294,258615,235,25,55,180
48962,50116,22,50116,22,152,66,86,2,10,1,1
48963,57384,443,63051,443,546,280,266,9,28,5,4
48964,57591,443,27521,443,2614,1689,925,18,20,10,8
48965,55312,53,35283,53,438,180,258,6,30,3,3
48966,55066,53,27707,53,180,94,86,2,30,1,1
48967,64538,53,57273,53,194,102,92,2,30,1,1
48968,56945,53,12864,53,180,94,86,2,30,1,1
48969,54973,53,3418,53,308,102,206,2,30,1,1
48970,64642,53,54204,53,751,94,657,2,30,1,1
48971,50642,53,37858,53,775,102,673,2,30,1,1
48972,64017,53,52336,53,209,110,99,2,30,1,1
48973,49317,53,48476,53,166,86,80,2,30,1,1
48974,49905,53,25136,53,180,94,86,2,30,1,1
48975,55093,53,0,0,318,86,232,2,30,1,1
48976,55538,53,14832,53,195,102,93,2,30,1,1
48977,49349,53,14349,53,183,94,89,2,30,1,1
48978,64711,53,26786,53,211,110,101,2,30,1,1
48979,20388,53,20388,53,203,82,121,2,30,1,1
48980,49323,53,60402,53,210,110,100,2,31,1,1
48981,64808,53,34038,53,239,94,145,2,30,1,1
48982,55487,53,60324,53,199,102,97,2,31,1,1
48983,16403,16384,56995,16384,556,256,300,10,31,5,5
48984,64071,53,28084,53,424,104,320,4,31,2,2
48985,53654,53,13764,53,523,85,438,4,31,2,2
48986,64347,53,32269,53,193,102,91,2,30,1,1
48987,49160,12176,2844,12176,852,150,702,4,1200,2,2
48988,56834,53,6671,53,178,94,84,2,31,1,1
48989,27005,27014,60254,27014,879,126,753,2,31,1,1
48990,17750,27517,53975,27517,491,150,341,2,1200,1,1
48991,50182,443,50182,443,12509,1447,11062,28,122,16,12
48992,51238,443,29233,443,8034,2584,5450,39,16,23,16
48993,52776,80,21861,80,432,240,192,8,101,5,3
48994,48009,443,46874,443,4015,1813,2202,17,256,9,8
48995,35672,443,33861,443,938,576,362,14,27,9,5
48996,47450,443,22297,443,162,102,60,2,5,1,1
48997,51239,443,46781,443,9649,4615,5034,42,16,24,18
48998,50018,80,3941,80,825,685,140,6,33,4,2
48999,56806,46903,25071,46903,3060,1569,1491,12,17,7,5
49000,50973,80,57219,80,314164,13077,301087,356,25,144,212
49001,37253,443,5340,443,6840,1556,5284,32,26,17,15
49002,51807,10920,61477,10920,70,70,0,1,5,1,0
49003,49926,53,15614,53,180,94,86,2,30,1,1
49004,55038,445,0,0,66,66,0,1,0,1,0
49005,55030,445,0,0,66,66,0,1,0,1,0
49006,55034,445,0,0,66,66,0,1,0,1,0
49007,55036,445,0,0,66,66,0,1,0,1,0
49008,55035,445,0,0,66,66,0,1,0,1,0
49009,55033,445,0,0,66,66,0,1,0,1,0
49010,55037,445,0,0,66,66,0,1,0,1,0
49011,55031,445,0,0,66,66,0,1,0,1,0
49012,54687,445,0,0,70,70,0,1,0,1,0
49013,57564,56205,0,0,66,66,0,1,0,1,0
49014,60350,51505,0,0,66,66,0,1,0,1,0
49015,60312,57470,0,0,74,74,0,1,0,1,0
49016,49616,30188,0,0,66,66,0,1,0,1,0
49017,56785,39004,0,0,145,145,0,1,0,1,0
49018,42252,33303,0,0,60,60,0,1,0,1,0
49019,41346,30188,0,0,62,62,0,1,0,1,0
49020,54682,445,0,0,70,70,0,1,0,1,0
49021,48706,23393,0,0,60,60,0,1,0,1,0
49022,59649,445,0,0,70,70,0,1,0,1,0
49023,59637,445,0,0,70,70,0,1,0,1,0
49024,59635,445,0,0,70,70,0,1,0,1,0
49025,55018,445,0,0,66,66,0,1,0,1,0
49026,55015,445,0,0,66,66,0,1,0,1,0
49027,55016,445,0,0,66,66,0,1,0,1,0
49028,36566,37965,0,0,62,62,0,1,0,1,0
49029,58038,51505,0,0,146,146,0,1,0,1,0
49030,59634,445,0,0,70,70,0,1,0,1,0
49031,53459,37807,0,0,62,62,0,1,0,1,0
49032,13643,22114,0,0,146,146,0,1,0,1,0
49033,56582,37965,0,0,66,66,0,1,0,1,0
49034,17579,57470,0,0,62,62,0,1,0,1,0
49035,59631,445,0,0,70,70,0,1,0,1,0
49036,45964,2228,0,0,60,60,0,1,0,1,0
49037,59630,445,0,0,70,70,0,1,0,1,0
49038,59624,445,0,0,70,70,0,1,0,1,0
49039,59622,445,0,0,70,70,0,1,0,1,0
49040,54669,445,0,0,70,70,0,1,0,1,0
49041,54666,445,0,0,70,70,0,1,0,1,0
49042,58485,40740,0,0,145,145,0,1,0,1,0
49043,42865,55839,0,0,137,137,0,1,0,1,0
49044,43916,21,0,0,60,60,0,1,0,1,0
49045,10639,11392,0,0,62,62,0,1,0,1,0
49046,25469,57470,0,0,62,62,0,1,0,1,0
49047,65518,5710,0,0,62,62,0,1,0,1,0
49048,59612,445,0,0,70,70,0,1,0,1,0
49049,59610,445,0,0,70,70,0,1,0,1,0
49050,59609,445,0,0,70,70,0,1,0,1,0
49051,48676,53392,0,0,60,60,0,1,0,1,0
49052,54661,445,0,0,70,70,0,1,0,1,0
49053,44849,46478,0,0,74,74,0,1,0,1,0
49054,54660,445,0,0,70,70,0,1,0,1,0
49055,51920,30188,0,0,62,62,0,1,0,1,0
49056,57649,6881,0,0,146,146,0,1,0,1,0
49057,54658,445,0,0,70,70,0,1,0,1,0
49058,53774,51505,0,0,66,66,0,1,0,1,0
49059,11023,51505,0,0,66,66,0,1,0,1,0
49060,2425,23117,0,0,62,62,0,1,0,1,0
49061,54996,445,0,0,66,66,0,1,0,1,0
49062,34936,30188,0,0,66,66,0,1,0,1,0
49063,59606,445,0,0,70,70,0,1,0,1,0
49064,59604,445,0,0,70,70,0,1,0,1,0
49065,52929,1433,0,0,60,60,0,1,0,1,0
49066,52837,35440,0,0,66,66,0,1,0,1,0
49067,54651,445,0,0,70,70,0,1,0,1,0
49068,6666,8888,0,0,60,60,0,1,0,1,0
49069,52111,44847,0,0,62,62,0,1,0,1,0
49070,0,0,0,0,98,98,0,1,0,1,0
49071,52929,1433,0,0,60,60,0,1,0,1,0
49072,34808,22114,0,0,66,66,0,1,0,1,0
49073,54649,445,0,0,70,70,0,1,0,1,0
49074,54648,445,0,0,70,70,0,1,0,1,0
49075,13581,51505,0,0,62,62,0,1,0,1,0
49076,54988,445,0,0,66,66,0,1,0,1,0
49077,54647,445,0,0,70,70,0,1,0,1,0
49078,54196,11392,0,0,66,66,0,1,0,1,0
49079,54646,445,0,0,70,70,0,1,0,1,0
49080,41562,123,0,0,234,234,0,1,0,1,0
49081,54642,445,0,0,70,70,0,1,0,1,0
49082,54643,445,0,0,70,70,0,1,0,1,0
49083,54986,445,0,0,66,66,0,1,0,1,0
49084,59592,445,0,0,70,70,0,1,0,1,0
49085,59589,445,0,0,70,70,0,1,0,1,0
49086,59588,445,0,0,70,70,0,1,0,1,0
49087,59583,445,0,0,70,70,0,1,0,1,0
49088,54984,445,0,0,66,66,0,1,0,1,0
49089,52696,21247,0,0,66,66,0,1,0,1,0
49090,54628,445,0,0,70,70,0,1,0,1,0
49091,54627,445,0,0,70,70,0,1,0,1,0
49092,54624,445,0,0,70,70,0,1,0,1,0
49093,54618,445,0,0,70,70,0,1,0,1,0
49094,54617,445,0,0,70,70,0,1,0,1,0
49095,59563,56205,0,0,66,66,0,1,0,1,0
49096,59581,445,0,0,70,70,0,1,0,1,0
49097,46901,26672,0,0,60,60,0,1,0,1,0
49098,19875,30170,0,0,145,145,0,1,0,1,0
49099,59576,445,0,0,70,70,0,1,0,1,0
49100,59574,445,0,0,70,70,0,1,0,1,0
49101,59572,445,0,0,70,70,0,1,0,1,0
49102,24174,57470,0,0,62,62,0,1,0,1,0
49103,54977,445,0,0,66,66,0,1,0,1,0
49104,52177,25320,0,0,66,66,0,1,0,1,0
49105,54973,445,0,0,66,66,0,1,0,1,0
49106,54968,445,0,0,66,66,0,1,0,1,0
49107,54970,445,0,0,66,66,0,1,0,1,0
49108,62549,53733,0,0,66,66,0,1,0,1,0
49109,54967,445,0,0,66,66,0,1,0,1,0
49110,54964,445,0,0,66,66,0,1,0,1,0
49111,54965,445,0,0,66,66,0,1,0,1,0
49112,6037,43890,0,0,70,70,0,1,0,1,0
49113,4515,37807,0,0,62,62,0,1,0,1,0
49114,54606,445,0,0,70,70,0,1,0,1,0
49115,55201,22114,0,0,62,62,0,1,0,1,0
49116,17453,35440,0,0,66,66,0,1,0,1,0
49117,43047,80,45126,80,2088,472,1616,15,155,3,12
49118,27005,27015,61856,27015,888,126,762,2,30,1,1
49119,58805,80,4161,80,1702,1388,314,10,16,5,5
49120,55622,33342,17108,33342,70,70,0,1,5,1,0
49121,52912,53,52912,53,237,91,146,2,32,1,1
49122,53624,7370,56004,7370,70,70,0,1,5,1,0
49123,60325,80,16267,80,3697,2062,1635,16,61,9,7
49124,38820,80,32872,80,1150,613,537,10,16,6,4
49125,64367,443,15536,443,4741,1306,3435,26,300,14,12
49126,44949,443,16538,443,4093,2830,1263,21,24,11,10
49127,59210,80,59210,80,1990,833,1157,10,21,6,4
49128,57396,443,25332,443,9318,3350,5968,31,140,14,17
49129,37896,443,37896,443,4704,1797,2907,19,30,11,8
49130,51810,33776,47745,33776,66,66,0,1,5,1,0
49131,64366,443,7841,443,6205,1316,4889,27,301,14,13
49132,42567,80,40138,80,2161,1178,983,16,17,10,6
49133,42811,80,59018,80,1114,534,580,12,16,7,5
49134,60330,80,20724,80,374,192,182,7,61,4,3
49135,60329,80,45049,80,374,192,182,7,61,4,3
49136,52673,80,57831,80,23776,1372,22404,35,112,15,20
49137,53073,80,1603,80,2594,1200,1394,16,17,10,6
49138,60327,80,34206,80,2125,1159,966,13,61,7,6
49139,51811,20740,15988,20740,66,66,0,1,5,1,0
49140,57490,80,59652,80,1614,1300,314,10,15,5,5
49141,49883,443,6647,443,17238,4435,12803,32,103,15,17
49142,42172,443,15822,443,7071,1908,5163,29,944,14,15
49143,45816,443,45816,443,4430,1523,2907,19,27,11,8
49144,58757,5222,20717,5222,3815,2065,1750,37,309,19,18
49145,52774,80,57936,80,432,240,192,8,101,5,3
49146,52772,80,28043,80,2501,1085,1416,15,108,8,7
49147,55620,20795,41932,20795,70,70,0,1,5,1,0
49148,48865,443,7956,443,12824,2604,10220,46,255,20,26
49149,42022,80,12678,80,31196,607,30589,29,500,5,24
49150,61732,443,11286,443,8655,2300,6355,24,21,12,12
49151,53121,8986,30082,8986,70,70,0,1,5,1,0
49152,49225,53,55909,53,295,101,194,4,49,2,2
49153,57647,80,36132,80,1530,1216,314,10,15,5,5
49154,51806,49530,42413,49530,66,66,0,1,5,1,0
49155,35405,53,35405,53,217,87,130,2,30,1,1
49156,64368,443,54903,443,4741,1306,3435,26,300,14,12
49157,64347,53,36083,53,186,95,91,2,30,1,1
49158,57207,53,13941,53,190,97,93,2,30,1,1
49159,43676,80,43895,80,2132,997,1135,14,20,8,6
49160,51402,443,14600,443,7788,2581,5207,39,70,19,20
49161,64091,80,64091,80,2244,1505,739,11,146,6,5
49162,36417,443,64743,443,8611,2046,6565,31,394,10,21
49163,52775,80,57119,80,432,240,192,8,101,5,3
49164,49104,80,61237,80,1638,1324,314,10,15,5,5
49165,60328,80,20117,80,2006,1095,911,11,61,6,5
49166,53614,8999,9856,8999,928,541,387,8,17,5,3
49167,51825,25501,11280,25501,70,70,0,2,9,2,0
49168,60326,80,6892,80,3697,2062,1635,16,61,9,7
49169,51813,63933,44889,63933,66,66,0,1,5,1,0
49170,41924,53,41924,53,237,91,146,2,33,1,1
49171,39322,443,56925,443,7450,2503,4947,21,977,11,10
49172,57944,80,62722,80,1718,1404,314,11,15,6,5
49173,53632,58037,54997,58037,70,70,0,1,5,1,0
49174,43154,80,38984,80,139303,9065,130238,210,20,120,90
49175,28331,53,28331,53,213,87,126,2,30,1,1
49176,27005,27015,11957,27015,901,126,775,2,30,1,1
49177,27005,27015,54928,27015,882,126,756,2,30,1,1
49178,65530,53,49940,53,96,96,0,1,30,1,0
49179,56834,53,36228,53,172,88,84,2,30,1,1
49180,49919,443,28097,443,4534,909,3625,16,32,8,8
49181,33087,53,33087,53,228,97,131,2,31,1,1
49182,34246,53,34246,53,217,87,130,2,31,1,1
49183,13980,53,13980,53,213,87,126,2,31,1,1
49184,37965,62918,1138,62918,489,149,340,2,1200,1,1
49185,443,30054,0,0,60,60,0,1,91,1,0
49186,44783,443,27769,443,4173582,66515,4107067,3494,129,510,2984
49187,53580,443,57283,443,4669,2251,2418,14,137,7,7
49188,59845,44847,0,0,66,66,0,1,0,1,0
49189,34176,51505,0,0,146,146,0,1,0,1,0
49190,59568,445,0,0,70,70,0,1,0,1,0
49191,59570,445,0,0,70,70,0,1,0,1,0
49192,59569,445,0,0,70,70,0,1,0,1,0
49193,443,1340,0,0,85,85,0,1,0,1,0
49194,54962,445,0,0,66,66,0,1,0,1,0
49195,55539,57470,0,0,66,66,0,1,0,1,0
49196,59563,445,0,0,70,70,0,1,0,1,0
49197,54958,445,0,0,66,66,0,1,0,1,0
49198,54955,445,0,0,66,66,0,1,0,1,0
49199,62414,50584,0,0,62,62,0,1,0,1,0
49200,65355,443,1822,443,3563945,186679,3377266,4424,723,1877,2547
49201,57015,80,50968,80,1348,844,504,13,255,8,5
49202,49282,53,64879,53,178,94,84,2,30,1,1
49203,27005,27015,20017,27015,882,126,756,2,30,1,1
49204,49282,53,56718,53,178,94,84,2,30,1,1
49205,54602,445,0,0,70,70,0,1,0,1,0
49206,54954,445,0,0,66,66,0,1,0,1,0
49207,11677,56205,0,0,62,62,0,1,0,1,0
49208,48016,57470,0,0,62,62,0,1,0,1,0
49209,49479,56205,0,0,66,66,0,1,0,1,0
49210,54592,445,0,0,70,70,0,1,0,1,0
49211,54593,445,0,0,70,70,0,1,0,1,0
49212,47700,51505,0,0,66,66,0,1,0,1,0
49213,54588,445,0,0,70,70,0,1,0,1,0
49214,54590,445,0,0,70,70,0,1,0,1,0
49215,59557,445,0,0,70,70,0,1,0,1,0
49216,54586,445,0,0,70,70,0,1,0,1,0
49217,59549,445,0,0,70,70,0,1,0,1,0
49218,59546,445,0,0,70,70,0,1,0,1,0
49219,2541,51505,0,0,66,66,0,1,0,1,0
49220,64990,55442,0,0,66,66,0,1,0,1,0
49221,1024,57470,0,0,62,62,0,1,0,1,0
49222,54579,445,0,0,70,70,0,1,0,1,0
49223,56542,443,7908,443,3701,1521,2180,19,7,10,9
49224,62152,56205,0,0,66,66,0,1,0,1,0
49225,1024,50265,0,0,62,62,0,1,0,1,0
49226,63194,50265,0,0,66,66,0,1,0,1,0
49227,46362,35440,0,0,66,66,0,1,0,1,0
49228,55032,62413,0,0,62,62,0,1,0,1,0
49229,16474,50584,0,0,146,146,0,1,0,1,0
49230,61962,53733,0,0,62,62,0,1,0,1,0
49231,54935,445,0,0,66,66,0,1,0,1,0
49232,59535,445,0,0,70,70,0,1,0,1,0
49233,21348,22,0,0,60,60,0,1,0,1,0
49234,13985,34159,0,0,66,66,0,1,0,1,0
49235,54572,445,0,0,70,70,0,1,0,1,0
49236,54932,445,0,0,66,66,0,1,0,1,0
49237,54569,445,0,0,70,70,0,1,0,1,0
49238,30179,57470,0,0,60,60,0,1,0,1,0
49239,62337,44847,0,0,62,62,0,1,0,1,0
49240,54926,445,0,0,66,66,0,1,0,1,0
49241,54566,445,0,0,70,70,0,1,0,1,0
49242,59262,5228,3053,5228,7054,2076,4978,32,5115,11,21
49243,49867,443,24010,443,7461,2841,4620,19,103,11,8
49244,40363,80,1315,80,3566,1637,1929,18,81,11,7
49245,5236,35120,49591,35120,23369,64,23305,65,31,2,63
49246,63243,53,40178,53,330,228,102,3,33,2,1
49247,51812,15279,41054,15279,70,70,0,1,4,1,0
49248,51809,52528,58895,52528,70,70,0,1,4,1,0
49249,53629,51413,42166,51413,70,70,0,1,4,1,0
49250,46392,443,48556,443,232,172,60,3,5,2,1
49251,52731,80,58843,80,1029,567,462,10,17,6,4
49252,64695,53,40312,53,193,102,91,2,29,1,1
49253,55950,443,51183,443,6490,1789,4701,30,95,16,14
49254,60146,53,47250,53,218,78,140,2,30,1,1
49255,61682,80,36902,80,1804,884,920,12,49,6,6
49256,54536,80,14992,80,4096,3455,641,13,15,8,5
49257,53644,58085,31937,58085,70,70,0,2,7,2,0
49258,6881,50321,40130,50321,238,118,120,2,1199,1,1
49259,52777,80,21198,80,432,240,192,8,100,5,3
49260,49225,53,59832,53,295,101,194,4,49,2,2
49261,64617,53,31755,53,389,102,287,4,33,2,2
49262,51409,443,49977,443,394,70,324,7,31,2,5
49263,55301,443,54571,443,9881,1486,8395,22,200,12,10
49264,51815,28665,10000,28665,70,70,0,1,4,1,0
49265,51827,48432,37555,48432,164,70,94,2,4,1,1
49266,51814,55393,29283,55393,70,70,0,1,4,1,0
49267,49926,53,46406,53,333,90,243,4,41,2,2
49268,57207,53,1667,53,195,102,93,2,29,1,1
49269,49905,53,31462,53,180,94,86,2,29,1,1
49270,49323,53,50782,53,210,110,100,2,29,1,1
49271,46860,53,42204,53,447,101,346,4,29,2,2
49272,62155,53,41278,53,263,86,177,2,29,1,1
49273,55995,53,32542,53,329,118,211,2,30,1,1
49274,55242,443,59852,443,214,140,74,4,15,3,1
49275,57311,53,54078,53,211,102,109,2,30,1,1
49276,51948,443,29548,443,4876,2559,2317,32,56,18,14
49277,53239,443,22787,443,982624,22331,960293,976,137,293,683
49278,56654,443,29055,443,18544,4402,14142,31,191,14,17
49279,49343,53,20254,53,478,106,372,4,48,2,2
49280,46140,443,48726,443,172,172,0,2,5,2,0
49281,27005,27015,32214,27015,878,126,752,2,30,1,1
49282,33197,443,9055,443,1067,650,417,10,27,6,4
49283,49267,53,55057,53,209,94,115,2,30,1,1
49284,46269,123,16380,123,184,94,90,2,30,1,1
49285,36690,443,36517,443,1520,1058,462,12,29,8,4
49286,51947,443,7702,443,3893,2046,1847,29,56,16,13
49287,64329,53,19539,53,281,110,171,2,30,1,1
49288,65530,53,53494,53,194,102,92,2,30,1,1
49289,41943,443,27053,443,8385,3143,5242,35,98,18,17
49290,57643,80,14145,80,172,172,0,2,5,2,0
49291,45020,443,48024,443,10427,2928,7499,34,106,16,18
49292,56076,80,28614,80,5055,3100,1955,34,17,28,6
49293,60504,443,51319,443,1875,1165,710,13,28,7,6
49294,49225,53,22731,53,295,101,194,4,48,2,2
49295,64912,53,22829,53,258,102,156,2,30,1,1
49296,27005,27001,29327,27001,883,126,757,2,30,1,1
49297,55949,443,10704,443,21852,2269,19583,48,95,23,25
49298,60717,443,21678,443,61464,11538,49926,87,32,41,46
49299,63550,80,63550,80,1232,481,751,10,15,5,5
49300,60087,443,43883,443,5470,3223,2247,43,172,22,21
49301,41619,443,17467,443,188529,10173,178356,248,256,93,155
49302,52406,443,64172,443,13978,8842,5136,46,52,26,20
49303,60821,443,28093,443,16554,7445,9109,49,255,24,25
49304,6881,6881,9262,6881,501,150,351,2,1200,1,1
49305,52698,80,54306,80,8280,5678,2602,25,111,14,11
49306,51808,46390,34181,46390,70,70,0,1,4,1,0
49307,9823,53,9823,53,244,98,146,2,32,1,1
49308,53630,64745,36069,64745,70,70,0,1,4,1,0
49309,39423,80,38195,80,78,78,0,1,4,1,0
49310,49317,53,7671,53,657,187,470,6,72,3,3
49311,53626,33194,63366,33194,70,70,0,1,4,1,0
49312,51826,58925,42484,58925,70,70,0,2,9,2,0
49313,56393,443,8306,443,25779,3436,22343,42,109,19,23
49314,50056,27018,38815,27018,468,390,78,5,29,4,1
49315,56403,443,13577,443,1710,976,734,16,81,8,8
49316,65356,443,39597,443,3122508,193850,2928658,4050,681,1740,2310
49317,64071,53,46762,53,194,102,92,2,29,1,1
49318,53628,50514,36687,50514,70,70,0,1,4,1,0
49319,57938,443,57938,443,27787,5566,22221,60,47,31,29
49320,64772,53,16557,53,416,107,309,4,29,2,2
49321,55621,28144,63708,28144,70,70,0,1,5,1,0
49322,63960,53,46740,53,228,110,118,2,29,1,1
49323,64347,53,53125,53,193,102,91,2,29,1,1
49324,64756,53,60471,53,195,102,93,2,30,1,1
49325,55487,53,48616,53,199,102,97,2,29,1,1
49326,41813,443,58792,443,33072,3479,29593,71,98,38,33
49327,55639,53,39796,53,292,102,190,2,29,1,1
49328,65374,443,10199,443,629017,29841,599176,758,162,331,427
49329,55762,53,29389,53,249,94,155,2,29,1,1
49330,43460,80,58949,80,23394,1667,21727,38,18,20,18
49331,56834,53,24622,53,178,94,84,2,29,1,1
49332,64538,53,8098,53,194,102,92,2,29,1,1
49333,60716,443,27537,443,31452,6667,24785,54,32,29,25
49334,53252,443,33448,443,41435,6615,34820,85,193,46,39
49335,35517,443,27389,443,130,70,60,3,5,2,1
49336,40242,443,42973,443,7407,2516,4891,37,32,19,18
49337,49282,53,14515,53,178,94,84,2,30,1,1
49338,55379,53,3403,53,358,102,256,2,30,1,1
49339,56679,53,5371,53,216,102,114,2,30,1,1
49340,64756,53,21500,53,195,102,93,2,30,1,1
49341,56424,53,14436,53,306,94,212,2,30,1,1
49342,27005,4444,11098,4444,881,126,755,2,30,1,1
49343,53864,443,31491,443,3124,1556,1568,21,275,11,10
49344,65373,443,38852,443,3104883,106687,2998196,3406,190,1320,2086
49345,49225,53,32550,53,295,101,194,4,49,2,2
49346,49323,53,9705,53,210,110,100,2,30,1,1
49347,54511,53,42780,53,304,86,218,2,30,1,1
49348,49601,53,32118,53,178,94,84,2,30,1,1
49349,64756,53,35378,53,195,102,93,2,30,1,1
49350,65083,53,18755,53,198,94,104,2,30,1,1
49351,49631,53,32416,53,323,102,221,2,30,1,1
49352,44037,5223,40215,5223,5096,1030,4066,25,1751,9,16
49353,33409,53,54982,53,79268,76966,2302,936,88,923,13
49354,27005,27015,38552,27015,876,126,750,2,31,1,1
49355,63822,14382,65355,14382,66,66,0,2,8,2,0
49356,54322,443,16940,443,14649,11393,3256,49,99,22,27
49357,27005,27015,18205,27015,888,126,762,3,32,2,1
49358,27005,27016,42584,27016,1010,252,758,4,33,3,1
49359,37576,443,21717,443,11777,4005,7772,35,44,15,20
49360,53124,52917,46926,52917,70,70,0,2,8,2,0
49361,56538,443,26463,443,8490,2953,5537,27,569,15,12
49362,63263,57470,0,0,66,66,0,1,0,1,0
49363,60312,57470,0,0,74,74,0,1,0,1,0
49364,54564,445,0,0,70,70,0,1,0,1,0
49365,54922,445,0,0,66,66,0,1,0,1,0
49366,34422,64147,0,0,145,145,0,1,0,1,0
49367,10427,50584,0,0,146,146,0,1,0,1,0
49368,27641,39004,0,0,62,62,0,1,0,1,0
49369,58497,39004,0,0,66,66,0,1,0,1,0
49370,54560,445,0,0,70,70,0,1,0,1,0
49371,54559,445,0,0,70,70,0,1,0,1,0
49372,5729,22114,0,0,62,62,0,1,0,1,0
49373,59524,445,0,0,70,70,0,1,0,1,0
49374,59526,445,0,0,70,70,0,1,0,1,0
49375,59523,445,0,0,70,70,0,1,0,1,0
49376,54903,445,0,0,66,66,0,1,0,1,0
49377,54906,445,0,0,66,66,0,1,0,1,0
49378,54909,445,0,0,66,66,0,1,0,1,0
49379,54910,445,0,0,66,66,0,1,0,1,0
49380,54905,445,0,0,66,66,0,1,0,1,0
49381,54904,445,0,0,66,66,0,1,0,1,0
49382,54908,445,0,0,66,66,0,1,0,1,0
49383,54902,445,0,0,66,66,0,1,0,1,0
49384,42732,57470,0,0,62,62,0,1,0,1,0
49385,54554,445,0,0,70,70,0,1,0,1,0
49386,59518,445,0,0,70,70,0,1,0,1,0
49387,59514,445,0,0,70,70,0,1,0,1,0
49388,59507,445,0,0,70,70,0,1,0,1,0
49389,52459,5555,0,0,60,60,0,1,0,1,0
49390,53835,62413,0,0,146,146,0,1,0,1,0
49391,45060,37965,0,0,62,62,0,1,0,1,0
49392,6999,11119,0,0,143,143,0,1,0,1,0
49393,54888,445,0,0,66,66,0,1,0,1,0
49394,54889,445,0,0,66,66,0,1,0,1,0
49395,54887,445,0,0,66,66,0,1,0,1,0
49396,43916,21,0,0,60,60,0,1,0,1,0
49397,59506,445,0,0,70,70,0,1,0,1,0
49398,37988,64147,0,0,66,66,0,1,0,1,0
49399,1080,8391,0,0,66,66,0,1,0,1,0
49400,54541,445,0,0,70,70,0,1,0,1,0
49401,58213,37807,0,0,66,66,0,1,0,1,0
49402,59504,445,0,0,70,70,0,1,0,1,0
49403,64379,37965,0,0,66,66,0,1,0,1,0
49404,44849,46478,0,0,74,74,0,1,0,1,0
49405,59502,445,0,0,70,70,0,1,0,1,0
49406,59500,445,0,0,70,70,0,1,0,1,0
49407,59498,445,0,0,70,70,0,1,0,1,0
49408,54538,445,0,0,70,70,0,1,0,1,0
49409,57410,37965,0,0,66,66,0,1,0,1,0
49410,56544,443,50945,443,3413,1537,1876,19,7,10,9
49411,63998,21247,0,0,62,62,0,1,0,1,0
49412,58681,36829,0,0,70,70,0,1,0,1,0
49413,59696,57470,0,0,62,62,0,1,0,1,0
49414,46670,51505,0,0,62,62,0,1,0,1,0
49415,50914,51505,0,0,66,66,0,1,0,1,0
49416,60550,50584,0,0,146,146,0,1,0,1,0
49417,6572,23,0,0,60,60,0,1,0,1,0
49418,54533,445,0,0,70,70,0,1,0,1,0
49419,54532,445,0,0,70,70,0,1,0,1,0
49420,59486,445,0,0,70,70,0,1,0,1,0
49421,59481,445,0,0,70,70,0,1,0,1,0
49422,59482,445,0,0,70,70,0,1,0,1,0
49423,54530,445,0,0,70,70,0,1,0,1,0
49424,57982,64147,0,0,66,66,0,1,0,1,0
49425,20108,64147,0,0,66,66,0,1,0,1,0
49426,56440,56205,0,0,62,62,0,1,0,1,0
49427,59994,11446,0,0,66,66,0,1,0,1,0
49428,64878,26467,0,0,62,62,0,1,0,1,0
49429,1162,57470,0,0,62,62,0,1,0,1,0
49430,54523,445,0,0,70,70,0,1,0,1,0
49431,54867,445,0,0,66,66,0,1,0,1,0
49432,58226,52848,0,0,145,145,0,1,0,1,0
49433,59478,445,0,0,70,70,0,1,0,1,0
49434,59476,445,0,0,70,70,0,1,0,1,0
49435,60627,51050,0,0,62,62,0,1,0,1,0
49436,54521,445,0,0,70,70,0,1,0,1,0
49437,22714,30188,0,0,62,62,0,1,0,1,0
49438,54520,445,0,0,70,70,0,1,0,1,0
49439,46901,26672,0,0,60,60,0,1,0,1,0
49440,54519,445,0,0,70,70,0,1,0,1,0
49441,54518,445,0,0,70,70,0,1,0,1,0
49442,50227,57470,0,0,62,62,0,1,0,1,0
49443,54516,445,0,0,70,70,0,1,0,1,0
49444,54860,445,0,0,66,66,0,1,0,1,0
49445,54858,445,0,0,66,66,0,1,0,1,0
49446,59465,445,0,0,70,70,0,1,0,1,0
49447,59459,445,0,0,70,70,0,1,0,1,0
49448,59456,445,0,0,70,70,0,1,0,1,0
49449,59454,445,0,0,70,70,0,1,0,1,0
49450,54500,445,0,0,70,70,0,1,0,1,0
49451,54855,445,0,0,66,66,0,1,0,1,0
49452,54499,445,0,0,70,70,0,1,0,1,0
49453,54497,445,0,0,70,70,0,1,0,1,0
49454,14252,35993,0,0,66,66,0,1,0,1,0
49455,54490,445,0,0,70,70,0,1,0,1,0
49456,54489,445,0,0,70,70,0,1,0,1,0
49457,57470,54343,65136,54343,330,330,0,6,1200,6,0
49458,62888,53,0,0,193,78,115,2,30,1,1
49459,38602,443,28302,443,130,70,60,3,5,2,1
49460,26461,80,26461,80,490,264,226,8,32,5,3
49461,53142,443,26091,443,4962,887,4075,15,28,9,6
49462,51216,443,25956,443,4540,1056,3484,19,17,11,8
49463,29647,53,29647,53,197,76,121,2,30,1,1
49464,37751,53,37751,53,194,87,107,2,30,1,1
49465,47595,33435,0,0,106,106,0,1,60,1,0
49466,27005,27015,19502,27015,880,126,754,2,30,1,1
49467,49907,443,59724,443,5895,728,5167,16,47,8,8
49468,57598,80,57598,80,1810,821,989,10,20,6,4
49469,57286,443,36985,443,134,60,74,3,10,2,1
49470,26458,80,26458,80,490,264,226,8,32,5,3
49471,27005,27017,57092,27017,900,126,774,2,30,1,1
49472,63955,53,0,0,219,81,138,2,30,1,1
49473,38914,80,38914,80,2993,1469,1524,13,20,8,5
49474,26459,80,26459,80,490,264,226,8,32,5,3
49475,26449,80,26449,80,642,338,304,10,33,6,4
49476,63804,52520,44580,52520,66,66,0,1,5,1,0
49477,60410,18359,27575,18359,1759,820,939,18,16,8,10
49478,53016,443,53016,443,4787,1880,2907,19,27,11,8
49479,49902,443,13295,443,7456,1591,5865,32,54,15,17
49480,50668,443,5052,443,2881,642,2239,13,135,6,7
49481,43809,443,45485,443,9842,2961,6881,31,19,16,15
49482,26460,80,26460,80,490,264,226,8,32,5,3
49483,51213,443,22292,443,6333,2018,4315,25,17,15,10
49484,34672,53,34672,53,213,87,126,2,30,1,1
49485,38947,443,49748,443,16499,9522,6977,44,364,22,22
49486,53143,443,21953,443,4962,887,4075,15,28,9,6
49487,38795,40042,2140,40042,142,80,62,2,31,1,1
49488,62005,80,62005,80,11822,1162,10660,22,20,11,11
49489,60393,443,18640,443,3371,2029,1342,16,360,8,8
49490,41405,443,41405,443,4565,1658,2907,19,29,11,8
49491,56793,14902,9937,14902,264,70,194,4,19,1,3
49492,64785,80,45125,80,2107,1131,976,13,97,7,6
49493,64776,80,31533,80,4502,1072,3430,15,98,7,8
49494,63803,41439,24865,41439,66,66,0,1,5,1,0
49495,50667,80,50667,80,15686,1227,14459,24,20,11,13
49496,49742,80,32579,80,103346,1476,101870,87,17,16,71
49497,58131,53,58131,53,194,87,107,2,30,1,1
49498,64779,80,26888,80,82972,2084,80888,85,98,26,59
49499,49906,443,34595,443,159116,5586,153530,191,47,77,114
49500,27005,27015,17073,27015,886,126,760,2,30,1,1
49501,26452,80,26452,80,642,338,304,10,33,6,4
49502,53822,80,58040,80,1655,1341,314,10,15,5,5
49503,56532,443,17749,443,8381,2848,5533,26,572,14,12
49504,27471,53,27471,53,237,91,146,2,32,1,1
49505,47050,443,20550,443,10868,2200,8668,32,44,14,18
49506,26462,80,26462,80,490,264,226,8,32,5,3
49507,49744,80,34902,80,1111,749,362,9,15,5,4
49508,40146,53,0,0,300,86,214,2,30,1,1
49509,1575,53,0,0,254,86,168,2,30,1,1
49510,50284,80,36535,80,8269,1423,6846,20,75,10,10
49511,38350,80,18584,80,1678,1364,314,10,16,5,5
49512,63955,53,0,0,219,81,138,2,30,1,1
49513,64790,443,44733,443,15810,7525,8285,35,97,18,17
49514,27005,27015,42167,27015,869,126,743,2,30,1,1
49515,64799,443,56278,443,1671,1004,667,16,76,8,8
49516,33923,443,55200,443,4472,1666,2806,13,121,6,7
49517,51509,24855,0,0,66,66,0,1,90,1,0
49518,57869,443,47551,443,11947,2436,9511,19,121,9,10
49519,57679,443,27474,443,6568,2770,3798,20,121,10,10
49520,48817,51634,48817,51634,480,149,331,2,1200,1,1
49521,25085,30188,0,0,62,62,0,1,0,1,0
49522,63724,23,0,0,60,60,0,1,0,1,0
49523,45964,3111,0,0,60,60,0,1,0,1,0
49524,59449,445,0,0,70,70,0,1,0,1,0
49525,59448,445,0,0,70,70,0,1,0,1,0
49526,59447,445,0,0,70,70,0,1,0,1,0
49527,59444,445,0,0,70,70,0,1,0,1,0
49528,54849,445,0,0,66,66,0,1,0,1,0
49529,54845,445,0,0,66,66,0,1,0,1,0
49530,54844,445,0,0,66,66,0,1,0,1,0
49531,54846,445,0,0,66,66,0,1,0,1,0
49532,33706,23,0,0,60,60,0,1,0,1,0
49533,55440,443,52938,443,6622,859,5763,18,15,10,8
49534,51209,443,1552,443,11983,2674,9309,51,17,29,22
49535,64797,53,45567,53,216,102,114,2,30,1,1
49536,54638,36829,0,0,146,146,0,1,0,1,0
49537,41025,38191,0,0,157,157,0,1,0,1,0
49538,53043,51050,0,0,66,66,0,1,0,1,0
49539,54839,445,0,0,66,66,0,1,0,1,0
49540,54838,445,0,0,66,66,0,1,0,1,0
49541,54837,445,0,0,66,66,0,1,0,1,0
49542,54478,445,0,0,70,70,0,1,0,1,0
49543,58022,8080,0,0,60,60,0,1,0,1,0
49544,51197,57470,0,0,66,66,0,1,0,1,0
49545,52526,30188,0,0,66,66,0,1,0,1,0
49546,34731,22114,0,0,62,62,0,1,0,1,0
49547,60970,20541,0,0,66,66,0,1,0,1,0
49548,59442,445,0,0,70,70,0,1,0,1,0
49549,59440,445,0,0,70,70,0,1,0,1,0
49550,10166,44847,0,0,62,62,0,1,0,1,0
49551,57860,51505,0,0,62,62,0,1,0,1,0
49552,54832,445,0,0,66,66,0,1,0,1,0
49553,59435,445,0,0,70,70,0,1,0,1,0
49554,51742,30317,0,0,66,66,0,1,0,1,0
49555,54830,445,0,0,66,66,0,1,0,1,0
49556,54472,445,0,0,70,70,0,1,0,1,0
49557,54829,445,0,0,66,66,0,1,0,1,0
49558,54827,445,0,0,66,66,0,1,0,1,0
49559,54826,445,0,0,66,66,0,1,0,1,0
49560,61808,18375,0,0,66,66,0,1,0,1,0
49561,54463,445,0,0,70,70,0,1,0,1,0
49562,54461,445,0,0,70,70,0,1,0,1,0
49563,54458,445,0,0,70,70,0,1,0,1,0
49564,54457,445,0,0,70,70,0,1,0,1,0
49565,54455,445,0,0,70,70,0,1,0,1,0
49566,43584,26543,0,0,156,156,0,1,0,1,0
49567,32071,51221,0,0,62,62,0,1,0,1,0
49568,53928,15503,0,0,62,62,0,1,0,1,0
49569,59430,445,0,0,70,70,0,1,0,1,0
49570,62011,57354,0,0,159,159,0,1,0,1,0
49571,59422,445,0,0,70,70,0,1,0,1,0
49572,59423,445,0,0,70,70,0,1,0,1,0
49573,34348,22114,0,0,62,62,0,1,0,1,0
49574,1694,30188,0,0,62,62,0,1,0,1,0
49575,64294,64147,0,0,146,146,0,1,0,1,0
49576,54817,445,0,0,66,66,0,1,0,1,0
49577,59745,53635,0,0,66,66,0,1,0,1,0
49578,30179,57470,0,0,60,60,0,1,0,1,0
49579,31384,56205,0,0,62,62,0,1,0,1,0
49580,54450,445,0,0,70,70,0,1,0,1,0
49581,28624,23,0,0,60,60,0,1,0,1,0
49582,59210,8168,0,0,66,66,0,1,0,1,0
49583,45472,8168,0,0,62,62,0,1,0,1,0
49584,45155,53,0,0,226,86,140,2,29,1,1
49585,54775,443,18687,443,12150,2950,9200,35,341,17,18
49586,26448,80,26448,80,642,338,304,10,32,6,4
49587,26451,80,26451,80,642,338,304,10,32,6,4
49588,64571,443,18253,443,9155,2109,7046,27,31,15,12
49589,54525,443,38089,443,3766,1654,2112,10,120,5,5
49590,49637,53,40941,53,255,102,153,2,30,1,1
49591,26450,80,26450,80,642,338,304,10,32,6,4
49592,56539,443,36962,443,8335,2802,5533,26,567,14,12
49593,60758,40010,38736,40010,316,136,180,6,5,3,3
49594,55117,443,14752,443,1350,689,661,14,18,8,6
49595,39599,443,45420,443,1352,691,661,14,18,8,6
49596,39597,443,19827,443,1350,689,661,14,18,8,6
49597,56826,53,57035,53,94,94,0,1,29,1,0
49598,64288,53,63361,53,229,110,119,2,29,1,1
49599,64937,53,3891,53,360,118,242,2,30,1,1
49600,65263,53,26647,53,356,88,268,4,55,2,2
49601,57886,53,57886,53,216,90,126,2,29,1,1
49602,55437,443,17546,443,6622,859,5763,18,15,10,8
49603,42954,443,44795,443,6813,2515,4298,30,58,16,14
49604,55984,53,2333,53,216,102,114,2,30,1,1
49605,62122,53,41697,53,179,86,93,2,30,1,1
49606,50863,443,18214,443,1501,590,911,12,26,6,6
49607,56808,54393,38896,54393,70,70,0,1,5,1,0
49608,55438,443,39653,443,6686,923,5763,19,15,11,8
49609,64793,80,12166,80,508,256,252,9,77,5,4
49610,51206,443,30642,443,12274,2677,9597,51,17,29,22
49611,51698,80,35267,80,15609,1298,14311,26,75,14,12
49612,49504,443,14991,443,18746,2976,15770,32,32,12,20
49613,42286,443,57060,443,6021,1249,4772,20,23,11,9
49614,33446,80,33446,80,1753,833,920,10,20,6,4
49615,45963,443,45963,443,4592,1685,2907,19,27,11,8
49616,49903,443,42458,443,8078,1511,6567,30,54,14,16
49617,56585,443,49312,443,7157,2183,4974,22,16,12,10
49618,56599,53,21288,53,258,110,148,2,30,1,1
49619,27005,27015,45773,27015,899,126,773,2,30,1,1
49620,42286,5228,46877,5228,3489,1598,1891,25,631,7,18
49621,54664,443,62017,443,175780,7700,168080,196,36,78,118
49622,60769,443,3938,443,7639,2051,5588,33,120,17,16
49623,50862,443,25283,443,1501,590,911,12,26,6,6
49624,64767,80,54344,80,3199,988,2211,14,99,7,7
49625,49743,80,24003,80,2981,473,2508,9,16,5,4
49626,63800,80,60637,80,314,192,122,6,15,4,2
49627,51939,80,10449,80,103732,4081,99651,128,61,55,73
49628,53077,80,56021,80,1352,625,727,8,75,5,3
49629,49744,53,4877,53,211,102,109,2,30,1,1
49630,56529,443,43021,443,266757,6935,259822,274,19,97,177
49631,60896,443,6271,443,14819,8197,6622,47,45,26,21
49632,38554,443,64744,443,5021,1030,3991,16,30,9,7
49633,56819,37372,7815,37372,70,70,0,1,5,1,0
49634,49741,80,28243,80,1149,412,737,8,17,5,3
49635,55525,53,40797,53,210,102,108,2,30,1,1
49636,57470,51413,59920,51413,528,528,0,9,1199,9,0
49637,42465,443,2367,443,4885,895,3990,16,29,9,7
49638,51205,443,62572,443,8857,2827,6030,52,17,29,23
49639,55115,443,23390,443,1348,687,661,14,18,8,6
49640,47795,443,48531,443,8708,3949,4759,22,21,11,11
49641,39303,80,19010,80,3198,1493,1705,18,80,11,7
49642,61686,80,38395,80,4004,1513,2491,20,47,10,10
49643,63823,51558,34606,51558,66,66,0,2,7,2,0
49644,56623,80,56144,80,234,234,0,4,12,4,0
49645,63953,53,20506,53,426,89,337,4,49,2,2
49646,51207,443,64631,443,12171,2763,9408,53,17,30,23
49647,64800,80,8529,80,508,256,252,9,75,5,4
49648,49917,443,56620,443,5899,732,5167,16,41,8,8
49649,57198,80,57198,80,6738,909,5829,14,20,7,7
49650,49912,443,43170,443,2048821,56490,1992331,2082,44,522,1560
49651,63729,80,63729,80,7324,1017,6307,16,20,8,8
49652,57909,80,57909,80,2648,921,1727,12,20,7,5
49653,55444,443,64554,443,13284,3562,9722,38,26,21,17
49654,55627,26192,42431,26192,70,70,0,2,8,2,0
49655,51167,80,51167,80,1502,817,685,10,20,6,4
49656,60641,443,61674,443,34758,2573,32185,50,320,21,29
49657,52491,53,62857,53,289,86,203,2,30,1,1
49658,53613,11309,52250,11309,492,306,186,8,16,5,3
49659,47732,80,47732,80,9621,1618,8003,19,20,10,9
49660,37902,123,60994,123,184,94,90,2,30,1,1
49661,59792,80,59792,80,33435,1694,31741,43,20,18,25
49662,27005,27013,56795,27013,879,126,753,2,30,1,1
49663,60314,80,12778,80,1498,539,959,10,77,6,4
49664,60890,443,16222,443,5089,4217,872,23,47,13,10
49665,51407,443,40522,443,25490,8419,17071,54,48,30,24
49666,51211,443,40776,443,7638,2405,5233,44,17,25,19
49667,52076,443,51633,443,24299,8382,15917,69,93,35,34
49668,55626,63805,65310,63805,70,70,0,2,8,2,0
49669,51941,80,19964,80,82496,3881,78615,104,61,47,57
49670,51938,80,6039,80,82321,4061,78260,109,61,50,59
49671,51940,80,62105,80,278312,9722,268590,323,61,135,188
49672,38922,80,38922,80,20984,1380,19604,34,15,18,16
49673,27005,27015,48788,27015,913,126,787,2,30,1,1
49674,65320,53,12285,53,227,110,117,2,30,1,1
49675,50861,443,62102,443,1501,590,911,12,26,6,6
49676,51210,443,30801,443,8248,2460,5788,45,17,26,19
49677,49905,80,54689,80,1173,672,501,8,31,5,3
49678,55617,53,58686,53,196,94,102,2,30,1,1
49679,28699,53,53419,53,278,86,192,2,30,1,1
49680,64232,53,50382,53,258,110,148,2,30,1,1
49681,49928,53,15390,53,243,102,141,2,30,1,1
49682,44847,2499,58207,2499,502,150,352,2,1200,1,1
49683,55877,56036,49566,56036,469,150,319,2,1200,1,1
49684,6882,42505,24055,42505,207,118,89,2,1200,1,1
49685,48337,443,44874,443,227876,8050,219826,236,36,83,153
49686,51208,443,57276,443,8886,2767,6119,52,17,28,24
49687,51422,3027,51422,3027,156,156,0,3,8,3,0
49688,56586,443,35077,443,7110,2183,4927,22,16,12,10
49689,46653,443,4259,443,4037,1058,2979,12,120,6,6
49690,47388,443,44848,443,2897,728,2169,10,121,5,5
49691,57314,443,14727,443,134,60,74,3,6,2,1
49692,57310,443,42139,443,134,60,74,3,6,2,1
49693,63817,50808,9849,50808,66,66,0,2,8,2,0
49694,49534,80,31376,80,1702,611,1091,8,30,4,4
49695,65474,53,12902,53,198,94,104,2,30,1,1
49696,57311,443,59894,443,134,60,74,3,6,2,1
49697,57309,443,42080,443,134,60,74,3,6,2,1
49698,63731,26467,0,0,66,66,0,1,0,1,0
49699,6881,6881,0,0,146,146,0,1,0,1,0
49700,54807,445,0,0,66,66,0,1,0,1,0
49701,59407,445,0,0,70,70,0,1,0,1,0
49702,54442,445,0,0,70,70,0,1,0,1,0
49703,60602,15503,0,0,62,62,0,1,0,1,0
49704,54440,445,0,0,70,70,0,1,0,1,0
49705,54804,445,0,0,66,66,0,1,0,1,0
49706,51620,56205,0,0,66,66,0,1,0,1,0
49707,41447,64147,0,0,62,62,0,1,0,1,0
49708,51996,35440,0,0,66,66,0,1,0,1,0
49709,51424,30188,0,0,66,66,0,1,0,1,0
49710,54436,445,0,0,70,70,0,1,0,1,0
49711,54434,445,0,0,70,70,0,1,0,1,0
49712,54797,445,0,0,66,66,0,1,0,1,0
49713,64240,50584,0,0,66,66,0,1,0,1,0
49714,54794,445,0,0,66,66,0,1,0,1,0
49715,28839,30188,0,0,146,146,0,1,0,1,0
49716,60000,80,0,0,60,60,0,1,0,1,0
49717,54858,51505,0,0,66,66,0,1,0,1,0
49718,65068,23,0,0,60,60,0,1,0,1,0
49719,45941,23386,0,0,60,60,0,1,0,1,0
49720,54997,26467,0,0,62,62,0,1,0,1,0
49721,54430,445,0,0,70,70,0,1,0,1,0
49722,17811,23,0,0,60,60,0,1,0,1,0
49723,54429,445,0,0,70,70,0,1,0,1,0
49724,55986,26467,0,0,66,66,0,1,0,1,0
49725,1070,26467,0,0,62,62,0,1,0,1,0
49726,1026,57866,0,0,146,146,0,1,0,1,0
49727,64940,26467,0,0,62,62,0,1,0,1,0
49728,59397,445,0,0,70,70,0,1,0,1,0
49729,59396,445,0,0,70,70,0,1,0,1,0
49730,59395,445,0,0,70,70,0,1,0,1,0
49731,5664,36237,0,0,66,66,0,1,0,1,0
49732,17873,23117,0,0,66,66,0,1,0,1,0
49733,54780,445,0,0,66,66,0,1,0,1,0
49734,54776,445,0,0,66,66,0,1,0,1,0
49735,54779,445,0,0,66,66,0,1,0,1,0
49736,54781,445,0,0,66,66,0,1,0,1,0
49737,54782,445,0,0,66,66,0,1,0,1,0
49738,54774,445,0,0,66,66,0,1,0,1,0
49739,54778,445,0,0,66,66,0,1,0,1,0
49740,54775,445,0,0,66,66,0,1,0,1,0
49741,15922,44847,0,0,66,66,0,1,0,1,0
49742,54424,445,0,0,70,70,0,1,0,1,0
49743,57853,64147,0,0,66,66,0,1,0,1,0
49744,52741,24211,0,0,66,66,0,1,0,1,0
49745,57339,50584,0,0,62,62,0,1,0,1,0
49746,60129,55442,0,0,66,66,0,1,0,1,0
49747,52699,26467,0,0,62,62,0,1,0,1,0
49748,8239,37965,0,0,146,146,0,1,0,1,0
49749,1024,64147,0,0,62,62,0,1,0,1,0
49750,53490,62413,0,0,66,66,0,1,0,1,0
49751,58966,30188,0,0,66,66,0,1,0,1,0
49752,59394,445,0,0,70,70,0,1,0,1,0
49753,59389,445,0,0,70,70,0,1,0,1,0
49754,59390,445,0,0,70,70,0,1,0,1,0
49755,51740,37965,0,0,66,66,0,1,0,1,0
49756,443,23133,0,0,97,97,0,1,0,1,0
49757,54760,445,0,0,66,66,0,1,0,1,0
49758,54761,445,0,0,66,66,0,1,0,1,0
49759,54759,445,0,0,66,66,0,1,0,1,0
49760,59377,445,0,0,70,70,0,1,0,1,0
49761,54411,445,0,0,70,70,0,1,0,1,0
49762,43584,24748,0,0,156,156,0,1,0,1,0
49763,43584,24748,0,0,156,156,0,1,0,1,0
49764,59459,37807,0,0,66,66,0,1,0,1,0
49765,43584,24748,0,0,156,156,0,1,0,1,0
49766,42414,50939,0,0,148,148,0,1,0,1,0
49767,43584,24748,0,0,156,156,0,1,0,1,0
49768,43584,24748,0,0,156,156,0,1,0,1,0
49769,49690,50265,0,0,62,62,0,1,0,1,0
49770,13907,57470,0,0,66,66,0,1,0,1,0
49771,43584,24748,0,0,156,156,0,1,0,1,0
49772,59375,445,0,0,70,70,0,1,0,1,0
49773,39524,10104,0,0,137,137,0,1,0,1,0
49774,61457,21247,0,0,62,62,0,1,0,1,0
49775,54408,445,0,0,70,70,0,1,0,1,0
49776,0,0,0,0,156,156,0,2,0,2,0
49777,0,0,0,0,156,156,0,2,0,2,0
49778,0,0,0,0,156,156,0,2,0,2,0
49779,0,0,0,0,156,156,0,2,0,2,0
49780,0,0,0,0,124,64,60,2,0,1,1
49781,0,0,0,0,320,320,0,5,0,5,0
49782,59374,445,0,0,70,70,0,1,0,1,0
49783,59370,445,0,0,70,70,0,1,0,1,0
49784,59373,445,0,0,70,70,0,1,0,1,0
49785,34999,25864,0,0,74,74,0,1,0,1,0
49786,50624,26467,0,0,66,66,0,1,0,1,0
49787,17027,1,0,0,62,62,0,1,0,1,0
49788,56966,35440,0,0,66,66,0,1,0,1,0
49789,60133,1,0,0,66,66,0,1,0,1,0
49790,54742,50584,0,0,66,66,0,1,0,1,0
49791,50419,26467,0,0,66,66,0,1,0,1,0
49792,54403,445,0,0,70,70,0,1,0,1,0
49793,57768,37965,0,0,66,66,0,1,0,1,0
49794,54402,445,0,0,70,70,0,1,0,1,0
49795,54400,445,0,0,70,70,0,1,0,1,0
49796,59358,445,0,0,70,70,0,1,0,1,0
49797,59356,445,0,0,70,70,0,1,0,1,0
49798,59353,445,0,0,70,70,0,1,0,1,0
49799,3803,51505,0,0,66,66,0,1,0,1,0
49800,55600,22,0,0,60,60,0,1,0,1,0
49801,44854,26467,0,0,62,62,0,1,0,1,0
49802,46901,26672,0,0,60,60,0,1,0,1,0
49803,50027,21247,0,0,62,62,0,1,0,1,0
49804,54109,36829,0,0,62,62,0,1,0,1,0
49805,6889,45850,0,0,143,143,0,1,0,1,0
49806,54393,445,0,0,70,70,0,1,0,1,0
49807,35843,51505,0,0,146,146,0,1,0,1,0
49808,52076,44847,0,0,62,62,0,1,0,1,0
49809,54391,445,0,0,70,70,0,1,0,1,0
49810,54739,445,0,0,66,66,0,1,0,1,0
49811,45964,2666,0,0,60,60,0,1,0,1,0
49812,49677,64147,0,0,62,62,0,1,0,1,0
49813,59350,445,0,0,70,70,0,1,0,1,0
49814,59347,445,0,0,70,70,0,1,0,1,0
49815,1046,48817,0,0,62,62,0,1,0,1,0
49816,54786,30188,0,0,66,66,0,1,0,1,0
49817,54390,445,0,0,70,70,0,1,0,1,0
49818,49497,443,3660,443,8816,4876,3940,23,31,12,11
49819,50987,10086,44124,10086,217,157,60,2,5,1,1
49820,51540,3389,51540,3389,4425,2641,1784,21,33,12,9
49821,35356,53,0,0,82,82,0,1,30,1,0
49822,41028,80,41028,80,100182,8294,91888,137,127,69,68
49823,33992,53,33992,53,79,79,0,1,30,1,0
49824,53017,80,53017,80,184725,5028,179697,217,25,75,142
49825,53019,80,53019,80,181759,5146,176613,216,25,77,139
49826,53298,443,6587,443,5601,1187,4414,24,80,13,11
49827,44960,80,44960,80,4372,2093,2279,16,19,10,6
49828,12677,53,12677,53,234,93,141,2,30,1,1
49829,33992,53,33992,53,462,158,304,4,30,2,2
49830,27005,27015,49303,27015,868,126,742,2,30,1,1
49831,54405,53,0,0,174,79,95,2,30,1,1
49832,38038,443,62435,443,6180,3550,2630,27,272,13,14
49833,65410,443,49825,443,2494,1643,851,17,25,9,8
49834,34245,443,35232,443,11441,6765,4676,40,792,19,21
49835,51221,52423,24107,52423,322,149,173,2,1201,1,1
49836,15503,3082,40195,3082,480,149,331,2,1200,1,1
49837,39213,443,39213,443,4378,1471,2907,19,29,11,8
49838,53020,80,53020,80,134273,4066,130207,163,22,59,104
49839,37965,51413,23143,51413,2020,1090,930,18,1200,15,3
49840,50116,22,50116,22,184,120,64,4,10,3,1
49841,49290,443,20906,443,1629306,22920,1606386,1339,116,262,1077
49842,54998,80,32299,80,2814,2440,374,13,16,7,6
49843,23397,53,23397,53,234,93,141,2,30,1,1
49844,34028,443,55750,443,7804,2108,5696,24,32,14,10
49845,53640,28937,48559,28937,70,70,0,2,8,2,0
49846,58714,53,58714,53,197,76,121,2,30,1,1
49847,52280,995,52280,995,142,78,64,2,5,1,1
49848,57470,29500,37295,29500,2772,2772,0,43,2311,43,0
49849,50584,19051,19819,19051,300,300,0,3,1200,3,0
49850,65286,3389,65286,3389,3424,1710,1714,16,31,8,8
49851,53297,443,55944,443,5600,1187,4413,24,80,13,11
49852,53018,80,53018,80,182677,4908,177769,213,25,73,140
49853,60418,39537,32602,39537,70,70,0,2,8,2,0
49854,10101,443,13897,443,7563,1536,6027,26,316,14,12
49855,49624,443,56067,443,6440,1965,4475,22,36,12,10
49856,27005,27017,63290,27017,917,126,791,2,30,1,1
49857,27005,27015,7639,27015,919,126,793,2,30,1,1
49858,50584,12948,3713,12948,346,161,185,2,1200,1,1
49859,46573,50584,0,0,66,66,0,1,0,1,0
49860,52633,30188,0,0,66,66,0,1,0,1,0
49861,39313,37965,0,0,62,62,0,1,0,1,0
49862,54389,445,0,0,70,70,0,1,0,1,0
49863,54388,445,0,0,70,70,0,1,0,1,0
49864,53770,64147,0,0,66,66,0,1,0,1,0
49865,54386,445,0,0,70,70,0,1,0,1,0
49866,54385,445,0,0,70,70,0,1,0,1,0
49867,40082,2222,0,0,60,60,0,1,0,1,0
49868,1025,35447,0,0,62,62,0,1,0,1,0
49869,45908,33330,0,0,60,60,0,1,0,1,0
49870,54731,445,0,0,66,66,0,1,0,1,0
49871,65476,443,36901,443,93073,4939,88134,111,16,45,66
49872,52286,995,52286,995,146,82,64,2,5,1,1
49873,37965,30982,7359,30982,528,528,0,9,1199,9,0
49874,55746,53,18233,53,302,84,218,4,46,2,2
49875,43757,3389,43757,3389,3910,1805,2105,20,18,12,8
49876,64326,53,53148,53,323,107,216,4,38,2,2
49877,57315,443,25232,443,134,60,74,3,5,2,1
49878,64723,53,23544,53,677,198,479,6,68,3,3
49879,56476,53,63647,53,239,94,145,2,30,1,1
49880,59470,443,18542,443,3726,688,3038,14,119,7,7
49881,33811,443,49179,443,17406,8237,9169,53,165,21,32
49882,50840,80,15901,80,268155,6485,261670,281,25,97,184
49883,56276,443,43498,443,71414,17145,54269,194,292,91,103
49884,63820,27441,36322,27441,66,66,0,2,7,2,0
49885,40165,443,53877,443,232,172,60,3,5,2,1
49886,65207,443,12429,443,8188,2769,5419,22,611,12,10
49887,63819,18445,64902,18445,66,66,0,2,7,2,0
49888,35357,53,47462,53,291,86,205,2,29,1,1
49889,50977,80,13754,80,45483,4137,41346,68,21,36,32
49890,50975,80,19286,80,24781,3304,21477,43,21,24,19
49891,61674,443,44305,443,6117,1224,4893,21,50,12,9
49892,56596,53,31877,53,350,94,256,2,30,1,1
49893,63816,2073,29145,2073,66,66,0,2,7,2,0
49894,64494,53,52141,53,337,110,227,2,29,1,1
49895,57312,443,4774,443,134,60,74,3,5,2,1
49896,27005,27015,22389,27015,879,126,753,2,30,1,1
49897,48817,10528,48817,10528,2736,1992,744,37,1580,25,12
49898,50584,8622,56694,8622,166,166,0,1,1200,1,0
49899,49501,443,9020,443,15456,2581,12875,28,31,10,18
49900,49475,53,49996,53,243,110,133,2,30,1,1
49901,34922,443,21368,443,8093,2068,6025,23,360,11,12
49902,60715,443,1663,443,1716,1136,580,15,30,9,6
49903,56441,80,25376,80,130,70,60,2,15,1,1
49904,51981,80,47640,80,48165,2605,45560,63,15,31,32
49905,55190,443,14814,443,12801,4250,8551,40,118,21,19
49906,65475,443,62261,443,429726,12570,417156,440,16,154,286
49907,60416,55998,61754,55998,70,70,0,2,8,2,0
49908,53314,443,30512,443,12053,6627,5426,47,1043,26,21
49909,5235,34592,6891,34592,247495,256,247239,361,49,5,356
49910,57093,80,11310,80,130,70,60,2,15,1,1
49911,50584,26433,35868,26433,166,166,0,1,1200,1,0
49912,49450,53,42470,53,330,118,212,2,30,1,1
49913,50584,12754,22956,12754,161,161,0,2,1200,2,0
49914,27005,27015,50537,27015,878,126,752,2,30,1,1
49915,50978,80,49892,80,81390,4223,77167,103,21,49,54
49916,36754,7,13340,7,138,78,60,2,5,1,1
49917,56428,80,32588,80,17247,1619,15628,26,25,11,15
49918,53292,443,45740,443,4028,2584,1444,18,80,10,8
49919,4780,443,25705,443,1191,692,499,12,40,7,5
49920,51952,80,54561,80,1263,640,623,12,45,7,5
49921,57340,3333,57340,3333,24544,10921,13623,171,1095,89,82
49922,37769,80,60461,80,1213,471,742,10,255,6,4
49923,51951,80,24462,80,1265,642,623,12,45,7,5
49924,59106,443,57756,443,7398,2209,5189,23,35,11,12
49925,49404,53,39531,53,253,102,151,2,30,1,1
49926,27005,27018,24466,27018,882,126,756,2,30,1,1
49927,27005,27015,30434,27015,877,126,751,2,30,1,1
49928,27005,27444,25309,27444,893,126,767,2,30,1,1
49929,56579,53,36844,53,288,94,194,2,30,1,1
49930,50584,6881,16713,6881,166,166,0,1,1200,1,0
49931,49597,80,42235,80,130,70,60,2,15,1,1
49932,50414,443,29700,443,1346,918,428,10,25,6,4
49933,50974,80,38911,80,181877,8980,172897,207,22,87,120
49934,49920,443,45165,443,8888,2265,6623,18,15,9,9
49935,49218,443,48762,443,8929,3316,5613,38,255,18,20
49936,57425,443,11895,443,16413,6367,10046,60,17,28,32
49937,60417,55100,30057,55100,258,70,188,4,8,2,2
49938,63814,12906,64380,12906,66,66,0,2,7,2,0
49939,63818,19291,56455,19291,66,66,0,2,7,2,0
49940,53641,16605,38186,16605,70,70,0,2,7,2,0
49941,57319,443,43757,443,134,60,74,3,5,2,1
49942,57313,443,59852,443,134,60,74,3,5,2,1
49943,45566,443,9859,443,570475,25559,544916,712,32,341,371
49944,46092,443,17410,443,130,70,60,2,15,1,1
49945,45079,80,36951,80,233914,10359,223555,294,442,136,158
49946,63670,11648,33474,11648,4501,3174,1327,26,61,16,10
49947,64539,53,23141,53,712,214,498,6,44,3,3
49948,63813,53455,26592,53455,66,66,0,2,7,2,0
49949,57328,443,39932,443,134,60,74,3,4,2,1
49950,52285,995,52285,995,146,82,64,2,5,1,1
49951,49414,53,44484,53,561,112,449,4,53,2,2
49952,33932,443,50545,443,54451,2603,51848,70,16,30,40
49953,61361,443,55767,443,9604,5021,4583,29,86,15,14
49954,63994,53,4398,53,225,110,115,2,30,1,1
49955,63980,443,5737,443,5237,2844,2393,14,135,7,7
49956,58194,443,27436,443,3108,1047,2061,14,136,7,7
49957,43976,80,46864,80,130,70,60,2,15,1,1
49958,37805,443,7210,443,9481,3482,5999,58,16,29,29
49959,51944,80,27996,80,2120,1080,1040,17,55,10,7
49960,44164,443,64667,443,280,140,140,5,130,3,2
49961,50584,1191,3170,1191,161,161,0,2,1200,2,0
49962,53373,443,1651,443,8557,1755,6802,28,35,14,14
49963,47902,443,46766,443,2420,1462,958,18,170,10,8
49964,51950,80,41291,80,1268,645,623,12,45,7,5
49965,50584,6881,12157,6881,166,166,0,1,1200,1,0
49966,50584,6889,8974,6889,166,166,0,1,1200,1,0
49967,55981,80,16434,80,824,469,355,9,360,5,4
49968,35122,80,19351,80,130,70,60,2,15,1,1
49969,53244,53,53244,53,217,82,135,2,32,1,1
49970,50976,80,37762,80,3030,1372,1658,13,21,8,5
49971,55979,53,61976,53,275,110,165,2,30,1,1
49972,64731,53,27701,53,403,142,261,2,30,1,1
49973,55060,123,26864,123,184,94,90,2,30,1,1
49974,51434,443,45613,443,12291742,358717,11933025,12485,181,3846,8639
49975,37000,443,57961,443,280,140,140,5,130,3,2
49976,60980,443,25213,443,134,60,74,3,6,2,1
49977,48070,443,9695,443,10240,2295,7945,38,121,20,18
49978,49135,443,9255,443,2529,1230,1299,17,16,9,8
49979,48344,443,40212,443,232,172,60,3,5,2,1
49980,51508,443,54920,443,98292,24468,73824,179,52,81,98
49981,56930,53,11324,53,297,94,203,2,30,1,1
49982,49292,53,63112,53,323,94,229,2,31,1,1
49983,50209,1688,49264,1688,70,70,0,2,8,2,0
49984,63796,60557,4607,60557,70,70,0,1,5,1,0
49985,51515,443,8850,443,16287,13303,2984,49,38,26,23
49986,5753,65473,0,0,146,146,0,1,0,1,0
49987,59943,37807,0,0,62,62,0,1,0,1,0
49988,54730,445,0,0,66,66,0,1,0,1,0
49989,59328,445,0,0,70,70,0,1,0,1,0
49990,54370,445,0,0,70,70,0,1,0,1,0
49991,51166,31573,0,0,66,66,0,1,0,1,0
49992,54369,445,0,0,70,70,0,1,0,1,0
49993,54366,445,0,0,70,70,0,1,0,1,0
49994,59320,445,0,0,70,70,0,1,0,1,0
49995,59317,445,0,0,70,70,0,1,0,1,0
49996,59315,445,0,0,70,70,0,1,0,1,0
49997,54359,445,0,0,70,70,0,1,0,1,0
49998,54360,445,0,0,70,70,0,1,0,1,0
49999,62029,36237,0,0,66,66,0,1,0,1,0
50000,54728,445,0,0,66,66,0,1,0,1,0
50001,33453,64147,0,0,62,62,0,1,0,1,0
50002,49177,54532,0,0,60,60,0,1,0,1,0
50003,59301,445,0,0,70,70,0,1,0,1,0
50004,43104,26467,0,0,62,62,0,1,0,1,0
50005,20576,37965,0,0,62,62,0,1,0,1,0
50006,443,43775,0,0,97,97,0,1,0,1,0
50007,55933,64097,0,0,62,62,0,1,0,1,0
50008,59297,445,0,0,70,70,0,1,0,1,0
50009,59296,445,0,0,70,70,0,1,0,1,0
50010,59295,445,0,0,70,70,0,1,0,1,0
50011,38358,22300,0,0,60,60,0,1,0,1,0
50012,54721,445,0,0,66,66,0,1,0,1,0
50013,54348,445,0,0,70,70,0,1,0,1,0
50014,7104,23,0,0,60,60,0,1,0,1,0
50015,17226,35440,0,0,62,62,0,1,0,1,0
50016,54717,445,0,0,66,66,0,1,0,1,0
50017,54716,445,0,0,66,66,0,1,0,1,0
50018,54712,445,0,0,66,66,0,1,0,1,0
50019,9377,56205,0,0,66,66,0,1,0,1,0
50020,7749,36237,0,0,62,62,0,1,0,1,0
50021,54711,445,0,0,66,66,0,1,0,1,0
50022,54710,445,0,0,66,66,0,1,0,1,0
50023,54709,445,0,0,66,66,0,1,0,1,0
50024,47652,51505,0,0,62,62,0,1,0,1,0
50025,63586,46824,0,0,62,62,0,1,0,1,0
50026,1054,15503,0,0,62,62,0,1,0,1,0
50027,4269,26672,0,0,60,60,0,1,0,1,0
50028,59292,445,0,0,70,70,0,1,0,1,0
50029,59287,445,0,0,70,70,0,1,0,1,0
50030,59286,445,0,0,70,70,0,1,0,1,0
50031,50254,44847,0,0,62,62,0,1,0,1,0
50032,54343,445,0,0,70,70,0,1,0,1,0
50033,54706,445,0,0,66,66,0,1,0,1,0
50034,39540,37965,0,0,66,66,0,1,0,1,0
50035,59285,445,0,0,70,70,0,1,0,1,0
50036,56173,37807,0,0,62,62,0,1,0,1,0
50037,54702,445,0,0,66,66,0,1,0,1,0
50038,49982,37965,0,0,66,66,0,1,0,1,0
50039,53406,50584,0,0,62,62,0,1,0,1,0
50040,54701,445,0,0,66,66,0,1,0,1,0
50041,54700,445,0,0,66,66,0,1,0,1,0
50042,49716,5900,0,0,60,60,0,1,0,1,0
50043,30179,57470,0,0,60,60,0,1,0,1,0
50044,54334,445,0,0,70,70,0,1,0,1,0
50045,54335,445,0,0,70,70,0,1,0,1,0
50046,43194,32480,0,0,145,145,0,1,0,1,0
50047,54698,445,0,0,66,66,0,1,0,1,0
50048,54332,445,0,0,70,70,0,1,0,1,0
50049,54331,445,0,0,70,70,0,1,0,1,0
50050,54327,445,0,0,70,70,0,1,0,1,0
50051,58264,44847,0,0,66,66,0,1,0,1,0
50052,59277,445,0,0,70,70,0,1,0,1,0
50053,59273,445,0,0,70,70,0,1,0,1,0
50054,59270,445,0,0,70,70,0,1,0,1,0
50055,52361,23718,0,0,66,66,0,1,0,1,0
50056,54321,445,0,0,70,70,0,1,0,1,0
50057,54687,445,0,0,66,66,0,1,0,1,0
50058,12221,81,0,0,60,60,0,1,0,1,0
50059,43916,21,0,0,60,60,0,1,0,1,0
50060,64339,18375,0,0,62,62,0,1,0,1,0
50061,54314,445,0,0,70,70,0,1,0,1,0
50062,54679,445,0,0,66,66,0,1,0,1,0
50063,54312,445,0,0,70,70,0,1,0,1,0
50064,51051,22,51051,22,327,140,187,4,0,2,2
50065,59257,445,0,0,70,70,0,1,0,1,0
50066,34936,30188,0,0,66,66,0,1,0,1,0
50067,3559,30188,0,0,66,66,0,1,0,1,0
50068,18246,64097,0,0,66,66,0,1,0,1,0
50069,7992,64147,0,0,62,62,0,1,0,1,0
50070,55921,43890,0,0,66,66,0,1,0,1,0
50071,52217,22114,0,0,62,62,0,1,0,1,0
50072,59790,44847,0,0,62,62,0,1,0,1,0
50073,54676,445,0,0,66,66,0,1,0,1,0
50074,54308,445,0,0,70,70,0,1,0,1,0
50075,54306,445,0,0,70,70,0,1,0,1,0
50076,23089,48817,0,0,62,62,0,1,0,1,0
50077,54670,445,0,0,66,66,0,1,0,1,0
50078,41298,51050,0,0,62,62,0,1,0,1,0
50079,33822,57470,0,0,66,66,0,1,0,1,0
50080,54666,445,0,0,66,66,0,1,0,1,0
50081,54302,445,0,0,70,70,0,1,0,1,0
50082,63542,15503,0,0,62,62,0,1,0,1,0
50083,54301,445,0,0,70,70,0,1,0,1,0
50084,57131,35776,0,0,145,145,0,1,0,1,0
50085,63092,46776,0,0,78,78,0,1,0,1,0
50086,63772,35440,0,0,62,62,0,1,0,1,0
50087,64877,37450,0,0,62,62,0,1,0,1,0
50088,58721,51505,0,0,66,66,0,1,0,1,0
50089,53774,51505,0,0,66,66,0,1,0,1,0
50090,49255,44847,0,0,66,66,0,1,0,1,0
50091,59248,445,0,0,70,70,0,1,0,1,0
50092,59246,445,0,0,70,70,0,1,0,1,0
50093,59245,445,0,0,70,70,0,1,0,1,0
50094,54651,445,0,0,66,66,0,1,0,1,0
50095,54647,445,0,0,66,66,0,1,0,1,0
50096,54652,445,0,0,66,66,0,1,0,1,0
50097,54648,445,0,0,66,66,0,1,0,1,0
50098,54649,445,0,0,66,66,0,1,0,1,0
50099,54653,445,0,0,66,66,0,1,0,1,0
50100,54650,445,0,0,66,66,0,1,0,1,0
50101,54654,445,0,0,66,66,0,1,0,1,0
50102,10639,11392,0,0,62,62,0,1,0,1,0
50103,54296,445,0,0,70,70,0,1,0,1,0
50104,49805,64147,0,0,62,62,0,1,0,1,0
50105,53178,26467,0,0,62,62,0,1,0,1,0
50106,33362,50584,0,0,146,146,0,1,0,1,0
50107,0,0,0,0,244,244,0,2,0,2,0
50108,0,0,0,0,156,156,0,2,0,2,0
50109,52643,36237,0,0,66,66,0,1,0,1,0
50110,63456,37965,0,0,62,62,0,1,0,1,0
50111,59232,445,0,0,70,70,0,1,0,1,0
50112,59229,445,0,0,70,70,0,1,0,1,0
50113,59230,445,0,0,70,70,0,1,0,1,0
50114,61838,37965,0,0,66,66,0,1,0,1,0
50115,54196,11392,0,0,66,66,0,1,0,1,0
50116,54632,445,0,0,66,66,0,1,0,1,0
50117,54633,445,0,0,66,66,0,1,0,1,0
50118,54631,445,0,0,66,66,0,1,0,1,0
50119,36080,26467,0,0,62,62,0,1,0,1,0
50120,54283,445,0,0,70,70,0,1,0,1,0
50121,59227,445,0,0,70,70,0,1,0,1,0
50122,80,37649,0,0,60,60,0,1,0,1,0
50123,52696,21247,0,0,66,66,0,1,0,1,0
50124,41346,30188,0,0,62,62,0,1,0,1,0
50125,57632,7302,0,0,146,146,0,1,0,1,0
50126,54280,445,0,0,70,70,0,1,0,1,0
50127,59225,445,0,0,70,70,0,1,0,1,0
50128,59220,445,0,0,70,70,0,1,0,1,0
50129,59216,445,0,0,70,70,0,1,0,1,0
50130,59214,445,0,0,70,70,0,1,0,1,0
50131,6666,44818,0,0,60,60,0,1,0,1,0
50132,59563,56205,0,0,66,66,0,1,0,1,0
50133,30578,55783,0,0,145,145,0,1,0,1,0
50134,1511,3389,0,0,60,60,0,1,0,1,0
50135,22904,56205,0,0,62,62,0,1,0,1,0
50136,54276,445,0,0,70,70,0,1,0,1,0
50137,54274,445,0,0,70,70,0,1,0,1,0
50138,62549,53733,0,0,66,66,0,1,0,1,0
50139,54272,445,0,0,70,70,0,1,0,1,0
50140,1033,35440,0,0,146,146,0,1,0,1,0
50141,30114,65151,0,0,60,60,0,1,0,1,0
50142,10151,1042,12380,1042,490,149,341,2,1200,1,1
50143,41027,80,41027,80,18224,2763,15461,29,126,14,15
50144,41030,80,41030,80,80261,4766,75495,91,126,35,56
50145,27005,27015,43696,27015,876,126,750,2,30,1,1
50146,49289,443,60908,443,3890599,46254,3844345,3173,116,609,2564
50147,60312,80,47441,80,2390,532,1858,11,75,6,5
50148,49535,80,31379,80,1548,847,701,10,16,5,5
50149,50767,80,50767,80,30767,854,29913,38,15,13,25
50150,53016,80,53016,80,265868,5026,260842,277,24,75,202
50151,37981,80,45214,80,1572,755,817,11,15,6,5
50152,56002,53,0,0,213,88,125,2,30,1,1
50153,23916,53,23916,53,224,88,136,2,30,1,1
50154,39932,443,25651,443,8309,4385,3924,26,121,12,14
50155,33006,80,33006,80,6582,886,5696,15,16,7,8
50156,65239,53,65239,53,231,90,141,2,30,1,1
50157,3181,53,3181,53,214,97,117,2,30,1,1
50158,58611,53,0,0,172,78,94,2,30,1,1
50159,57700,53,0,0,300,90,210,2,30,1,1
50160,49233,8080,49233,8080,2602,846,1756,13,136,7,6
50161,49023,5223,36604,5223,139,139,0,1,5,1,0
50162,49536,80,12566,80,4544,3602,942,15,15,8,7
50163,44912,443,31289,443,414,140,274,7,26,3,4
50164,57674,53,0,0,195,79,116,2,30,1,1
50165,64172,53,0,0,174,79,95,2,30,1,1
50166,13699,53,13699,53,194,87,107,2,30,1,1
50167,58217,53,0,0,266,85,181,2,30,1,1
50168,57240,53,0,0,230,87,143,2,30,1,1
50169,58120,53,58120,53,825,99,726,2,30,1,1
50170,51091,53,51091,53,243,96,147,2,30,1,1
50171,55866,53,45530,53,732,89,643,2,30,1,1
50172,52763,53,0,0,296,87,209,2,30,1,1
50173,30960,45703,22089,45703,330,330,0,6,3609,6,0
50174,41029,80,41029,80,12386,2651,9735,24,126,12,12
50175,45336,443,30419,443,2312,1382,930,19,28,11,8
50176,43969,7000,43969,7000,3370,1595,1775,16,15,9,7
50177,51969,80,41756,80,7304882,206543,7098339,7398,37,2677,4721
50178,54908,53,0,0,174,79,95,2,30,1,1
50179,63799,13835,56478,13835,66,66,0,1,5,1,0
50180,44395,443,50721,443,18921,10848,8073,49,401,20,29
50181,42040,5228,65521,5228,3467,1977,1490,29,3742,14,15
50182,48786,80,30638,80,1834,1520,314,14,15,9,5
50183,59468,80,3821,80,1594,1280,314,10,15,5,5
50184,45337,443,2595,443,2312,1382,930,19,24,11,8
50185,23333,53,23333,53,215,80,135,2,33,1,1
50186,56077,80,50993,80,5302,704,4598,14,18,8,6
50187,49225,8080,49225,8080,43790,20134,23656,73,400,45,28
50188,51972,80,28549,80,7001170,112187,6888983,6101,29,1546,4555
50189,63797,47784,45642,47784,66,66,0,1,5,1,0
50190,49845,53,0,0,206,83,123,2,30,1,1
50191,61452,53,0,0,223,89,134,2,30,1,1
50192,49235,8080,49235,8080,2600,844,1756,13,136,7,6
50193,25251,53,25251,53,231,90,141,2,30,1,1
50194,42008,53,0,0,82,82,0,1,30,1,0
50195,42891,53,42891,53,224,88,136,2,30,1,1
50196,59891,53,0,0,248,75,173,2,30,1,1
50197,1955,53,1955,53,216,89,127,2,30,1,1
50198,27005,27017,10381,27017,600,126,474,2,30,1,1
50199,22633,53,0,0,300,90,210,2,30,1,1
50200,52033,443,12817,443,9609,3239,6370,25,143,12,13
50201,41032,80,41032,80,11428,2250,9178,22,126,11,11
50202,59208,445,0,0,70,70,0,1,0,1,0
50203,59207,445,0,0,70,70,0,1,0,1,0
50204,59203,445,0,0,70,70,0,1,0,1,0
50205,28229,51505,0,0,146,146,0,1,0,1,0
50206,59845,44847,0,0,66,66,0,1,0,1,0
50207,24174,57470,0,0,62,62,0,1,0,1,0
50208,17453,35440,0,0,66,66,0,1,0,1,0
50209,55539,57470,0,0,66,66,0,1,0,1,0
50210,80,53945,0,0,60,60,0,1,0,1,0
50211,54265,445,0,0,70,70,0,1,0,1,0
50212,54263,445,0,0,70,70,0,1,0,1,0
50213,2541,51505,0,0,66,66,0,1,0,1,0
50214,61415,443,64279,443,6143,1796,4347,21,21,11,10
50215,38028,443,50090,443,8805,1300,7505,23,30,12,11
50216,64378,53,28947,53,273,94,179,2,30,1,1
50217,41901,443,21025,443,5586,1404,4182,17,212,10,7
50218,57304,443,45886,443,134,60,74,3,5,2,1
50219,48706,23393,0,0,60,60,0,1,0,1,0
50220,54612,445,0,0,66,66,0,1,0,1,0
50221,46679,64147,0,0,62,62,0,1,0,1,0
50222,54262,445,0,0,70,70,0,1,0,1,0
50223,59200,445,0,0,70,70,0,1,0,1,0
50224,59198,445,0,0,70,70,0,1,0,1,0
50225,54261,445,0,0,70,70,0,1,0,1,0
50226,54260,445,0,0,70,70,0,1,0,1,0
50227,28498,36237,0,0,146,146,0,1,0,1,0
50228,54254,445,0,0,70,70,0,1,0,1,0
50229,54256,445,0,0,70,70,0,1,0,1,0
50230,48706,23393,0,0,60,60,0,1,0,1,0
50231,49177,54532,0,0,60,60,0,1,0,1,0
50232,51558,37965,0,0,72,72,0,1,0,1,0
50233,56906,50584,0,0,146,146,0,1,0,1,0
50234,54605,445,0,0,66,66,0,1,0,1,0
50235,54242,445,0,0,70,70,0,1,0,1,0
50236,54241,445,0,0,70,70,0,1,0,1,0
50237,54235,445,0,0,70,70,0,1,0,1,0
50238,54232,445,0,0,70,70,0,1,0,1,0
50239,54231,445,0,0,70,70,0,1,0,1,0
50240,54602,445,0,0,66,66,0,1,0,1,0
50241,65115,50584,0,0,62,62,0,1,0,1,0
50242,59186,445,0,0,70,70,0,1,0,1,0
50243,2394,43890,0,0,62,62,0,1,0,1,0
50244,22683,39210,0,0,60,60,0,1,0,1,0
50245,443,56858,0,0,85,85,0,1,0,1,0
50246,52643,15941,0,0,66,66,0,1,0,1,0
50247,59181,445,0,0,70,70,0,1,0,1,0
50248,59180,445,0,0,70,70,0,1,0,1,0
50249,59177,445,0,0,70,70,0,1,0,1,0
50250,21145,11392,0,0,146,146,0,1,0,1,0
50251,54600,445,0,0,66,66,0,1,0,1,0
50252,49479,56205,0,0,66,66,0,1,0,1,0
50253,34134,30188,0,0,62,62,0,1,0,1,0
50254,50280,57470,0,0,78,78,0,1,0,1,0
50255,64835,53,44115,53,371,126,245,2,30,1,1
50256,39228,53,7632,53,199,94,105,2,30,1,1
50257,45218,443,18311,443,16297,12965,3332,54,193,30,24
50258,53013,80,53013,80,258732,4788,253944,268,25,71,197
50259,3440,7000,3440,7000,3127,676,2451,15,19,7,8
50260,63798,16357,31313,16357,70,70,0,1,4,1,0
50261,49533,80,42327,80,8220,849,7371,13,28,5,8
50262,63795,52376,52814,52376,70,70,0,1,4,1,0
50263,36788,443,36788,443,4555,1648,2907,19,29,11,8
50264,40236,443,44776,443,4945,1401,3544,21,25,11,10
50265,51522,443,24413,443,8517,2719,5798,24,360,12,12
50266,55684,53,0,0,219,86,133,2,29,1,1
50267,52837,53,0,0,86,86,0,1,29,1,0
50268,35187,443,44307,443,27553,21226,6327,57,216,31,26
50269,50211,53,50211,53,217,90,127,2,29,1,1
50270,50491,53,0,0,183,86,97,2,29,1,1
50271,56969,53,53086,53,196,94,102,2,29,1,1
50272,14237,53,14237,53,245,98,147,2,29,1,1
50273,65191,53,21889,53,196,94,102,2,29,1,1
50274,58126,443,22478,443,3179,954,2225,10,120,5,5
50275,57426,66,63838,66,70,70,0,1,5,1,0
50276,56804,33375,57101,33375,70,70,0,1,5,1,0
50277,49710,53,2087,53,179,94,85,2,30,1,1
50278,27005,27019,52593,27019,1007,252,755,4,32,3,1
50279,51433,443,11382,443,194,70,124,3,11,1,2
50280,49234,8080,49234,8080,2604,848,1756,13,136,7,6
50281,5588,5588,0,0,3354,1792,1562,46,192,23,23
50282,59752,443,56734,443,2233,1237,996,18,75,9,9
50283,56592,53,8567,53,262,94,168,2,30,1,1
50284,52189,443,26207,443,4688,3009,1679,33,80,17,16
50285,54136,80,22556,80,25148,5233,19915,39,71,21,18
50286,34535,443,2952,443,74325,3719,70606,98,200,44,54
50287,49416,443,60402,443,625995,31468,594527,722,199,256,466
50288,49710,53,37323,53,179,94,85,2,30,1,1
50289,50265,43974,25412,43974,132,132,0,3,1200,3,0
50290,52763,53,0,0,641,87,554,2,30,1,1
50291,53310,443,4749,443,2253,1403,850,15,121,9,6
50292,56818,45179,49960,45179,70,70,0,1,5,1,0
50293,61421,443,24287,443,7206,1897,5309,20,21,11,9
50294,52071,443,56996,443,8232,3997,4235,21,16,11,10
50295,49562,53,45656,53,380,90,290,4,48,2,2
50296,60756,40010,4489,40010,316,136,180,6,6,3,3
50297,42776,443,39063,443,4353,687,3666,14,25,8,6
50298,37082,443,41934,443,2419,1461,958,18,170,10,8
50299,56235,53,15523,53,199,94,105,2,30,1,1
50300,27005,27222,42780,27222,890,126,764,2,30,1,1
50301,65200,53,35834,53,290,102,188,2,30,1,1
50302,41031,80,41031,80,2791,1259,1532,13,125,7,6
50303,58830,28678,13686,28678,1806,1806,0,22,224,22,0
50304,60240,443,63324,443,4310,2523,1787,42,120,24,18
50305,53318,80,64678,80,1536,982,554,10,76,6,4
50306,54246,80,56298,80,506,292,214,8,16,5,3
50307,56622,80,24066,80,234,234,0,4,12,4,0
50308,60411,58131,27448,58131,70,70,0,1,5,1,0
50309,53716,443,15837,443,70,70,0,1,5,1,0
50310,39059,443,37868,443,3221,1299,1922,15,19,9,6
50311,42777,443,6253,443,4353,687,3666,14,25,8,6
50312,50827,443,28235,443,166814,93487,73327,620,4017,312,308
50313,49493,443,39689,443,9692,6055,3637,21,30,11,10
50314,43776,7000,43776,7000,3174,1617,1557,17,18,9,8
50315,50121,443,39430,443,29425,9485,19940,54,35,27,27
50316,53120,49860,25192,49860,70,70,0,1,5,1,0
50317,58346,443,42517,443,5571,1518,4053,22,614,13,9
50318,49434,53,30404,53,326,134,192,2,30,1,1
50319,65009,53,56985,53,737,94,643,2,30,1,1
50320,51789,443,60352,443,6218,4326,1892,31,124,17,14
50321,27005,27017,61483,27017,878,126,752,2,30,1,1
50322,27005,27333,2413,27333,890,126,764,2,30,1,1
50323,52734,443,39307,443,257777,12962,244815,347,41,162,185
50324,27005,27015,17359,27015,878,126,752,2,30,1,1
50325,60412,12965,9031,12965,70,70,0,1,5,1,0
50326,51432,443,60618,443,194,70,124,3,11,1,2
50327,60013,443,65408,443,145369,7769,137600,224,21,106,118
50328,55368,443,50740,443,8551,2955,5596,28,423,15,13
50329,53319,443,19200,443,2246,1396,850,15,117,9,6
50330,50567,443,27568,443,198,120,78,4,15,3,1
50331,49881,53,28793,53,395,102,293,2,30,1,1
50332,50265,2710,57990,2710,320,320,0,6,1200,6,0
50333,57470,17984,5691,17984,402,132,270,6,1209,3,3
50334,35844,443,58126,443,5196,1875,3321,45,5922,12,33
50335,60384,443,3369,443,4315,928,3387,16,15,10,6
50336,32777,443,20717,443,8080,2049,6031,23,255,12,11
50337,55624,80,8124,80,70,70,0,2,8,2,0
50338,51447,443,8869,443,202,70,132,3,11,1,2
50339,52729,443,62575,443,9026,3447,5579,50,45,26,24
50340,50122,443,3201,443,15217,5689,9528,52,35,27,25
50341,50705,21,33829,21,2222,983,1239,27,18,13,14
50342,49849,53,48086,53,325,126,199,2,30,1,1
50343,53707,53,63109,53,86,86,0,1,30,1,0
50344,63990,53,19922,53,270,94,176,2,30,1,1
50345,45743,8765,60687,8765,336,150,186,6,89,3,3
50346,27005,27111,57650,27111,893,126,767,2,30,1,1
50347,27005,27015,50781,27015,881,126,755,2,30,1,1
50348,49266,443,52610,443,183,70,113,2,120,1,1
50349,37965,63402,11159,63402,2118,858,1260,28,1283,14,14
50350,59157,443,21885,443,7139,3570,3569,22,166,11,11
50351,57470,52217,58146,52217,1969,730,1239,19,1199,10,9
50352,52741,443,63085,443,85011,4398,80613,113,26,52,61
50353,53981,53,31166,53,199,94,105,2,31,1,1
50354,40967,443,61086,443,1786,172,1614,7,121,3,4
50355,52745,443,60430,443,19919,2270,17649,38,26,21,17
50356,52743,443,59107,443,1547,960,587,14,26,8,6
50357,52742,443,24275,443,69884,4367,65517,96,26,44,52
50358,52098,5228,3628,5228,3117,1602,1515,31,66,16,15
50359,56652,80,44398,80,9012,4718,4294,43,81,21,22
50360,53201,443,8091,443,3907,2251,1656,16,321,8,8
50361,59329,53,2601,53,199,94,105,2,30,1,1
50362,43531,53,58732,53,199,94,105,2,30,1,1
50363,4269,26672,0,0,60,60,0,1,0,1,0
50364,35722,30188,0,0,146,146,0,1,0,1,0
50365,51525,35440,0,0,66,66,0,1,0,1,0
50366,59174,445,0,0,70,70,0,1,0,1,0
50367,45941,23386,0,0,60,60,0,1,0,1,0
50368,61223,37965,0,0,66,66,0,1,0,1,0
50369,57676,64147,0,0,70,70,0,1,0,1,0
50370,3436,46783,0,0,145,145,0,1,0,1,0
50371,45941,23386,0,0,60,60,0,1,0,1,0
50372,1866,51505,0,0,62,62,0,1,0,1,0
50373,54220,445,0,0,70,70,0,1,0,1,0
50374,59170,445,0,0,70,70,0,1,0,1,0
50375,59168,445,0,0,70,70,0,1,0,1,0
50376,59166,445,0,0,70,70,0,1,0,1,0
50377,54593,445,0,0,66,66,0,1,0,1,0
50378,30179,57470,0,0,60,60,0,1,0,1,0
50379,54587,445,0,0,66,66,0,1,0,1,0
50380,54588,445,0,0,66,66,0,1,0,1,0
50381,54586,445,0,0,66,66,0,1,0,1,0
50382,13985,34159,0,0,66,66,0,1,0,1,0
50383,54583,445,0,0,66,66,0,1,0,1,0
50384,54582,445,0,0,66,66,0,1,0,1,0
50385,54580,445,0,0,66,66,0,1,0,1,0
50386,50369,50584,0,0,62,62,0,1,0,1,0
50387,59430,50584,0,0,66,66,0,1,0,1,0
50388,54216,445,0,0,70,70,0,1,0,1,0
50389,59164,445,0,0,70,70,0,1,0,1,0
50390,59162,445,0,0,70,70,0,1,0,1,0
50391,59159,445,0,0,70,70,0,1,0,1,0
50392,57289,31573,0,0,62,62,0,1,0,1,0
50393,54577,445,0,0,66,66,0,1,0,1,0
50394,51909,6881,0,0,62,62,0,1,0,1,0
50395,59157,445,0,0,70,70,0,1,0,1,0
50396,54575,445,0,0,66,66,0,1,0,1,0
50397,54205,445,0,0,70,70,0,1,0,1,0
50398,54206,445,0,0,70,70,0,1,0,1,0
50399,54204,445,0,0,70,70,0,1,0,1,0
50400,54201,445,0,0,70,70,0,1,0,1,0
50401,54573,445,0,0,66,66,0,1,0,1,0
50402,54572,445,0,0,66,66,0,1,0,1,0
50403,54200,445,0,0,70,70,0,1,0,1,0
50404,50360,35440,0,0,62,62,0,1,0,1,0
50405,54570,445,0,0,66,66,0,1,0,1,0
50406,14070,62413,0,0,62,62,0,1,0,1,0
50407,28221,37965,0,0,62,62,0,1,0,1,0
50408,25304,64147,0,0,146,146,0,1,0,1,0
50409,59149,445,0,0,70,70,0,1,0,1,0
50410,59146,445,0,0,70,70,0,1,0,1,0
50411,55898,443,55898,443,1850,431,1419,5,0,3,2
50412,59139,445,0,0,70,70,0,1,0,1,0
50413,45673,30188,0,0,62,62,0,1,0,1,0
50414,54194,445,0,0,70,70,0,1,0,1,0
50415,21534,42246,0,0,66,66,0,1,0,1,0
50416,54559,445,0,0,66,66,0,1,0,1,0
50417,54186,445,0,0,70,70,0,1,0,1,0
50418,42332,22114,0,0,66,66,0,1,0,1,0
50419,54183,445,0,0,70,70,0,1,0,1,0
50420,54551,445,0,0,66,66,0,1,0,1,0
50421,59129,445,0,0,70,70,0,1,0,1,0
50422,49485,11392,0,0,62,62,0,1,0,1,0
50423,61323,23117,0,0,62,62,0,1,0,1,0
50424,54180,445,0,0,70,70,0,1,0,1,0
50425,45941,23388,0,0,60,60,0,1,0,1,0
50426,54178,445,0,0,70,70,0,1,0,1,0
50427,54549,445,0,0,66,66,0,1,0,1,0
50428,63092,46776,0,0,78,78,0,1,0,1,0
50429,55396,26467,0,0,62,62,0,1,0,1,0
50430,54174,445,0,0,70,70,0,1,0,1,0
50431,54540,445,0,0,66,66,0,1,0,1,0
50432,54539,445,0,0,66,66,0,1,0,1,0
50433,64880,9694,0,0,66,66,0,1,0,1,0
50434,28345,11392,0,0,62,62,0,1,0,1,0
50435,54173,445,0,0,70,70,0,1,0,1,0
50436,13441,57470,0,0,62,62,0,1,0,1,0
50437,57410,37965,0,0,66,66,0,1,0,1,0
50438,20108,64147,0,0,66,66,0,1,0,1,0
50439,54168,445,0,0,70,70,0,1,0,1,0
50440,59122,445,0,0,70,70,0,1,0,1,0
50441,59118,445,0,0,70,70,0,1,0,1,0
50442,59117,445,0,0,70,70,0,1,0,1,0
50443,3911,50584,0,0,62,62,0,1,0,1,0
50444,54518,445,0,0,66,66,0,1,0,1,0
50445,54520,445,0,0,66,66,0,1,0,1,0
50446,54524,445,0,0,66,66,0,1,0,1,0
50447,54521,445,0,0,66,66,0,1,0,1,0
50448,54526,445,0,0,66,66,0,1,0,1,0
50449,54525,445,0,0,66,66,0,1,0,1,0
50450,54523,445,0,0,66,66,0,1,0,1,0
50451,54519,445,0,0,66,66,0,1,0,1,0
50452,57431,15503,0,0,62,62,0,1,0,1,0
50453,56440,56205,0,0,62,62,0,1,0,1,0
50454,42798,26467,0,0,62,62,0,1,0,1,0
50455,60423,35440,0,0,146,146,0,1,0,1,0
50456,60152,26467,0,0,62,62,0,1,0,1,0
50457,31978,57470,0,0,60,60,0,1,0,1,0
50458,22714,30188,0,0,62,62,0,1,0,1,0
50459,80,9918,0,0,60,60,0,1,0,1,0
50460,46495,4607,0,0,60,60,0,1,0,1,0
50461,19875,30170,0,0,145,145,0,1,0,1,0
50462,59112,445,0,0,70,70,0,1,0,1,0
50463,59109,445,0,0,70,70,0,1,0,1,0
50464,59101,445,0,0,70,70,0,1,0,1,0
50465,54155,445,0,0,70,70,0,1,0,1,0
50466,54505,445,0,0,66,66,0,1,0,1,0
50467,54504,445,0,0,66,66,0,1,0,1,0
50468,54503,445,0,0,66,66,0,1,0,1,0
50469,57545,35440,0,0,66,66,0,1,0,1,0
50470,54152,445,0,0,70,70,0,1,0,1,0
50471,59100,445,0,0,70,70,0,1,0,1,0
50472,9106,53,9106,53,227,89,138,2,30,1,1
50473,52052,80,64577,80,2188,593,1595,11,16,5,6
50474,45184,80,27181,80,1718,1404,314,11,15,6,5
50475,27005,27015,57619,27015,902,126,776,2,30,1,1
50476,48753,80,48753,80,19937,2162,17775,36,24,19,17
50477,52737,443,14623,443,32774,3629,29145,52,26,27,25
50478,51803,33973,32167,33973,66,66,0,1,5,1,0
50479,41543,443,55490,443,234,234,0,4,12,4,0
50480,53616,44166,57712,44166,70,70,0,1,5,1,0
50481,55196,443,1122,443,13568,2119,11449,35,316,17,18
50482,37183,443,43656,443,9631,4184,5447,33,271,17,16
50483,56590,53,0,0,82,82,0,1,30,1,0
50484,2939,53,2939,53,200,90,110,2,30,1,1
50485,18105,53,18105,53,216,98,118,2,30,1,1
50486,52740,443,65500,443,168753,7954,160799,212,26,95,117
50487,46232,53,46232,53,194,87,107,2,30,1,1
50488,35185,3389,35185,3389,3424,1710,1714,16,33,8,8
50489,52886,443,7611,443,26307,17595,8712,52,498,29,23
50490,53536,443,47086,443,7901,3483,4418,24,30,13,11
50491,58771,443,59212,443,5750,1163,4587,25,258,13,12
50492,52738,443,34014,443,56339,3530,52809,79,26,39,40
50493,51818,43942,37942,43942,258,70,188,4,8,2,2
50494,53615,867,2680,867,70,70,0,1,5,1,0
50495,45632,443,51632,443,55844,3452,52392,85,255,38,47
50496,52480,443,40106,443,7103,2432,4671,18,76,10,8
50497,30960,45701,51481,45701,330,330,0,6,3609,6,0
50498,34417,53,11898,53,168,78,90,2,30,1,1
50499,40296,80,40296,80,1032410,43358,989052,1356,72,591,765
50500,40907,443,19035,443,7183,1824,5359,27,316,14,13
50501,52064,80,49794,80,2125,709,1416,11,16,5,6
50502,58115,53,48692,53,578,286,292,9,15,5,4
50503,35156,8635,35156,8635,138,78,60,2,5,1,1
50504,63807,38976,18542,38976,66,66,0,2,8,2,0
50505,42731,443,42301,443,6131,1399,4732,20,983,10,10
50506,49290,443,44950,443,4783,2366,2417,16,203,8,8
50507,51548,80,33223,80,1654,1340,314,11,15,6,5
50508,63809,45193,55784,45193,66,66,0,2,8,2,0
50509,50393,8080,50393,8080,378,180,198,7,31,4,3
50510,52476,443,35367,443,7787,3056,4731,19,87,10,9
50511,52739,443,43890,443,25048,2850,22198,45,26,23,22
50512,52963,80,22153,80,1600,581,1019,10,15,6,4
50513,55276,80,42794,80,1594,1280,314,10,15,5,5
50514,45335,443,8948,443,2814,1454,1360,23,28,12,11
50515,49528,443,34727,443,5968,985,4983,17,28,8,9
50516,27005,27013,37862,27013,869,126,743,2,30,1,1
50517,30906,53,30906,53,227,89,138,2,30,1,1
50518,7539,53,7539,53,194,87,107,2,30,1,1
50519,35311,443,37900,443,6584,1945,4639,14,120,7,7
50520,56987,443,32142,443,3800,1324,2476,14,136,7,7
50521,52773,443,22036,443,19594,11977,7617,48,100,25,23
50522,59097,445,0,0,70,70,0,1,0,1,0
50523,53833,26467,0,0,66,66,0,1,0,1,0
50524,14694,443,0,0,60,60,0,1,0,1,0
50525,59093,445,0,0,70,70,0,1,0,1,0
50526,59091,445,0,0,70,70,0,1,0,1,0
50527,59089,445,0,0,70,70,0,1,0,1,0
50528,46576,23718,0,0,66,66,0,1,0,1,0
50529,53168,44847,0,0,146,146,0,1,0,1,0
50530,9605,57470,0,0,62,62,0,1,0,1,0
50531,11133,51505,0,0,66,66,0,1,0,1,0
50532,54148,445,0,0,70,70,0,1,0,1,0
50533,53650,64147,0,0,62,62,0,1,0,1,0
50534,58343,23718,0,0,66,66,0,1,0,1,0
50535,54146,445,0,0,70,70,0,1,0,1,0
50536,45964,2666,0,0,60,60,0,1,0,1,0
50537,58564,50432,0,0,66,66,0,1,0,1,0
50538,10448,14914,0,0,143,143,0,1,0,1,0
50539,54144,445,0,0,70,70,0,1,0,1,0
50540,54819,443,59534,443,3429,1188,2241,13,134,6,7
50541,47711,443,57619,443,11793,7188,4605,34,128,17,17
50542,65199,53,63329,53,793,207,586,6,59,3,3
50543,57256,5228,53413,5228,7144,1872,5272,36,22,20,16
50544,49212,80,1671,80,1013,566,447,8,134,5,3
50545,51804,31012,28842,31012,70,70,0,1,5,1,0
50546,20,64488,20,50706,624666,17676,606990,671,14,267,404
50547,39916,53,62317,53,168,78,90,2,30,1,1
50548,27005,27016,9591,27016,884,126,758,2,30,1,1
50549,56180,53,56180,53,229,98,131,2,30,1,1
50550,52744,443,47091,443,14838,2048,12790,32,25,18,14
50551,52728,443,50981,443,186399,56439,129960,335,45,170,165
50552,52736,443,12534,443,1217451,39642,1177809,1359,39,539,820
50553,52732,443,31396,443,27467,22472,4995,85,42,45,40
50554,49986,443,61933,443,25918,2247,23671,53,124,26,27
50555,37321,53,37321,53,197,90,107,2,30,1,1
50556,56817,48650,23825,48650,130,70,60,2,5,1,1
50557,57492,443,47894,443,380975,82011,298964,804,171,343,461
50558,37002,443,19218,443,6646,2747,3899,20,134,10,10
50559,23226,53,23226,53,217,82,135,2,33,1,1
50560,56358,443,56358,443,4674,1767,2907,19,29,11,8
50561,42843,53,7011,53,168,78,90,2,30,1,1
50562,50550,53,58594,53,168,78,90,2,30,1,1
50563,10151,53,10151,53,220,90,130,2,30,1,1
50564,56555,443,29813,443,6308,829,5479,18,15,9,9
50565,64221,53,19919,53,262,102,160,2,30,1,1
50566,49761,80,49761,80,2937,703,2234,13,142,6,7
50567,36448,53,11652,53,199,94,105,2,30,1,1
50568,11295,53,11295,53,197,90,107,2,30,1,1
50569,49574,53,2504,53,496,92,404,4,58,2,2
50570,24412,53,24412,53,200,90,110,2,30,1,1
50571,51805,15298,5839,15298,70,70,0,1,5,1,0
50572,59750,443,51830,443,2633,1179,1454,20,74,8,12
50573,49502,443,43578,443,31780,3232,28548,44,29,16,28
50574,65138,53,7886,53,418,94,324,2,30,1,1
50575,19473,58093,47634,58093,460,150,310,2,1200,1,1
50576,59748,443,39145,443,8789,1592,7197,25,75,13,12
50577,6881,40783,51733,40783,509,150,359,2,1199,1,1
50578,34957,80,4367,80,7136,3526,3610,42,1239,21,21
50579,49899,443,2357,443,26284,21857,4427,72,83,39,33
50580,60665,443,60665,443,5715,1432,4283,19,15,9,10
50581,27005,27017,7063,27017,877,126,751,3,31,2,1
50582,27005,27015,62315,27015,1006,252,754,4,32,3,1
50583,57918,443,47624,443,38204,3737,34467,77,95,40,37
50584,61711,443,17336,443,7485,1962,5523,27,95,13,14
50585,52733,443,22448,443,613606,29392,584214,757,42,337,420
50586,63793,48970,37013,48970,70,70,0,1,4,1,0
50587,53123,59228,32782,59228,70,70,0,2,8,2,0
50588,49177,443,60972,443,654956,17062,637894,673,18,244,429
50589,51159,443,36632,443,6405463,157088,6248375,6383,90,2146,4237
50590,52746,443,40862,443,104383,5038,99345,135,25,62,73
50591,47976,443,55009,443,16187,11705,4482,33,159,19,14
50592,52727,443,14385,443,1369,708,661,14,45,8,6
50593,50552,443,41023,443,8311,3156,5155,29,17,16,13
50594,49537,53,41171,53,686,276,410,8,74,4,4
50595,33919,53,58115,53,168,78,90,2,30,1,1
50596,63974,53,33864,53,618,111,507,4,30,2,2
50597,49823,53,39316,53,388,102,286,2,30,1,1
50598,8283,45858,63554,45858,130,70,60,2,30,1,1
50599,55044,53,47229,53,168,78,90,2,30,1,1
50600,27005,27016,25142,27016,883,126,757,2,30,1,1
50601,27005,27015,25382,27015,937,126,811,2,30,1,1
50602,35408,53,57895,53,168,78,90,2,30,1,1
50603,44400,443,34284,443,6576,1937,4639,14,120,7,7
50604,46544,443,31614,443,332590,15084,317506,341,139,89,252
50605,47500,443,47942,443,7464,2375,5089,15,120,7,8
50606,52447,443,48925,443,7980,5952,2028,22,99,12,10
50607,10056,443,53947,443,12677,10470,2207,42,80,23,19
50608,61673,443,54566,443,9218,3728,5490,30,50,16,14
50609,11826,53,11826,53,216,98,118,2,30,1,1
50610,55392,53,63211,53,418,94,324,2,30,1,1
50611,59316,443,4398,443,17547,11857,5690,34,159,20,14
50612,56816,12523,45890,12523,70,70,0,1,5,1,0
50613,46232,53,46232,53,216,90,126,2,30,1,1
50614,27005,49000,39068,49000,887,126,761,2,30,1,1
50615,51836,53,49755,53,168,78,90,2,30,1,1
50616,34565,53,14106,53,168,78,90,2,30,1,1
50617,58785,53,58785,53,216,90,126,2,30,1,1
50618,29413,53,29413,53,217,82,135,2,32,1,1
50619,49760,80,49760,80,613303,16858,596445,666,143,251,415
50620,58794,5222,61380,5222,47445,16812,30633,144,870,65,79
50621,51666,443,15224,443,3256,2213,1043,16,15,8,8
50622,49304,7010,49304,7010,6247,4138,2109,21,15,13,8
50623,27005,27015,28808,27015,873,126,747,2,30,1,1
50624,44901,443,19443,443,11891,6219,5672,35,174,16,19
50625,50584,60395,46252,60395,166,166,0,1,1200,1,0
50626,52183,443,6530,443,3560269,64410,3495859,2930,132,383,2547
50627,45401,443,44939,443,9535,3495,6040,18,121,10,8
50628,50584,56209,14402,56209,166,166,0,1,1200,1,0
50629,27005,31000,35910,31000,898,126,772,2,31,1,1
50630,56962,80,49373,80,8730,5681,3049,21,31,12,9
50631,60505,443,23004,443,1061,727,334,9,26,4,5
50632,50625,80,24486,80,8688,4248,4440,56,131,34,22
50633,49439,443,14852,443,9495,2281,7214,22,78,11,11
50634,49920,443,27141,443,9759,1989,7770,25,16,13,12
50635,49633,443,1902,443,60196,10141,50055,122,33,62,60
50636,57620,443,56080,443,5177,3010,2167,37,83,17,20
50637,55041,80,12804,80,486,240,246,9,35,5,4
50638,56114,53,31669,53,194,86,108,2,30,1,1
50639,15986,8000,14701,8000,274,150,124,4,61,2,2
50640,49437,443,4843,443,9621,2347,7274,24,78,12,12
50641,30472,53,56482,53,223,86,137,2,30,1,1
50642,55046,80,10209,80,2775,1332,1443,12,34,7,5
50643,60173,443,14780,443,7909,3501,4408,19,181,9,10
50644,3578,51505,0,0,62,62,0,1,0,1,0
50645,6881,55839,0,0,139,139,0,1,0,1,0
50646,62386,37965,0,0,62,62,0,1,0,1,0
50647,1162,57470,0,0,62,62,0,1,0,1,0
50648,51197,57470,0,0,66,66,0,1,0,1,0
50649,59080,445,0,0,70,70,0,1,0,1,0
50650,59079,445,0,0,70,70,0,1,0,1,0
50651,59075,445,0,0,70,70,0,1,0,1,0
50652,49177,54532,0,0,60,60,0,1,0,1,0
50653,54137,445,0,0,70,70,0,1,0,1,0
50654,51742,30317,0,0,66,66,0,1,0,1,0
50655,54135,445,0,0,70,70,0,1,0,1,0
50656,9219,32480,0,0,72,72,0,1,0,1,0
50657,59505,53733,0,0,66,66,0,1,0,1,0
50658,54134,445,0,0,70,70,0,1,0,1,0
50659,54133,445,0,0,70,70,0,1,0,1,0
50660,54132,445,0,0,70,70,0,1,0,1,0
50661,52887,37807,0,0,66,66,0,1,0,1,0
50662,54129,445,0,0,70,70,0,1,0,1,0
50663,54128,445,0,0,70,70,0,1,0,1,0
50664,54484,445,0,0,66,66,0,1,0,1,0
50665,59072,445,0,0,70,70,0,1,0,1,0
50666,59070,445,0,0,70,70,0,1,0,1,0
50667,61881,48817,0,0,148,148,0,1,0,1,0
50668,62566,35993,0,0,66,66,0,1,0,1,0
50669,4269,26672,0,0,60,60,0,1,0,1,0
50670,53453,2767,0,0,66,66,0,1,0,1,0
50671,34348,22114,0,0,62,62,0,1,0,1,0
50672,54114,445,0,0,70,70,0,1,0,1,0
50673,54113,445,0,0,70,70,0,1,0,1,0
50674,54109,445,0,0,70,70,0,1,0,1,0
50675,54103,445,0,0,70,70,0,1,0,1,0
50676,54104,445,0,0,70,70,0,1,0,1,0
50677,52064,22114,0,0,62,62,0,1,0,1,0
50678,54475,445,0,0,66,66,0,1,0,1,0
50679,54474,445,0,0,66,66,0,1,0,1,0
50680,59062,445,0,0,70,70,0,1,0,1,0
50681,59053,445,0,0,70,70,0,1,0,1,0
50682,59049,445,0,0,70,70,0,1,0,1,0
50683,59050,445,0,0,70,70,0,1,0,1,0
50684,44538,50584,0,0,146,146,0,1,0,1,0
50685,54471,445,0,0,66,66,0,1,0,1,0
50686,52431,50265,0,0,62,62,0,1,0,1,0
50687,52459,5555,0,0,60,60,0,1,0,1,0
50688,50088,1604,0,0,84,84,0,1,0,1,0
50689,54092,445,0,0,70,70,0,1,0,1,0
50690,23934,41615,0,0,145,145,0,1,0,1,0
50691,23934,41615,0,0,145,145,0,1,0,1,0
50692,15296,37965,0,0,66,66,0,1,0,1,0
50693,59781,56205,0,0,66,66,0,1,0,1,0
50694,11859,64147,0,0,62,62,0,1,0,1,0
50695,48692,57470,0,0,62,62,0,1,0,1,0
50696,59044,445,0,0,70,70,0,1,0,1,0
50697,36908,26467,0,0,62,62,0,1,0,1,0
50698,58486,57470,0,0,66,66,0,1,0,1,0
50699,59042,445,0,0,70,70,0,1,0,1,0
50700,59041,445,0,0,70,70,0,1,0,1,0
50701,59039,445,0,0,70,70,0,1,0,1,0
50702,54464,445,0,0,66,66,0,1,0,1,0
50703,54460,445,0,0,66,66,0,1,0,1,0
50704,54459,445,0,0,66,66,0,1,0,1,0
50705,54456,445,0,0,66,66,0,1,0,1,0
50706,51424,30188,0,0,66,66,0,1,0,1,0
50707,54454,445,0,0,66,66,0,1,0,1,0
50708,54455,445,0,0,66,66,0,1,0,1,0
50709,54452,445,0,0,66,66,0,1,0,1,0
50710,64240,50584,0,0,66,66,0,1,0,1,0
50711,54088,445,0,0,70,70,0,1,0,1,0
50712,6416,22114,0,0,62,62,0,1,0,1,0
50713,62908,21,0,0,60,60,0,1,0,1,0
50714,6712,161,0,0,82,82,0,1,0,1,0
50715,59034,445,0,0,70,70,0,1,0,1,0
50716,59033,445,0,0,70,70,0,1,0,1,0
50717,59030,445,0,0,70,70,0,1,0,1,0
50718,54078,445,0,0,70,70,0,1,0,1,0
50719,54077,445,0,0,70,70,0,1,0,1,0
50720,35460,35440,0,0,62,62,0,1,0,1,0
50721,54450,445,0,0,66,66,0,1,0,1,0
50722,54074,445,0,0,70,70,0,1,0,1,0
50723,54076,445,0,0,70,70,0,1,0,1,0
50724,59029,445,0,0,70,70,0,1,0,1,0
50725,23528,44847,0,0,62,62,0,1,0,1,0
50726,54071,445,0,0,70,70,0,1,0,1,0
50727,54446,445,0,0,66,66,0,1,0,1,0
50728,54445,445,0,0,66,66,0,1,0,1,0
50729,54443,445,0,0,66,66,0,1,0,1,0
50730,64066,23718,0,0,66,66,0,1,0,1,0
50731,46478,64147,0,0,62,62,0,1,0,1,0
50732,54442,445,0,0,66,66,0,1,0,1,0
50733,57131,31061,0,0,145,145,0,1,0,1,0
50734,63221,53436,0,0,62,62,0,1,0,1,0
50735,59459,37807,0,0,66,66,0,1,0,1,0
50736,33324,42873,0,0,62,62,0,1,0,1,0
50737,41447,64147,0,0,62,62,0,1,0,1,0
50738,57853,64147,0,0,66,66,0,1,0,1,0
50739,59021,445,0,0,70,70,0,1,0,1,0
50740,54065,445,0,0,70,70,0,1,0,1,0
50741,26084,36237,0,0,62,62,0,1,0,1,0
50742,59013,445,0,0,70,70,0,1,0,1,0
50743,59012,445,0,0,70,70,0,1,0,1,0
50744,60162,53436,0,0,66,66,0,1,0,1,0
50745,63092,46776,0,0,78,78,0,1,0,1,0
50746,54432,445,0,0,66,66,0,1,0,1,0
50747,54058,445,0,0,70,70,0,1,0,1,0
50748,61701,44847,0,0,66,66,0,1,0,1,0
50749,54057,445,0,0,70,70,0,1,0,1,0
50750,6015,23,0,0,60,60,0,1,0,1,0
50751,1384,44847,0,0,66,66,0,1,0,1,0
50752,3377,50584,0,0,66,66,0,1,0,1,0
50753,54423,445,0,0,66,66,0,1,0,1,0
50754,54051,445,0,0,70,70,0,1,0,1,0
50755,59001,445,0,0,70,70,0,1,0,1,0
50756,50624,26467,0,0,66,66,0,1,0,1,0
50757,54050,445,0,0,70,70,0,1,0,1,0
50758,44855,58414,0,0,146,146,0,1,0,1,0
50759,45941,23386,0,0,60,60,0,1,0,1,0
50760,54420,445,0,0,66,66,0,1,0,1,0
50761,50804,1,0,0,62,62,0,1,0,1,0
50762,57500,37965,0,0,62,62,0,1,0,1,0
50763,54046,445,0,0,70,70,0,1,0,1,0
50764,57325,37965,0,0,62,62,0,1,0,1,0
50765,17027,1,0,0,62,62,0,1,0,1,0
50766,60133,1,0,0,66,66,0,1,0,1,0
50767,10006,64147,0,0,62,62,0,1,0,1,0
50768,54413,445,0,0,66,66,0,1,0,1,0
50769,51674,51505,0,0,66,66,0,1,0,1,0
50770,54045,445,0,0,70,70,0,1,0,1,0
50771,54410,445,0,0,66,66,0,1,0,1,0
50772,56966,35440,0,0,66,66,0,1,0,1,0
50773,53779,51505,0,0,66,66,0,1,0,1,0
50774,62737,64147,0,0,66,66,0,1,0,1,0
50775,45964,5333,0,0,60,60,0,1,0,1,0
50776,54040,445,0,0,70,70,0,1,0,1,0
50777,31978,57470,0,0,60,60,0,1,0,1,0
50778,61520,23718,0,0,62,62,0,1,0,1,0
50779,51026,37450,0,0,66,66,0,1,0,1,0
50780,58992,445,0,0,70,70,0,1,0,1,0
50781,58991,445,0,0,70,70,0,1,0,1,0
50782,58989,445,0,0,70,70,0,1,0,1,0
50783,443,64347,0,0,131,131,0,1,0,1,0
50784,51192,15503,0,0,66,66,0,1,0,1,0
50785,10319,42707,0,0,62,62,0,1,0,1,0
50786,54392,445,0,0,66,66,0,1,0,1,0
50787,54395,445,0,0,66,66,0,1,0,1,0
50788,54397,445,0,0,66,66,0,1,0,1,0
50789,54398,445,0,0,66,66,0,1,0,1,0
50790,54394,445,0,0,66,66,0,1,0,1,0
50791,54393,445,0,0,66,66,0,1,0,1,0
50792,54396,445,0,0,66,66,0,1,0,1,0
50793,54390,445,0,0,66,66,0,1,0,1,0
50794,60750,42707,0,0,66,66,0,1,0,1,0
50795,64940,26467,0,0,62,62,0,1,0,1,0
50796,50419,26467,0,0,66,66,0,1,0,1,0
50797,46573,50584,0,0,66,66,0,1,0,1,0
50798,54786,30188,0,0,66,66,0,1,0,1,0
50799,65454,61600,0,0,66,66,0,1,0,1,0
50800,53608,1024,20573,1024,70,70,0,1,5,1,0
50801,53126,443,10677,443,6668,2026,4642,15,120,8,7
50802,53599,47783,42378,47783,618,432,186,9,17,6,3
50803,58429,443,42456,443,10588,1664,8924,29,631,11,18
50804,27005,27016,53095,27016,889,126,763,3,31,2,1
50805,27997,80,36977,80,3683,591,3092,11,45,6,5
50806,56944,80,48541,80,214,140,74,4,30,3,1
50807,53612,1032,48115,1032,130,70,60,2,6,1,1
50808,60413,43555,44163,43555,70,70,0,2,8,2,0
50809,33640,53,0,0,138,69,69,2,30,1,1
50810,63755,17866,46456,17866,2568,1944,624,20,29,13,7
50811,44731,443,63210,443,4920,2738,2182,33,259,16,17
50812,61189,443,61189,443,1092,645,447,10,34,6,4
50813,27186,53,27186,53,821,97,724,2,30,1,1
50814,19557,53,19557,53,194,87,107,2,30,1,1
50815,39148,443,64587,443,6818,1800,5018,30,271,16,14
50816,63991,443,63991,443,4597,1690,2907,19,28,11,8
50817,53072,443,53072,443,49826,37097,12729,66,163,40,26
50818,34600,443,63857,443,7950,1925,6025,26,66,14,12
50819,49529,443,17894,443,9047,1436,7611,22,27,10,12
50820,51821,28306,23516,28306,316,136,180,6,6,3,3
50821,53597,42845,3911,42845,678,492,186,10,18,7,3
50822,39328,80,5790,80,78,78,0,1,5,1,0
50823,53609,38060,54791,38060,70,70,0,1,5,1,0
50824,51823,15843,1473,15843,70,70,0,1,5,1,0
50825,49616,443,57635,443,7238,2601,4637,20,17,10,10
50826,52267,443,8782,443,24712,9272,15440,65,136,34,31
50827,56644,443,7171,443,12924,3689,9235,31,82,17,14
50828,49352,443,43143,443,2118582,46411,2072171,2066,90,617,1449
50829,21133,43408,64774,43408,480,149,331,2,1200,1,1
50830,40599,443,12842,443,89724,81316,8408,148,404,69,79
50831,10088,443,42389,443,7243,1860,5383,26,330,14,12
50832,55038,443,26774,443,4424,876,3548,15,35,8,7
50833,24961,53,24961,53,215,80,135,2,33,1,1
50834,1431,53,1431,53,215,80,135,2,32,1,1
50835,54144,443,15023,443,2227,1018,1209,17,16,8,9
50836,27996,80,2657,80,2058,589,1469,10,45,6,4
50837,46280,443,46280,443,4754,1847,2907,19,26,11,8
50838,49485,443,26234,443,49823,7236,42587,56,29,20,36
50839,55813,443,55813,443,4543,1636,2907,19,29,11,8
50840,30728,53,30728,53,196,88,108,2,30,1,1
50841,30227,3386,30227,3386,146,60,86,2,30,1,1
50842,27005,27015,31216,27015,939,126,813,2,30,1,1
50843,55765,443,54125,443,4660,1915,2745,23,120,12,11
50844,27005,27017,14487,27017,882,126,756,2,31,1,1
50845,36939,80,43312,80,5733,3036,2697,25,235,9,16
50846,41270,443,43404,443,14659,5023,9636,46,400,14,32
50847,30960,45700,20531,45700,330,330,0,6,3609,6,0
50848,27005,27018,60808,27018,881,126,755,2,31,1,1
50849,49237,443,19934,443,8293,4179,4114,22,128,11,11
50850,54693,30188,0,0,62,62,0,1,0,1,0
50851,54146,5900,0,0,60,60,0,1,0,1,0
50852,58981,445,0,0,70,70,0,1,0,1,0
50853,58980,445,0,0,70,70,0,1,0,1,0
50854,58973,445,0,0,70,70,0,1,0,1,0
50855,51544,34476,0,0,137,137,0,1,0,1,0
50856,4961,62741,0,0,66,66,0,1,0,1,0
50857,4447,35440,0,0,66,66,0,1,0,1,0
50858,60772,36829,0,0,66,66,0,1,0,1,0
50859,50316,37965,0,0,66,66,0,1,0,1,0
50860,54024,445,0,0,70,70,0,1,0,1,0
50861,54377,445,0,0,66,66,0,1,0,1,0
50862,64315,53,11433,53,322,102,220,2,30,1,1
50863,51816,27721,33144,27721,70,70,0,2,8,2,0
50864,60798,443,60798,443,1092,645,447,10,34,6,4
50865,49765,53,55989,53,233,102,131,2,30,1,1
50866,33247,443,33617,443,7527,2435,5092,16,120,8,8
50867,48163,443,22836,443,20124,12085,8039,54,385,29,25
50868,55047,80,59301,80,306,180,126,6,32,4,2
50869,44095,443,27127,443,6109,3363,2746,60,615,33,27
50870,48467,80,55817,80,1113,534,579,12,15,7,5
50871,56960,80,32758,80,6363,3790,2573,16,30,10,6
50872,64184,443,64184,443,4561,1654,2907,19,28,11,8
50873,49504,443,22336,443,62,62,0,1,5,1,0
50874,56958,80,27013,80,9535,3968,5567,21,30,12,9
50875,48279,8080,0,0,368,156,212,5,13,3,2
50876,55037,443,19621,443,10640,3171,7469,28,45,15,13
50877,56445,53,50550,53,353,110,243,4,46,2,2
50878,56966,80,60389,80,214,140,74,4,30,3,1
50879,56939,80,26245,80,194,128,66,4,31,3,1
50880,54437,443,40534,443,716056,89267,626789,952,300,368,584
50881,55042,80,32886,80,306,180,126,6,34,4,2
50882,56815,50510,55664,50510,70,70,0,1,5,1,0
50883,56813,37092,33767,37092,70,70,0,1,5,1,0
50884,35400,443,23133,443,11083,4080,7003,38,40,14,24
50885,55213,53,60229,53,238,94,144,2,30,1,1
50886,35685,123,34944,123,184,94,90,2,30,1,1
50887,53669,80,61903,80,1119,665,454,12,15,7,5
50888,55043,80,21312,80,306,180,126,6,34,4,2
50889,64067,53,26067,53,331,102,229,2,30,1,1
50890,49506,443,26865,443,18260,2912,15348,30,28,11,19
50891,60415,40829,35259,40829,70,70,0,2,8,2,0
50892,54859,443,24991,443,6677,1006,5671,19,26,11,8
50893,49998,53,11230,53,467,90,377,4,39,2,2
50894,60709,443,60709,443,1092,645,447,10,34,6,4
50895,42898,443,46834,443,4999,2845,2154,41,87,22,19
50896,49921,80,16260,80,1126,609,517,11,15,6,5
50897,56788,443,35911,443,22508,1965,20543,32,17,13,19
50898,49922,80,11141,80,1126,609,517,11,15,6,5
50899,50249,443,46250,443,6125,1674,4451,22,81,11,11
50900,63218,22,63218,22,9001,4087,4914,59,39,27,32
50901,56965,80,39996,80,526,304,222,8,30,5,3
50902,49923,80,28185,80,1126,609,517,11,15,6,5
50903,57929,53,0,0,294,86,208,2,30,1,1
50904,50419,80,4719,80,350,350,0,1,120,1,0
50905,64349,53,48163,53,392,102,290,2,30,1,1
50906,55209,53,33482,53,196,102,94,2,33,1,1
50907,57353,443,50919,443,70,70,0,1,5,1,0
50908,54287,443,5975,443,250,190,60,2,5,1,1
50909,60891,443,53303,443,204,70,134,4,25,2,2
50910,49860,53,13520,53,550,129,421,4,57,2,2
50911,37991,443,14336,443,8365,3018,5347,31,271,15,16
50912,64379,53,61307,53,333,94,239,2,30,1,1
50913,64506,53,36287,53,184,86,98,2,30,1,1
50914,60731,80,1160,80,5911,4727,1184,20,16,11,9
50915,55040,80,41951,80,486,240,246,9,34,5,4
50916,55044,80,26880,80,306,180,126,6,34,4,2
50917,49326,443,20775,443,9303,2551,6752,33,16,18,15
50918,53131,443,19273,443,10705,5303,5402,36,650,16,20
50919,56963,80,25455,80,6974,3906,3068,19,30,11,8
50920,55619,42873,30146,42873,422,140,282,6,16,3,3
50921,42520,443,59710,443,6795,2090,4705,27,21,15,12
50922,56959,80,53934,80,15752,5736,10016,28,30,14,14
50923,56961,80,26352,80,5885,3796,2089,16,30,10,6
50924,56899,443,29729,443,29904,3111,26793,68,164,35,33
50925,53607,51631,46867,51631,70,70,0,1,4,1,0
50926,60409,44739,64818,44739,70,70,0,1,5,1,0
50927,56814,56255,27834,56255,70,70,0,1,5,1,0
50928,53605,13468,43310,13468,70,70,0,1,4,1,0
50929,56800,1,46367,1,70,70,0,1,5,1,0
50930,49897,443,63900,443,113036,13164,99872,191,144,89,102
50931,51824,53021,41842,53021,70,70,0,1,5,1,0
50932,58858,443,49748,443,208,60,148,4,10,2,2
50933,56955,80,64782,80,214,140,74,4,30,3,1
50934,60407,8106,10620,8106,2541,1158,1383,19,16,9,10
50935,48697,5222,62184,5222,8355,4135,4220,79,616,41,38
50936,41184,53,29887,53,168,78,90,2,30,1,1
50937,50564,443,39683,443,8182,1488,6694,23,133,13,10
50938,64102,53,25876,53,274,94,180,2,29,1,1
50939,64353,53,31104,53,225,102,123,2,29,1,1
50940,54807,443,9391,443,10078,2210,7868,36,120,19,17
50941,33461,443,33205,443,8366,3900,4466,19,120,10,9
50942,64162,53,14611,53,225,110,115,2,30,1,1
50943,6881,6881,30399,6881,238,118,120,2,1199,1,1
50944,60414,52559,64596,52559,70,70,0,2,8,2,0
50945,51801,33531,13546,33531,70,70,0,1,5,1,0
50946,51800,63796,15243,63796,70,70,0,1,5,1,0
50947,60377,443,48988,443,8588,2020,6568,20,76,10,10
50948,48905,80,43588,80,1868,1374,494,12,15,7,5
50949,20957,53,20957,53,216,90,126,2,30,1,1
50950,27005,27015,5485,27015,889,126,763,2,30,1,1
50951,27005,27020,57425,27020,890,126,764,2,30,1,1
50952,18102,53,59095,53,223,86,137,2,30,1,1
50953,27005,27016,11653,27016,876,126,750,3,31,2,1
50954,49924,80,4925,80,1126,609,517,11,15,6,5
50955,60875,443,60875,443,1092,645,447,10,34,6,4
50956,60721,443,60721,443,1092,645,447,10,34,6,4
50957,56621,80,4891,80,234,234,0,4,12,4,0
50958,51798,37020,7892,37020,70,70,0,1,5,1,0
50959,53119,58118,18768,58118,70,70,0,1,5,1,0
50960,56946,80,58825,80,214,140,74,4,30,3,1
50961,56945,80,24790,80,214,140,74,4,30,3,1
50962,43086,443,19069,443,6496,2026,4470,20,16,12,8
50963,27005,30000,59167,30000,913,126,787,2,30,1,1
50964,49774,53,40062,53,234,102,132,2,30,1,1
50965,50875,53,21370,53,78,78,0,1,30,1,0
50966,60031,443,5116,443,350,210,140,6,15,4,2
50967,51943,53,57117,53,200,86,114,2,30,1,1
50968,39435,443,17310,443,2403265,93626,2309639,2795,243,1103,1692
50969,63941,53,9002,53,228,94,134,2,30,1,1
50970,52245,443,44464,443,7488,2474,5014,23,3600,12,11
50971,43595,443,60251,443,31194,5024,26170,44,121,18,26
50972,47823,443,63568,443,9842,2224,7618,20,122,10,10
50973,56970,443,2688,443,20635942,626393,20009549,21680,138,6969,14711
50974,6881,6881,43994,6881,502,150,352,2,1200,1,1
50975,52478,443,31557,443,7985,2085,5900,18,121,8,10
50976,49919,443,15575,443,16012,2097,13915,33,16,15,18
50977,41311,443,64855,443,70,70,0,1,5,1,0
50978,58930,443,53896,443,70,70,0,1,5,1,0
50979,50188,80,44459,80,1746,780,966,19,56,7,12
50980,53668,80,20063,80,1173,665,508,13,16,7,6
50981,57545,443,29665,443,25540,8247,17293,187,574,79,108
50982,49178,2710,40497,2710,70,70,0,1,5,1,0
50983,54376,445,0,0,66,66,0,1,0,1,0
50984,54375,445,0,0,66,66,0,1,0,1,0
50985,58971,445,0,0,70,70,0,1,0,1,0
50986,57768,37965,0,0,66,66,0,1,0,1,0
50987,58969,445,0,0,70,70,0,1,0,1,0
50988,54019,445,0,0,70,70,0,1,0,1,0
50989,58968,445,0,0,70,70,0,1,0,1,0
50990,58962,445,0,0,70,70,0,1,0,1,0
50991,58959,445,0,0,70,70,0,1,0,1,0
50992,59943,37807,0,0,62,62,0,1,0,1,0
50993,54018,445,0,0,70,70,0,1,0,1,0
50994,49177,54532,0,0,60,60,0,1,0,1,0
50995,47762,36180,0,0,146,146,0,1,0,1,0
50996,58811,53976,0,0,66,66,0,1,0,1,0
50997,54016,445,0,0,70,70,0,1,0,1,0
50998,1025,35447,0,0,62,62,0,1,0,1,0
50999,58562,57587,0,0,66,66,0,1,0,1,0
51000,43611,50939,0,0,145,145,0,1,0,1,0
51001,52095,56079,0,0,66,66,0,1,0,1,0
51002,47652,51505,0,0,62,62,0,1,0,1,0
51003,58952,445,0,0,70,70,0,1,0,1,0
51004,58950,445,0,0,70,70,0,1,0,1,0
51005,58946,445,0,0,70,70,0,1,0,1,0
51006,4269,26672,0,0,60,60,0,1,0,1,0
51007,54009,445,0,0,70,70,0,1,0,1,0
51008,27153,992,0,0,60,60,0,1,0,1,0
51009,50280,57470,0,0,78,78,0,1,0,1,0
51010,33305,54532,0,0,60,60,0,1,0,1,0
51011,39313,37965,0,0,62,62,0,1,0,1,0
51012,54007,445,0,0,70,70,0,1,0,1,0
51013,39540,37965,0,0,66,66,0,1,0,1,0
51014,48706,23393,0,0,60,60,0,1,0,1,0
51015,5774,37965,0,0,66,66,0,1,0,1,0
51016,54006,445,0,0,70,70,0,1,0,1,0
51017,54005,445,0,0,70,70,0,1,0,1,0
51018,54004,445,0,0,70,70,0,1,0,1,0
51019,54002,445,0,0,70,70,0,1,0,1,0
51020,53999,445,0,0,70,70,0,1,0,1,0
51021,54355,445,0,0,66,66,0,1,0,1,0
51022,58944,445,0,0,70,70,0,1,0,1,0
51023,58941,445,0,0,70,70,0,1,0,1,0
51024,58264,44847,0,0,66,66,0,1,0,1,0
51025,53986,445,0,0,70,70,0,1,0,1,0
51026,53985,445,0,0,70,70,0,1,0,1,0
51027,53976,445,0,0,70,70,0,1,0,1,0
51028,53975,445,0,0,70,70,0,1,0,1,0
51029,62907,21,0,0,60,60,0,1,0,1,0
51030,58751,9571,0,0,62,62,0,1,0,1,0
51031,16948,990,0,0,60,60,0,1,0,1,0
51032,54348,445,0,0,66,66,0,1,0,1,0
51033,6712,161,0,0,82,82,0,1,0,1,0
51034,12232,41864,0,0,139,139,0,1,0,1,0
51035,54345,445,0,0,66,66,0,1,0,1,0
51036,58934,445,0,0,70,70,0,1,0,1,0
51037,64586,50584,0,0,146,146,0,1,0,1,0
51038,58924,445,0,0,70,70,0,1,0,1,0
51039,58923,445,0,0,70,70,0,1,0,1,0
51040,58922,445,0,0,70,70,0,1,0,1,0
51041,54342,445,0,0,66,66,0,1,0,1,0
51042,3559,30188,0,0,66,66,0,1,0,1,0
51043,50522,443,53720,443,460,394,66,4,0,3,1
51044,43688,22114,0,0,62,62,0,1,0,1,0
51045,53964,445,0,0,70,70,0,1,0,1,0
51046,63586,46824,0,0,62,62,0,1,0,1,0
51047,18246,64097,0,0,66,66,0,1,0,1,0
51048,45941,23386,0,0,60,60,0,1,0,1,0
51049,55921,43890,0,0,66,66,0,1,0,1,0
51050,58917,445,0,0,70,70,0,1,0,1,0
51051,55225,11392,0,0,62,62,0,1,0,1,0
51052,58914,445,0,0,70,70,0,1,0,1,0
51053,58910,445,0,0,70,70,0,1,0,1,0
51054,58912,445,0,0,70,70,0,1,0,1,0
51055,10265,64147,0,0,62,62,0,1,0,1,0
51056,54336,445,0,0,66,66,0,1,0,1,0
51057,52160,1,0,0,145,145,0,1,0,1,0
51058,54330,445,0,0,66,66,0,1,0,1,0
51059,54332,445,0,0,66,66,0,1,0,1,0
51060,54328,445,0,0,66,66,0,1,0,1,0
51061,43611,32480,0,0,109,109,0,1,0,1,0
51062,53960,445,0,0,70,70,0,1,0,1,0
51063,54324,445,0,0,66,66,0,1,0,1,0
51064,54323,445,0,0,66,66,0,1,0,1,0
51065,54325,445,0,0,66,66,0,1,0,1,0
51066,52726,56205,0,0,62,62,0,1,0,1,0
51067,63205,9571,0,0,62,62,0,1,0,1,0
51068,41298,51050,0,0,62,62,0,1,0,1,0
51069,19697,26296,0,0,159,159,0,1,0,1,0
51070,26494,26467,0,0,62,62,0,1,0,1,0
51071,53950,445,0,0,70,70,0,1,0,1,0
51072,53949,445,0,0,70,70,0,1,0,1,0
51073,53945,445,0,0,70,70,0,1,0,1,0
51074,53948,445,0,0,70,70,0,1,0,1,0
51075,59377,9319,0,0,62,62,0,1,0,1,0
51076,58909,445,0,0,70,70,0,1,0,1,0
51077,58906,445,0,0,70,70,0,1,0,1,0
51078,53944,445,0,0,70,70,0,1,0,1,0
51079,58902,445,0,0,70,70,0,1,0,1,0
51080,54320,445,0,0,66,66,0,1,0,1,0
51081,58901,445,0,0,70,70,0,1,0,1,0
51082,51920,30188,0,0,66,66,0,1,0,1,0
51083,42241,11392,0,0,62,62,0,1,0,1,0
51084,54318,445,0,0,66,66,0,1,0,1,0
51085,50116,22,0,0,60,60,0,1,0,1,0
51086,54315,445,0,0,66,66,0,1,0,1,0
51087,54314,445,0,0,66,66,0,1,0,1,0
51088,54313,445,0,0,66,66,0,1,0,1,0
51089,26480,64147,0,0,62,62,0,1,0,1,0
51090,2425,23117,0,0,66,66,0,1,0,1,0
51091,53938,445,0,0,70,70,0,1,0,1,0
51092,58893,445,0,0,70,70,0,1,0,1,0
51093,49255,44847,0,0,66,66,0,1,0,1,0
51094,13285,29892,0,0,145,145,0,1,0,1,0
51095,13285,29892,0,0,145,145,0,1,0,1,0
51096,58891,445,0,0,70,70,0,1,0,1,0
51097,58888,445,0,0,70,70,0,1,0,1,0
51098,21892,15503,0,0,62,62,0,1,0,1,0
51099,53930,445,0,0,70,70,0,1,0,1,0
51100,52111,44847,0,0,66,66,0,1,0,1,0
51101,53928,445,0,0,70,70,0,1,0,1,0
51102,61234,48817,0,0,106,106,0,1,0,1,0
51103,38320,51505,0,0,66,66,0,1,0,1,0
51104,54304,445,0,0,66,66,0,1,0,1,0
51105,61838,37965,0,0,66,66,0,1,0,1,0
51106,13581,51505,0,0,66,66,0,1,0,1,0
51107,53924,445,0,0,70,70,0,1,0,1,0
51108,15959,56205,0,0,62,62,0,1,0,1,0
51109,53922,445,0,0,70,70,0,1,0,1,0
51110,54294,445,0,0,66,66,0,1,0,1,0
51111,58879,445,0,0,70,70,0,1,0,1,0
51112,53918,445,0,0,70,70,0,1,0,1,0
51113,31978,57470,0,0,60,60,0,1,0,1,0
51114,54292,445,0,0,66,66,0,1,0,1,0
51115,21173,37965,0,0,62,62,0,1,0,1,0
51116,53917,445,0,0,70,70,0,1,0,1,0
51117,5357,32468,0,0,62,62,0,1,0,1,0
51118,52177,25320,0,0,66,66,0,1,0,1,0
51119,1026,64147,0,0,145,145,0,1,0,1,0
51120,54285,445,0,0,66,66,0,1,0,1,0
51121,1024,5529,0,0,146,146,0,1,0,1,0
51122,54278,445,0,0,66,66,0,1,0,1,0
51123,1067,51221,0,0,62,62,0,1,0,1,0
51124,6037,43890,0,0,74,74,0,1,0,1,0
51125,57504,44847,0,0,66,66,0,1,0,1,0
51126,27005,27017,65015,27017,880,126,754,2,30,1,1
51127,37096,443,16174,443,130,70,60,2,15,1,1
51128,64570,443,7059,443,24984,2042,22942,41,32,19,22
51129,49486,443,60567,443,4160,1015,3145,16,28,8,8
51130,49527,443,43125,443,5968,985,4983,17,26,8,9
51131,53624,7370,12914,7370,70,70,0,2,8,2,0
51132,53632,58037,4206,58037,70,70,0,2,8,2,0
51133,55622,33342,63556,33342,70,70,0,2,8,2,0
51134,53012,80,53012,80,278027,5087,272940,288,22,76,212
51135,37182,80,39276,80,1638,1324,314,10,16,5,5
51136,50604,443,50604,443,4716,1809,2907,19,30,11,8
51137,49498,443,53084,443,4172,1018,3154,16,27,8,8
51138,54125,443,54125,443,65572,14874,50698,92,84,48,44
51139,55691,443,55691,443,165616,8760,156856,199,82,79,120
51140,20520,53,20520,53,215,80,135,2,32,1,1
51141,55620,20795,23864,20795,70,70,0,2,8,2,0
51142,64797,80,54604,80,378,192,186,7,71,4,3
51143,54124,443,54124,443,105609,16179,89430,150,84,79,71
51144,47750,443,44039,443,70,70,0,1,5,1,0
51145,39630,443,32291,443,70,70,0,1,5,1,0
51146,47871,443,47202,443,70,70,0,1,5,1,0
51147,56515,443,56741,443,5083,969,4114,18,32,10,8
51148,56973,443,43404,443,22953,5010,17943,38,123,14,24
51149,27005,27015,35469,27015,886,126,760,2,30,1,1
51150,40603,443,49368,443,9462,6402,3060,32,394,11,21
51151,49512,443,31852,443,7626,1741,5885,35,256,17,18
51152,54711,443,57738,443,7169,2405,4764,18,135,10,8
51153,51813,63933,50803,63933,70,70,0,2,8,2,0
51154,38557,443,3043,443,70,70,0,1,5,1,0
51155,51819,59208,38763,59208,70,70,0,1,5,1,0
51156,56968,80,38598,80,2273,1511,762,7,29,4,3
51157,43029,443,37384,443,6053,1321,4732,19,980,9,10
51158,53121,8986,41857,8986,70,70,0,2,8,2,0
51159,34203,443,27925,443,33068,2556,30512,48,81,21,27
51160,49526,443,23120,443,6032,1049,4983,18,26,9,9
51161,61168,443,61168,443,4599,1692,2907,19,29,11,8
51162,1183,53,1183,53,213,79,134,2,33,1,1
51163,49859,80,22070,80,1644,1324,320,10,15,5,5
51164,58477,443,37357,443,10026,5706,4320,20,120,10,10
51165,55619,443,51009,443,13144,7075,6069,33,161,16,17
51166,56514,443,14098,443,5084,969,4115,18,32,10,8
51167,51817,54601,57265,54601,316,136,180,6,7,3,3
51168,54121,443,54121,443,184574,24037,160537,209,84,87,122
51169,54114,443,54114,443,171467,27550,143917,220,85,108,112
51170,27930,53,0,0,222,82,140,2,30,1,1
51171,54122,443,54122,443,186718,24971,161747,253,84,127,126
51172,59240,53,59240,53,194,87,107,2,30,1,1
51173,6881,6881,7756,6881,501,150,351,2,1200,1,1
51174,55201,22114,0,0,66,66,0,1,0,1,0
51175,9104,26296,0,0,157,157,0,1,0,1,0
51176,53912,445,0,0,70,70,0,1,0,1,0
51177,58865,445,0,0,70,70,0,1,0,1,0
51178,58862,445,0,0,70,70,0,1,0,1,0
51179,58861,445,0,0,70,70,0,1,0,1,0
51180,61481,443,1524,443,23229,1880,21349,46,80,21,25
51181,3254,3389,3254,3389,3790,1685,2105,18,17,10,8
51182,53626,33194,41822,33194,70,70,0,2,7,2,0
51183,53629,51413,13341,51413,70,70,0,2,7,2,0
51184,55996,53,10816,53,168,86,82,2,30,1,1
51185,55431,443,58607,443,999955,25445,974510,1003,171,325,678
51186,39446,443,32219,443,1647482,62713,1584769,1898,219,744,1154
51187,63788,80,49704,80,314,192,122,6,15,4,2
51188,49636,443,28958,443,50297,4871,45426,86,31,40,46
51189,27005,27016,25389,27016,1006,252,754,4,32,3,1
51190,51403,443,50805,443,190,70,120,4,8,2,2
51191,52438,443,56919,443,70,70,0,1,4,1,0
51192,57160,53,20461,53,255,110,145,2,29,1,1
51193,39596,53,5876,53,168,78,90,2,30,1,1
51194,64700,53,35656,53,239,86,153,2,29,1,1
51195,65404,53,47407,53,334,226,108,3,29,2,1
51196,62724,443,47821,443,87797,47766,40031,754,453,303,451
51197,52409,443,39608,443,1369,708,661,14,24,8,6
51198,55429,443,27216,443,343735,15691,328044,423,171,179,244
51199,50469,443,24709,443,3049,1569,1480,17,19,10,7
51200,50460,443,36423,443,5572,4252,1320,18,34,11,7
51201,56519,80,41989,80,370,222,148,6,32,4,2
51202,52405,53,59064,53,168,78,90,2,30,1,1
51203,46972,443,1778,443,45264,4281,40983,59,120,24,35
51204,37965,4546,34269,4546,3957,2324,1633,51,1720,29,22
51205,56351,53,2881,53,195,102,93,2,30,1,1
51206,49494,443,9142,443,4168,1018,3150,16,27,8,8
51207,55996,53,61146,53,196,86,110,2,30,1,1
51208,49511,443,56126,443,1200,623,577,13,27,6,7
51209,60192,53,4239,53,236,94,142,2,30,1,1
51210,56259,53,56259,53,244,98,146,2,32,1,1
51211,41472,443,2469,443,4500,2769,1731,29,80,14,15
51212,49531,443,58024,443,8107,2474,5633,24,25,12,12
51213,56452,53,0,0,82,82,0,2,40,2,0
51214,50456,80,33099,80,4473,3398,1075,14,34,8,6
51215,52410,443,38111,443,128802,48896,79906,237,24,121,116
51216,49495,443,17412,443,12452,10841,1611,26,27,14,12
51217,55428,443,63993,443,74784,4781,70003,122,171,55,67
51218,56502,443,5913,443,5414,1010,4404,17,33,9,8
51219,42804,443,52813,443,8113,1626,6487,24,21,14,10
51220,52411,443,20618,443,9428,3770,5658,54,24,28,26
51221,50454,80,32603,80,4185,3618,567,14,34,8,6
51222,36682,443,16201,443,4590,3104,1486,25,95,14,11
51223,55980,123,7764,123,184,94,90,2,30,1,1
51224,50453,80,44692,80,5978,3592,2386,15,34,8,7
51225,56584,53,11866,53,214,102,112,2,30,1,1
51226,56977,53,42818,53,273,102,171,2,30,1,1
51227,53392,53,29793,53,164,78,86,2,31,1,1
51228,49522,443,12494,443,3090,1796,1294,19,26,10,9
51229,49477,443,54783,443,1332,876,456,11,27,6,5
51230,49532,80,7798,80,4577,3951,626,11,25,6,5
51231,51815,28665,41311,28665,70,70,0,2,7,2,0
51232,55621,28144,20259,28144,70,70,0,2,8,2,0
51233,59789,443,5705,443,6695,2021,4674,23,45,11,12
51234,49518,80,62849,80,11011,7675,3336,21,26,11,10
51235,50229,80,35977,80,1743,979,764,13,81,7,6
51236,54123,443,54123,443,79652,20710,58942,112,84,58,54
51237,41064,80,41064,80,2118,1493,625,9,82,6,3
51238,49637,443,18252,443,50296,4666,45630,90,31,43,47
51239,64907,53,16767,53,211,102,109,2,30,1,1
51240,27005,27017,4799,27017,883,126,757,2,30,1,1
51241,63464,443,28849,443,3120,976,2144,13,135,6,7
51242,56258,443,7050,443,3325,1067,2258,13,135,6,7
51243,56351,53,53304,53,195,102,93,2,33,1,1
51244,51796,48779,32373,48779,70,70,0,1,5,1,0
51245,50471,80,51148,80,1658,1247,411,8,15,5,3
51246,50631,443,5471,443,4158,1021,3137,15,26,8,7
51247,55430,443,62629,443,805321,15163,790158,752,171,204,548
51248,56513,443,40120,443,4989,1014,3975,16,32,9,7
51249,49508,443,35365,443,4151,1015,3136,16,27,8,8
51250,49491,443,28351,443,1627,884,743,12,27,6,6
51251,64778,53,20977,53,269,110,159,2,30,1,1
51252,34671,53,40615,53,168,78,90,2,30,1,1
51253,49988,53,19025,53,214,102,112,2,30,1,1
51254,27005,27015,3616,27015,887,126,761,2,30,1,1
51255,60180,53,36445,53,225,110,115,2,30,1,1
51256,53628,50514,20883,50514,70,70,0,2,7,2,0
51257,36516,443,59096,443,70,70,0,1,4,1,0
51258,64609,53,8196,53,404,95,309,4,43,2,2
51259,40848,8434,40848,8434,156,156,0,3,8,3,0
51260,51814,55393,12935,55393,70,70,0,2,7,2,0
51261,42469,80,53240,80,2169,1419,750,10,15,6,4
51262,51518,443,15866,443,38155,33545,4610,79,26,42,37
51263,49496,443,45834,443,15404,11220,4184,29,27,16,13
51264,48713,80,47813,80,1767,751,1016,10,15,6,4
51265,44417,53,0,0,82,82,0,2,40,2,0
51266,51501,443,62787,443,10861,5281,5580,65,49,33,32
51267,53630,64745,62898,64745,70,70,0,2,7,2,0
51268,64488,53,54282,53,356,98,258,4,35,2,2
51269,50461,443,58774,443,5440,4368,1072,19,34,11,8
51270,54972,80,43170,80,1074,691,383,12,66,7,5
51271,62883,53,56502,53,205,86,119,2,29,1,1
51272,48883,53,16845,53,168,78,90,2,30,1,1
51273,53600,8999,29889,8999,492,306,186,8,15,5,3
51274,49489,443,60116,443,1627,884,743,12,27,6,6
51275,65087,53,63765,53,230,110,120,2,30,1,1
51276,64979,53,11759,53,254,102,152,2,30,1,1
51277,65072,53,64909,53,338,110,228,2,29,1,1
51278,57470,6881,50879,6881,1806,726,1080,24,2426,12,12
51279,45563,443,24709,443,1022491,42917,979574,1099,36,416,683
51280,61480,443,37591,443,5716,1341,4375,29,80,16,13
51281,51820,53738,52497,53738,70,70,0,1,5,1,0
51282,50455,80,38947,80,4395,3599,796,15,34,8,7
51283,49490,443,58298,443,1627,884,743,12,27,6,6
51284,50265,37083,2868,37083,490,150,340,2,1200,1,1
51285,51797,30712,27964,30712,70,70,0,1,5,1,0
51286,50465,80,35475,80,8499,2011,6488,17,21,8,9
51287,50447,80,50342,80,67694,29654,38040,85,37,40,45
51288,60889,443,46801,443,9959,2430,7529,27,46,16,11
51289,30127,53,30127,53,197,90,107,2,30,1,1
51290,63925,53,47553,53,388,134,254,2,30,1,1
51291,49713,53,41539,53,233,94,139,2,30,1,1
51292,65037,53,14259,53,243,94,149,2,30,1,1
51293,49509,443,19603,443,4091,1015,3076,15,27,8,7
51294,49507,443,13013,443,4151,1015,3136,16,27,8,8
51295,49500,443,37954,443,1197,620,577,13,27,6,7
51296,53103,443,15301,443,130,70,60,2,15,1,1
51297,65340,53,10565,53,226,102,124,2,30,1,1
51298,65102,53,16634,53,210,102,108,2,30,1,1
51299,59052,53,10639,53,504,110,394,2,30,1,1
51300,17750,58572,62694,58572,150,150,0,1,1200,1,0
51301,56816,53,22918,53,233,94,139,2,30,1,1
51302,57470,27232,13855,27232,4212,2724,1488,57,2411,33,24
51303,49503,443,6313,443,20565,2848,17717,31,27,10,21
51304,56940,80,20270,80,2925,1480,1445,11,30,7,4
51305,65209,53,17107,53,212,102,110,2,30,1,1
51306,56707,53,58987,53,199,94,105,2,30,1,1
51307,44550,80,64720,80,3577,1983,1594,18,153,9,9
51308,37307,443,33957,443,9563,2336,7227,25,15,14,11
51309,56599,443,36954,443,348780,9144,339636,358,32,123,235
51310,48658,443,56881,443,6799,4474,2325,38,85,20,18
51311,60755,40010,18324,40010,316,136,180,6,7,3,3
51312,51558,37965,0,0,72,72,0,1,0,1,0
51313,54266,445,0,0,66,66,0,1,0,1,0
51314,54269,445,0,0,66,66,0,1,0,1,0
51315,54264,445,0,0,66,66,0,1,0,1,0
51316,54267,445,0,0,66,66,0,1,0,1,0
51317,54268,445,0,0,66,66,0,1,0,1,0
51318,54263,445,0,0,66,66,0,1,0,1,0
51319,54262,445,0,0,66,66,0,1,0,1,0
51320,54261,445,0,0,66,66,0,1,0,1,0
51321,36080,26467,0,0,62,62,0,1,0,1,0
51322,62414,50584,0,0,66,66,0,1,0,1,0
51323,11677,56205,0,0,66,66,0,1,0,1,0
51324,60147,25198,0,0,148,148,0,1,0,1,0
51325,18950,50584,0,0,146,146,0,1,0,1,0
51326,18950,50584,0,0,62,62,0,1,0,1,0
51327,47700,51505,0,0,66,66,0,1,0,1,0
51328,53899,445,0,0,70,70,0,1,0,1,0
51329,8191,51221,0,0,62,62,0,1,0,1,0
51330,11385,48543,0,0,145,145,0,1,0,1,0
51331,43260,41615,0,0,145,145,0,1,0,1,0
51332,53894,445,0,0,70,70,0,1,0,1,0
51333,58853,445,0,0,70,70,0,1,0,1,0
51334,58851,445,0,0,70,70,0,1,0,1,0
51335,58850,445,0,0,70,70,0,1,0,1,0
51336,54248,445,0,0,66,66,0,1,0,1,0
51337,54247,445,0,0,66,66,0,1,0,1,0
51338,54246,445,0,0,66,66,0,1,0,1,0
51339,52643,15941,0,0,66,66,0,1,0,1,0
51340,24450,48817,0,0,157,157,0,1,0,1,0
51341,55032,62413,0,0,66,66,0,1,0,1,0
51342,2394,43890,0,0,62,62,0,1,0,1,0
51343,62152,56205,0,0,66,66,0,1,0,1,0
51344,443,1785,0,0,97,97,0,1,0,1,0
51345,55248,67,0,0,60,60,0,1,0,1,0
51346,53890,445,0,0,70,70,0,1,0,1,0
51347,61962,53733,0,0,66,66,0,1,0,1,0
51348,7286,51221,0,0,62,62,0,1,0,1,0
51349,58841,445,0,0,70,70,0,1,0,1,0
51350,55157,7302,0,0,66,66,0,1,0,1,0
51351,58840,445,0,0,70,70,0,1,0,1,0
51352,58839,445,0,0,70,70,0,1,0,1,0
51353,58835,445,0,0,70,70,0,1,0,1,0
51354,57473,23,0,0,60,60,0,1,0,1,0
51355,51525,35440,0,0,66,66,0,1,0,1,0
51356,53886,445,0,0,70,70,0,1,0,1,0
51357,50280,57470,0,0,78,78,0,1,0,1,0
51358,33305,54532,0,0,60,60,0,1,0,1,0
51359,1024,57470,0,0,62,62,0,1,0,1,0
51360,61223,37965,0,0,66,66,0,1,0,1,0
51361,59201,51221,0,0,62,62,0,1,0,1,0
51362,62337,44847,0,0,66,66,0,1,0,1,0
51363,43129,15503,0,0,62,62,0,1,0,1,0
51364,6931,55108,0,0,139,139,0,1,0,1,0
51365,50031,44847,0,0,70,70,0,1,0,1,0
51366,59430,50584,0,0,66,66,0,1,0,1,0
51367,63263,57470,0,0,66,66,0,1,0,1,0
51368,50562,37965,0,0,62,62,0,1,0,1,0
51369,53879,445,0,0,70,70,0,1,0,1,0
51370,1880,57470,0,0,146,146,0,1,0,1,0
51371,58824,445,0,0,70,70,0,1,0,1,0
51372,58822,445,0,0,70,70,0,1,0,1,0
51373,58818,445,0,0,70,70,0,1,0,1,0
51374,53877,445,0,0,70,70,0,1,0,1,0
51375,53876,445,0,0,70,70,0,1,0,1,0
51376,53875,445,0,0,70,70,0,1,0,1,0
51377,53874,445,0,0,70,70,0,1,0,1,0
51378,53872,445,0,0,70,70,0,1,0,1,0
51379,53870,445,0,0,70,70,0,1,0,1,0
51380,5729,22114,0,0,66,66,0,1,0,1,0
51381,22904,56205,0,0,62,62,0,1,0,1,0
51382,22904,56205,0,0,146,146,0,1,0,1,0
51383,1880,57470,0,0,146,146,0,1,0,1,0
51384,54223,445,0,0,66,66,0,1,0,1,0
51385,64175,56502,0,0,66,66,0,1,0,1,0
51386,32007,1212,0,0,145,145,0,1,0,1,0
51387,58815,445,0,0,70,70,0,1,0,1,0
51388,58814,445,0,0,70,70,0,1,0,1,0
51389,53856,445,0,0,70,70,0,1,0,1,0
51390,53855,445,0,0,70,70,0,1,0,1,0
51391,53853,445,0,0,70,70,0,1,0,1,0
51392,53845,445,0,0,70,70,0,1,0,1,0
51393,53846,445,0,0,70,70,0,1,0,1,0
51394,52112,26467,0,0,66,66,0,1,0,1,0
51395,80,44459,0,0,66,66,0,1,0,1,0
51396,17640,55442,0,0,62,62,0,1,0,1,0
51397,45673,30188,0,0,62,62,0,1,0,1,0
51398,54991,36829,0,0,62,62,0,1,0,1,0
51399,54218,445,0,0,66,66,0,1,0,1,0
51400,25015,64147,0,0,66,66,0,1,0,1,0
51401,42732,57470,0,0,62,62,0,1,0,1,0
51402,42332,22114,0,0,66,66,0,1,0,1,0
51403,54217,445,0,0,66,66,0,1,0,1,0
51404,58801,445,0,0,70,70,0,1,0,1,0
51405,47030,81,0,0,60,60,0,1,0,1,0
51406,58800,445,0,0,70,70,0,1,0,1,0
51407,58795,445,0,0,70,70,0,1,0,1,0
51408,58792,445,0,0,70,70,0,1,0,1,0
51409,53834,445,0,0,70,70,0,1,0,1,0
51410,54214,445,0,0,66,66,0,1,0,1,0
51411,45060,37965,0,0,62,62,0,1,0,1,0
51412,21213,23,0,0,60,60,0,1,0,1,0
51413,64379,37965,0,0,66,66,0,1,0,1,0
51414,58790,445,0,0,70,70,0,1,0,1,0
51415,58786,445,0,0,70,70,0,1,0,1,0
51416,58785,445,0,0,70,70,0,1,0,1,0
51417,58782,445,0,0,70,70,0,1,0,1,0
51418,51745,57470,0,0,145,145,0,1,0,1,0
51419,15341,23,0,0,60,60,0,1,0,1,0
51420,48676,53392,0,0,60,60,0,1,0,1,0
51421,54206,445,0,0,66,66,0,1,0,1,0
51422,53830,445,0,0,70,70,0,1,0,1,0
51423,34134,30188,0,0,62,62,0,1,0,1,0
51424,54204,445,0,0,66,66,0,1,0,1,0
51425,54202,445,0,0,66,66,0,1,0,1,0
51426,54199,445,0,0,66,66,0,1,0,1,0
51427,63998,21247,0,0,66,66,0,1,0,1,0
51428,58681,36829,0,0,74,74,0,1,0,1,0
51429,16319,44847,0,0,146,146,0,1,0,1,0
51430,54197,445,0,0,66,66,0,1,0,1,0
51431,54198,445,0,0,66,66,0,1,0,1,0
51432,54196,445,0,0,66,66,0,1,0,1,0
51433,42034,28189,0,0,62,62,0,1,0,1,0
51434,53820,445,0,0,70,70,0,1,0,1,0
51435,53819,445,0,0,70,70,0,1,0,1,0
51436,63598,64147,0,0,66,66,0,1,0,1,0
51437,53817,445,0,0,70,70,0,1,0,1,0
51438,53816,445,0,0,70,70,0,1,0,1,0
51439,64880,9694,0,0,66,66,0,1,0,1,0
51440,53813,445,0,0,70,70,0,1,0,1,0
51441,58779,445,0,0,70,70,0,1,0,1,0
51442,58778,445,0,0,70,70,0,1,0,1,0
51443,58777,445,0,0,70,70,0,1,0,1,0
51444,0,0,0,0,152,78,74,2,0,1,1
51445,54191,445,0,0,66,66,0,1,0,1,0
51446,58773,445,0,0,70,70,0,1,0,1,0
51447,54189,445,0,0,66,66,0,1,0,1,0
51448,57982,64147,0,0,66,66,0,1,0,1,0
51449,54188,445,0,0,66,66,0,1,0,1,0
51450,54187,445,0,0,66,66,0,1,0,1,0
51451,54184,445,0,0,66,66,0,1,0,1,0
51452,53807,445,0,0,70,70,0,1,0,1,0
51453,3911,50584,0,0,62,62,0,1,0,1,0
51454,59696,57470,0,0,62,62,0,1,0,1,0
51455,32007,26543,0,0,145,145,0,1,0,1,0
51456,58765,445,0,0,70,70,0,1,0,1,0
51457,60627,51050,0,0,66,66,0,1,0,1,0
51458,65501,26467,0,0,62,62,0,1,0,1,0
51459,58764,445,0,0,70,70,0,1,0,1,0
51460,58759,445,0,0,70,70,0,1,0,1,0
51461,53800,445,0,0,70,70,0,1,0,1,0
51462,53799,445,0,0,70,70,0,1,0,1,0
51463,32096,55108,0,0,139,139,0,1,0,1,0
51464,31978,57470,0,0,60,60,0,1,0,1,0
51465,60875,50584,0,0,62,62,0,1,0,1,0
51466,55396,26467,0,0,62,62,0,1,0,1,0
51467,53833,26467,0,0,66,66,0,1,0,1,0
51468,50227,57470,0,0,66,66,0,1,0,1,0
51469,54176,445,0,0,66,66,0,1,0,1,0
51470,53794,445,0,0,70,70,0,1,0,1,0
51471,60294,30188,0,0,62,62,0,1,0,1,0
51472,53792,445,0,0,70,70,0,1,0,1,0
51473,58074,11392,0,0,62,62,0,1,0,1,0
51474,61323,23117,0,0,62,62,0,1,0,1,0
51475,45964,5333,0,0,60,60,0,1,0,1,0
51476,54166,445,0,0,66,66,0,1,0,1,0
51477,58747,445,0,0,70,70,0,1,0,1,0
51478,25085,30188,0,0,66,66,0,1,0,1,0
51479,53788,445,0,0,70,70,0,1,0,1,0
51480,3564,57470,0,0,62,62,0,1,0,1,0
51481,46576,23718,0,0,66,66,0,1,0,1,0
51482,34095,53,34095,53,243,104,139,2,30,1,1
51483,28121,443,57798,443,9075,2662,6413,34,462,16,18
51484,56645,443,5860,443,32966,3481,29485,49,80,21,28
51485,33784,443,3722,443,2378,1126,1252,14,979,7,7
51486,46859,15000,30674,15000,130,70,60,2,6,1,1
51487,51811,20740,61529,20740,70,70,0,2,8,2,0
51488,36241,443,45879,443,7768,3776,3992,21,132,11,10
51489,35012,443,7162,443,1461,980,481,11,25,7,4
51490,27005,27016,47379,27016,882,126,756,2,30,1,1
51491,59543,443,39979,443,7358,2661,4697,22,17,11,11
51492,27005,52013,29857,52013,252,252,0,3,32,3,0
51493,63804,52520,33916,52520,66,66,0,2,8,2,0
51494,36445,443,53718,443,78,78,0,1,5,1,0
51495,44320,443,45352,443,1657,1128,529,15,35,9,6
51496,56642,443,26637,443,27108,2396,24712,40,80,18,22
51497,49283,6881,34041,6881,803,617,186,6,16,3,3
51498,51035,443,33243,443,2227,1018,1209,17,16,8,9
51499,58104,443,9408,443,2396,1144,1252,14,979,7,7
51500,65257,53,65257,53,176,78,98,2,30,1,1
51501,64253,53,64253,53,288,83,205,2,30,1,1
51502,64607,443,37548,443,3182,1568,1614,8,120,4,4
51503,53011,80,53011,80,349769,6527,343242,368,22,100,268
51504,49710,53,26259,53,89,89,0,1,30,1,0
51505,47272,443,40986,443,6318,1025,5293,17,35,9,8
51506,63803,41439,2152,41439,66,66,0,2,8,2,0
51507,35105,5222,32302,5222,1964,919,1045,20,16,10,10
51508,59830,443,59830,443,21205,1711,19494,32,1806,11,21
51509,55618,45341,56428,45341,70,70,0,1,5,1,0
51510,53627,1099,28999,1099,320,140,180,6,7,3,3
51511,10570,53,10570,53,215,80,135,2,32,1,1
51512,49282,6881,35216,6881,709,523,186,6,16,3,3
51513,53366,53,53366,53,237,98,139,2,30,1,1
51514,49891,443,42695,443,8211,3683,4528,27,623,14,13
51515,59177,53,0,0,619,76,543,2,30,1,1
51516,47257,443,58413,443,64727,10981,53746,91,141,36,55
51517,57470,44667,49855,44667,480,149,331,2,1200,1,1
51518,47595,33434,0,0,106,106,0,1,60,1,0
51519,56643,443,30724,443,8167,1980,6187,22,80,12,10
51520,43113,443,54317,443,3083,1817,1266,18,15,8,10
51521,27005,27015,11588,27015,1019,252,767,4,32,3,1
51522,54444,443,57397,443,9802,2594,7208,25,360,10,15
51523,9402,53,9402,53,237,91,146,2,32,1,1
51524,48668,7275,13487,7275,276,70,206,5,32,2,3
51525,38168,443,45970,443,6136,1404,4732,20,979,10,10
51526,60405,64722,55660,64722,70,70,0,1,5,1,0
51527,59177,53,0,0,426,152,274,4,30,2,2
51528,57709,53,57709,53,265,111,154,2,30,1,1
51529,27988,40012,43574,40012,253,190,63,2,30,1,1
51530,27005,27014,39253,27014,882,126,756,2,30,1,1
51531,27005,27016,26467,27016,885,126,759,2,30,1,1
51532,64755,443,45264,443,23561,3667,19894,40,121,19,21
51533,10920,53,0,0,266,85,181,2,31,1,1
51534,44399,443,14238,443,11367,9355,2012,32,395,13,19
51535,6882,6889,19915,6889,492,150,342,2,1200,1,1
51536,57470,6882,62846,6882,528,528,0,9,1200,9,0
51537,59766,443,36182,443,508206,39212,468994,748,192,296,452
51538,51086,443,36949,443,11749,5336,6413,32,153,18,14
51539,33965,443,58848,443,31008,10449,20559,69,130,31,38
51540,42744,443,24894,443,224178,118713,105465,333,140,162,171
51541,37965,47686,60898,47686,480,149,331,2,1200,1,1
51542,42898,43890,0,0,62,62,0,1,0,1,0
51543,54164,445,0,0,66,66,0,1,0,1,0
51544,53786,445,0,0,70,70,0,1,0,1,0
51545,6666,401,0,0,60,60,0,1,0,1,0
51546,60319,23,0,0,60,60,0,1,0,1,0
51547,52356,55442,0,0,62,62,0,1,0,1,0
51548,58564,50432,0,0,66,66,0,1,0,1,0
51549,64878,26467,0,0,62,62,0,1,0,1,0
51550,58343,23718,0,0,66,66,0,1,0,1,0
51551,54155,445,0,0,66,66,0,1,0,1,0
51552,21399,35440,0,0,146,146,0,1,0,1,0
51553,54149,445,0,0,66,66,0,1,0,1,0
51554,60406,64337,21894,64337,70,70,0,1,5,1,0
51555,51628,443,16414,443,8084,2509,5575,36,195,19,17
51556,52667,443,52477,443,4797,2794,2003,20,271,11,9
51557,53626,443,63196,443,10520,3200,7320,29,38,16,13
51558,58147,443,65421,443,8365,2826,5539,27,693,15,12
51559,41292,443,17156,443,7644,1098,6546,19,35,10,9
51560,48681,80,45826,80,918,461,457,9,15,6,3
51561,58182,443,50635,443,15327,8305,7022,49,137,24,25
51562,60404,37869,1264,37869,164,70,94,2,5,1,1
51563,41295,443,40323,443,7661,1115,6546,19,35,10,9
51564,39317,443,31071,443,2045,1025,1020,17,80,9,8
51565,49778,53,5798,53,319,98,221,4,53,2,2
51566,56947,53,0,0,86,86,0,1,29,1,0
51567,64099,53,12065,53,227,110,117,2,30,1,1
51568,47091,443,62680,443,3543,1570,1973,18,120,9,9
51569,60752,28080,10717,28080,70,70,0,1,5,1,0
51570,27454,53,27454,53,244,98,146,2,32,1,1
51571,51812,15279,9004,15279,70,70,0,2,8,2,0
51572,51270,48061,22070,48061,70,70,0,1,5,1,0
51573,5588,5588,0,0,3354,1792,1562,46,192,23,23
51574,40498,443,31302,443,9807,2542,7265,47,19,24,23
51575,27005,27018,12355,27018,879,126,753,2,30,1,1
51576,64219,53,37826,53,264,102,162,2,30,1,1
51577,64596,53,15356,53,215,86,129,2,30,1,1
51578,56808,54393,51587,54393,70,70,0,2,8,2,0
51579,35670,443,58907,443,295458,11828,283630,339,185,137,202
51580,51794,53911,18093,53911,70,70,0,1,5,1,0
51581,10051,443,38650,443,11412,1763,9649,27,110,13,14
51582,55708,443,3177,443,10710,4573,6137,53,3376,31,22
51583,49176,443,46832,443,2802,1902,900,22,1118,12,10
51584,50632,443,47511,443,4158,1021,3137,15,26,8,7
51585,39423,80,5862,80,234,234,0,4,12,4,0
51586,64667,53,24129,53,353,118,235,2,30,1,1
51587,46034,53,59880,53,168,78,90,2,30,1,1
51588,49510,443,46546,443,1012,495,517,10,26,4,6
51589,63652,443,53205,443,51005,2084,48921,61,120,22,39
51590,36410,53,36410,53,268,114,154,2,30,1,1
51591,49518,53,34801,53,213,102,111,2,30,1,1
51592,51788,443,22272,443,3679,1712,1967,14,135,7,7
51593,27005,27016,18663,27016,892,126,766,2,30,1,1
51594,56620,80,60684,80,234,234,0,4,12,4,0
51595,49316,53,52712,53,338,102,236,2,30,1,1
51596,27005,27016,43090,27016,878,126,752,2,30,1,1
51597,51795,60258,28772,60258,70,70,0,1,5,1,0
51598,56792,42155,44462,42155,70,70,0,1,5,1,0
51599,49180,53,47398,53,402,102,300,2,30,1,1
51600,63062,53,18913,53,70,70,0,1,30,1,0
51601,50867,443,9876,443,2782,1480,1302,17,15,9,8
51602,41294,443,46411,443,7595,1115,6480,18,35,10,8
51603,49020,80,13819,80,3422,2088,1334,18,152,9,9
51604,39487,80,41504,80,1403,651,752,10,15,6,4
51605,37965,54371,6962,54371,132,132,0,3,1199,3,0
51606,55849,443,27388,443,5944,1501,4443,27,163,13,14
51607,56145,3389,56145,3389,4286,2261,2025,20,17,11,9
51608,51654,80,36290,80,170875,6864,164011,255,35,93,162
51609,60408,55557,8506,55557,70,70,0,1,5,1,0
51610,49402,80,31803,80,405,285,120,5,15,3,2
51611,57419,443,3080,443,9224,2381,6843,29,19,14,15
51612,56791,11500,23499,11500,70,70,0,1,5,1,0
51613,38761,123,12089,123,184,94,90,2,30,1,1
51614,56810,33957,19531,33957,70,70,0,1,5,1,0
51615,64370,53,62116,53,399,102,297,4,54,2,2
51616,64075,53,49394,53,352,86,266,4,36,2,2
51617,65194,53,62268,53,298,102,196,2,29,1,1
51618,54891,80,41573,80,1222,782,440,11,15,6,5
51619,54160,53,34866,53,199,94,105,2,29,1,1
51620,10053,443,28179,443,1832,1113,719,18,110,10,8
51621,27005,27015,45197,27015,881,126,755,2,30,1,1
51622,64893,53,31080,53,232,102,130,2,30,1,1
51623,57432,443,39026,443,2714,336,2378,10,120,5,5
51624,58568,53,2690,53,294,86,208,2,30,1,1
51625,59030,443,52271,443,10079,2210,7869,36,120,19,17
51626,34325,80,9980,80,2243,1115,1128,14,152,7,7
51627,51660,80,21356,80,52002,2984,49018,77,35,35,42
51628,61981,443,61981,443,4533,1626,2907,19,29,11,8
51629,60755,443,57914,443,61151,2474,58677,61,25,16,45
51630,65474,443,34045,443,355358,10960,344398,369,16,131,238
51631,51791,56116,24331,56116,70,70,0,1,5,1,0
51632,51221,47391,14393,47391,323,150,173,2,1203,1,1
51633,56723,53,3556,53,198,94,104,2,30,1,1
51634,33255,443,24023,443,7579,3093,4486,25,21,14,11
51635,51793,12210,25465,12210,70,70,0,1,5,1,0
51636,64276,53,2055,53,436,89,347,4,42,2,2
51637,51499,443,54241,443,1610,1073,537,14,15,8,6
51638,10031,443,14432,443,34551,3731,30820,54,112,23,31
51639,36877,443,64698,443,9787,2382,7405,17,120,7,10
51640,60022,443,9132,443,6906,1458,5448,24,16,14,10
51641,10052,443,12703,443,1832,1113,719,18,110,10,8
51642,64649,53,33149,53,225,102,123,2,30,1,1
51643,50471,53,24459,53,168,78,90,2,30,1,1
51644,44847,6881,11410,6881,502,150,352,2,1200,1,1
51645,47450,443,63060,443,9950,4684,5266,26,306,12,14
51646,63787,18318,22110,18318,70,70,0,1,5,1,0
51647,53602,12395,5014,12395,70,70,0,1,5,1,0
51648,63585,443,56391,443,123421,11745,111676,267,125,108,159
51649,54130,53,45665,53,168,78,90,2,30,1,1
51650,63786,50091,41625,50091,70,70,0,1,5,1,0
51651,1024,57470,0,0,62,62,0,1,0,1,0
51652,53782,445,0,0,70,70,0,1,0,1,0
51653,18632,51505,0,0,66,66,0,1,0,1,0
51654,41037,55839,0,0,157,157,0,1,0,1,0
51655,5690,23,0,0,60,60,0,1,0,1,0
51656,58736,445,0,0,70,70,0,1,0,1,0
51657,58734,445,0,0,70,70,0,1,0,1,0
51658,58733,445,0,0,70,70,0,1,0,1,0
51659,29203,26467,0,0,62,62,0,1,0,1,0
51660,54141,445,0,0,66,66,0,1,0,1,0
51661,54139,445,0,0,66,66,0,1,0,1,0
51662,54138,445,0,0,66,66,0,1,0,1,0
51663,54140,445,0,0,66,66,0,1,0,1,0
51664,54137,445,0,0,66,66,0,1,0,1,0
51665,54136,445,0,0,66,66,0,1,0,1,0
51666,54135,445,0,0,66,66,0,1,0,1,0
51667,54133,445,0,0,66,66,0,1,0,1,0
51668,59505,53733,0,0,66,66,0,1,0,1,0
51669,27064,51221,0,0,72,72,0,1,0,1,0
51670,60683,5900,0,0,60,60,0,1,0,1,0
51671,9219,32480,0,0,72,72,0,1,0,1,0
51672,61808,18375,0,0,66,66,0,1,0,1,0
51673,20012,311,0,0,60,60,0,1,0,1,0
51674,52887,37807,0,0,66,66,0,1,0,1,0
51675,53769,445,0,0,70,70,0,1,0,1,0
51676,53453,2767,0,0,66,66,0,1,0,1,0
51677,32071,51221,0,0,66,66,0,1,0,1,0
51678,62566,35993,0,0,66,66,0,1,0,1,0
51679,6881,26296,0,0,146,146,0,1,0,1,0
51680,53766,445,0,0,70,70,0,1,0,1,0
51681,50280,57470,0,0,78,78,0,1,0,1,0
51682,33305,54532,0,0,60,60,0,1,0,1,0
51683,59745,53635,0,0,66,66,0,1,0,1,0
51684,58729,445,0,0,70,70,0,1,0,1,0
51685,58728,445,0,0,70,70,0,1,0,1,0
51686,58727,445,0,0,70,70,0,1,0,1,0
51687,60152,26467,0,0,62,62,0,1,0,1,0
51688,2949,57470,0,0,66,66,0,1,0,1,0
51689,54121,445,0,0,66,66,0,1,0,1,0
51690,54120,445,0,0,66,66,0,1,0,1,0
51691,54119,445,0,0,66,66,0,1,0,1,0
51692,30765,56205,0,0,66,66,0,1,0,1,0
51693,4127,26467,0,0,62,62,0,1,0,1,0
51694,53928,15503,0,0,62,62,0,1,0,1,0
51695,53761,445,0,0,70,70,0,1,0,1,0
51696,58716,445,0,0,70,70,0,1,0,1,0
51697,60602,15503,0,0,66,66,0,1,0,1,0
51698,53760,445,0,0,70,70,0,1,0,1,0
51699,45941,23388,0,0,60,60,0,1,0,1,0
51700,37876,23,0,0,60,60,0,1,0,1,0
51701,41561,23,0,0,60,60,0,1,0,1,0
51702,53758,445,0,0,70,70,0,1,0,1,0
51703,58713,445,0,0,70,70,0,1,0,1,0
51704,58705,445,0,0,70,70,0,1,0,1,0
51705,58703,445,0,0,70,70,0,1,0,1,0
51706,58701,445,0,0,70,70,0,1,0,1,0
51707,15296,37965,0,0,66,66,0,1,0,1,0
51708,51996,35440,0,0,66,66,0,1,0,1,0
51709,50820,57470,0,0,62,62,0,1,0,1,0
51710,48692,57470,0,0,62,62,0,1,0,1,0
51711,53751,445,0,0,70,70,0,1,0,1,0
51712,53749,445,0,0,70,70,0,1,0,1,0
51713,58694,445,0,0,70,70,0,1,0,1,0
51714,58695,445,0,0,70,70,0,1,0,1,0
51715,58691,445,0,0,70,70,0,1,0,1,0
51716,42798,26467,0,0,62,62,0,1,0,1,0
51717,54997,26467,0,0,66,66,0,1,0,1,0
51718,53748,445,0,0,70,70,0,1,0,1,0
51719,49842,7302,0,0,62,62,0,1,0,1,0
51720,25565,34677,0,0,60,60,0,1,0,1,0
51721,53747,445,0,0,70,70,0,1,0,1,0
51722,60805,5900,0,0,60,60,0,1,0,1,0
51723,53746,445,0,0,70,70,0,1,0,1,0
51724,57478,7302,0,0,62,62,0,1,0,1,0
51725,53740,445,0,0,70,70,0,1,0,1,0
51726,53741,445,0,0,70,70,0,1,0,1,0
51727,50067,64147,0,0,62,62,0,1,0,1,0
51728,7275,9524,0,0,66,66,0,1,0,1,0
51729,23528,44847,0,0,62,62,0,1,0,1,0
51730,64066,23718,0,0,66,66,0,1,0,1,0
51731,3541,22114,0,0,62,62,0,1,0,1,0
51732,11859,64147,0,0,62,62,0,1,0,1,0
51733,53728,445,0,0,70,70,0,1,0,1,0
51734,53727,445,0,0,70,70,0,1,0,1,0
51735,53722,445,0,0,70,70,0,1,0,1,0
51736,54096,445,0,0,66,66,0,1,0,1,0
51737,53718,445,0,0,70,70,0,1,0,1,0
51738,53717,445,0,0,70,70,0,1,0,1,0
51739,22357,6004,0,0,62,62,0,1,0,1,0
51740,58686,445,0,0,70,70,0,1,0,1,0
51741,58685,445,0,0,70,70,0,1,0,1,0
51742,6666,6379,0,0,60,60,0,1,0,1,0
51743,52741,24211,0,0,66,66,0,1,0,1,0
51744,63221,53436,0,0,62,62,0,1,0,1,0
51745,60162,53436,0,0,66,66,0,1,0,1,0
51746,49001,48817,0,0,160,160,0,1,0,1,0
51747,35319,51505,0,0,146,146,0,1,0,1,0
51748,33793,23,0,0,60,60,0,1,0,1,0
51749,38763,30188,0,0,146,146,0,1,0,1,0
51750,48488,50584,0,0,146,146,0,1,0,1,0
51751,64756,11392,0,0,146,146,0,1,0,1,0
51752,50878,53733,0,0,62,62,0,1,0,1,0
51753,54091,445,0,0,66,66,0,1,0,1,0
51754,1024,64147,0,0,62,62,0,1,0,1,0
51755,40547,24051,0,0,74,74,0,1,0,1,0
51756,58468,57587,0,0,66,66,0,1,0,1,0
51757,54089,445,0,0,66,66,0,1,0,1,0
51758,57339,50584,0,0,66,66,0,1,0,1,0
51759,53706,445,0,0,70,70,0,1,0,1,0
51760,58678,445,0,0,70,70,0,1,0,1,0
51761,4000,44847,0,0,66,66,0,1,0,1,0
51762,58671,445,0,0,70,70,0,1,0,1,0
51763,58668,445,0,0,70,70,0,1,0,1,0
51764,58665,445,0,0,70,70,0,1,0,1,0
51765,45964,2225,0,0,60,60,0,1,0,1,0
51766,48020,7484,0,0,60,60,0,1,0,1,0
51767,54086,445,0,0,66,66,0,1,0,1,0
51768,3377,50584,0,0,66,66,0,1,0,1,0
51769,61457,21247,0,0,66,66,0,1,0,1,0
51770,46093,32661,0,0,74,74,0,1,0,1,0
51771,0,0,0,0,480,244,236,4,0,2,2
51772,49690,50265,0,0,66,66,0,1,0,1,0
51773,58660,445,0,0,70,70,0,1,0,1,0
51774,53702,445,0,0,70,70,0,1,0,1,0
51775,58238,23,0,0,60,60,0,1,0,1,0
51776,58658,445,0,0,70,70,0,1,0,1,0
51777,58656,445,0,0,70,70,0,1,0,1,0
51778,58654,445,0,0,70,70,0,1,0,1,0
51779,51413,25864,0,0,72,72,0,1,0,1,0
51780,54078,445,0,0,66,66,0,1,0,1,0
51781,54073,445,0,0,66,66,0,1,0,1,0
51782,54075,445,0,0,66,66,0,1,0,1,0
51783,54074,445,0,0,66,66,0,1,0,1,0
51784,53692,445,0,0,70,70,0,1,0,1,0
51785,53693,445,0,0,70,70,0,1,0,1,0
51786,39895,26467,0,0,62,62,0,1,0,1,0
51787,26799,50584,0,0,62,62,0,1,0,1,0
51788,53688,445,0,0,70,70,0,1,0,1,0
51789,53689,445,0,0,70,70,0,1,0,1,0
51790,54070,445,0,0,66,66,0,1,0,1,0
51791,54069,445,0,0,66,66,0,1,0,1,0
51792,54067,445,0,0,66,66,0,1,0,1,0
51793,53685,445,0,0,70,70,0,1,0,1,0
51794,54062,49813,0,0,62,62,0,1,0,1,0
51795,26560,26467,0,0,66,66,0,1,0,1,0
51796,51244,30228,0,0,100,100,0,1,0,1,0
51797,53779,51505,0,0,66,66,0,1,0,1,0
51798,52447,43890,0,0,62,62,0,1,0,1,0
51799,58652,445,0,0,70,70,0,1,0,1,0
51800,58649,445,0,0,70,70,0,1,0,1,0
51801,58646,445,0,0,70,70,0,1,0,1,0
51802,54064,445,0,0,66,66,0,1,0,1,0
51803,58645,445,0,0,70,70,0,1,0,1,0
51804,54061,445,0,0,66,66,0,1,0,1,0
51805,44854,26467,0,0,62,62,0,1,0,1,0
51806,51026,37450,0,0,66,66,0,1,0,1,0
51807,19875,30170,0,0,145,145,0,1,0,1,0
51808,54060,445,0,0,66,66,0,1,0,1,0
51809,54059,445,0,0,66,66,0,1,0,1,0
51810,53680,445,0,0,70,70,0,1,0,1,0
51811,54057,445,0,0,66,66,0,1,0,1,0
51812,8999,57099,0,0,146,146,0,1,0,1,0
51813,50027,21247,0,0,66,66,0,1,0,1,0
51814,10319,42707,0,0,62,62,0,1,0,1,0
51815,8999,59353,0,0,146,146,0,1,0,1,0
51816,54109,36829,0,0,66,66,0,1,0,1,0
51817,39868,55839,0,0,137,137,0,1,0,1,0
51818,24972,27262,0,0,60,60,0,1,0,1,0
51819,60750,42707,0,0,66,66,0,1,0,1,0
51820,52076,44847,0,0,66,66,0,1,0,1,0
51821,49677,64147,0,0,62,62,0,1,0,1,0
51822,53672,445,0,0,70,70,0,1,0,1,0
51823,44934,443,47157,443,416,210,206,7,24,4,3
51824,61666,80,7138,80,16580,1400,15180,33,48,15,18
51825,46983,443,17844,443,2809,1884,925,19,25,11,8
51826,63571,443,39273,443,1882441,60775,1821666,2129,129,795,1334
51827,55877,27906,5770,27906,480,149,331,2,1200,1,1
51828,38133,53,38133,53,194,87,107,2,30,1,1
51829,44564,22,44564,22,5130,2103,3027,28,21,16,12
51830,51496,443,43516,443,416,210,206,7,15,4,3
51831,59952,53,59952,53,215,80,135,2,32,1,1
51832,52375,80,39641,80,78,78,0,1,5,1,0
51833,35608,443,36107,443,8530,2685,5845,25,100,15,10
51834,40763,443,27693,443,15679,4305,11374,32,43,17,15
51835,59762,443,29034,443,382,164,218,2,31,1,1
51836,63529,53,63529,53,217,91,126,2,30,1,1
51837,56118,53,56118,53,233,91,142,2,30,1,1
51838,60939,53,60939,53,237,91,146,2,32,1,1
51839,58638,445,0,0,70,70,0,1,0,1,0
51840,53670,445,0,0,70,70,0,1,0,1,0
51841,54600,6881,0,0,62,62,0,1,0,1,0
51842,58634,445,0,0,70,70,0,1,0,1,0
51843,58631,445,0,0,70,70,0,1,0,1,0
51844,35460,35440,0,0,62,62,0,1,0,1,0
51845,22327,53,22327,53,237,91,146,2,32,1,1
51846,43319,53,43319,53,237,91,146,2,32,1,1
51847,49238,53,49238,53,235,90,145,2,32,1,1
51848,53622,61393,55834,61393,320,140,180,6,7,3,3
51849,55689,443,55689,443,177498,9805,167693,244,80,119,125
51850,55690,443,55690,443,14768,2185,12583,32,80,13,19
51851,59761,53,13611,53,569,164,405,2,31,1,1
51852,56766,41605,18996,41605,1639,460,1179,8,30,4,4
51853,7231,53,7231,53,215,80,135,2,33,1,1
51854,38655,443,22510,443,498,210,288,8,26,4,4
51855,43601,80,43601,80,1252,539,713,10,20,5,5
51856,37052,53,37052,53,259,104,155,2,30,1,1
51857,27005,27016,44583,27016,898,126,772,3,31,2,1
51858,1165,53,1165,53,196,88,108,2,30,1,1
51859,51810,33776,19037,33776,70,70,0,2,8,2,0
51860,58887,80,17469,80,1493,765,728,10,90,6,4
51861,47521,53,9404,53,198,93,105,2,30,1,1
51862,44808,443,1785,443,22366,9583,12783,50,37,25,25
51863,38867,53,38867,53,213,79,134,2,32,1,1
51864,35055,80,30586,80,3650999,83941,3567058,3541,21,1184,2357
51865,64645,443,28393,443,7752,4399,3353,34,159,17,17
51866,35609,443,52136,443,9225,2759,6466,27,100,16,11
51867,47821,53,47821,53,228,97,131,2,30,1,1
51868,45846,443,47275,443,2227,1018,1209,17,15,8,9
51869,51998,80,30634,80,52288,7809,44479,105,37,40,65
51870,57824,443,57824,443,4669,1762,2907,19,30,11,8
51871,55688,443,55688,443,115875,6637,109238,158,80,71,87
51872,55693,443,55693,443,23467,2707,20760,45,80,21,24
51873,50422,53,50422,53,194,87,107,2,30,1,1
51874,57925,443,19196,443,43126,33414,9712,214,220,108,106
51875,36037,53,7009,53,198,93,105,2,30,1,1
51876,36649,53,5716,53,198,93,105,2,30,1,1
51877,59831,53,14617,53,198,93,105,2,30,1,1
51878,34158,53,34158,53,217,87,130,2,30,1,1
51879,49465,443,48053,443,2894,725,2169,10,121,5,5
51880,48808,443,13852,443,8192,2071,6121,23,361,10,13
51881,56568,5228,36431,5228,2387,1435,952,16,3600,8,8
51882,49160,13917,61966,13917,150,150,0,1,1201,1,0
51883,59477,443,16193,443,7825,4076,3749,19,121,10,9
51884,5786,53,5786,53,213,87,126,2,31,1,1
51885,48817,61613,48817,61613,490,149,341,2,1200,1,1
51886,38238,443,28773,443,33229,5348,27881,55,125,26,29
51887,53770,64147,0,0,66,66,0,1,0,1,0
51888,53665,445,0,0,70,70,0,1,0,1,0
51889,54047,445,0,0,66,66,0,1,0,1,0
51890,57325,37965,0,0,62,62,0,1,0,1,0
51891,50316,37965,0,0,66,66,0,1,0,1,0
51892,53664,445,0,0,70,70,0,1,0,1,0
51893,60772,36829,0,0,66,66,0,1,0,1,0
51894,20576,37965,0,0,62,62,0,1,0,1,0
51895,33324,42873,0,0,62,62,0,1,0,1,0
51896,51166,31573,0,0,66,66,0,1,0,1,0
51897,5223,11387,0,0,66,66,0,1,0,1,0
51898,42532,22114,0,0,62,62,0,1,0,1,0
51899,27005,27018,46285,27018,895,126,769,2,30,1,1
51900,37759,53,3026,53,199,94,105,2,30,1,1
51901,34286,53,18958,53,199,94,105,2,30,1,1
51902,63586,443,51785,443,12760,2205,10555,39,122,21,18
51903,53268,80,36603,80,2960,1928,1032,13,75,8,5
51904,51497,443,10165,443,350,210,140,6,14,4,2
51905,49904,53,31561,53,217,94,123,2,29,1,1
51906,48620,53,31132,53,199,94,105,2,29,1,1
51907,33849,53,34954,53,336,231,105,3,30,2,1
51908,50777,53,12522,53,199,94,105,2,30,1,1
51909,55443,443,53890,443,12806,2828,9978,55,2983,24,31
51910,55528,443,24685,443,7845,1860,5985,24,81,14,10
51911,65473,443,51323,443,91831,4379,87452,101,15,37,64
51912,55454,53,34563,53,321,105,216,4,40,2,2
51913,57470,10714,2677,10714,132,132,0,3,1199,3,0
51914,2267,53,36345,53,468,320,148,5,49,3,2
51915,53601,30160,62732,30160,70,70,0,1,4,1,0
51916,53595,28976,64230,28976,492,306,186,8,15,5,3
51917,43674,53,36130,53,199,94,105,2,30,1,1
51918,36394,443,63478,443,6485,1692,4793,23,170,13,10
51919,49918,443,5366,443,3291,1714,1577,18,16,11,7
51920,60473,8765,52424,8765,1370,750,620,21,329,11,10
51921,47050,53,14793,53,199,94,105,2,30,1,1
51922,53793,53,24147,53,213,78,135,2,30,1,1
51923,27005,27018,55202,27018,881,126,755,2,30,1,1
51924,27005,27025,27504,27025,895,126,769,2,30,1,1
51925,51808,46390,6189,46390,70,70,0,2,8,2,0
51926,60751,20010,62533,20010,70,70,0,1,5,1,0
51927,55329,443,18522,443,9458,2227,7231,23,15,12,11
51928,40501,443,64068,443,6517,1812,4705,21,255,11,10
51929,44948,443,65427,443,4792,3072,1720,31,80,16,15
51930,63957,53,57529,53,211,102,109,2,30,1,1
51931,47824,53,65037,53,199,94,105,2,30,1,1
51932,57415,53,16994,53,223,86,137,2,30,1,1
51933,58601,53,45683,53,198,86,112,2,30,1,1
51934,50864,443,25636,443,6391,1285,5106,19,15,10,9
51935,64294,53,36421,53,329,118,211,2,30,1,1
51936,60287,53,47078,53,215,86,129,2,30,1,1
51937,58415,443,47391,443,145249,142210,3039,143,185,106,37
51938,43039,53,37075,53,241,78,163,2,30,1,1
51939,64752,53,43912,53,210,94,116,2,30,1,1
51940,55080,53,5647,53,330,86,244,2,30,1,1
51941,59764,53,23530,53,304,86,218,2,30,1,1
51942,25758,53,25758,53,198,90,108,2,30,1,1
51943,64753,443,41377,443,145226,5591,139635,164,120,58,106
51944,56740,443,56740,443,41851,2810,39041,66,45,31,35
51945,53594,27639,27513,27639,552,306,246,9,15,5,4
51946,64280,53,51701,53,211,94,117,2,30,1,1
51947,56738,443,56738,443,48740,2961,45779,73,46,33,40
51948,51790,46839,56676,46839,70,70,0,1,5,1,0
51949,58600,443,58600,443,4396,1489,2907,19,26,11,8
51950,59765,443,22401,443,571,166,405,2,30,1,1
51951,64019,53,58991,53,267,94,173,2,30,1,1
51952,62023,53,10426,53,301,102,199,2,30,1,1
51953,57138,443,50278,443,498,210,288,8,26,4,4
51954,63967,53,14948,53,283,97,186,4,36,2,2
51955,63589,443,25041,443,19134,2422,16712,49,120,22,27
51956,53192,80,30945,80,814,335,479,10,15,5,5
51957,42960,443,37505,443,5057,2448,2609,27,544,12,15
51958,53603,53796,21410,53796,70,70,0,1,4,1,0
51959,44805,443,37165,443,6975,2168,4807,20,15,11,9
51960,42705,80,6053,80,1222,782,440,11,15,6,5
51961,51448,80,39374,80,214,140,74,4,15,3,1
51962,51689,53,28477,53,198,86,112,2,29,1,1
51963,34798,53,14935,53,199,94,105,2,30,1,1
51964,57149,53,45353,53,222,86,136,2,30,1,1
51965,57423,443,2574,443,10222,4415,5807,26,15,11,15
51966,50061,443,34942,443,4819,2004,2815,22,80,11,11
51967,44947,443,36944,443,6359,4441,1918,33,80,17,16
51968,27005,27016,63808,27016,879,126,753,2,30,1,1
51969,57952,443,57780,443,480591,8786,471805,442,46,102,340
51970,55321,443,9589,443,9462,2297,7165,23,15,13,10
51971,27005,27015,32826,27015,880,126,754,2,30,1,1
51972,56508,80,35273,80,318,192,126,6,30,4,2
51973,27005,27015,45042,27015,878,126,752,2,30,1,1
51974,123,123,22929,123,184,94,90,2,29,1,1
51975,61559,53,9585,53,376,86,290,2,29,1,1
51976,55784,53,34530,53,199,94,105,2,29,1,1
51977,42895,53,15137,53,168,78,90,2,30,1,1
51978,59766,53,33803,53,512,166,346,2,30,1,1
51979,59752,443,12592,443,304,86,218,2,30,1,1
51980,59751,53,11335,53,304,86,218,2,30,1,1
51981,47478,443,52438,443,4019,1462,2557,21,120,11,10
51982,35195,443,32117,443,3672,1259,2413,16,120,8,8
51983,57347,443,40026,443,3889,1296,2593,11,120,6,5
51984,55763,443,52551,443,48162,46496,1666,59,136,39,20
51985,1462,41599,5098,41599,70,70,0,1,5,1,0
51986,56932,80,33047,80,8325,5642,2683,16,28,9,7
51987,56878,443,56878,443,27657,5506,22151,58,46,30,28
51988,39484,80,6764,80,1403,651,752,10,16,6,4
51989,64449,53,61840,53,197,94,103,2,30,1,1
51990,53792,53,47522,53,224,86,138,2,30,1,1
51991,55454,53,16777,53,168,78,90,2,30,1,1
51992,53791,53,53567,53,260,86,174,2,30,1,1
51993,56739,443,56739,443,94524,4465,90059,126,45,56,70
51994,55692,443,55692,443,7516,1498,6018,25,79,11,14
51995,58511,53,45280,53,302,86,216,2,30,1,1
51996,49762,53,13712,53,335,142,193,2,30,1,1
51997,59763,443,40613,443,304,86,218,2,30,1,1
51998,57344,443,60771,443,3872,1641,2231,14,125,6,8
51999,51809,52528,62433,52528,70,70,0,2,8,2,0
52000,41464,443,7904,443,3978,2714,1264,24,83,13,11
52001,60318,123,6592,123,184,94,90,2,30,1,1
52002,45937,53,13210,53,241,78,163,2,30,1,1
52003,43382,53,39674,53,86,86,0,1,30,1,0
52004,40151,443,46330,443,80789,5008,75781,92,128,33,59
52005,52239,443,55922,443,6564,3283,3281,19,140,10,9
52006,60308,443,63284,443,2622412,144918,2477494,3052,316,1078,1974
52007,15503,36501,26789,36501,323,150,173,2,1201,1,1
52008,37635,443,29591,443,4266,1768,2498,18,121,8,10
52009,63798,16357,18681,16357,66,66,0,2,8,2,0
52010,58616,80,39662,80,1056,682,374,10,15,6,4
52011,49720,443,3612,443,180777,5704,175073,204,105,67,137
52012,64989,53,60666,53,214,102,112,2,30,1,1
52013,53789,53,10128,53,167,78,89,2,30,1,1
52014,45237,53,45237,53,235,90,145,2,33,1,1
52015,61075,53,61075,53,244,98,146,2,32,1,1
52016,63795,52376,47084,52376,66,66,0,2,8,2,0
52017,51787,35661,9669,35661,70,70,0,1,5,1,0
52018,53442,443,20405,443,10500,2835,7665,34,114,14,20
52019,49914,53,31140,53,215,86,129,2,30,1,1
52020,49863,53,59500,53,200,86,114,2,30,1,1
52021,59755,443,15018,443,448,166,282,2,30,1,1
52022,14697,8000,26641,8000,212,150,62,2,31,1,1
52023,64180,53,33989,53,296,91,205,4,55,2,2
52024,63796,60557,39305,60557,66,66,0,2,8,2,0
52025,64858,53,1882,53,227,102,125,2,30,1,1
52026,64468,53,38719,53,259,118,141,2,30,1,1
52027,53660,445,0,0,70,70,0,1,0,1,0
52028,54038,445,0,0,66,66,0,1,0,1,0
52029,58624,445,0,0,70,70,0,1,0,1,0
52030,53659,445,0,0,70,70,0,1,0,1,0
52031,35749,18375,0,0,146,146,0,1,0,1,0
52032,58811,53976,0,0,66,66,0,1,0,1,0
52033,54035,445,0,0,66,66,0,1,0,1,0
52034,21420,44847,0,0,66,66,0,1,0,1,0
52035,27642,23,0,0,60,60,0,1,0,1,0
52036,58562,57587,0,0,66,66,0,1,0,1,0
52037,54029,445,0,0,66,66,0,1,0,1,0
52038,53654,445,0,0,70,70,0,1,0,1,0
52039,7749,36237,0,0,66,66,0,1,0,1,0
52040,52095,56079,0,0,66,66,0,1,0,1,0
52041,49982,37965,0,0,66,66,0,1,0,1,0
52042,54021,445,0,0,66,66,0,1,0,1,0
52043,34234,993,0,0,60,60,0,1,0,1,0
52044,34233,993,0,0,60,60,0,1,0,1,0
52045,52860,9694,0,0,62,62,0,1,0,1,0
52046,49950,23,0,0,60,60,0,1,0,1,0
52047,51244,42416,0,0,100,100,0,1,0,1,0
52048,50254,44847,0,0,66,66,0,1,0,1,0
52049,33453,64147,0,0,62,62,0,1,0,1,0
52050,33305,54532,0,0,60,60,0,1,0,1,0
52051,50280,57470,0,0,78,78,0,1,0,1,0
52052,18415,37965,0,0,62,62,0,1,0,1,0
52053,56173,37807,0,0,66,66,0,1,0,1,0
52054,5774,37965,0,0,66,66,0,1,0,1,0
52055,57500,37965,0,0,62,62,0,1,0,1,0
52056,65203,30188,0,0,66,66,0,1,0,1,0
52057,53476,5900,0,0,60,60,0,1,0,1,0
52058,52459,5555,0,0,60,60,0,1,0,1,0
52059,58609,445,0,0,70,70,0,1,0,1,0
52060,58606,445,0,0,70,70,0,1,0,1,0
52061,58605,445,0,0,70,70,0,1,0,1,0
52062,59592,37965,0,0,62,62,0,1,0,1,0
52063,53406,50584,0,0,66,66,0,1,0,1,0
52064,20004,48817,0,0,146,146,0,1,0,1,0
52065,54013,445,0,0,66,66,0,1,0,1,0
52066,54011,445,0,0,66,66,0,1,0,1,0
52067,54012,445,0,0,66,66,0,1,0,1,0
52068,54010,445,0,0,66,66,0,1,0,1,0
52069,54009,445,0,0,66,66,0,1,0,1,0
52070,54007,445,0,0,66,66,0,1,0,1,0
52071,54006,445,0,0,66,66,0,1,0,1,0
52072,54005,445,0,0,66,66,0,1,0,1,0
52073,22583,9822,0,0,62,62,0,1,0,1,0
52074,53641,445,0,0,70,70,0,1,0,1,0
52075,8999,52290,0,0,146,146,0,1,0,1,0
52076,53469,44847,0,0,62,62,0,1,0,1,0
52077,51244,50432,0,0,100,100,0,1,0,1,0
52078,10822,48817,0,0,140,140,0,1,0,1,0
52079,53638,445,0,0,70,70,0,1,0,1,0
52080,6712,5632,0,0,60,60,0,1,0,1,0
52081,54703,23,0,0,60,60,0,1,0,1,0
52082,55600,22,0,0,60,60,0,1,0,1,0
52083,20939,60461,0,0,60,60,0,1,0,1,0
52084,52361,23718,0,0,66,66,0,1,0,1,0
52085,58602,445,0,0,70,70,0,1,0,1,0
52086,58596,445,0,0,70,70,0,1,0,1,0
52087,58594,445,0,0,70,70,0,1,0,1,0
52088,1054,15503,0,0,62,62,0,1,0,1,0
52089,20939,60461,0,0,60,60,0,1,0,1,0
52090,53634,445,0,0,70,70,0,1,0,1,0
52091,53990,445,0,0,66,66,0,1,0,1,0
52092,53992,445,0,0,66,66,0,1,0,1,0
52093,53991,445,0,0,66,66,0,1,0,1,0
52094,19999,30170,0,0,145,145,0,1,0,1,0
52095,53632,445,0,0,70,70,0,1,0,1,0
52096,24812,44847,0,0,146,146,0,1,0,1,0
52097,12608,21247,0,0,66,66,0,1,0,1,0
52098,58587,445,0,0,70,70,0,1,0,1,0
52099,53630,445,0,0,70,70,0,1,0,1,0
52100,64339,18375,0,0,66,66,0,1,0,1,0
52101,30046,15503,0,0,62,62,0,1,0,1,0
52102,58585,445,0,0,70,70,0,1,0,1,0
52103,9377,56205,0,0,66,66,0,1,0,1,0
52104,6886,55839,0,0,139,139,0,1,0,1,0
52105,58576,445,0,0,70,70,0,1,0,1,0
52106,58575,445,0,0,70,70,0,1,0,1,0
52107,58574,445,0,0,70,70,0,1,0,1,0
52108,29424,37807,0,0,62,62,0,1,0,1,0
52109,52217,22114,0,0,66,66,0,1,0,1,0
52110,59790,44847,0,0,66,66,0,1,0,1,0
52111,37589,443,25099,443,499,425,74,4,0,3,1
52112,37590,443,21881,443,499,425,74,4,0,3,1
52113,37592,443,5868,443,499,425,74,4,0,3,1
52114,37588,443,34121,443,499,425,74,4,0,3,1
52115,37591,443,50251,443,499,425,74,4,0,3,1
52116,37585,443,50718,443,499,425,74,4,2,3,1
52117,53178,26467,0,0,62,62,0,1,0,1,0
52118,53623,445,0,0,70,70,0,1,0,1,0
52119,37902,23718,0,0,62,62,0,1,0,1,0
52120,63542,15503,0,0,66,66,0,1,0,1,0
52121,21833,22114,0,0,62,62,0,1,0,1,0
52122,53621,445,0,0,70,70,0,1,0,1,0
52123,53620,445,0,0,70,70,0,1,0,1,0
52124,58568,445,0,0,70,70,0,1,0,1,0
52125,58566,445,0,0,70,70,0,1,0,1,0
52126,58562,445,0,0,70,70,0,1,0,1,0
52127,53619,445,0,0,70,70,0,1,0,1,0
52128,53618,445,0,0,70,70,0,1,0,1,0
52129,53616,445,0,0,70,70,0,1,0,1,0
52130,53614,445,0,0,70,70,0,1,0,1,0
52131,63772,35440,0,0,66,66,0,1,0,1,0
52132,51920,30188,0,0,66,66,0,1,0,1,0
52133,64877,37450,0,0,66,66,0,1,0,1,0
52134,58721,51505,0,0,66,66,0,1,0,1,0
52135,53810,23,0,0,60,60,0,1,0,1,0
52136,53600,445,0,0,70,70,0,1,0,1,0
52137,53599,445,0,0,70,70,0,1,0,1,0
52138,53594,445,0,0,70,70,0,1,0,1,0
52139,53590,445,0,0,70,70,0,1,0,1,0
52140,53589,445,0,0,70,70,0,1,0,1,0
52141,2425,23117,0,0,66,66,0,1,0,1,0
52142,53968,445,0,0,66,66,0,1,0,1,0
52143,58558,445,0,0,70,70,0,1,0,1,0
52144,58559,445,0,0,70,70,0,1,0,1,0
52145,26494,26467,0,0,62,62,0,1,0,1,0
52146,49805,64147,0,0,66,66,0,1,0,1,0
52147,0,0,0,0,320,320,0,5,0,5,0
52148,52643,36237,0,0,66,66,0,1,0,1,0
52149,53578,445,0,0,70,70,0,1,0,1,0
52150,53963,445,0,0,66,66,0,1,0,1,0
52151,52111,44847,0,0,66,66,0,1,0,1,0
52152,13581,51505,0,0,66,66,0,1,0,1,0
52153,53961,445,0,0,66,66,0,1,0,1,0
52154,58549,445,0,0,70,70,0,1,0,1,0
52155,11983,57470,0,0,62,62,0,1,0,1,0
52156,58541,445,0,0,70,70,0,1,0,1,0
52157,58542,445,0,0,70,70,0,1,0,1,0
52158,58536,445,0,0,70,70,0,1,0,1,0
52159,2697,28189,0,0,60,60,0,1,0,1,0
52160,53959,445,0,0,66,66,0,1,0,1,0
52161,5283,56205,0,0,146,146,0,1,0,1,0
52162,53573,445,0,0,70,70,0,1,0,1,0
52163,52743,15503,0,0,66,66,0,1,0,1,0
52164,58533,445,0,0,70,70,0,1,0,1,0
52165,58530,445,0,0,70,70,0,1,0,1,0
52166,58526,445,0,0,70,70,0,1,0,1,0
52167,58528,445,0,0,70,70,0,1,0,1,0
52168,53563,445,0,0,70,70,0,1,0,1,0
52169,53564,445,0,0,70,70,0,1,0,1,0
52170,53951,445,0,0,66,66,0,1,0,1,0
52171,53562,445,0,0,70,70,0,1,0,1,0
52172,53559,445,0,0,70,70,0,1,0,1,0
52173,53557,445,0,0,70,70,0,1,0,1,0
52174,53948,445,0,0,66,66,0,1,0,1,0
52175,53949,445,0,0,66,66,0,1,0,1,0
52176,53947,445,0,0,66,66,0,1,0,1,0
52177,52177,25320,0,0,66,66,0,1,0,1,0
52178,53942,445,0,0,66,66,0,1,0,1,0
52179,53940,445,0,0,66,66,0,1,0,1,0
52180,53939,445,0,0,66,66,0,1,0,1,0
52181,52339,26467,0,0,66,66,0,1,0,1,0
52182,61420,64097,0,0,62,62,0,1,0,1,0
52183,7992,64147,0,0,62,62,0,1,0,1,0
52184,6037,43890,0,0,74,74,0,1,0,1,0
52185,55201,22114,0,0,66,66,0,1,0,1,0
52186,34553,48637,0,0,60,60,0,1,0,1,0
52187,58524,445,0,0,70,70,0,1,0,1,0
52188,58521,445,0,0,70,70,0,1,0,1,0
52189,54862,19000,22196,19000,476,216,260,2,30,1,1
52190,53116,32014,29630,32014,698,320,378,10,17,6,4
52191,42310,443,52115,443,6673,2151,4522,27,125,13,14
52192,27005,27018,58513,27018,888,126,762,2,30,1,1
52193,49721,443,34964,443,65732,3951,61781,102,65,40,62
52194,56809,40641,18349,40641,70,70,0,1,5,1,0
52195,53708,80,59470,80,2434,516,1918,12,76,6,6
52196,10039,443,49424,443,12579,1722,10857,29,171,12,17
52197,49727,443,37710,443,5037,1135,3902,16,18,9,7
52198,20378,53,20378,53,235,90,145,2,32,1,1
52199,59404,53,59404,53,237,91,146,2,32,1,1
52200,51806,49530,21191,49530,70,70,0,2,8,2,0
52201,31132,53,31132,53,227,89,138,2,30,1,1
52202,27005,27020,41783,27020,898,126,772,2,30,1,1
52203,15733,3389,15733,3389,3910,1805,2105,20,19,12,8
52204,62731,443,8633,443,27905,17646,10259,131,308,73,58
52205,49725,443,10242,443,311104,8270,302834,336,18,99,237
52206,58356,443,14561,443,10817,2611,8206,44,135,21,23
52207,49726,443,20489,443,5393,1263,4130,21,18,11,10
52208,63797,47784,12377,47784,66,66,0,2,8,2,0
52209,53010,80,53010,80,210304,4398,205906,225,21,65,160
52210,60888,443,18783,443,7454,3131,4323,23,46,13,10
52211,63799,13835,2064,13835,66,66,0,2,8,2,0
52212,56785,28902,26302,28902,66,66,0,1,5,1,0
52213,59754,53,13358,53,303,85,218,2,30,1,1
52214,45918,443,28786,443,12351,7584,4767,38,48,22,16
52215,49728,443,36312,443,5037,1135,3902,16,18,9,7
52216,10006,80,62598,80,1142,636,506,10,45,6,4
52217,15420,53,15420,53,237,91,146,2,32,1,1
52218,49722,443,49212,443,28376,3058,25318,42,63,17,25
52219,59457,53,59457,53,213,87,126,2,30,1,1
52220,50367,53,22257,53,578,286,292,9,15,5,4
52221,54051,53,54051,53,617,67,550,2,30,1,1
52222,59753,443,43725,443,303,85,218,2,30,1,1
52223,59993,443,5215,443,6452,2146,4306,30,125,14,16
52224,54991,443,64659,443,15109,5866,9243,71,362,29,42
52225,64842,443,46917,443,5467,2738,2729,23,137,11,12
52226,54137,443,48423,443,2573,330,2243,12,136,5,7
52227,58519,445,0,0,70,70,0,1,0,1,0
52228,53937,445,0,0,66,66,0,1,0,1,0
52229,53676,35974,0,0,60,60,0,1,0,1,0
52230,34677,51185,0,0,60,60,0,1,0,1,0
52231,58517,445,0,0,70,70,0,1,0,1,0
52232,49805,6881,0,0,62,62,0,1,0,1,0
52233,53551,445,0,0,70,70,0,1,0,1,0
52234,53933,445,0,0,66,66,0,1,0,1,0
52235,44594,64147,0,0,66,66,0,1,0,1,0
52236,30114,65151,0,0,60,60,0,1,0,1,0
52237,53931,445,0,0,66,66,0,1,0,1,0
52238,53930,445,0,0,66,66,0,1,0,1,0
52239,54575,11392,0,0,66,66,0,1,0,1,0
52240,56986,2310,0,0,159,159,0,1,0,1,0
52241,18950,50584,0,0,62,62,0,1,0,1,0
52242,53928,445,0,0,66,66,0,1,0,1,0
52243,46906,25604,0,0,100,100,0,1,0,1,0
52244,62414,50584,0,0,66,66,0,1,0,1,0
52245,50305,443,65523,443,7725,2029,5696,23,136,13,10
52246,59060,443,38409,443,16775,1879,14896,36,16,17,19
52247,53716,443,47470,443,70,70,0,2,8,2,0
52248,53544,445,0,0,70,70,0,1,0,1,0
52249,53543,445,0,0,70,70,0,1,0,1,0
52250,45908,33330,0,0,60,60,0,1,0,1,0
52251,58510,445,0,0,70,70,0,1,0,1,0
52252,6886,45378,0,0,139,139,0,1,0,1,0
52253,47700,51505,0,0,66,66,0,1,0,1,0
52254,58507,445,0,0,70,70,0,1,0,1,0
52255,58505,445,0,0,70,70,0,1,0,1,0
52256,53538,445,0,0,70,70,0,1,0,1,0
52257,53536,445,0,0,70,70,0,1,0,1,0
52258,53917,445,0,0,66,66,0,1,0,1,0
52259,65115,50584,0,0,66,66,0,1,0,1,0
52260,51682,443,60633,443,5060,2867,2193,26,398,9,17
52261,27005,27017,13207,27017,890,126,764,2,30,1,1
52262,41466,443,58480,443,3356,2158,1198,21,82,11,10
52263,51807,10920,47874,10920,70,70,0,2,8,2,0
52264,56624,53,53106,53,259,118,141,2,29,1,1
52265,49729,443,33717,443,8322,2585,5737,23,16,12,11
52266,65516,53,35992,53,305,89,216,4,41,2,2
52267,49723,443,17483,443,11181,3795,7386,50,20,23,27
52268,61352,443,38180,443,14131,5620,8511,38,216,20,18
52269,46287,443,19273,443,7071,2628,4443,32,23,16,16
52270,49185,53,26156,53,307,94,213,2,29,1,1
52271,64305,53,21382,53,598,196,402,6,71,3,3
52272,50015,53,57649,53,287,94,193,2,29,1,1
52273,59749,443,34617,443,304,86,218,2,29,1,1
52274,31630,53,31630,53,220,90,130,2,30,1,1
52275,49483,53,5607,53,273,94,179,2,30,1,1
52276,59750,53,24886,53,304,86,218,2,29,1,1
52277,51491,443,61886,443,343,163,180,6,15,3,3
52278,52663,443,53022,443,4416,1702,2714,19,126,9,10
52279,49571,443,40326,443,12258,5621,6637,52,286,25,27
52280,50260,53,44495,53,168,86,82,2,30,1,1
52281,53034,53,25305,53,238,94,144,2,30,1,1
52282,41458,443,29775,443,13059,5161,7898,34,84,19,15
52283,56804,33375,39167,33375,70,70,0,2,8,2,0
52284,56735,80,56735,80,2243,1548,695,11,46,7,4
52285,27005,27017,24115,27017,880,126,754,2,30,1,1
52286,12346,53,12346,53,216,98,118,2,30,1,1
52287,41462,443,16265,443,3467,2269,1198,21,82,11,10
52288,60911,53,60911,53,216,90,126,2,30,1,1
52289,49370,53,35451,53,430,85,345,4,54,2,2
52290,49300,53,25911,53,232,86,146,2,30,1,1
52291,27005,27016,26608,27016,880,126,754,2,30,1,1
52292,49192,53,8580,53,212,102,110,2,30,1,1
52293,60412,12965,23315,12965,70,70,0,2,8,2,0
52294,37644,443,35046,443,3886,2516,1370,22,95,12,10
52295,53120,49860,38739,49860,70,70,0,2,8,2,0
52296,57426,66,14765,66,70,70,0,2,8,2,0
52297,60411,58131,51349,58131,70,70,0,2,8,2,0
52298,55434,53,55434,53,198,90,108,2,30,1,1
52299,59859,53,1491,53,218,86,132,2,30,1,1
52300,55514,53,24000,53,216,94,122,2,30,1,1
52301,33534,443,30363,443,4640,1416,3224,18,121,9,9
52302,48018,443,52238,443,1429,1295,134,10,29,8,2
52303,38631,443,46548,443,6231,1151,5080,23,109,13,10
52304,51492,80,15284,80,1517,481,1036,11,15,6,5
52305,49719,443,56556,443,560073,155518,404555,923,110,411,512
52306,60358,443,56425,443,17547,2695,14852,30,76,14,16
52307,38630,443,20829,443,9277,3025,6252,32,109,17,15
52308,49665,53,62694,53,289,99,190,4,35,2,2
52309,53598,40326,59380,40326,70,70,0,1,4,1,0
52310,51788,35787,25759,35787,70,70,0,1,4,1,0
52311,53582,40872,7897,40872,492,306,186,8,16,5,3
52312,52703,443,1986,443,7843,2397,5446,23,256,12,11
52313,51411,443,26944,443,509,329,180,6,8,3,3
52314,56619,80,59686,80,234,234,0,4,12,4,0
52315,59760,53,48696,53,384,166,218,2,29,1,1
52316,59758,443,28743,443,384,166,218,2,29,1,1
52317,35738,80,42244,80,1151,711,440,10,16,5,5
52318,53790,53,7041,53,167,78,89,2,29,1,1
52319,50213,80,50213,80,1723391,21750,1701641,1450,16,326,1124
52320,49917,443,38114,443,7645,2967,4678,23,15,13,10
52321,53707,443,35739,443,7272,930,6342,19,75,9,10
52322,51694,80,56366,80,1307,649,658,8,75,5,3
52323,59748,53,27175,53,304,86,218,2,29,1,1
52324,65116,53,7436,53,220,94,126,2,29,1,1
52325,59759,53,55695,53,384,166,218,2,29,1,1
52326,59757,443,52007,443,384,166,218,2,29,1,1
52327,64065,53,29677,53,270,94,176,2,30,1,1
52328,59756,53,64652,53,571,166,405,2,29,1,1
52329,50877,443,13364,443,7984,2447,5537,41,2904,24,17
52330,27005,27035,7636,27035,891,126,765,2,30,1,1
52331,57326,443,3757,443,64382,9305,55077,101,123,41,60
52332,59747,443,7939,443,304,86,218,2,29,1,1
52333,63951,443,17963,443,6718,3582,3136,18,126,10,8
52334,57812,7635,57812,7635,138,78,60,3,6,2,1
52335,41460,443,23165,443,13890,5926,7964,36,84,20,16
52336,45658,443,10440,443,5359,3152,2207,51,2901,28,23
52337,50260,53,50381,53,196,86,110,2,30,1,1
52338,27005,27016,11664,27016,902,126,776,2,30,1,1
52339,64303,443,22839,443,3205,781,2424,17,135,8,9
52340,49985,443,2510,443,10737,3664,7073,20,137,10,10
52341,51413,443,55199,443,695,575,120,4,6,2,2
52342,58166,53,23423,53,224,94,130,2,30,1,1
52343,63950,443,48115,443,5844,2360,3484,25,127,12,13
52344,26791,443,23053,443,21391,16334,5057,38,20,21,17
52345,45567,443,10380,443,1473,988,485,12,25,7,5
52346,49791,53,7553,53,216,94,122,2,30,1,1
52347,64952,53,2309,53,232,94,138,2,30,1,1
52348,62061,53,49325,53,181,78,103,2,30,1,1
52349,49612,53,33123,53,234,94,140,2,31,1,1
52350,34758,5228,2453,5228,10206,2218,7988,36,4265,18,18
52351,50973,443,10208,443,9525,6135,3390,24,120,13,11
52352,51438,443,45079,443,42419,28515,13904,108,246,53,55
52353,64668,53,24152,53,211,102,109,2,30,1,1
52354,44691,53,43758,53,199,94,105,2,30,1,1
52355,1528,53,1528,53,193,90,103,2,30,1,1
52356,63679,443,51267,443,7987,2092,5895,18,119,8,10
52357,47673,443,27427,443,10372,4341,6031,28,319,15,13
52358,29744,53,29744,53,235,90,145,2,33,1,1
52359,57602,80,57602,80,4226,2910,1316,19,38,10,9
52360,64990,53,21080,53,323,94,229,2,30,1,1
52361,65372,53,52621,53,330,91,239,4,44,2,2
52362,54983,443,42126,443,865636,22536,843100,903,50,309,594
52363,36010,443,44715,443,5689,1505,4184,24,19,13,11
52364,55188,443,45668,443,6649,1556,5093,23,24,13,10
52365,57464,80,18705,80,78,78,0,1,5,1,0
52366,49898,443,53027,443,44110,4769,39341,90,108,46,44
52367,51072,80,39928,80,1299,793,506,12,16,6,6
52368,53532,445,0,0,70,70,0,1,0,1,0
52369,1030,44847,0,0,62,62,0,1,0,1,0
52370,46679,64147,0,0,62,62,0,1,0,1,0
52371,48676,53398,0,0,60,60,0,1,0,1,0
52372,62152,56205,0,0,66,66,0,1,0,1,0
52373,55032,62413,0,0,66,66,0,1,0,1,0
52374,53910,445,0,0,66,66,0,1,0,1,0
52375,16697,64147,0,0,145,145,0,1,0,1,0
52376,12537,28816,0,0,145,145,0,1,0,1,0
52377,53531,445,0,0,70,70,0,1,0,1,0
52378,58495,445,0,0,70,70,0,1,0,1,0
52379,22724,9822,0,0,62,62,0,1,0,1,0
52380,34897,50584,0,0,62,62,0,1,0,1,0
52381,22683,39210,0,0,60,60,0,1,0,1,0
52382,50280,57470,0,0,78,78,0,1,0,1,0
52383,53907,445,0,0,66,66,0,1,0,1,0
52384,1866,51505,0,0,66,66,0,1,0,1,0
52385,57676,64147,0,0,74,74,0,1,0,1,0
52386,53526,445,0,0,70,70,0,1,0,1,0
52387,62337,44847,0,0,66,66,0,1,0,1,0
52388,53901,445,0,0,66,66,0,1,0,1,0
52389,61912,17546,0,0,62,62,0,1,0,1,0
52390,50369,50584,0,0,66,66,0,1,0,1,0
52391,53897,445,0,0,66,66,0,1,0,1,0
52392,63263,57470,0,0,66,66,0,1,0,1,0
52393,1024,57470,0,0,62,62,0,1,0,1,0
52394,443,11266,0,0,124,124,0,1,0,1,0
52395,37008,42707,0,0,62,62,0,1,0,1,0
52396,51909,6881,0,0,66,66,0,1,0,1,0
52397,57289,31573,0,0,66,66,0,1,0,1,0
52398,40500,5618,0,0,146,146,0,1,0,1,0
52399,53513,445,0,0,70,70,0,1,0,1,0
52400,58481,445,0,0,70,70,0,1,0,1,0
52401,58477,445,0,0,70,70,0,1,0,1,0
52402,58478,445,0,0,70,70,0,1,0,1,0
52403,50360,35440,0,0,66,66,0,1,0,1,0
52404,53881,445,0,0,66,66,0,1,0,1,0
52405,53884,445,0,0,66,66,0,1,0,1,0
52406,53878,445,0,0,66,66,0,1,0,1,0
52407,53880,445,0,0,66,66,0,1,0,1,0
52408,53882,445,0,0,66,66,0,1,0,1,0
52409,53883,445,0,0,66,66,0,1,0,1,0
52410,53877,445,0,0,66,66,0,1,0,1,0
52411,53879,445,0,0,66,66,0,1,0,1,0
52412,5729,22114,0,0,66,66,0,1,0,1,0
52413,14070,62413,0,0,66,66,0,1,0,1,0
52414,53510,445,0,0,70,70,0,1,0,1,0
52415,17643,50584,0,0,146,146,0,1,0,1,0
52416,58470,445,0,0,70,70,0,1,0,1,0
52417,58468,445,0,0,70,70,0,1,0,1,0
52418,58464,445,0,0,70,70,0,1,0,1,0
52419,53505,445,0,0,70,70,0,1,0,1,0
52420,21534,42246,0,0,66,66,0,1,0,1,0
52421,53504,445,0,0,70,70,0,1,0,1,0
52422,28124,8497,0,0,148,148,0,1,0,1,0
52423,53864,445,0,0,66,66,0,1,0,1,0
52424,53865,445,0,0,66,66,0,1,0,1,0
52425,53862,445,0,0,66,66,0,1,0,1,0
52426,30109,5223,0,0,148,148,0,1,0,1,0
52427,53502,445,0,0,70,70,0,1,0,1,0
52428,443,48120,0,0,97,97,0,1,0,1,0
52429,5223,44091,0,0,220,220,0,1,0,1,0
52430,53105,42707,0,0,66,66,0,1,0,1,0
52431,6712,161,0,0,82,82,0,1,0,1,0
52432,58459,445,0,0,70,70,0,1,0,1,0
52433,80,5101,0,0,78,78,0,1,0,1,0
52434,45410,1,0,0,62,62,0,1,0,1,0
52435,58457,445,0,0,70,70,0,1,0,1,0
52436,49485,11392,0,0,66,66,0,1,0,1,0
52437,58447,445,0,0,70,70,0,1,0,1,0
52438,58449,445,0,0,70,70,0,1,0,1,0
52439,58445,445,0,0,70,70,0,1,0,1,0
52440,64379,37965,0,0,66,66,0,1,0,1,0
52441,45060,37965,0,0,62,62,0,1,0,1,0
52442,53495,445,0,0,70,70,0,1,0,1,0
52443,27446,30188,0,0,66,66,0,1,0,1,0
52444,53493,445,0,0,70,70,0,1,0,1,0
52445,28221,37965,0,0,62,62,0,1,0,1,0
52446,58681,36829,0,0,74,74,0,1,0,1,0
52447,63998,21247,0,0,66,66,0,1,0,1,0
52448,53779,37965,0,0,66,66,0,1,0,1,0
52449,40959,61903,0,0,145,145,0,1,0,1,0
52450,53492,445,0,0,70,70,0,1,0,1,0
52451,53491,445,0,0,70,70,0,1,0,1,0
52452,53490,445,0,0,70,70,0,1,0,1,0
52453,53487,445,0,0,70,70,0,1,0,1,0
52454,53488,445,0,0,70,70,0,1,0,1,0
52455,1660,8696,0,0,62,62,0,1,0,1,0
52456,56946,1,0,0,66,66,0,1,0,1,0
52457,28345,11392,0,0,66,66,0,1,0,1,0
52458,58440,445,0,0,70,70,0,1,0,1,0
52459,58438,445,0,0,70,70,0,1,0,1,0
52460,58435,445,0,0,70,70,0,1,0,1,0
52461,13285,29892,0,0,145,145,0,1,0,1,0
52462,29021,23,0,0,60,60,0,1,0,1,0
52463,57131,7774,0,0,145,145,0,1,0,1,0
52464,1092,57470,0,0,145,145,0,1,0,1,0
52465,14352,8055,0,0,148,148,0,1,0,1,0
52466,53472,445,0,0,70,70,0,1,0,1,0
52467,53470,445,0,0,70,70,0,1,0,1,0
52468,53466,445,0,0,70,70,0,1,0,1,0
52469,57982,64147,0,0,66,66,0,1,0,1,0
52470,53462,445,0,0,70,70,0,1,0,1,0
52471,53461,445,0,0,70,70,0,1,0,1,0
52472,65153,38303,0,0,62,62,0,1,0,1,0
52473,16330,50584,0,0,146,146,0,1,0,1,0
52474,57431,15503,0,0,66,66,0,1,0,1,0
52475,2697,28189,0,0,60,60,0,1,0,1,0
52476,43129,15503,0,0,62,62,0,1,0,1,0
52477,53841,445,0,0,66,66,0,1,0,1,0
52478,58432,445,0,0,70,70,0,1,0,1,0
52479,58430,445,0,0,70,70,0,1,0,1,0
52480,54188,6004,0,0,78,78,0,1,0,1,0
52481,60627,51050,0,0,66,66,0,1,0,1,0
52482,443,64347,0,0,131,131,0,1,0,1,0
52483,59136,50584,0,0,62,62,0,1,0,1,0
52484,53450,445,0,0,70,70,0,1,0,1,0
52485,13441,57470,0,0,62,62,0,1,0,1,0
52486,12471,48817,0,0,62,62,0,1,0,1,0
52487,61736,50584,0,0,66,66,0,1,0,1,0
52488,53835,445,0,0,66,66,0,1,0,1,0
52489,50227,57470,0,0,66,66,0,1,0,1,0
52490,10115,52700,0,0,62,62,0,1,0,1,0
52491,19875,30170,0,0,145,145,0,1,0,1,0
52492,53833,445,0,0,66,66,0,1,0,1,0
52493,42732,57470,0,0,62,62,0,1,0,1,0
52494,58419,445,0,0,70,70,0,1,0,1,0
52495,26528,51221,0,0,78,78,0,1,0,1,0
52496,58416,445,0,0,70,70,0,1,0,1,0
52497,58409,445,0,0,70,70,0,1,0,1,0
52498,58411,445,0,0,70,70,0,1,0,1,0
52499,57545,35440,0,0,66,66,0,1,0,1,0
52500,53829,445,0,0,66,66,0,1,0,1,0
52501,46495,4607,0,0,60,60,0,1,0,1,0
52502,53446,445,0,0,70,70,0,1,0,1,0
52503,10079,443,27678,443,7122,1766,5356,27,331,14,13
52504,59486,80,62432,80,2633,1151,1482,10,32,6,4
52505,47423,80,58553,80,1056,682,374,10,15,6,4
52506,40765,443,6306,443,1093,662,431,10,41,6,4
52507,58446,443,26245,443,111535,9830,101705,141,192,62,79
52508,52405,443,59113,443,10506,2063,8443,31,46,17,14
52509,59082,443,59082,443,6264,1435,4829,21,15,11,10
52510,51803,33973,12809,33973,70,70,0,2,8,2,0
52511,51519,443,51519,443,8680,2323,6357,31,173,13,18
52512,51516,443,51516,443,143921,6996,136925,152,174,42,110
52513,35078,53,22216,53,198,93,105,2,30,1,1
52514,38334,443,30322,443,1864,250,1614,8,121,4,4
52515,27005,27016,44876,27016,887,126,761,2,30,1,1
52516,2946,53,2946,53,240,96,144,2,30,1,1
52517,58151,443,48543,443,6563,1656,4907,22,318,13,9
52518,41597,53,41597,53,213,79,134,2,32,1,1
52519,44933,443,37036,443,8958,1683,7275,24,23,10,14
52520,40766,443,50985,443,1093,662,431,10,41,6,4
52521,61667,80,57155,80,21567,1666,19901,35,46,18,17
52522,5631,80,5631,80,16287,756,15531,23,16,9,14
52523,37661,53,37661,53,237,91,146,2,32,1,1
52524,12934,53,12934,53,237,91,146,2,33,1,1
52525,46785,53,46785,53,230,91,139,2,30,1,1
52526,51410,443,38178,443,13187,6736,6451,22,55,12,10
52527,49914,443,10717,443,10915,2554,8361,33,270,17,16
52528,27005,27019,28419,27019,880,126,754,2,30,1,1
52529,52108,443,27930,443,18735,3452,15283,42,52,22,20
52530,53615,867,16773,867,70,70,0,2,7,2,0
52531,13749,53,13749,53,237,91,146,2,32,1,1
52532,43563,80,9467,80,10597,2910,7687,24,47,14,10
52533,45334,443,8591,443,8798,1667,7131,25,22,14,11
52534,51203,443,62126,443,5737,1829,3908,22,18,13,9
52535,53616,44166,16410,44166,70,70,0,2,7,2,0
52536,65460,80,65460,80,48356,4069,44287,55,48,19,36
52537,65315,53,36671,53,300,99,201,4,30,2,2
52538,65315,53,56097,53,216,110,106,2,30,1,1
52539,60511,443,60511,443,4658,1751,2907,19,30,11,8
52540,57605,80,57605,80,36471,5174,31297,57,38,23,34
52541,57604,80,57604,80,16101,4026,12075,35,38,16,19
52542,57601,80,57601,80,25872,4400,21472,41,38,16,25
52543,57819,443,40837,443,6161,925,5236,18,28,10,8
52544,53611,58508,47899,58508,320,140,180,6,7,3,3
52545,62820,53,62820,53,237,91,146,2,33,1,1
52546,38364,15000,10224,15000,130,70,60,2,5,1,1
52547,35481,443,52517,443,6804,1473,5331,33,258,15,18
52548,54235,443,28529,443,4665,2167,2498,23,16,12,11
52549,9786,53,9786,53,230,91,139,2,30,1,1
52550,44823,53,0,0,82,82,0,1,30,1,0
52551,56351,53,9188,53,190,97,93,2,30,1,1
52552,60750,53,24428,53,198,93,105,2,30,1,1
52553,49751,53,48975,53,232,92,140,2,30,1,1
52554,51407,443,24262,443,22626,10213,12413,35,57,20,15
52555,17295,18242,0,0,66,66,0,1,90,1,0
52556,56274,443,23756,443,3093,868,2225,10,120,5,5
52557,34756,443,27102,443,100090,8304,91786,135,127,50,85
52558,50803,443,27237,443,25297,10467,14830,51,362,27,24
52559,64609,53,57916,53,146,75,71,2,31,1,1
52560,60039,53,37317,53,312,82,230,2,31,1,1
52561,38501,53,38501,53,233,91,142,2,31,1,1
52562,50435,80,14382,80,672,70,602,11,392,2,9
52563,50706,443,45520,443,13948,10445,3503,25,121,14,11
52564,30960,45694,42221,45694,330,330,0,6,3610,6,0
52565,34910,443,51247,443,18452,11429,7023,39,64,23,16
52566,47605,443,46505,443,12572,3471,9101,34,363,14,20
52567,9849,53,9849,53,219,87,132,2,31,1,1
52568,27005,27018,47282,27018,891,126,765,2,31,1,1
52569,27005,27017,53290,27017,881,126,755,2,31,1,1
52570,37330,53,37330,53,237,91,146,2,31,1,1
52571,57470,61803,17706,61803,792,792,0,13,1200,13,0
52572,10151,55051,56267,55051,468,149,319,2,1200,1,1
52573,51582,48817,0,0,66,66,0,1,0,1,0
52574,18357,51180,0,0,62,62,0,1,0,1,0
52575,34553,48637,0,0,60,60,0,1,0,1,0
52576,59481,41182,0,0,62,62,0,1,0,1,0
52577,53436,445,0,0,70,70,0,1,0,1,0
52578,53437,445,0,0,70,70,0,1,0,1,0
52579,53676,35974,0,0,60,60,0,1,0,1,0
52580,34677,51185,0,0,60,60,0,1,0,1,0
52581,58404,445,0,0,70,70,0,1,0,1,0
52582,53431,445,0,0,70,70,0,1,0,1,0
52583,53433,445,0,0,70,70,0,1,0,1,0
52584,11133,51505,0,0,66,66,0,1,0,1,0
52585,58402,445,0,0,70,70,0,1,0,1,0
52586,58401,445,0,0,70,70,0,1,0,1,0
52587,58398,445,0,0,70,70,0,1,0,1,0
52588,60480,57470,0,0,62,62,0,1,0,1,0
52589,53429,445,0,0,70,70,0,1,0,1,0
52590,9605,57470,0,0,62,62,0,1,0,1,0
52591,53823,445,0,0,66,66,0,1,0,1,0
52592,53650,64147,0,0,66,66,0,1,0,1,0
52593,53819,445,0,0,66,66,0,1,0,1,0
52594,53818,445,0,0,66,66,0,1,0,1,0
52595,53816,445,0,0,66,66,0,1,0,1,0
52596,3578,51505,0,0,66,66,0,1,0,1,0
52597,42379,443,23086,443,6598,1506,5092,22,305,12,10
52598,27005,27015,63716,27015,889,126,763,2,30,1,1
52599,63782,6969,48433,6969,70,70,0,1,5,1,0
52600,57603,80,57603,80,4373,2985,1388,21,37,11,10
52601,53118,56839,2314,56839,70,70,0,1,4,1,0
52602,49156,53,13189,53,199,94,105,2,29,1,1
52603,65234,5228,52749,5228,4149,2263,1886,46,708,23,23
52604,63996,53,49603,53,252,102,150,2,30,1,1
52605,47046,80,21371,80,1114,534,580,12,15,7,5
52606,57906,443,24320,443,2725,1564,1161,19,124,10,9
52607,60001,443,64771,443,10580,2487,8093,28,16,16,12
52608,57908,443,7958,443,1648,1017,631,18,124,10,8
52609,49916,443,14101,443,2970,1793,1177,20,15,12,8
52610,57139,443,39822,443,2162,1317,845,16,25,9,7
52611,57907,443,20224,443,1584,953,631,17,124,9,8
52612,41508,53,41508,53,244,98,146,2,32,1,1
52613,56351,53,4846,53,195,102,93,2,32,1,1
52614,57268,443,5467,443,1617,1073,544,16,15,9,7
52615,3591,53,3591,53,235,90,145,2,32,1,1
52616,50386,443,59778,443,1346,918,428,10,26,6,4
52617,33171,443,48753,443,6509,973,5536,17,25,10,7
52618,63793,48970,37925,48970,66,66,0,2,7,2,0
52619,53596,56732,3415,56732,70,70,0,1,4,1,0
52620,15164,53,15164,53,217,82,135,2,31,1,1
52621,53619,11513,10996,11513,320,140,180,6,6,3,3
52622,63463,53,56932,53,199,86,113,2,29,1,1
52623,51786,37832,29443,37832,70,70,0,1,5,1,0
52624,49708,53,19621,53,212,94,118,2,29,1,1
52625,49340,53,43709,53,94,94,0,1,30,1,0
52626,6881,33969,15980,33969,509,150,359,2,1200,1,1
52627,27005,27015,12555,27015,887,126,761,2,30,1,1
52628,27005,27017,49070,27017,883,126,757,2,30,1,1
52629,60900,53,31593,53,181,86,95,2,30,1,1
52630,51521,443,51521,443,138679,4142,134537,141,173,33,108
52631,51518,443,51518,443,15967,3046,12921,39,173,15,24
52632,60403,60092,40292,60092,70,70,0,1,5,1,0
52633,38759,443,24886,443,7878,1531,6347,36,257,16,20
52634,54984,443,11572,443,68519,3801,64718,93,31,40,53
52635,54979,443,32141,443,643217,29500,613717,787,53,338,449
52636,53788,53,27955,53,213,78,135,2,30,1,1
52637,61167,443,24525,443,27000,11646,15354,176,640,82,94
52638,27005,52013,16949,52013,901,126,775,2,30,1,1
52639,55921,443,55921,443,4510,1603,2907,19,27,11,8
52640,27005,27015,11118,27015,881,126,755,2,30,1,1
52641,38119,443,46487,443,1820,1101,719,18,16,10,8
52642,57253,443,15843,443,8613,2377,6236,41,17,23,18
52643,55826,53,63992,53,168,86,82,2,30,1,1
52644,6754,443,21695,443,13520,2288,11232,43,192,19,24
52645,51520,443,51520,443,53075,3609,49466,74,173,25,49
52646,64872,53,23783,53,323,94,229,2,30,1,1
52647,49915,443,34488,443,7648,2967,4681,23,15,13,10
52648,51573,53,28199,53,212,86,126,2,30,1,1
52649,27005,27018,42119,27018,881,126,755,2,30,1,1
52650,27005,27015,38522,27015,878,126,752,2,30,1,1
52651,2745,53,2745,53,244,98,146,2,32,1,1
52652,58610,53,58610,53,244,98,146,2,32,1,1
52653,56708,443,38081,443,9634,3110,6524,26,138,11,15
52654,40799,443,51690,443,21024,14637,6387,46,271,26,20
52655,63230,443,3094,443,1309,670,639,16,127,9,7
52656,51804,31012,6657,31012,70,70,0,2,8,2,0
52657,55616,42929,13566,42929,70,70,0,1,5,1,0
52658,61347,443,30207,443,5589,2260,3329,36,217,17,19
52659,45455,443,59423,443,17237,2632,14605,34,420,18,16
52660,63224,443,7611,443,1373,734,639,17,155,10,7
52661,57807,80,6054,80,1013,566,447,8,162,5,3
52662,57421,80,60577,80,4507,2978,1529,13,15,6,7
52663,50017,80,11643,80,827,687,140,6,32,4,2
52664,53586,44515,38182,44515,678,432,246,10,15,6,4
52665,36762,443,46444,443,560,280,280,9,25,5,4
52666,53592,23578,9676,23578,70,70,0,1,4,1,0
52667,51805,15298,11456,15298,70,70,0,2,8,2,0
52668,57606,80,57606,80,11536,3264,8272,29,37,15,14
52669,57909,443,27742,443,2653,1558,1095,18,124,10,8
52670,57590,443,26107,443,2614,1689,925,18,19,10,8
52671,49324,443,52610,443,6147,943,5204,17,16,9,8
52672,5588,5588,0,0,3354,1792,1562,46,194,23,23
52673,38285,443,16953,443,6872,1815,5057,22,318,13,9
52674,49377,443,17002,443,11627,4670,6957,37,155,16,21
52675,62049,443,63135,443,9526,1375,8151,24,125,12,12
52676,65043,53,7870,53,213,94,119,2,29,1,1
52677,44125,5222,56837,5222,6329,3447,2882,67,841,34,33
52678,60229,443,63035,443,8297,1280,7017,15,135,7,8
52679,57343,53,10133,53,214,86,128,2,29,1,1
52680,61879,53,34841,53,207,86,121,2,29,1,1
52681,65219,53,25255,53,229,102,127,2,29,1,1
52682,27005,27015,11891,27015,885,126,759,2,30,1,1
52683,8892,443,11185,443,8106,1626,6480,31,341,11,20
52684,53629,443,53629,443,4620,1713,2907,19,30,11,8
52685,51517,443,51517,443,153968,7663,146305,170,173,43,127
52686,55826,53,27290,53,86,86,0,2,34,2,0
52687,51785,33253,63010,33253,70,70,0,1,5,1,0
52688,65315,53,22076,53,216,110,106,2,30,1,1
52689,53581,12169,27472,12169,492,306,186,8,15,5,3
52690,62705,443,33676,443,178,118,60,2,15,1,1
52691,56007,53,0,0,86,86,0,1,30,1,0
52692,65315,53,30606,53,216,110,106,2,30,1,1
52693,65394,53,54686,53,230,94,136,2,30,1,1
52694,32299,40014,29367,40014,280,182,98,2,30,1,1
52695,44059,53,51061,53,199,94,105,2,30,1,1
52696,53585,43611,54963,43611,612,306,306,10,15,5,5
52697,62050,443,9772,443,2139,1140,999,15,124,9,6
52698,19629,53,19629,53,244,98,146,2,33,1,1
52699,50116,22,50116,22,66,66,0,1,5,1,0
52700,56807,18177,32535,18177,70,70,0,1,5,1,0
52701,51648,80,37574,80,974005,25912,948093,1003,32,361,642
52702,34527,443,29221,443,480624,56231,424393,860,196,427,433
52703,64755,53,11546,53,339,134,205,2,30,1,1
52704,55252,53,15058,53,212,102,110,2,30,1,1
52705,52784,443,37799,443,16022,3217,12805,25,138,11,14
52706,55966,443,15279,443,9006,2048,6958,36,121,18,18
52707,52403,443,54910,443,8811,3668,5143,26,126,13,13
52708,52170,443,6811,443,11716,7393,4323,47,146,21,26
52709,65157,53,24624,53,209,102,107,2,31,1,1
52710,56667,53,23608,53,168,86,82,2,31,1,1
52711,42309,443,23092,443,7295,1469,5826,30,360,9,21
52712,49815,443,13935,443,8614049,176366,8437683,7757,202,1608,6149
52713,62470,443,10717,443,38402253,1191239,37211014,39088,243,12126,26962
52714,58439,443,54279,443,2659,1417,1242,19,276,9,10
52715,57470,31112,14070,31112,132,132,0,3,1199,3,0
52716,57470,41315,64435,41315,792,792,0,13,1199,13,0
52717,6881,12388,2664,12388,216,118,98,2,1199,1,1
52718,33434,5228,15468,5228,12979,2808,10171,46,648,21,25
52719,6881,7005,9518,7005,118,118,0,1,1200,1,0
52720,63228,443,36281,443,3749,2597,1152,25,134,15,10
52721,60754,40010,30483,40010,316,136,180,6,6,3,3
52722,2138,53,2138,53,235,90,145,2,34,1,1
52723,34873,443,26122,443,236097,12185,223912,307,32,125,182
52724,36793,80,35918,80,156726,8626,148100,206,32,104,102
52725,36789,80,36658,80,129896,7448,122448,172,32,87,85
52726,58415,443,33034,443,560,280,280,9,30,5,4
52727,56934,80,1586,80,486,280,206,8,26,5,3
52728,26177,53,26177,53,220,90,130,2,30,1,1
52729,63963,53,44790,53,212,102,110,2,30,1,1
52730,63225,443,50090,443,4882,2412,2470,32,155,16,16
52731,53618,1025,19237,1025,320,140,180,6,7,3,3
52732,36792,80,39617,80,152694,8416,144278,200,32,101,99
52733,49923,53,15331,53,199,94,105,2,30,1,1
52734,53787,53,59844,53,224,86,138,2,30,1,1
52735,64255,53,2166,53,332,102,230,2,30,1,1
52736,56443,53,9982,53,168,86,82,2,31,1,1
52737,63233,443,64284,443,1373,734,639,17,125,10,7
52738,63229,443,6765,443,1373,734,639,17,134,10,7
52739,53607,51631,7980,51631,70,70,0,2,8,2,0
52740,56933,80,47498,80,486,280,206,8,26,5,3
52741,51173,443,13645,443,13772,1738,12034,26,31,12,14
52742,65153,53,10346,53,241,118,123,2,30,1,1
52743,53813,445,0,0,66,66,0,1,0,1,0
52744,53814,445,0,0,66,66,0,1,0,1,0
52745,53811,445,0,0,66,66,0,1,0,1,0
52746,9246,35440,0,0,62,62,0,1,0,1,0
52747,62386,37965,0,0,66,66,0,1,0,1,0
52748,11464,37965,0,0,62,62,0,1,0,1,0
52749,57860,51505,0,0,66,66,0,1,0,1,0
52750,7931,30170,0,0,146,146,0,1,0,1,0
52751,53423,445,0,0,70,70,0,1,0,1,0
52752,58397,445,0,0,70,70,0,1,0,1,0
52753,58395,445,0,0,70,70,0,1,0,1,0
52754,58393,445,0,0,70,70,0,1,0,1,0
52755,17009,53733,0,0,62,62,0,1,0,1,0
52756,53809,445,0,0,66,66,0,1,0,1,0
52757,51010,22114,0,0,146,146,0,1,0,1,0
52758,58389,445,0,0,70,70,0,1,0,1,0
52759,43260,41615,0,0,145,145,0,1,0,1,0
52760,57789,30188,0,0,62,62,0,1,0,1,0
52761,49174,50584,0,0,146,146,0,1,0,1,0
52762,53806,445,0,0,66,66,0,1,0,1,0
52763,53804,445,0,0,66,66,0,1,0,1,0
52764,53803,445,0,0,66,66,0,1,0,1,0
52765,6881,6881,0,0,146,146,0,1,0,1,0
52766,53800,445,0,0,66,66,0,1,0,1,0
52767,53416,445,0,0,70,70,0,1,0,1,0
52768,53415,445,0,0,70,70,0,1,0,1,0
52769,61808,18375,0,0,66,66,0,1,0,1,0
52770,2323,23117,0,0,62,62,0,1,0,1,0
52771,58382,445,0,0,70,70,0,1,0,1,0
52772,22587,30188,0,0,62,62,0,1,0,1,0
52773,32071,51221,0,0,66,66,0,1,0,1,0
52774,53409,445,0,0,70,70,0,1,0,1,0
52775,58376,445,0,0,70,70,0,1,0,1,0
52776,58374,445,0,0,70,70,0,1,0,1,0
52777,53408,445,0,0,70,70,0,1,0,1,0
52778,59696,57470,0,0,62,62,0,1,0,1,0
52779,50280,57470,0,0,78,78,0,1,0,1,0
52780,48676,53395,0,0,60,60,0,1,0,1,0
52781,53790,445,0,0,66,66,0,1,0,1,0
52782,52064,22114,0,0,66,66,0,1,0,1,0
52783,53404,445,0,0,70,70,0,1,0,1,0
52784,36586,5900,0,0,60,60,0,1,0,1,0
52785,59745,53635,0,0,66,66,0,1,0,1,0
52786,47910,7461,0,0,60,60,0,1,0,1,0
52787,53403,445,0,0,70,70,0,1,0,1,0
52788,13943,22,0,0,60,60,0,1,0,1,0
52789,53782,445,0,0,66,66,0,1,0,1,0
52790,58361,445,0,0,70,70,0,1,0,1,0
52791,30765,56205,0,0,66,66,0,1,0,1,0
52792,59781,56205,0,0,66,66,0,1,0,1,0
52793,56307,52700,0,0,66,66,0,1,0,1,0
52794,53779,445,0,0,66,66,0,1,0,1,0
52795,53398,445,0,0,70,70,0,1,0,1,0
52796,7308,50584,0,0,62,62,0,1,0,1,0
52797,60602,15503,0,0,66,66,0,1,0,1,0
52798,53928,15503,0,0,62,62,0,1,0,1,0
52799,51996,35440,0,0,66,66,0,1,0,1,0
52800,58305,51180,0,0,66,66,0,1,0,1,0
52801,53773,445,0,0,66,66,0,1,0,1,0
52802,12530,35440,0,0,62,62,0,1,0,1,0
52803,53768,445,0,0,66,66,0,1,0,1,0
52804,6416,22114,0,0,66,66,0,1,0,1,0
52805,26400,44847,0,0,146,146,0,1,0,1,0
52806,31112,50584,0,0,62,62,0,1,0,1,0
52807,60196,53,0,0,88,88,0,1,0,1,0
52808,17581,23,0,0,60,60,0,1,0,1,0
52809,42898,43890,0,0,62,62,0,1,0,1,0
52810,53385,445,0,0,70,70,0,1,0,1,0
52811,59378,50584,0,0,62,62,0,1,0,1,0
52812,6666,2222,0,0,60,60,0,1,0,1,0
52813,24534,50584,0,0,146,146,0,1,0,1,0
52814,58352,445,0,0,70,70,0,1,0,1,0
52815,58350,445,0,0,70,70,0,1,0,1,0
52816,58349,445,0,0,70,70,0,1,0,1,0
52817,53754,445,0,0,66,66,0,1,0,1,0
52818,53757,445,0,0,66,66,0,1,0,1,0
52819,53755,445,0,0,66,66,0,1,0,1,0
52820,53756,445,0,0,66,66,0,1,0,1,0
52821,53753,445,0,0,66,66,0,1,0,1,0
52822,53751,445,0,0,66,66,0,1,0,1,0
52823,53752,445,0,0,66,66,0,1,0,1,0
52824,53749,445,0,0,66,66,0,1,0,1,0
52825,53382,445,0,0,70,70,0,1,0,1,0
52826,65250,22114,0,0,62,62,0,1,0,1,0
52827,54155,64147,0,0,66,66,0,1,0,1,0
52828,52431,50265,0,0,62,62,0,1,0,1,0
52829,52973,23,0,0,60,60,0,1,0,1,0
52830,44121,23,0,0,60,60,0,1,0,1,0
52831,22357,6004,0,0,62,62,0,1,0,1,0
52832,63547,37965,0,0,66,66,0,1,0,1,0
52833,52741,24211,0,0,66,66,0,1,0,1,0
52834,26084,36237,0,0,66,66,0,1,0,1,0
52835,53377,445,0,0,70,70,0,1,0,1,0
52836,53376,445,0,0,70,70,0,1,0,1,0
52837,15530,49718,0,0,146,146,0,1,0,1,0
52838,58348,445,0,0,70,70,0,1,0,1,0
52839,58342,445,0,0,70,70,0,1,0,1,0
52840,58339,445,0,0,70,70,0,1,0,1,0
52841,53374,445,0,0,70,70,0,1,0,1,0
52842,57339,50584,0,0,66,66,0,1,0,1,0
52843,53737,445,0,0,66,66,0,1,0,1,0
52844,53736,445,0,0,66,66,0,1,0,1,0
52845,53734,445,0,0,66,66,0,1,0,1,0
52846,61701,44847,0,0,66,66,0,1,0,1,0
52847,58331,445,0,0,70,70,0,1,0,1,0
52848,8999,57470,0,0,146,146,0,1,0,1,0
52849,51725,56205,0,0,62,62,0,1,0,1,0
52850,58330,445,0,0,70,70,0,1,0,1,0
52851,55255,37965,0,0,146,146,0,1,0,1,0
52852,58327,445,0,0,70,70,0,1,0,1,0
52853,58328,445,0,0,70,70,0,1,0,1,0
52854,58321,445,0,0,70,70,0,1,0,1,0
52855,46478,64147,0,0,62,62,0,1,0,1,0
52856,53367,445,0,0,70,70,0,1,0,1,0
52857,0,0,0,0,98,98,0,1,0,1,0
52858,0,0,0,0,98,98,0,1,0,1,0
52859,0,0,0,0,98,98,0,1,0,1,0
52860,0,0,0,0,98,98,0,1,0,1,0
52861,0,0,0,0,134,64,70,2,0,1,1
52862,53365,445,0,0,70,70,0,1,0,1,0
52863,49690,50265,0,0,66,66,0,1,0,1,0
52864,61457,21247,0,0,66,66,0,1,0,1,0
52865,36908,26467,0,0,62,62,0,1,0,1,0
52866,53364,445,0,0,70,70,0,1,0,1,0
52867,51192,15503,0,0,66,66,0,1,0,1,0
52868,53363,445,0,0,70,70,0,1,0,1,0
52869,51413,25864,0,0,72,72,0,1,0,1,0
52870,53362,445,0,0,70,70,0,1,0,1,0
52871,53357,445,0,0,70,70,0,1,0,1,0
52872,53356,445,0,0,70,70,0,1,0,1,0
52873,51674,51505,0,0,66,66,0,1,0,1,0
52874,2697,28189,0,0,60,60,0,1,0,1,0
52875,26799,50584,0,0,62,62,0,1,0,1,0
52876,52103,53733,0,0,62,62,0,1,0,1,0
52877,58312,445,0,0,70,70,0,1,0,1,0
52878,58311,445,0,0,70,70,0,1,0,1,0
52879,58307,445,0,0,70,70,0,1,0,1,0
52880,53344,445,0,0,70,70,0,1,0,1,0
52881,53343,445,0,0,70,70,0,1,0,1,0
52882,53341,445,0,0,70,70,0,1,0,1,0
52883,53334,445,0,0,70,70,0,1,0,1,0
52884,53333,445,0,0,70,70,0,1,0,1,0
52885,61520,23718,0,0,66,66,0,1,0,1,0
52886,58396,22114,0,0,66,66,0,1,0,1,0
52887,27147,22114,0,0,62,62,0,1,0,1,0
52888,50027,21247,0,0,66,66,0,1,0,1,0
52889,54109,36829,0,0,66,66,0,1,0,1,0
52890,56119,46824,0,0,62,62,0,1,0,1,0
52891,53714,445,0,0,66,66,0,1,0,1,0
52892,58298,445,0,0,70,70,0,1,0,1,0
52893,58295,445,0,0,70,70,0,1,0,1,0
52894,52076,44847,0,0,66,66,0,1,0,1,0
52895,53322,445,0,0,70,70,0,1,0,1,0
52896,50804,1,0,0,62,62,0,1,0,1,0
52897,34553,48637,0,0,60,60,0,1,0,1,0
52898,4041,23,0,0,60,60,0,1,0,1,0
52899,43600,443,57317,443,172272,14401,157871,254,418,100,154
52900,54501,80,17667,80,254,128,126,5,16,3,2
52901,53899,443,60991,443,21288,10113,11175,107,31,51,56
52902,49468,443,51693,443,6940,1302,5638,20,119,10,10
52903,56169,53,17161,53,916,86,830,2,30,1,1
52904,57236,53,14592,53,748,95,653,2,30,1,1
52905,52016,80,31831,80,19693,1957,17736,49,32,23,26
52906,58145,1433,58145,1433,60,60,0,2,5,2,0
52907,31362,23,31362,23,60,60,0,1,5,1,0
52908,53608,1024,52758,1024,70,70,0,2,8,2,0
52909,33570,443,59571,443,81954,13611,68343,174,34,79,95
52910,49469,443,50617,443,6416,1302,5114,20,119,10,10
52911,34038,5222,46652,5222,2853,1289,1564,30,1555,12,18
52912,51317,443,51634,443,59889,7472,52417,83,145,32,51
52913,53617,1056,21327,1056,320,140,180,6,6,3,3
52914,42566,443,31210,443,10127,4193,5934,30,24,17,13
52915,55030,80,10323,80,2954,671,2283,12,15,7,5
52916,49629,53,19594,53,916,86,830,2,30,1,1
52917,60464,53,0,0,180,82,98,2,30,1,1
52918,48906,80,50980,80,2544,1681,863,12,185,7,5
52919,39292,80,43537,80,1655,1341,314,10,16,5,5
52920,36839,80,35799,80,10345,6823,3522,25,25,14,11
52921,39804,443,42042,443,56980,4095,52885,90,256,37,53
52922,42510,53,42510,53,237,91,146,2,32,1,1
52923,53609,38060,12354,38060,70,70,0,2,8,2,0
52924,56805,1,17140,1,70,70,0,1,5,1,0
52925,51784,34568,52434,34568,66,66,0,1,5,1,0
52926,36497,80,36497,80,7594,863,6731,18,21,8,10
52927,50438,53,48155,53,295,101,194,4,31,2,2
52928,27005,27016,9043,27016,881,126,755,2,30,1,1
52929,27005,27015,8409,27015,897,126,771,2,30,1,1
52930,56103,443,24314,443,22293,16437,5856,51,30,27,24
52931,59312,443,40068,443,233778,8502,225276,276,34,109,167
52932,49737,443,48877,443,35419,29471,5948,42,31,27,15
52933,34990,80,36946,80,1534,996,538,10,35,6,4
52934,57022,80,30750,80,77115,5003,72112,110,35,56,54
52935,52014,80,24294,80,30427,2131,28296,66,32,25,41
52936,33568,443,55064,443,9180,2197,6983,36,34,20,16
52937,36823,80,35585,80,3335,2735,600,12,30,7,5
52938,57392,443,57392,443,4729,1822,2907,19,27,11,8
52939,33569,443,28286,443,9032,2162,6870,34,34,18,16
52940,64572,443,16176,443,24918,2042,22876,40,16,19,21
52941,35149,53,35149,53,235,90,145,2,32,1,1
52942,34424,443,13536,443,8277,2394,5883,31,316,16,15
52943,56443,53,2207,53,168,86,82,2,30,1,1
52944,56667,53,46013,53,168,86,82,2,30,1,1
52945,53150,80,13371,80,2398,2024,374,12,15,6,6
52946,33576,443,52498,443,170319,23354,146965,283,34,121,162
52947,46492,443,13641,443,11163,3642,7521,25,30,14,11
52948,36810,80,28528,80,18460,3166,15294,34,32,18,16
52949,52694,80,51604,80,1960,1366,594,12,34,7,5
52950,60936,443,44472,443,4621,3079,1542,24,52,13,11
52951,56102,443,1329,443,8577,3450,5127,23,30,13,10
52952,58993,443,16211,443,1437,736,701,15,28,7,8
52953,51908,443,56072,443,8481,1976,6505,23,25,13,10
52954,35501,53,35501,53,213,79,134,2,33,1,1
52955,51949,80,39415,80,5106,766,4340,16,45,9,7
52956,45204,53,45204,53,237,91,146,2,33,1,1
52957,35554,443,35554,443,4378,1471,2907,19,28,11,8
52958,62791,443,22999,443,17411,8921,8490,98,291,41,57
52959,53860,443,53373,443,8712,2293,6419,26,315,13,13
52960,11826,53,11826,53,237,91,146,2,33,1,1
52961,52018,80,20950,80,1660,791,869,11,32,6,5
52962,56202,53,30224,53,916,86,830,2,30,1,1
52963,55736,53,0,0,338,70,268,2,30,1,1
52964,47722,80,12273,80,1720,1406,314,10,15,5,5
52965,43473,53,43473,53,220,100,120,2,30,1,1
52966,55736,53,0,0,623,70,553,2,30,1,1
52967,34111,53,34111,53,213,87,126,2,30,1,1
52968,27005,27015,8429,27015,882,126,756,2,30,1,1
52969,26900,27017,21825,27017,422,164,258,6,31,3,3
52970,56940,443,47279,443,5147,2613,2534,19,137,10,9
52971,26900,27017,60597,27017,422,164,258,6,31,3,3
52972,5938,18721,0,0,60,60,0,1,91,1,0
52973,42820,443,51976,443,25721,8999,16722,38,121,18,20
52974,51282,443,3652,443,4933,2248,2685,14,135,7,7
52975,64971,53,0,0,229,85,144,2,31,1,1
52976,50226,443,45230,443,7726,4613,3113,21,137,11,10
52977,45538,5228,21561,5228,2372,1452,920,16,3600,8,8
52978,62737,64147,0,0,66,66,0,1,0,1,0
52979,65454,61600,0,0,66,66,0,1,0,1,0
52980,49677,64147,0,0,62,62,0,1,0,1,0
52981,53676,35974,0,0,60,60,0,1,0,1,0
52982,34677,51185,0,0,60,60,0,1,0,1,0
52983,54693,30188,0,0,66,66,0,1,0,1,0
52984,53770,64147,0,0,66,66,0,1,0,1,0
52985,53707,445,0,0,66,66,0,1,0,1,0
52986,1049,54369,0,0,62,62,0,1,0,1,0
52987,4447,35440,0,0,66,66,0,1,0,1,0
52988,53705,445,0,0,66,66,0,1,0,1,0
52989,10006,64147,0,0,62,62,0,1,0,1,0
52990,27005,27015,48748,27015,894,126,768,2,30,1,1
52991,63967,53,11149,53,195,102,93,2,30,1,1
52992,41051,443,30990,443,37711,4074,33637,69,32,31,38
52993,45254,443,27475,443,8328,2592,5736,35,34,18,17
52994,36776,80,31947,80,16274,9170,7104,34,32,19,15
52995,34883,443,14501,443,51393,3538,47855,70,30,29,41
52996,48067,443,48553,443,12648,5285,7363,58,32,27,31
52997,49466,443,64942,443,4562,2466,2096,20,119,11,9
52998,58361,443,12659,443,7297,2046,5251,22,29,13,9
52999,36790,80,59682,80,191737,8302,183435,205,31,79,126
53000,49672,80,61052,80,3874260,98179,3776081,4003,1072,1479,2524
53001,49464,443,43565,443,4555,2472,2083,20,119,11,9
53002,36791,80,9992,80,196328,10952,185376,244,31,117,127
53003,52415,443,32301,443,2007,1152,855,14,15,8,6
53004,37738,443,1957,443,6470,1931,4539,27,32,14,13
53005,43675,80,34710,80,1676620,41953,1634667,1725,25,636,1089
53006,36765,80,13699,80,2272,1679,593,10,34,6,4
53007,36533,443,27150,443,10488,4495,5993,38,32,20,18
53008,34710,53,34710,53,244,98,146,2,33,1,1
53009,49467,443,18409,443,4564,2466,2098,20,119,11,9
53010,46641,8100,13057,8100,78,78,0,1,4,1,0
53011,63235,443,19696,443,1373,734,639,17,96,10,7
53012,63779,12226,30689,12226,70,70,0,1,4,1,0
53013,53605,13468,23024,13468,70,70,0,2,7,2,0
53014,45540,8100,31556,8100,78,78,0,1,4,1,0
53015,49639,53,29692,53,250,102,148,2,29,1,1
53016,49924,443,9177,443,13502,2331,11171,42,194,19,23
53017,62888,53,62888,53,240,98,142,2,29,1,1
53018,34173,53,34173,53,240,98,142,2,29,1,1
53019,56667,53,25410,53,250,86,164,4,29,2,2
53020,49447,53,25197,53,248,102,146,2,29,1,1
53021,64073,53,51133,53,361,86,275,2,30,1,1
53022,55158,53,42446,53,239,102,137,2,30,1,1
53023,59607,443,14075,443,2150,1280,870,18,832,10,8
53024,56543,443,26469,443,245527,10641,234886,322,405,136,186
53025,56663,53,28501,53,215,102,113,2,30,1,1
53026,50097,53,57646,53,199,94,105,2,30,1,1
53027,56997,53,45686,53,168,86,82,2,30,1,1
53028,34469,53,59263,53,226,78,148,2,30,1,1
53029,37918,443,25153,443,6123,860,5263,18,361,9,9
53030,57427,53,45535,53,363,94,269,2,30,1,1
53031,53577,53,0,0,82,82,0,2,40,2,0
53032,60409,44739,34320,44739,70,70,0,2,8,2,0
53033,51798,37020,11736,37020,70,70,0,2,8,2,0
53034,52413,443,50762,443,2114,1152,962,14,15,8,6
53035,54995,443,62942,443,23418,2454,20964,56,197,26,30
53036,41385,53,41385,53,244,98,146,2,34,1,1
53037,58055,80,49869,80,254,128,126,5,15,3,2
53038,41542,23,41542,23,66,66,0,1,5,1,0
53039,56618,80,46340,80,234,234,0,4,12,4,0
53040,51580,53,9399,53,199,94,105,2,30,1,1
53041,56742,53,0,0,82,82,0,2,40,2,0
53042,16224,443,3120,443,7525,1098,6427,22,16,12,10
53043,56048,53,3715,53,296,110,186,2,30,1,1
53044,63777,80,2556,80,314,192,122,6,15,4,2
53045,59723,80,4011,80,613,539,74,7,15,6,1
53046,59165,53,3627,53,320,94,226,2,30,1,1
53047,64609,53,7201,53,168,86,82,2,30,1,1
53048,50466,80,60136,80,1718,1247,471,9,15,5,4
53049,64609,53,19942,53,168,86,82,2,30,1,1
53050,64926,53,31198,53,309,118,191,2,30,1,1
53051,19473,14168,34740,14168,491,150,341,2,1200,1,1
53052,27005,27015,9469,27015,887,126,761,2,30,1,1
53053,55284,53,61340,53,193,102,91,2,30,1,1
53054,49205,80,50738,80,890,411,479,11,15,6,5
53055,54957,80,50979,80,416,210,206,7,15,4,3
53056,51800,63796,36885,63796,70,70,0,2,8,2,0
53057,13956,53,13956,53,244,98,146,2,34,1,1
53058,53117,37529,38733,37529,70,70,0,1,5,1,0
53059,57362,53,47817,53,183,86,97,2,30,1,1
53060,50595,443,32592,443,8981,4625,4356,22,135,11,11
53061,60012,443,58670,443,8127,1796,6331,21,79,12,9
53062,53119,58118,15448,58118,70,70,0,2,8,2,0
53063,45648,80,30446,80,130,70,60,2,15,1,1
53064,59574,443,1442,443,2582500,86854,2495646,2678,84,986,1692
53065,58413,443,5177,443,9371,1936,7435,26,29,14,12
53066,47020,443,34656,443,3545,1817,1728,22,95,11,11
53067,36068,80,51482,80,41269,2915,38354,62,33,32,30
53068,54672,443,53803,443,7210,2267,4943,22,15,12,10
53069,45067,443,54041,443,7794,2844,4950,26,29,16,10
53070,36788,80,9413,80,235873,12126,223747,306,31,154,152
53071,45257,443,55440,443,36062,4663,31399,87,33,41,46
53072,49465,443,16999,443,4555,2472,2083,20,119,11,9
53073,53358,443,35239,443,8626,2839,5787,47,27,24,23
53074,41421,443,56908,443,168930,11361,157569,252,31,101,151
53075,63232,443,26677,443,4496,2346,2150,28,124,15,13
53076,49073,443,18222,443,8960,2497,6463,35,32,19,16
53077,63231,443,12369,443,7124,3843,3281,42,126,20,22
53078,59538,80,28530,80,1895,755,1140,11,14,6,5
53079,56997,53,24700,53,337,107,230,4,34,2,2
53080,58705,80,29021,80,2543,1880,663,12,14,6,6
53081,51801,33531,27515,33531,70,70,0,2,8,2,0
53082,56680,8100,18544,8100,78,78,0,1,4,1,0
53083,48882,443,39008,443,8105,1902,6203,24,26,14,10
53084,14420,80,14420,80,4591,3155,1436,22,45,13,9
53085,40953,443,21244,443,4093,1595,2498,23,15,12,11
53086,55484,443,18380,443,782,428,354,12,25,7,5
53087,16223,443,54966,443,7461,1034,6427,21,16,11,10
53088,49954,443,61436,443,25995,13597,12398,53,186,28,25
53089,63234,443,45160,443,5846,3321,2525,34,96,19,15
53090,46414,80,41611,80,1155,781,374,10,15,6,4
53091,62408,3478,35393,3478,3548,1868,1680,57,87,29,28
53092,64005,53,59576,53,402,125,277,4,37,2,2
53093,64991,53,47067,53,625,192,433,6,46,3,3
53094,65364,53,50447,53,226,110,116,2,29,1,1
53095,55347,443,1685,443,116686,21822,94864,224,186,112,112
53096,64693,53,28781,53,248,102,146,2,30,1,1
53097,27005,27017,1737,27017,891,126,765,2,30,1,1
53098,56443,53,48417,53,250,86,164,4,29,2,2
53099,56667,53,35767,53,168,86,82,2,29,1,1
53100,53786,53,10105,53,260,86,174,2,30,1,1
53101,37916,443,12180,443,6202,872,5330,19,361,9,10
53102,56443,53,60191,53,168,86,82,2,30,1,1
53103,43361,80,14228,80,630,630,0,10,217,10,0
53104,60480,443,16166,443,6511,2810,3701,34,3665,12,22
53105,36886,443,32940,443,2907,1637,1270,20,364,11,9
53106,55427,443,18604,443,9255,2064,7191,43,78,18,25
53107,41631,123,31654,123,184,94,90,2,30,1,1
53108,57991,53,26816,53,220,78,142,2,30,1,1
53109,51176,53,44581,53,236,86,150,2,30,1,1
53110,27005,27015,41826,27015,868,126,742,2,30,1,1
53111,46865,443,9898,443,416,210,206,7,32,4,3
53112,27005,27018,40971,27018,882,126,756,2,30,1,1
53113,40893,443,32829,443,10450,3898,6552,20,135,11,9
53114,60644,5222,7350,5222,9852,2665,7187,60,360,25,35
53115,51764,443,51764,443,4632,1725,2907,19,27,11,8
53116,56800,1,6191,1,70,70,0,2,8,2,0
53117,58962,80,58962,80,22844,1529,21315,39,28,20,19
53118,62783,443,22003,443,28847,16957,11890,144,293,60,84
53119,43872,53,52878,53,199,94,105,2,30,1,1
53120,55072,53,52370,53,168,86,82,2,30,1,1
53121,64609,53,7620,53,250,86,164,4,30,2,2
53122,48458,53,30263,53,168,78,90,2,31,1,1
53123,37917,443,55165,443,6124,860,5264,18,361,9,9
53124,61762,443,14583,443,5975,2713,3262,24,125,12,12
53125,61305,443,56273,443,5399,2711,2688,13,120,7,6
53126,64072,53,31241,53,292,110,182,2,30,1,1
53127,60241,443,21837,443,4512,1810,2702,16,135,7,9
53128,50464,80,22574,80,8453,2011,6442,17,21,8,9
53129,57304,53,22240,53,292,110,182,2,30,1,1
53130,16980,53,16980,53,197,90,107,2,30,1,1
53131,61151,443,65420,443,121129,5559,115570,157,640,51,106
53132,49665,53,45405,53,197,102,95,2,30,1,1
53133,52508,53,51671,53,168,78,90,2,30,1,1
53134,50438,53,55322,53,199,102,97,2,31,1,1
53135,53578,34129,19410,34129,70,70,0,1,5,1,0
53136,25448,23,25448,23,66,66,0,1,5,1,0
53137,50452,80,41109,80,318,192,126,6,29,4,2
53138,39118,443,29645,443,5229,2388,2841,23,367,12,11
53139,64082,53,17005,53,356,97,259,4,58,2,2
53140,58289,445,0,0,70,70,0,1,0,1,0
53141,58305,18375,0,0,62,62,0,1,0,1,0
53142,53318,445,0,0,70,70,0,1,0,1,0
53143,58286,445,0,0,70,70,0,1,0,1,0
53144,58287,445,0,0,70,70,0,1,0,1,0
53145,58284,445,0,0,70,70,0,1,0,1,0
53146,51166,31573,0,0,66,66,0,1,0,1,0
53147,4961,62741,0,0,66,66,0,1,0,1,0
53148,53702,445,0,0,66,66,0,1,0,1,0
53149,53309,445,0,0,70,70,0,1,0,1,0
53150,53308,445,0,0,70,70,0,1,0,1,0
53151,53305,445,0,0,70,70,0,1,0,1,0
53152,53303,445,0,0,70,70,0,1,0,1,0
53153,33174,22,0,0,60,60,0,1,0,1,0
53154,53302,445,0,0,70,70,0,1,0,1,0
53155,46640,8880,0,0,60,60,0,1,0,1,0
53156,58278,445,0,0,70,70,0,1,0,1,0
53157,61221,35440,0,0,66,66,0,1,0,1,0
53158,58273,445,0,0,70,70,0,1,0,1,0
53159,58270,445,0,0,70,70,0,1,0,1,0
53160,58269,445,0,0,70,70,0,1,0,1,0
53161,53696,445,0,0,66,66,0,1,0,1,0
53162,58703,50584,0,0,66,66,0,1,0,1,0
53163,53692,445,0,0,66,66,0,1,0,1,0
53164,53691,445,0,0,66,66,0,1,0,1,0
53165,53687,445,0,0,66,66,0,1,0,1,0
53166,53686,445,0,0,66,66,0,1,0,1,0
53167,53685,445,0,0,66,66,0,1,0,1,0
53168,53683,445,0,0,66,66,0,1,0,1,0
53169,1024,64147,0,0,62,62,0,1,0,1,0
53170,7749,36237,0,0,66,66,0,1,0,1,0
53171,52860,9694,0,0,62,62,0,1,0,1,0
53172,53294,445,0,0,70,70,0,1,0,1,0
53173,60018,64147,0,0,62,62,0,1,0,1,0
53174,59377,9319,0,0,62,62,0,1,0,1,0
53175,58268,445,0,0,70,70,0,1,0,1,0
53176,58265,445,0,0,70,70,0,1,0,1,0
53177,58263,445,0,0,70,70,0,1,0,1,0
53178,56712,46824,0,0,62,62,0,1,0,1,0
53179,53682,445,0,0,66,66,0,1,0,1,0
53180,58260,445,0,0,70,70,0,1,0,1,0
53181,50254,44847,0,0,66,66,0,1,0,1,0
53182,53677,445,0,0,66,66,0,1,0,1,0
53183,53286,445,0,0,70,70,0,1,0,1,0
53184,56173,37807,0,0,66,66,0,1,0,1,0
53185,62071,22114,0,0,62,62,0,1,0,1,0
53186,53676,445,0,0,66,66,0,1,0,1,0
53187,53675,445,0,0,66,66,0,1,0,1,0
53188,53283,445,0,0,70,70,0,1,0,1,0
53189,53673,445,0,0,66,66,0,1,0,1,0
53190,53406,50584,0,0,66,66,0,1,0,1,0
53191,53178,26467,0,0,62,62,0,1,0,1,0
53192,17481,64097,0,0,146,146,0,1,0,1,0
53193,20576,37965,0,0,62,62,0,1,0,1,0
53194,53280,445,0,0,70,70,0,1,0,1,0
53195,49982,37965,0,0,66,66,0,1,0,1,0
53196,25797,30188,0,0,146,146,0,1,0,1,0
53197,62549,64147,0,0,62,62,0,1,0,1,0
53198,53278,445,0,0,70,70,0,1,0,1,0
53199,65203,30188,0,0,66,66,0,1,0,1,0
53200,58253,445,0,0,70,70,0,1,0,1,0
53201,58248,445,0,0,70,70,0,1,0,1,0
53202,58245,445,0,0,70,70,0,1,0,1,0
53203,41410,30188,0,0,146,146,0,1,0,1,0
53204,53274,445,0,0,70,70,0,1,0,1,0
53205,52361,23718,0,0,66,66,0,1,0,1,0
53206,53664,445,0,0,66,66,0,1,0,1,0
53207,5751,64147,0,0,66,66,0,1,0,1,0
53208,53273,445,0,0,70,70,0,1,0,1,0
53209,50535,51505,0,0,62,62,0,1,0,1,0
53210,32491,15503,0,0,66,66,0,1,0,1,0
53211,43688,22114,0,0,66,66,0,1,0,1,0
53212,53654,445,0,0,66,66,0,1,0,1,0
53213,57772,50584,0,0,66,66,0,1,0,1,0
53214,58234,445,0,0,70,70,0,1,0,1,0
53215,58751,9571,0,0,62,62,0,1,0,1,0
53216,25010,30188,0,0,62,62,0,1,0,1,0
53217,9377,56205,0,0,66,66,0,1,0,1,0
53218,53268,445,0,0,70,70,0,1,0,1,0
53219,64339,18375,0,0,66,66,0,1,0,1,0
53220,59728,5900,0,0,60,60,0,1,0,1,0
53221,55225,11392,0,0,66,66,0,1,0,1,0
53222,53652,445,0,0,66,66,0,1,0,1,0
53223,29049,23,0,0,60,60,0,1,0,1,0
53224,1054,15503,0,0,62,62,0,1,0,1,0
53225,63542,15503,0,0,66,66,0,1,0,1,0
53226,10265,64147,0,0,66,66,0,1,0,1,0
53227,52217,22114,0,0,66,66,0,1,0,1,0
53228,59790,44847,0,0,66,66,0,1,0,1,0
53229,52726,56205,0,0,66,66,0,1,0,1,0
53230,53645,445,0,0,66,66,0,1,0,1,0
53231,37902,23718,0,0,62,62,0,1,0,1,0
53232,53639,445,0,0,66,66,0,1,0,1,0
53233,42532,22114,0,0,62,62,0,1,0,1,0
53234,63205,9571,0,0,66,66,0,1,0,1,0
53235,52997,5900,0,0,60,60,0,1,0,1,0
53236,9412,7302,0,0,62,62,0,1,0,1,0
53237,53255,445,0,0,70,70,0,1,0,1,0
53238,63465,56205,0,0,66,66,0,1,0,1,0
53239,64877,37450,0,0,66,66,0,1,0,1,0
53240,63772,35440,0,0,66,66,0,1,0,1,0
53241,17411,43890,0,0,146,146,0,1,0,1,0
53242,15530,49718,0,0,146,146,0,1,0,1,0
53243,42241,11392,0,0,66,66,0,1,0,1,0
53244,58721,51505,0,0,66,66,0,1,0,1,0
53245,53252,445,0,0,70,70,0,1,0,1,0
53246,15005,32480,0,0,145,145,0,1,0,1,0
53247,45941,23386,0,0,60,60,0,1,0,1,0
53248,58224,445,0,0,70,70,0,1,0,1,0
53249,58220,445,0,0,70,70,0,1,0,1,0
53250,58221,445,0,0,70,70,0,1,0,1,0
53251,53628,445,0,0,66,66,0,1,0,1,0
53252,53629,445,0,0,66,66,0,1,0,1,0
53253,53626,445,0,0,66,66,0,1,0,1,0
53254,53623,445,0,0,66,66,0,1,0,1,0
53255,53625,445,0,0,66,66,0,1,0,1,0
53256,53627,445,0,0,66,66,0,1,0,1,0
53257,53624,445,0,0,66,66,0,1,0,1,0
53258,53621,445,0,0,66,66,0,1,0,1,0
53259,63716,23,0,0,60,60,0,1,0,1,0
53260,37597,50584,0,0,66,66,0,1,0,1,0
53261,58445,17500,0,0,66,66,0,1,0,1,0
53262,26921,37965,0,0,62,62,0,1,0,1,0
53263,51617,21247,0,0,66,66,0,1,0,1,0
53264,54343,50584,0,0,62,62,0,1,0,1,0
53265,56474,18375,0,0,62,62,0,1,0,1,0
53266,53247,445,0,0,70,70,0,1,0,1,0
53267,49805,64147,0,0,66,66,0,1,0,1,0
53268,33453,64147,0,0,62,62,0,1,0,1,0
53269,53246,445,0,0,70,70,0,1,0,1,0
53270,2935,64147,0,0,62,62,0,1,0,1,0
53271,12549,50265,0,0,146,146,0,1,0,1,0
53272,53244,445,0,0,70,70,0,1,0,1,0
53273,52643,36237,0,0,66,66,0,1,0,1,0
53274,37587,443,50576,443,499,425,74,4,0,3,1
53275,37586,443,60521,443,499,425,74,4,0,3,1
53276,37584,443,21310,443,499,425,74,4,0,3,1
53277,37581,443,35670,443,499,425,74,4,0,3,1
53278,37582,443,52781,443,499,425,74,4,0,3,1
53279,37583,443,36088,443,499,425,74,4,0,3,1
53280,58217,445,0,0,70,70,0,1,0,1,0
53281,58213,445,0,0,70,70,0,1,0,1,0
53282,58209,445,0,0,70,70,0,1,0,1,0
53283,38358,22300,0,0,60,60,0,1,0,1,0
53284,38320,51505,0,0,66,66,0,1,0,1,0
53285,55770,64147,0,0,66,66,0,1,0,1,0
53286,24471,32167,0,0,60,60,0,1,0,1,0
53287,53609,445,0,0,66,66,0,1,0,1,0
53288,53608,445,0,0,66,66,0,1,0,1,0
53289,53606,445,0,0,66,66,0,1,0,1,0
53290,58202,445,0,0,70,70,0,1,0,1,0
53291,45082,17,0,0,60,60,0,1,0,1,0
53292,2697,28189,0,0,60,60,0,1,0,1,0
53293,16027,22,0,0,60,60,0,1,0,1,0
53294,5222,7493,0,0,66,66,0,1,0,1,0
53295,6853,48543,0,0,148,148,0,1,0,1,0
53296,53237,445,0,0,70,70,0,1,0,1,0
53297,58200,445,0,0,70,70,0,1,0,1,0
53298,58196,445,0,0,70,70,0,1,0,1,0
53299,58198,445,0,0,70,70,0,1,0,1,0
53300,58191,445,0,0,70,70,0,1,0,1,0
53301,53235,445,0,0,70,70,0,1,0,1,0
53302,1024,6881,0,0,146,146,0,1,0,1,0
53303,57283,64147,0,0,66,66,0,1,0,1,0
53304,42252,33303,0,0,60,60,0,1,0,1,0
53305,5223,16383,0,0,66,66,0,1,0,1,0
53306,53234,445,0,0,70,70,0,1,0,1,0
53307,53233,445,0,0,70,70,0,1,0,1,0
53308,53232,445,0,0,70,70,0,1,0,1,0
53309,53226,445,0,0,70,70,0,1,0,1,0
53310,53229,445,0,0,70,70,0,1,0,1,0
53311,31021,35440,0,0,62,62,0,1,0,1,0
53312,5357,32468,0,0,66,66,0,1,0,1,0
53313,53214,445,0,0,70,70,0,1,0,1,0
53314,53212,445,0,0,70,70,0,1,0,1,0
53315,5208,63836,0,0,145,145,0,1,0,1,0
53316,58183,445,0,0,70,70,0,1,0,1,0
53317,58182,445,0,0,70,70,0,1,0,1,0
53318,58177,445,0,0,70,70,0,1,0,1,0
53319,53209,445,0,0,70,70,0,1,0,1,0
53320,57504,44847,0,0,66,66,0,1,0,1,0
53321,53204,445,0,0,70,70,0,1,0,1,0
53322,26900,27017,37776,27017,422,164,258,6,30,3,3
53323,60409,443,2686,443,7925,1878,6047,26,66,12,14
53324,37939,80,33562,80,1616,1302,314,10,15,5,5
53325,53587,32029,40143,32029,70,70,0,1,5,1,0
53326,50230,80,20217,80,2384,952,1432,15,75,8,7
53327,26900,27017,30659,27017,168,82,86,2,30,1,1
53328,55209,53,9446,53,98,98,0,1,30,1,0
53329,49835,53,4982,53,146,75,71,2,30,1,1
53330,56631,443,17729,443,7889,1900,5989,20,16,11,9
53331,53612,1032,47132,1032,130,70,60,3,5,2,1
53332,51782,10637,45950,10637,66,66,0,1,5,1,0
53333,49485,80,52074,80,1155,781,374,10,15,6,4
53334,36907,53,36907,53,237,91,146,2,33,1,1
53335,55207,80,45213,80,1979,1326,653,16,500,10,6
53336,65397,443,12248,443,2494,1643,851,17,25,9,8
53337,49663,53,18877,53,184,80,104,2,30,1,1
53338,55404,53,28730,53,711,87,624,2,30,1,1
53339,57842,53,57842,53,225,87,138,2,30,1,1
53340,14374,443,14374,443,1582,883,699,18,32,10,8
53341,9158,53,9158,53,237,91,146,2,33,1,1
53342,53579,59332,61782,59332,70,70,0,1,5,1,0
53343,26900,27017,15992,27017,422,164,258,6,30,3,3
53344,52010,80,42870,80,29838,2481,27357,56,31,24,32
53345,50227,80,3538,80,1935,895,1040,15,75,8,7
53346,53584,62974,57251,62974,70,70,0,1,5,1,0
53347,51781,43909,49326,43909,66,66,0,1,5,1,0
53348,11295,40002,59394,40002,209,85,124,4,34,2,2
53349,41981,80,51523,80,1556,1236,320,10,15,5,5
53350,26900,27017,35355,27017,422,164,258,6,30,3,3
53351,56632,443,5495,443,7941,1952,5989,20,15,11,9
53352,49665,53,12263,53,194,99,95,2,30,1,1
53353,53580,48066,12026,48066,70,70,0,1,5,1,0
53354,65384,53,58692,53,194,99,95,2,30,1,1
53355,57659,80,4317,80,742,140,602,12,409,3,9
53356,41052,443,41052,443,4596,1689,2907,19,27,11,8
53357,56633,443,38597,443,7889,1900,5989,20,15,11,9
53358,22602,53,22602,53,217,87,130,2,30,1,1
53359,17932,53,17932,53,213,87,126,2,30,1,1
53360,51780,21130,19007,21130,66,66,0,1,5,1,0
53361,51269,36983,59727,36983,70,70,0,1,5,1,0
53362,43884,80,63772,80,1774,1460,314,13,15,8,5
53363,58225,443,29188,443,2484,330,2154,12,135,5,7
53364,62184,443,42085,443,4283,2038,2245,14,135,7,7
53365,30188,1381,10671,1381,324,150,174,2,1200,1,1
53366,47445,443,40456,443,8710,2009,6701,30,395,10,20
53367,48303,53,44805,53,198,93,105,2,31,1,1
53368,57487,443,43988,443,1786,172,1614,7,121,3,4
53369,55028,443,55949,443,6015,3964,2051,32,361,18,14
53370,6882,43825,33329,43825,200,111,89,2,1200,1,1
53371,50265,45599,34078,45599,330,330,0,6,1200,6,0
53372,53203,445,0,0,70,70,0,1,0,1,0
53373,34553,48637,0,0,60,60,0,1,0,1,0
53374,26480,64147,0,0,62,62,0,1,0,1,0
53375,53676,35974,0,0,60,60,0,1,0,1,0
53376,34677,51185,0,0,60,60,0,1,0,1,0
53377,56679,51505,0,0,146,146,0,1,0,1,0
53378,28973,30188,0,0,66,66,0,1,0,1,0
53379,5223,22981,0,0,60,60,0,1,0,1,0
53380,53585,445,0,0,66,66,0,1,0,1,0
53381,53192,445,0,0,70,70,0,1,0,1,0
53382,58175,445,0,0,70,70,0,1,0,1,0
53383,58167,445,0,0,70,70,0,1,0,1,0
53384,32806,7275,9524,7275,1564,560,1004,23,38,9,14
53385,26900,27017,1315,27017,422,164,258,6,30,3,3
53386,64505,53,38734,53,373,126,247,2,30,1,1
53387,62486,53,59489,53,102,102,0,1,30,1,0
53388,56771,53,26360,53,193,102,91,2,31,1,1
53389,40707,443,1072,443,1969,1195,774,18,122,11,7
53390,49178,53,17300,53,348,105,243,4,45,2,2
53391,49178,2710,54926,2710,70,70,0,2,7,2,0
53392,55284,53,36720,53,193,102,91,2,29,1,1
53393,27005,27016,12661,27016,879,126,753,2,30,1,1
53394,65050,53,2914,53,264,102,162,2,30,1,1
53395,33043,443,36029,443,1788,968,820,20,15,11,9
53396,65376,443,34209,443,55500,40540,14960,137,131,72,65
53397,51802,21555,33946,21555,316,136,180,6,6,3,3
53398,65392,443,55705,443,5939,772,5167,17,27,9,8
53399,64849,53,57025,53,340,110,230,2,29,1,1
53400,50459,80,33223,80,1328,917,411,10,28,6,4
53401,64171,53,42919,53,211,102,109,2,29,1,1
53402,50451,80,26551,80,378,192,186,7,28,4,3
53403,49480,53,4215,53,168,78,90,2,29,1,1
53404,27005,27015,45770,27015,874,126,748,2,30,1,1
53405,56760,53,34251,53,216,102,114,2,30,1,1
53406,55593,53,53460,53,102,102,0,1,30,1,0
53407,49291,53,26536,53,277,110,167,2,30,1,1
53408,27005,27015,65142,27015,883,126,757,2,30,1,1
53409,26900,27017,64029,27017,422,164,258,6,30,3,3
53410,26900,27017,21436,27017,422,164,258,6,30,3,3
53411,65460,53,1825,53,177,94,83,2,30,1,1
53412,44443,80,37663,80,1114,534,580,12,16,7,5
53413,49395,53,16625,53,315,90,225,4,32,2,2
53414,52118,443,25040,443,22072,2166,19906,44,49,22,22
53415,27005,27015,60376,27015,878,126,752,2,30,1,1
53416,56426,80,33168,80,17008,1379,15629,22,25,7,15
53417,27005,27017,40278,27017,891,126,765,2,30,1,1
53418,49629,53,59085,53,216,102,114,2,30,1,1
53419,52385,53,0,0,139,70,69,2,30,1,1
53420,56417,53,7039,53,389,126,263,2,30,1,1
53421,51779,49525,20031,49525,70,70,0,1,5,1,0
53422,49865,443,26140,443,5708,1025,4683,16,35,9,7
53423,65384,53,41711,53,197,102,95,2,30,1,1
53424,49661,443,16392,443,9021,2548,6473,38,80,19,19
53425,65276,53,64809,53,195,86,109,2,30,1,1
53426,37581,53,0,0,86,86,0,1,30,1,0
53427,50958,53,61318,53,94,94,0,1,30,1,0
53428,26900,27017,57216,27017,422,164,258,6,30,3,3
53429,49835,53,4123,53,250,86,164,4,30,2,2
53430,50011,53,36525,53,94,94,0,1,30,1,0
53431,26900,27017,59839,27017,422,164,258,6,30,3,3
53432,64477,53,1968,53,272,94,178,2,30,1,1
53433,26900,27017,63924,27017,422,164,258,6,30,3,3
53434,56760,443,12877,443,7894,1671,6223,21,185,11,10
53435,62597,53,18771,53,102,102,0,1,30,1,0
53436,60683,443,28178,443,17071,1532,15539,17,147,3,14
53437,51796,48779,55326,48779,70,70,0,2,8,2,0
53438,56780,48298,2043,48298,264,70,194,4,19,1,3
53439,53482,53,51944,53,168,78,90,2,30,1,1
53440,26900,27017,20527,27017,422,164,258,6,30,3,3
53441,26900,27017,48615,27017,422,164,258,6,30,3,3
53442,57839,53,54040,53,78,78,0,1,30,1,0
53443,49844,53,62050,53,368,118,250,2,30,1,1
53444,44847,6881,46281,6881,150,150,0,1,1200,1,0
53445,50265,12348,24050,12348,858,858,0,14,1200,14,0
53446,50265,28520,23958,28520,132,132,0,3,1200,3,0
53447,27005,27017,59484,27017,882,126,756,2,30,1,1
53448,57028,8080,10225,8080,78,78,0,2,8,2,0
53449,42349,443,27589,443,90562,4227,86335,118,200,49,69
53450,64954,53,8799,53,94,94,0,1,30,1,0
53451,65136,53,1364,53,86,86,0,1,30,1,0
53452,64240,53,21453,53,256,110,146,2,30,1,1
53453,64122,53,64122,53,220,90,130,2,30,1,1
53454,49835,53,23738,53,168,86,82,2,30,1,1
53455,65515,53,35838,53,718,94,624,2,30,1,1
53456,64803,53,39873,53,102,102,0,1,30,1,0
53457,26900,27017,40342,27017,422,164,258,6,30,3,3
53458,55721,53,4903,53,212,94,118,2,30,1,1
53459,37965,32305,6845,32305,1650,1650,0,26,1537,26,0
53460,27005,27016,48371,27016,887,126,761,2,30,1,1
53461,57118,443,64702,443,5133,631,4502,14,15,8,6
53462,53589,40281,44450,40281,70,70,0,1,4,1,0
53463,52641,6881,46429,6881,1162,856,306,10,14,5,5
53464,61158,443,55712,443,12854,2237,10617,47,638,19,28
53465,53606,54476,23615,54476,320,140,180,6,6,3,3
53466,57382,2258,57382,2258,156,156,0,3,8,3,0
53467,53583,15354,45877,15354,70,70,0,1,4,1,0
53468,26900,27017,43419,27017,422,164,258,6,30,3,3
53469,50438,53,8831,53,199,102,97,2,29,1,1
53470,64884,53,48287,53,239,110,129,2,30,1,1
53471,26900,27017,31665,27017,254,82,172,4,30,2,2
53472,59488,443,37367,443,6100,580,5520,17,53,5,12
53473,46864,443,31788,443,5349,1090,4259,18,31,10,8
53474,65460,53,48122,53,177,94,83,2,30,1,1
53475,56568,53,34489,53,102,102,0,1,30,1,0
53476,64146,53,33411,53,273,94,179,2,30,1,1
53477,51646,80,63912,80,1038219,43977,994242,1734,30,616,1118
53478,61580,53,48820,53,275,94,181,2,29,1,1
53479,50438,53,42985,53,199,102,97,2,29,1,1
53480,51467,443,43898,443,186117,12962,173155,249,143,83,166
53481,50639,443,28987,443,15714,2748,12966,58,21,23,35
53482,55209,53,7531,53,196,102,94,2,33,1,1
53483,65472,443,58915,443,460338,13340,446998,472,16,165,307
53484,49855,53,19600,53,916,86,830,2,30,1,1
53485,49706,53,34348,53,258,110,148,2,30,1,1
53486,57398,53,44535,53,202,86,116,2,30,1,1
53487,58472,53,5380,53,86,86,0,1,30,1,0
53488,56463,53,28170,53,368,118,250,2,30,1,1
53489,26900,27017,25587,27017,422,164,258,6,30,3,3
53490,26900,27017,26989,27017,422,164,258,6,30,3,3
53491,26900,27017,65080,27017,422,164,258,6,30,3,3
53492,27005,27015,36150,27015,889,126,763,2,30,1,1
53493,59677,443,25449,443,13551,5488,8063,33,95,16,17
53494,49650,443,63033,443,93063,2948,90115,107,80,30,77
53495,49914,443,22293,443,12190,2075,10115,28,16,14,14
53496,65393,443,57467,443,5121,936,4185,17,27,9,8
53497,54980,443,53564,443,1541965,48559,1493406,1663,51,623,1040
53498,53986,53,15974,53,102,102,0,1,30,1,0
53499,65349,53,10010,53,275,110,165,2,30,1,1
53500,27005,27018,42247,27018,881,126,755,2,30,1,1
53501,27005,27016,2145,27016,883,126,757,2,30,1,1
53502,47147,443,41911,443,5789,952,4837,19,150,10,9
53503,50265,57121,42011,57121,132,132,0,3,1200,3,0
53504,40226,443,40694,443,13853,4638,9215,42,387,21,21
53505,53707,443,35476,443,350,210,140,6,25,4,2
53506,57109,443,58630,443,7170,1436,5734,35,261,19,16
53507,65384,53,35279,53,197,102,95,2,33,1,1
53508,51797,30712,39713,30712,70,70,0,2,8,2,0
53509,51778,60565,33068,60565,70,70,0,1,5,1,0
53510,26900,27017,49635,27017,422,164,258,6,30,3,3
53511,59487,443,5005,443,8702,580,8122,17,53,5,12
53512,49835,53,35014,53,168,86,82,2,30,1,1
53513,26900,27017,34490,27017,422,164,258,6,30,3,3
53514,49501,53,50538,53,229,110,119,2,30,1,1
53515,21133,27613,37990,27613,481,150,331,2,1199,1,1
53516,56192,53,60489,53,177,94,83,2,31,1,1
53517,57470,48096,60784,48096,132,132,0,3,1200,3,0
53518,61744,443,1594,443,3743,1654,2089,10,121,5,5
53519,57470,44822,45311,44822,132,132,0,3,1200,3,0
53520,27761,53,27761,53,832,106,726,2,30,1,1
53521,60546,53,37684,53,199,94,105,2,30,1,1
53522,56801,21916,14491,21916,316,136,180,6,7,3,3
53523,64110,443,18222,443,5060,3367,1693,21,102,12,9
53524,50725,443,41613,443,6593,3522,3071,56,76,33,23
53525,34351,443,4638,443,402051,17714,384337,520,83,228,292
53526,56448,53,42442,53,177,94,83,2,30,1,1
53527,55056,53,32343,53,177,94,83,2,31,1,1
53528,49438,443,63285,443,18773,1492,17281,38,94,11,27
53529,64380,53,9655,53,196,102,94,2,33,1,1
53530,50904,80,18118,80,12289218,202774,12086444,11470,149,2789,8681
53531,61345,21247,0,0,62,62,0,1,0,1,0
53532,45964,5333,0,0,60,60,0,1,0,1,0
53533,25179,62609,0,0,148,148,0,1,0,1,0
53534,53580,445,0,0,66,66,0,1,0,1,0
53535,23795,44847,0,0,146,146,0,1,0,1,0
53536,53188,445,0,0,70,70,0,1,0,1,0
53537,53577,445,0,0,66,66,0,1,0,1,0
53538,58162,445,0,0,70,70,0,1,0,1,0
53539,58154,445,0,0,70,70,0,1,0,1,0
53540,58152,445,0,0,70,70,0,1,0,1,0
53541,58153,445,0,0,70,70,0,1,0,1,0
53542,65115,50584,0,0,66,66,0,1,0,1,0
53543,21173,37965,0,0,62,62,0,1,0,1,0
53544,11816,50584,0,0,62,62,0,1,0,1,0
53545,1030,44847,0,0,62,62,0,1,0,1,0
53546,53575,445,0,0,66,66,0,1,0,1,0
53547,58326,50584,0,0,62,62,0,1,0,1,0
53548,53178,445,0,0,70,70,0,1,0,1,0
53549,53176,445,0,0,70,70,0,1,0,1,0
53550,53173,445,0,0,70,70,0,1,0,1,0
53551,53419,28189,0,0,60,60,0,1,0,1,0
53552,53171,445,0,0,70,70,0,1,0,1,0
53553,55157,7302,0,0,66,66,0,1,0,1,0
53554,34897,50584,0,0,62,62,0,1,0,1,0
53555,58149,445,0,0,70,70,0,1,0,1,0
53556,53207,50265,0,0,66,66,0,1,0,1,0
53557,58145,445,0,0,70,70,0,1,0,1,0
53558,58143,445,0,0,70,70,0,1,0,1,0
53559,58142,445,0,0,70,70,0,1,0,1,0
53560,1866,51505,0,0,66,66,0,1,0,1,0
53561,57676,64147,0,0,74,74,0,1,0,1,0
53562,46679,64147,0,0,62,62,0,1,0,1,0
53563,53568,445,0,0,66,66,0,1,0,1,0
53564,6881,64910,0,0,146,146,0,1,0,1,0
53565,53565,445,0,0,66,66,0,1,0,1,0
53566,53560,445,0,0,66,66,0,1,0,1,0
53567,53559,445,0,0,66,66,0,1,0,1,0
53568,59201,51221,0,0,66,66,0,1,0,1,0
53569,8191,51221,0,0,62,62,0,1,0,1,0
53570,57131,26296,0,0,145,145,0,1,0,1,0
53571,53558,445,0,0,66,66,0,1,0,1,0
53572,53555,445,0,0,66,66,0,1,0,1,0
53573,53557,445,0,0,66,66,0,1,0,1,0
53574,34930,20005,0,0,60,60,0,1,0,1,0
53575,53165,445,0,0,70,70,0,1,0,1,0
53576,53355,23117,0,0,62,62,0,1,0,1,0
53577,50031,44847,0,0,74,74,0,1,0,1,0
53578,443,64347,0,0,131,131,0,1,0,1,0
53579,50369,50584,0,0,66,66,0,1,0,1,0
53580,50562,37965,0,0,66,66,0,1,0,1,0
53581,5223,7851,0,0,66,66,0,1,0,1,0
53582,58137,445,0,0,70,70,0,1,0,1,0
53583,58139,445,0,0,70,70,0,1,0,1,0
53584,58134,445,0,0,70,70,0,1,0,1,0
53585,53551,445,0,0,66,66,0,1,0,1,0
53586,53157,445,0,0,70,70,0,1,0,1,0
53587,58132,445,0,0,70,70,0,1,0,1,0
53588,53156,445,0,0,70,70,0,1,0,1,0
53589,53550,445,0,0,66,66,0,1,0,1,0
53590,51909,6881,0,0,66,66,0,1,0,1,0
53591,57289,31573,0,0,66,66,0,1,0,1,0
53592,54773,50584,0,0,62,62,0,1,0,1,0
53593,62678,57470,0,0,62,62,0,1,0,1,0
53594,53548,445,0,0,66,66,0,1,0,1,0
53595,53547,445,0,0,66,66,0,1,0,1,0
53596,42951,44847,0,0,66,66,0,1,0,1,0
53597,53545,445,0,0,66,66,0,1,0,1,0
53598,50360,35440,0,0,66,66,0,1,0,1,0
53599,53150,445,0,0,70,70,0,1,0,1,0
53600,53166,61600,0,0,62,62,0,1,0,1,0
53601,14070,62413,0,0,66,66,0,1,0,1,0
53602,14260,36829,0,0,62,62,0,1,0,1,0
53603,7285,51221,0,0,66,66,0,1,0,1,0
53604,53149,445,0,0,70,70,0,1,0,1,0
53605,64175,56502,0,0,66,66,0,1,0,1,0
53606,7992,64147,0,0,62,62,0,1,0,1,0
53607,58125,445,0,0,70,70,0,1,0,1,0
53608,58116,445,0,0,70,70,0,1,0,1,0
53609,58117,445,0,0,70,70,0,1,0,1,0
53610,53145,445,0,0,70,70,0,1,0,1,0
53611,55254,50584,0,0,66,66,0,1,0,1,0
53612,17640,55442,0,0,66,66,0,1,0,1,0
53613,53144,445,0,0,70,70,0,1,0,1,0
53614,54991,36829,0,0,66,66,0,1,0,1,0
53615,53536,445,0,0,66,66,0,1,0,1,0
53616,21534,42246,0,0,66,66,0,1,0,1,0
53617,25015,64147,0,0,66,66,0,1,0,1,0
53618,30365,45991,0,0,60,60,0,1,0,1,0
53619,60875,56205,0,0,66,66,0,1,0,1,0
53620,34822,31573,0,0,62,62,0,1,0,1,0
53621,53526,445,0,0,66,66,0,1,0,1,0
53622,53139,445,0,0,70,70,0,1,0,1,0
53623,58108,445,0,0,70,70,0,1,0,1,0
53624,53523,445,0,0,66,66,0,1,0,1,0
53625,49485,11392,0,0,66,66,0,1,0,1,0
53626,51559,26467,0,0,66,66,0,1,0,1,0
53627,53517,445,0,0,66,66,0,1,0,1,0
53628,53506,445,0,0,66,66,0,1,0,1,0
53629,53126,445,0,0,70,70,0,1,0,1,0
53630,3521,6881,0,0,62,62,0,1,0,1,0
53631,28345,11392,0,0,66,66,0,1,0,1,0
53632,53123,445,0,0,70,70,0,1,0,1,0
53633,0,0,0,0,98,98,0,1,0,1,0
53634,0,0,0,0,60,60,0,1,0,1,0
53635,0,0,0,0,156,156,0,2,0,2,0
53636,0,0,0,0,98,98,0,1,0,1,0
53637,0,0,0,0,98,98,0,1,0,1,0
53638,0,0,0,0,244,244,0,2,0,2,0
53639,0,0,0,0,98,98,0,1,0,1,0
53640,42034,28189,0,0,62,62,0,1,0,1,0
53641,64324,37807,0,0,62,62,0,1,0,1,0
53642,58095,445,0,0,70,70,0,1,0,1,0
53643,58092,445,0,0,70,70,0,1,0,1,0
53644,58093,445,0,0,70,70,0,1,0,1,0
53645,5195,64147,0,0,66,66,0,1,0,1,0
53646,53494,445,0,0,66,66,0,1,0,1,0
53647,53496,445,0,0,66,66,0,1,0,1,0
53648,53499,445,0,0,66,66,0,1,0,1,0
53649,53501,445,0,0,66,66,0,1,0,1,0
53650,53497,445,0,0,66,66,0,1,0,1,0
53651,53498,445,0,0,66,66,0,1,0,1,0
53652,53500,445,0,0,66,66,0,1,0,1,0
53653,53495,445,0,0,66,66,0,1,0,1,0
53654,63670,64097,0,0,66,66,0,1,0,1,0
53655,43129,15503,0,0,62,62,0,1,0,1,0
53656,60550,50584,0,0,62,62,0,1,0,1,0
53657,57431,15503,0,0,66,66,0,1,0,1,0
53658,48298,2043,0,0,60,60,0,1,0,1,0
53659,53118,445,0,0,70,70,0,1,0,1,0
53660,52749,64147,0,0,66,66,0,1,0,1,0
53661,53117,445,0,0,70,70,0,1,0,1,0
53662,1025,35447,0,0,62,62,0,1,0,1,0
53663,20057,44847,0,0,62,62,0,1,0,1,0
53664,53115,445,0,0,70,70,0,1,0,1,0
53665,65501,26467,0,0,66,66,0,1,0,1,0
53666,60875,50584,0,0,66,66,0,1,0,1,0
53667,58086,445,0,0,70,70,0,1,0,1,0
53668,58087,445,0,0,70,70,0,1,0,1,0
53669,58082,445,0,0,70,70,0,1,0,1,0
53670,64406,50584,0,0,62,62,0,1,0,1,0
53671,57452,57470,0,0,62,62,0,1,0,1,0
53672,53481,445,0,0,66,66,0,1,0,1,0
53673,53480,445,0,0,66,66,0,1,0,1,0
53674,53479,445,0,0,66,66,0,1,0,1,0
53675,60384,64147,0,0,62,62,0,1,0,1,0
53676,58074,445,0,0,70,70,0,1,0,1,0
53677,53108,445,0,0,70,70,0,1,0,1,0
53678,57545,35440,0,0,66,66,0,1,0,1,0
53679,53106,445,0,0,70,70,0,1,0,1,0
53680,58072,445,0,0,70,70,0,1,0,1,0
53681,26528,51221,0,0,78,78,0,1,0,1,0
53682,58064,445,0,0,70,70,0,1,0,1,0
53683,58063,445,0,0,70,70,0,1,0,1,0
53684,58060,445,0,0,70,70,0,1,0,1,0
53685,53097,443,17057,443,7013,1718,5295,18,326,9,9
53686,53092,443,57966,443,8071,1789,6282,20,326,10,10
53687,53101,443,37557,443,8071,1789,6282,20,326,10,10
53688,47080,80,47080,80,276453,7832,268621,287,165,92,195
53689,56192,53,2949,53,170,87,83,2,30,1,1
53690,55056,53,8605,53,170,87,83,2,30,1,1
53691,58283,443,44449,443,42792,12402,30390,98,370,45,53
53692,51799,58416,38209,58416,316,136,180,6,6,3,3
53693,41328,53,51462,53,198,93,105,2,30,1,1
53694,53100,443,46629,443,8571,1789,6782,20,326,10,10
53695,53130,443,27794,443,7169,1715,5454,18,325,9,9
53696,56630,443,6016,443,7941,1952,5989,20,15,11,9
53697,57205,53,27220,53,711,87,624,2,30,1,1
53698,41520,53,0,0,82,82,0,1,30,1,0
53699,27005,27015,31409,27015,891,126,765,2,31,1,1
53700,53166,80,34843,80,1487,838,649,10,323,6,4
53701,53126,443,9290,443,5604,2738,2866,20,325,10,10
53702,53102,443,30366,443,7149,1719,5430,18,326,9,9
53703,53140,443,26358,443,6401,1225,5176,18,324,9,9
53704,53168,80,46007,80,1501,958,543,10,323,6,4
53705,58974,443,58974,443,6792,1521,5271,18,28,11,7
53706,55618,45341,55864,45341,70,70,0,2,8,2,0
53707,37961,443,21395,443,153,93,60,2,5,1,1
53708,28316,3389,28316,3389,4695,2520,2175,22,19,13,9
53709,37805,443,65176,443,5577,1977,3600,29,56,16,13
53710,45540,443,45540,443,4702,1795,2907,19,28,11,8
53711,64380,53,44055,53,98,98,0,1,30,1,0
53712,58970,80,38149,80,1521,967,554,10,75,6,4
53713,54823,53,13813,53,198,93,105,2,30,1,1
53714,57162,53,0,0,198,91,107,2,30,1,1
53715,29805,53,29805,53,226,89,137,2,30,1,1
53716,52728,80,55587,80,13372,7598,5774,29,555,18,11
53717,35601,80,28025,80,1151,711,440,10,15,5,5
53718,53138,443,15464,443,6760,1346,5414,18,325,9,9
53719,52652,443,14258,443,14511,4628,9883,29,559,15,14
53720,53158,443,6890,443,7427,1517,5910,22,323,11,11
53721,53095,443,22543,443,7014,1719,5295,18,326,9,9
53722,56803,52421,20663,52421,164,70,94,2,5,1,1
53723,39328,80,62636,80,234,234,0,4,12,4,0
53724,41518,443,53815,443,25342,17809,7533,56,80,28,28
53725,51775,57887,37993,57887,66,66,0,1,5,1,0
53726,56628,443,49515,443,7941,1952,5989,20,15,11,9
53727,3669,53,3669,53,825,99,726,2,30,1,1
53728,53085,53,0,0,82,82,0,1,30,1,0
53729,56629,443,57154,443,7889,1900,5989,20,15,11,9
53730,37233,53,50033,53,198,93,105,2,30,1,1
53731,60405,64722,47645,64722,70,70,0,2,8,2,0
53732,20892,53,20892,53,825,99,726,2,30,1,1
53733,53597,53,0,0,233,85,148,2,30,1,1
53734,56750,53,56750,53,217,87,130,2,30,1,1
53735,41772,80,18406,80,738,70,668,12,394,2,10
53736,52335,443,49316,443,5670,2739,2931,18,129,9,9
53737,8933,56205,0,0,62,62,0,1,0,1,0
53738,53105,445,0,0,70,70,0,1,0,1,0
53739,53104,445,0,0,70,70,0,1,0,1,0
53740,60294,30188,0,0,66,66,0,1,0,1,0
53741,53103,445,0,0,70,70,0,1,0,1,0
53742,27010,64147,0,0,62,62,0,1,0,1,0
53743,53097,445,0,0,70,70,0,1,0,1,0
53744,53100,445,0,0,70,70,0,1,0,1,0
53745,9605,57470,0,0,62,62,0,1,0,1,0
53746,11133,51505,0,0,66,66,0,1,0,1,0
53747,13441,57470,0,0,62,62,0,1,0,1,0
53748,12895,37965,0,0,62,62,0,1,0,1,0
53749,58074,11392,0,0,66,66,0,1,0,1,0
53750,48706,23393,0,0,60,60,0,1,0,1,0
53751,53650,64147,0,0,66,66,0,1,0,1,0
53752,43671,37965,0,0,62,62,0,1,0,1,0
53753,52356,55442,0,0,66,66,0,1,0,1,0
53754,3564,57470,0,0,62,62,0,1,0,1,0
53755,42783,53,31772,53,199,94,105,2,30,1,1
53756,39834,53,46672,53,199,94,105,2,30,1,1
53757,51270,48061,59473,48061,70,70,0,2,8,2,0
53758,41295,443,9928,443,1482,988,494,12,26,7,5
53759,3578,51505,0,0,66,66,0,1,0,1,0
53760,53085,445,0,0,70,70,0,1,0,1,0
53761,53083,445,0,0,70,70,0,1,0,1,0
53762,53080,445,0,0,70,70,0,1,0,1,0
53763,53075,445,0,0,70,70,0,1,0,1,0
53764,53074,445,0,0,70,70,0,1,0,1,0
53765,50143,35253,0,0,62,62,0,1,0,1,0
53766,58054,445,0,0,70,70,0,1,0,1,0
53767,58053,445,0,0,70,70,0,1,0,1,0
53768,58049,445,0,0,70,70,0,1,0,1,0
53769,64051,36829,0,0,62,62,0,1,0,1,0
53770,28221,37965,0,0,62,62,0,1,0,1,0
53771,62386,37965,0,0,66,66,0,1,0,1,0
53772,47173,35440,0,0,146,146,0,1,0,1,0
53773,16322,57470,0,0,62,62,0,1,0,1,0
53774,53063,445,0,0,70,70,0,1,0,1,0
53775,58468,37965,0,0,66,66,0,1,0,1,0
53776,53454,445,0,0,66,66,0,1,0,1,0
53777,37646,53,37646,53,832,106,726,2,30,1,1
53778,37066,443,21003,443,2386,1423,963,18,169,10,8
53779,58780,443,38855,443,8661,1687,6974,30,244,16,14
53780,65471,443,32170,443,92569,4939,87630,111,15,45,66
53781,65118,53,14399,53,539,91,448,4,43,2,2
53782,55613,56511,52356,56511,504,318,186,8,15,5,3
53783,63971,53,59567,53,358,94,264,4,45,2,2
53784,55889,53,31264,53,177,94,83,2,29,1,1
53785,56448,53,60650,53,177,94,83,2,29,1,1
53786,52957,80,46330,80,156378,5406,150972,165,383,60,105
53787,64540,53,44077,53,352,107,245,4,37,2,2
53788,60404,37869,39714,37869,258,70,188,4,8,2,2
53789,56799,1,48991,1,316,136,180,6,6,3,3
53790,64407,53,18646,53,232,110,122,2,29,1,1
53791,53115,40693,57479,40693,70,70,0,1,5,1,0
53792,51513,443,33339,443,75323,6054,69269,110,38,52,58
53793,35515,53,6694,53,199,94,105,2,29,1,1
53794,65111,53,60409,53,198,94,104,2,29,1,1
53795,26900,27017,25827,27017,172,86,86,2,29,1,1
53796,49360,53,44969,53,263,102,161,2,29,1,1
53797,49818,53,22415,53,211,102,109,2,29,1,1
53798,52922,443,7305,443,5583,1390,4193,19,15,9,10
53799,19872,53,19872,53,235,90,145,2,32,1,1
53800,51773,23728,8041,23728,70,70,0,1,5,1,0
53801,5588,5588,0,0,3354,1792,1562,46,193,23,23
53802,65064,53,64961,53,197,94,103,2,30,1,1
53803,29606,53,29606,53,216,90,126,2,30,1,1
53804,27005,27015,58465,27015,881,126,755,2,30,1,1
53805,57867,27019,34880,27019,468,390,78,5,30,4,1
53806,64365,53,32131,53,234,94,140,2,30,1,1
53807,53160,80,36074,80,1213,725,488,10,323,6,4
53808,51776,14645,62934,14645,70,70,0,1,5,1,0
53809,60753,40010,14923,40010,316,136,180,6,6,3,3
53810,46263,7700,25323,7700,1440,956,484,15,35,8,7
53811,51793,12210,40752,12210,70,70,0,2,8,2,0
53812,50648,80,8370,80,62,62,0,1,5,1,0
53813,59975,443,17092,443,7875,3100,4775,42,24,22,20
53814,49913,443,1275,443,4275,2222,2053,24,15,14,10
53815,53577,8999,47694,8999,372,186,186,6,15,3,3
53816,56792,42155,2470,42155,70,70,0,2,8,2,0
53817,49662,443,39223,443,2690,1342,1348,23,19,12,11
53818,55056,53,24229,53,177,94,83,2,30,1,1
53819,44498,53,11053,53,168,78,90,2,30,1,1
53820,63966,53,6914,53,214,102,112,2,30,1,1
53821,48165,53,17622,53,199,94,105,2,30,1,1
53822,50838,53,8440,53,70,70,0,1,30,1,0
53823,27005,27015,14961,27015,884,126,758,2,30,1,1
53824,56266,53,6584,53,245,102,143,2,30,1,1
53825,51505,443,46771,443,645662,22326,623336,743,41,299,444
53826,49202,80,38617,80,3223,605,2618,13,15,7,6
53827,33254,443,31595,443,4838,2974,1864,21,17,13,8
53828,27005,27016,2493,27016,895,126,769,2,30,1,1
53829,52932,80,19505,80,4214,1921,2293,18,383,10,8
53830,13514,53,13514,53,244,98,146,2,32,1,1
53831,7447,53,7447,53,244,98,146,2,32,1,1
53832,51791,56116,1472,56116,70,70,0,2,8,2,0
53833,60406,64337,47861,64337,70,70,0,2,8,2,0
53834,42165,443,38543,443,7583,607,6976,18,119,7,11
53835,57790,443,14547,443,6321,3341,2980,19,135,9,10
53836,46762,443,18994,443,565251,13665,551586,542,30,173,369
53837,56405,443,34557,443,6202,1212,4990,27,1197,8,19
53838,27005,27025,44976,27025,893,126,767,2,30,1,1
53839,53490,80,9100,80,2577,1278,1299,14,267,8,6
53840,52732,80,5693,80,23509,14666,8843,70,553,38,32
53841,56791,11500,39420,11500,70,70,0,2,8,2,0
53842,55611,58049,54667,58049,504,318,186,8,15,5,3
53843,28004,443,21121,443,5517,1390,4127,18,15,9,9
53844,26900,27017,23576,27017,340,82,258,5,29,2,3
53845,59756,53,24009,53,211,78,133,2,29,1,1
53846,56970,80,14502,80,1783,841,942,10,20,6,4
53847,27005,27015,4886,27015,876,126,750,2,30,1,1
53848,64481,53,22915,53,386,106,280,4,51,2,2
53849,26900,27017,12614,27017,422,164,258,6,29,3,3
53850,42956,443,56970,443,11435,2668,8767,38,233,14,24
53851,55889,53,19175,53,177,94,83,2,29,1,1
53852,57788,443,31761,443,6400,1327,5073,21,21,13,8
53853,44389,53,44389,53,235,90,145,2,32,1,1
53854,56745,53,50042,53,900,110,790,2,30,1,1
53855,34988,53,12799,53,199,94,105,2,30,1,1
53856,60469,53,22418,53,78,78,0,1,30,1,0
53857,51217,443,21771,443,126,60,66,3,5,2,1
53858,51774,16930,9118,16930,70,70,0,1,5,1,0
53859,49686,443,60868,443,8475,1661,6814,32,76,14,18
53860,46262,123,34977,123,184,94,90,2,30,1,1
53861,49986,53,35150,53,209,94,115,2,30,1,1
53862,60752,28080,38222,28080,70,70,0,2,8,2,0
53863,51268,47662,19145,47662,70,70,0,1,5,1,0
53864,49798,53,59765,53,365,97,268,4,40,2,2
53865,42917,53,23421,53,168,78,90,2,30,1,1
53866,52318,443,6808,443,9453,2797,6656,46,32,25,21
53867,27005,27015,56758,27015,869,126,743,2,30,1,1
53868,27005,27015,46152,27015,875,126,749,2,30,1,1
53869,60281,443,39585,443,63696,4774,58922,83,125,32,51
53870,41476,53,41476,53,235,90,145,2,33,1,1
53871,51794,53911,31763,53911,70,70,0,2,8,2,0
53872,51795,60258,12488,60258,70,70,0,2,8,2,0
53873,56617,80,63909,80,234,234,0,4,12,4,0
53874,49556,443,13898,443,6440,1844,4596,22,141,11,11
53875,8180,53,8180,53,220,90,130,2,30,1,1
53876,64415,53,14789,53,228,102,126,2,30,1,1
53877,56192,53,54480,53,177,94,83,2,30,1,1
53878,64678,53,21797,53,229,110,119,2,30,1,1
53879,27005,27015,19285,27015,892,126,766,2,30,1,1
53880,58805,443,39224,443,9030,2311,6719,24,362,13,11
53881,60408,55557,44331,55557,70,70,0,2,8,2,0
53882,57470,24874,7043,24874,132,132,0,3,1199,3,0
53883,50265,55243,25034,55243,481,150,331,2,1200,1,1
53884,50186,443,39007,443,6440,1603,4837,23,361,11,12
53885,17750,1024,34469,1024,323,150,173,2,1200,1,1
53886,49657,443,29231,443,9039,2175,6864,32,20,17,15
53887,56192,53,12282,53,282,87,195,4,45,2,2
53888,59974,443,48312,443,200862,57949,142913,361,24,172,189
53889,56140,53,23511,53,195,86,109,2,30,1,1
53890,63787,18318,40020,18318,66,66,0,2,8,2,0
53891,53601,30160,44927,30160,70,70,0,2,8,2,0
53892,59980,443,52666,443,345468,18536,326932,432,22,200,232
53893,52763,443,13803,443,256711,14141,242570,367,96,152,215
53894,36025,443,36025,443,4585,1678,2907,19,29,11,8
53895,64973,53,36407,53,257,102,155,2,30,1,1
53896,57096,53,51826,53,177,94,83,2,30,1,1
53897,52921,443,13055,443,5581,1388,4193,19,15,9,10
53898,28003,443,64020,443,5515,1388,4127,18,15,9,9
53899,52412,443,22141,443,11565,5557,6008,52,16,27,25
53900,49743,53,12081,53,636,202,434,6,47,3,3
53901,65511,53,22579,53,545,136,409,4,56,2,2
53902,56363,53,52930,53,212,102,110,2,30,1,1
53903,65209,57866,0,0,62,62,0,1,0,1,0
53904,58043,445,0,0,70,70,0,1,0,1,0
53905,53419,28189,0,0,60,60,0,1,0,1,0
53906,2323,23117,0,0,62,62,0,1,0,1,0
53907,18091,23,0,0,60,60,0,1,0,1,0
53908,6889,40740,0,0,143,143,0,1,0,1,0
53909,58787,23,0,0,60,60,0,1,0,1,0
53910,64940,36237,0,0,62,62,0,1,0,1,0
53911,53059,445,0,0,70,70,0,1,0,1,0
53912,1024,57470,0,0,62,62,0,1,0,1,0
53913,53449,445,0,0,66,66,0,1,0,1,0
53914,53448,445,0,0,66,66,0,1,0,1,0
53915,52064,22114,0,0,66,66,0,1,0,1,0
53916,58036,445,0,0,70,70,0,1,0,1,0
53917,53049,445,0,0,70,70,0,1,0,1,0
53918,53050,445,0,0,70,70,0,1,0,1,0
53919,2923,57470,0,0,66,66,0,1,0,1,0
53920,4127,26467,0,0,66,66,0,1,0,1,0
53921,53044,445,0,0,70,70,0,1,0,1,0
53922,53045,445,0,0,70,70,0,1,0,1,0
53923,58030,445,0,0,70,70,0,1,0,1,0
53924,58027,445,0,0,70,70,0,1,0,1,0
53925,58023,445,0,0,70,70,0,1,0,1,0
53926,53043,445,0,0,70,70,0,1,0,1,0
53927,53447,445,0,0,66,66,0,1,0,1,0
53928,80,37649,0,0,60,60,0,1,0,1,0
53929,59781,56205,0,0,66,66,0,1,0,1,0
53930,6881,59353,0,0,146,146,0,1,0,1,0
53931,6881,29517,0,0,146,146,0,1,0,1,0
53932,58020,445,0,0,70,70,0,1,0,1,0
53933,58017,445,0,0,70,70,0,1,0,1,0
53934,58015,445,0,0,70,70,0,1,0,1,0
53935,58013,445,0,0,70,70,0,1,0,1,0
53936,53439,445,0,0,66,66,0,1,0,1,0
53937,53037,445,0,0,70,70,0,1,0,1,0
53938,53242,37965,0,0,66,66,0,1,0,1,0
53939,53433,445,0,0,66,66,0,1,0,1,0
53940,53432,445,0,0,66,66,0,1,0,1,0
53941,53431,445,0,0,66,66,0,1,0,1,0
53942,80,53945,0,0,60,60,0,1,0,1,0
53943,19747,37965,0,0,62,62,0,1,0,1,0
53944,53427,445,0,0,66,66,0,1,0,1,0
53945,53428,445,0,0,66,66,0,1,0,1,0
53946,53429,445,0,0,66,66,0,1,0,1,0
53947,50067,64147,0,0,66,66,0,1,0,1,0
53948,29203,26467,0,0,62,62,0,1,0,1,0
53949,6416,22114,0,0,66,66,0,1,0,1,0
53950,53029,445,0,0,70,70,0,1,0,1,0
53951,36930,22,36930,22,293,126,167,4,0,2,2
53952,5222,48709,0,0,66,66,0,1,0,1,0
53953,53027,445,0,0,70,70,0,1,0,1,0
53954,58011,445,0,0,70,70,0,1,0,1,0
53955,58010,445,0,0,70,70,0,1,0,1,0
53956,58008,445,0,0,70,70,0,1,0,1,0
53957,53425,445,0,0,66,66,0,1,0,1,0
53958,58004,445,0,0,70,70,0,1,0,1,0
53959,49842,7302,0,0,66,66,0,1,0,1,0
53960,53421,445,0,0,66,66,0,1,0,1,0
53961,57478,7302,0,0,66,66,0,1,0,1,0
53962,50820,57470,0,0,66,66,0,1,0,1,0
53963,17837,62609,0,0,148,148,0,1,0,1,0
53964,53418,445,0,0,66,66,0,1,0,1,0
53965,53419,445,0,0,66,66,0,1,0,1,0
53966,53023,445,0,0,70,70,0,1,0,1,0
53967,63305,62413,0,0,62,62,0,1,0,1,0
53968,53415,445,0,0,66,66,0,1,0,1,0
53969,53021,445,0,0,70,70,0,1,0,1,0
53970,443,64347,0,0,131,131,0,1,0,1,0
53971,3541,22114,0,0,62,62,0,1,0,1,0
53972,53017,445,0,0,70,70,0,1,0,1,0
53973,57996,445,0,0,70,70,0,1,0,1,0
53974,26722,11446,0,0,62,62,0,1,0,1,0
53975,57995,445,0,0,70,70,0,1,0,1,0
53976,57990,445,0,0,70,70,0,1,0,1,0
53977,26084,36237,0,0,66,66,0,1,0,1,0
53978,58468,57587,0,0,66,66,0,1,0,1,0
53979,53016,445,0,0,70,70,0,1,0,1,0
53980,57789,30188,0,0,62,62,0,1,0,1,0
53981,19534,26467,0,0,66,66,0,1,0,1,0
53982,53405,445,0,0,66,66,0,1,0,1,0
53983,50878,53733,0,0,66,66,0,1,0,1,0
53984,27064,51221,0,0,72,72,0,1,0,1,0
53985,61701,44847,0,0,66,66,0,1,0,1,0
53986,49628,35440,0,0,66,66,0,1,0,1,0
53987,19610,9571,0,0,62,62,0,1,0,1,0
53988,443,9986,0,0,66,66,0,1,0,1,0
53989,443,9986,0,0,152,152,0,1,0,1,0
53990,57060,50584,0,0,62,62,0,1,0,1,0
53991,53011,445,0,0,70,70,0,1,0,1,0
53992,53397,445,0,0,66,66,0,1,0,1,0
53993,51725,56205,0,0,62,62,0,1,0,1,0
53994,0,0,0,0,98,98,0,1,0,1,0
53995,0,0,0,0,98,98,0,1,0,1,0
53996,53395,445,0,0,66,66,0,1,0,1,0
53997,1888,51505,0,0,62,62,0,1,0,1,0
53998,52431,50265,0,0,62,62,0,1,0,1,0
53999,25565,30367,0,0,60,60,0,1,0,1,0
54000,65512,44847,0,0,62,62,0,1,0,1,0
54001,53388,445,0,0,66,66,0,1,0,1,0
54002,52998,445,0,0,70,70,0,1,0,1,0
54003,51760,50584,0,0,62,62,0,1,0,1,0
54004,53377,445,0,0,66,66,0,1,0,1,0
54005,51674,51505,0,0,66,66,0,1,0,1,0
54006,23274,50584,0,0,62,62,0,1,0,1,0
54007,59055,11392,0,0,62,62,0,1,0,1,0
54008,54062,49813,0,0,62,62,0,1,0,1,0
54009,52447,43890,0,0,66,66,0,1,0,1,0
54010,52995,445,0,0,70,70,0,1,0,1,0
54011,80,9918,0,0,60,60,0,1,0,1,0
54012,49976,22114,0,0,62,62,0,1,0,1,0
54013,443,52365,0,0,97,97,0,1,0,1,0
54014,36908,26467,0,0,62,62,0,1,0,1,0
54015,57965,445,0,0,70,70,0,1,0,1,0
54016,57967,445,0,0,70,70,0,1,0,1,0
54017,57964,445,0,0,70,70,0,1,0,1,0
54018,53371,445,0,0,66,66,0,1,0,1,0
54019,53372,445,0,0,66,66,0,1,0,1,0
54020,53370,445,0,0,66,66,0,1,0,1,0
54021,53369,445,0,0,66,66,0,1,0,1,0
54022,53368,445,0,0,66,66,0,1,0,1,0
54023,53367,445,0,0,66,66,0,1,0,1,0
54024,53366,445,0,0,66,66,0,1,0,1,0
54025,53365,445,0,0,66,66,0,1,0,1,0
54026,23776,57354,0,0,145,145,0,1,0,1,0
54027,45079,31573,0,0,62,62,0,1,0,1,0
54028,52990,445,0,0,70,70,0,1,0,1,0
54029,57654,35440,0,0,66,66,0,1,0,1,0
54030,52989,445,0,0,70,70,0,1,0,1,0
54031,61520,23718,0,0,66,66,0,1,0,1,0
54032,27147,22114,0,0,62,62,0,1,0,1,0
54033,26528,51221,0,0,78,78,0,1,0,1,0
54034,62776,62413,0,0,62,62,0,1,0,1,0
54035,52987,445,0,0,70,70,0,1,0,1,0
54036,54600,6881,0,0,66,66,0,1,0,1,0
54037,65454,61600,0,0,66,66,0,1,0,1,0
54038,46478,64147,0,0,62,62,0,1,0,1,0
54039,62737,64147,0,0,66,66,0,1,0,1,0
54040,53460,443,38830,443,25079,5739,19340,39,337,18,21
54041,11592,80,11592,80,6967,765,6202,15,16,7,8
54042,55021,443,3999,443,5987,1556,4431,19,47,12,7
54043,57194,53,31354,53,2198,193,2005,6,90,3,3
54044,53009,80,53009,80,378,180,198,7,17,4,3
54045,41625,15000,38798,15000,130,70,60,2,5,1,1
54046,59420,443,62141,443,2854,1732,1122,16,15,8,8
54047,54135,443,36564,443,11065,1394,9671,23,75,13,10
54048,57140,53,16030,53,170,87,83,2,30,1,1
54049,51772,59814,9968,59814,66,66,0,1,5,1,0
54050,52107,443,6381,443,12091,3135,8956,30,49,16,14
54051,58885,15000,9072,15000,138,78,60,2,5,1,1
54052,55584,53,31260,53,184,80,104,2,30,1,1
54053,37444,53,37444,53,213,79,134,2,32,1,1
54054,60017,443,51690,443,134,60,74,3,10,2,1
54055,61467,443,56685,443,130792,4916,125876,161,89,69,92
54056,39336,443,55309,443,7759,4000,3759,23,96,11,12
54057,58259,53,21594,53,578,286,292,9,15,5,4
54058,55540,443,32830,443,10458,5272,5186,24,76,13,11
54059,55786,53,21732,53,170,87,83,2,30,1,1
54060,39611,443,2531,443,78,78,0,1,5,1,0
54061,61469,443,16667,443,6204,1125,5079,23,89,13,10
54062,54137,443,45668,443,10046,1394,8652,22,75,13,9
54063,61493,443,44435,443,5325,1242,4083,23,27,13,10
54064,54134,443,5561,443,10425,1383,9042,23,75,13,10
54065,61494,443,60069,443,14558,2653,11905,33,27,18,15
54066,59419,443,5544,443,2854,1732,1122,16,15,8,8
54067,61462,443,27750,443,6271,1191,5080,24,94,14,10
54068,56360,53,64885,53,711,87,624,2,30,1,1
54069,55800,53,53999,53,711,87,624,2,30,1,1
54070,49685,443,41646,443,8435,1687,6748,30,76,14,16
54071,50564,443,64623,443,1894028,31411,1862617,1579,122,209,1370
54072,54136,443,41489,443,10109,1394,8715,22,75,13,9
54073,2084,7000,2084,7000,3566,1999,1567,16,15,8,8
54074,56626,443,26601,443,7941,1952,5989,20,15,11,9
54075,61465,80,64777,80,17320,9430,7890,67,93,35,32
54076,35053,80,19912,80,71843,2833,69010,83,15,36,47
54077,61468,443,50536,443,6265,1185,5080,24,89,14,10
54078,61464,80,54948,80,366,180,186,7,93,4,3
54079,56627,443,11832,443,7889,1900,5989,20,15,11,9
54080,61461,443,31107,443,9073,2899,6174,36,94,19,17
54081,61466,443,43127,443,6205,1125,5080,23,89,13,10
54082,63793,53,63793,53,237,91,146,2,33,1,1
54083,58994,443,24369,443,204,70,134,4,25,2,2
54084,56625,443,59240,443,7888,1899,5989,20,15,11,9
54085,59418,443,6727,443,2946,1812,1134,16,15,8,8
54086,56624,443,34630,443,7940,1951,5989,20,16,11,9
54087,41335,53,41335,53,825,99,726,2,30,1,1
54088,48720,53,0,0,82,82,0,1,30,1,0
54089,56472,53,0,0,371,77,294,2,30,1,1
54090,65386,443,29589,443,5405,4034,1371,25,43,10,15
54091,48533,443,47218,443,160,69,91,2,121,1,1
54092,13262,53,13262,53,208,94,114,2,31,1,1
54093,36986,53,36986,53,234,93,141,2,31,1,1
54094,5431,53,5431,53,224,88,136,2,31,1,1
54095,7176,53,7176,53,233,91,142,2,31,1,1
54096,5938,47512,0,0,60,60,0,1,90,1,0
54097,55542,53,5269,53,711,87,624,2,31,1,1
54098,52151,53,52151,53,198,89,109,2,31,1,1
54099,11835,53,11835,53,216,88,128,2,31,1,1
54100,27386,53,27386,53,194,87,107,2,31,1,1
54101,52677,53,52677,53,233,91,142,2,31,1,1
54102,56282,53,56282,53,194,87,107,2,31,1,1
54103,55128,53,34503,53,711,87,624,2,31,1,1
54104,50038,53,0,0,275,85,190,2,31,1,1
54105,50038,53,0,0,275,85,190,2,31,1,1
54106,57470,32177,25835,32177,480,149,331,2,1200,1,1
54107,30960,45692,4911,45692,330,330,0,6,3609,6,0
54108,61896,34021,0,0,66,66,0,1,91,1,0
54109,32618,53,32618,53,231,90,141,2,31,1,1
54110,47063,53,47063,53,221,89,132,2,31,1,1
54111,58178,53,58178,53,237,93,144,2,31,1,1
54112,8762,53,8762,53,233,91,142,2,31,1,1
54113,63755,53,63755,53,223,92,131,2,31,1,1
54114,41199,443,15931,443,30604,3050,27554,45,122,18,27
54115,59267,53,59267,53,222,87,135,2,31,1,1
54116,55072,53,31850,53,168,86,82,2,31,1,1
54117,49432,5228,59843,5228,10635,3087,7548,41,3661,22,19
54118,54693,30188,0,0,66,66,0,1,0,1,0
54119,57963,445,0,0,70,70,0,1,0,1,0
54120,57961,445,0,0,70,70,0,1,0,1,0
54121,57956,445,0,0,70,70,0,1,0,1,0
54122,8239,37965,0,0,146,146,0,1,0,1,0
54123,53352,445,0,0,66,66,0,1,0,1,0
54124,53351,445,0,0,66,66,0,1,0,1,0
54125,53349,445,0,0,66,66,0,1,0,1,0
54126,52980,445,0,0,70,70,0,1,0,1,0
54127,4447,35440,0,0,66,66,0,1,0,1,0
54128,57946,445,0,0,70,70,0,1,0,1,0
54129,51192,15503,0,0,66,66,0,1,0,1,0
54130,60751,20010,54269,20010,70,70,0,2,8,2,0
54131,55786,53,23026,53,177,94,83,2,30,1,1
54132,59984,443,19518,443,1527,940,587,14,21,8,6
54133,59982,443,1995,443,1467,880,587,13,21,7,6
54134,53603,53796,63183,53796,70,70,0,2,7,2,0
54135,52978,445,0,0,70,70,0,1,0,1,0
54136,21892,15503,0,0,62,62,0,1,0,1,0
54137,4961,62741,0,0,66,66,0,1,0,1,0
54138,39895,26467,0,0,62,62,0,1,0,1,0
54139,52977,445,0,0,70,70,0,1,0,1,0
54140,57944,445,0,0,70,70,0,1,0,1,0
54141,26800,22,0,0,60,60,0,1,0,1,0
54142,52976,445,0,0,70,70,0,1,0,1,0
54143,52975,445,0,0,70,70,0,1,0,1,0
54144,57943,445,0,0,70,70,0,1,0,1,0
54145,57934,445,0,0,70,70,0,1,0,1,0
54146,57936,445,0,0,70,70,0,1,0,1,0
54147,52971,445,0,0,70,70,0,1,0,1,0
54148,52970,445,0,0,70,70,0,1,0,1,0
54149,61426,64910,0,0,66,66,0,1,0,1,0
54150,50717,9571,0,0,62,62,0,1,0,1,0
54151,21420,44847,0,0,66,66,0,1,0,1,0
54152,42252,33303,0,0,60,60,0,1,0,1,0
54153,52957,445,0,0,70,70,0,1,0,1,0
54154,52956,445,0,0,70,70,0,1,0,1,0
54155,52953,445,0,0,70,70,0,1,0,1,0
54156,443,64347,0,0,60,60,0,1,0,1,0
54157,52945,445,0,0,70,70,0,1,0,1,0
54158,52946,445,0,0,70,70,0,1,0,1,0
54159,55056,53,38233,53,177,94,83,2,29,1,1
54160,49940,53,29743,53,197,94,103,2,29,1,1
54161,56646,53,30377,53,177,94,83,2,30,1,1
54162,51103,80,39889,80,2792,2073,719,15,30,9,6
54163,63786,50091,30767,50091,66,66,0,2,7,2,0
54164,59608,443,1997,443,2149,1277,872,18,829,10,8
54165,53602,12395,26422,12395,70,70,0,2,7,2,0
54166,59981,443,57380,443,180817,9921,170896,241,21,116,125
54167,55462,53,41879,53,194,102,92,2,33,1,1
54168,55417,53,62498,53,198,102,96,2,32,1,1
54169,51975,443,14807,443,29510,15378,14132,76,216,35,41
54170,123,123,55557,123,184,94,90,2,29,1,1
54171,56646,53,16936,53,177,94,83,2,29,1,1
54172,54427,443,64059,443,2878,1252,1626,16,361,9,7
54173,51100,80,29611,80,12300,4454,7846,26,30,13,13
54174,55615,13826,16730,13826,70,70,0,1,5,1,0
54175,27490,53,27490,53,214,82,132,2,33,1,1
54176,49176,443,60169,443,533295,14310,518985,552,18,201,351
54177,61472,443,58092,443,6211,1132,5079,23,88,13,10
54178,58557,443,4317,443,114852,43911,70941,248,69,132,116
54179,42106,443,29417,443,5361,973,4388,18,15,10,8
54180,49752,53,64105,53,193,102,91,2,30,1,1
54181,52407,443,29892,443,1043,556,487,10,16,6,4
54182,60455,443,23230,443,25055,5440,19615,65,84,35,30
54183,2083,7000,2083,7000,3374,1535,1839,16,15,8,8
54184,61833,443,61833,443,80743,4724,76019,101,89,37,64
54185,55041,53,58764,53,234,94,140,2,30,1,1
54186,43677,443,54935,443,30090,19982,10108,77,543,41,36
54187,55614,29731,26252,29731,70,70,0,1,5,1,0
54188,57140,53,49557,53,177,94,83,2,30,1,1
54189,37697,443,26341,443,2071929,56793,2015136,2088,179,685,1403
54190,51771,19103,1964,19103,70,70,0,1,5,1,0
54191,55254,443,12972,443,3257,782,2475,17,140,8,9
54192,50151,53,24855,53,177,94,83,2,30,1,1
54193,61470,443,10942,443,12420,4900,7520,47,88,24,23
54194,52408,443,37575,443,1043,556,487,10,16,6,4
54195,56798,40759,43301,40759,70,70,0,1,5,1,0
54196,61463,443,9374,443,11355,3474,7881,45,93,22,23
54197,42599,443,19054,443,215284,28807,186477,346,129,151,195
54198,55607,17820,29778,17820,504,318,186,8,16,5,3
54199,56569,53,52915,53,94,94,0,1,30,1,0
54200,64537,53,63183,53,718,94,624,2,30,1,1
54201,55610,23383,13424,23383,70,70,0,1,5,1,0
54202,43205,22,43205,22,6957,2330,4627,35,27,17,18
54203,55429,443,25959,443,6292,4834,1458,18,129,11,7
54204,46695,443,28304,443,12787534,288179,12499355,12299,64,4036,8263
54205,44836,443,51394,443,34881,6721,28160,62,46,30,32
54206,2085,7010,2085,7010,3342,1983,1359,16,15,8,8
54207,49724,443,21055,443,4139,511,3628,12,15,6,6
54208,37310,443,2394,443,3950,2949,1001,26,69,15,11
54209,51102,80,31602,80,2794,2075,719,15,30,9,6
54210,50638,443,62460,443,14401,2712,11689,52,19,23,29
54211,55836,53,41454,53,181,94,87,2,33,1,1
54212,49374,53,26610,53,307,102,205,4,35,2,2
54213,49658,443,50327,443,14121,2299,11822,37,19,19,18
54214,56783,21279,24337,21279,70,70,0,1,5,1,0
54215,59983,443,57676,443,158230,9208,149022,214,21,105,109
54216,1462,41599,48660,41599,70,70,0,2,8,2,0
54217,50202,443,56858,443,8415,3119,5296,26,73,9,17
54218,64779,53,46294,53,497,102,395,4,40,2,2
54219,39570,443,58125,443,127970,4968,123002,144,30,53,91
54220,61471,443,26685,443,18168,2973,15195,46,88,21,25
54221,42963,443,15595,443,7681,4711,2970,36,28,17,19
54222,52112,443,29903,443,59796,4486,55310,92,48,45,47
54223,58302,443,37691,443,4611,3176,1435,26,30,15,11
54224,26865,443,47610,443,20959,15902,5057,38,20,21,17
54225,64636,53,42647,53,727,223,504,6,70,3,3
54226,27005,23010,35544,23010,881,126,755,2,29,1,1
54227,49284,53,32626,53,245,102,143,2,29,1,1
54228,49163,36069,48102,36069,5990,5698,292,17,51,14,3
54229,57096,53,50734,53,177,94,83,2,29,1,1
54230,49844,53,30878,53,755,102,653,2,30,1,1
54231,55777,53,11730,53,200,94,106,2,30,1,1
54232,55699,53,21219,53,211,102,109,2,29,1,1
54233,35546,443,6886,443,5198,973,4225,16,17,10,6
54234,49203,53,26385,53,240,94,146,2,29,1,1
54235,55669,53,15322,53,94,94,0,1,29,1,0
54236,55786,53,33325,53,177,94,83,2,30,1,1
54237,57397,53,56026,53,177,94,83,2,31,1,1
54238,65269,53,55640,53,273,134,139,2,30,1,1
54239,65291,53,62097,53,247,118,129,2,30,1,1
54240,49234,53,59585,53,177,94,83,2,30,1,1
54241,23514,53,23514,53,245,98,147,2,30,1,1
54242,49792,443,37527,443,9841,3185,6656,25,186,14,11
54243,40985,443,29028,443,3166,2097,1069,24,46,12,12
54244,60401,30046,40405,30046,70,70,0,1,5,1,0
54245,55609,39869,60499,39869,70,70,0,1,5,1,0
54246,39571,443,44587,443,580560,15724,564836,583,30,187,396
54247,39573,443,27028,443,29226,2150,27076,44,30,19,25
54248,39569,443,5001,443,1784075,46752,1737323,1812,47,606,1206
54249,57004,53,12740,53,195,78,117,2,30,1,1
54250,56551,53,25599,53,225,102,123,2,30,1,1
54251,45816,443,14384,443,21950,3632,18318,46,140,20,26
54252,49160,14387,38901,14387,854,150,704,4,1200,2,2
54253,1609,53,1609,53,197,90,107,2,30,1,1
54254,63526,3389,63526,3389,4365,2581,1784,20,33,11,9
54255,32811,443,18226,443,16652,13777,2875,48,44,27,21
54256,39572,443,50194,443,64247,3857,60390,94,30,43,51
54257,58056,443,35080,443,10493,2658,7835,50,1469,26,24
54258,60400,56243,17811,56243,70,70,0,1,5,1,0
54259,60822,443,12029,443,7839,2697,5142,21,137,10,11
54260,63967,53,22995,53,195,102,93,2,33,1,1
54261,51790,46839,55080,46839,70,70,0,2,8,2,0
54262,57140,53,49322,53,177,94,83,2,30,1,1
54263,63972,53,28656,53,325,94,231,2,30,1,1
54264,50151,53,38506,53,177,94,83,2,30,1,1
54265,57397,53,60967,53,177,94,83,2,30,1,1
54266,55539,53,25818,53,249,94,155,2,31,1,1
54267,37965,14259,39595,14259,150,150,0,1,1199,1,0
54268,52048,443,14008,443,3182,1568,1614,8,120,4,4
54269,49919,53,2531,53,225,102,123,2,30,1,1
54270,27005,1102,9620,1102,867,126,741,2,30,1,1
54271,49672,53,36807,53,718,94,624,2,30,1,1
54272,49509,53,2190,53,339,110,229,2,30,1,1
54273,49757,53,31813,53,177,94,83,2,31,1,1
54274,53521,443,20457,443,280,140,140,5,129,3,2
54275,6881,37957,48141,37957,509,150,359,2,1199,1,1
54276,51221,9869,40891,9869,870,330,540,12,1298,6,6
54277,37272,443,58616,443,10809,2465,8344,45,121,21,24
54278,37989,49152,16381,49152,156,156,0,3,8,3,0
54279,58969,80,39801,80,1431,783,648,10,75,6,4
54280,51247,443,62660,443,5747,1892,3855,19,16,11,8
54281,57117,443,28755,443,8997,1155,7842,19,76,11,8
54282,50905,80,47395,80,11749346,149441,11599905,10089,147,2116,7973
54283,41210,443,59857,443,78,78,0,1,5,1,0
54284,58796,443,14867,443,7402,2429,4973,40,139,22,18
54285,58802,443,37884,443,8591,2275,6316,37,137,21,16
54286,51237,443,50232,443,9668,4698,4970,42,16,25,17
54287,55113,53,62810,53,198,102,96,2,33,1,1
54288,49665,53,6360,53,779,298,481,8,67,4,4
54289,27005,1108,19358,1108,873,126,747,2,30,1,1
54290,49628,443,14591,443,12843,3808,9035,26,81,13,13
54291,63783,1375,0,0,109,109,0,1,0,1,0
54292,19698,502,0,0,60,60,0,1,0,1,0
54293,18415,37965,0,0,62,62,0,1,0,1,0
54294,53419,28189,0,0,60,60,0,1,0,1,0
54295,21145,11392,0,0,62,62,0,1,0,1,0
54296,57925,445,0,0,70,70,0,1,0,1,0
54297,57927,445,0,0,70,70,0,1,0,1,0
54298,57921,445,0,0,70,70,0,1,0,1,0
54299,16393,22114,0,0,62,62,0,1,0,1,0
54300,30922,22,0,0,60,60,0,1,0,1,0
54301,41482,23,0,0,60,60,0,1,0,1,0
54302,52934,445,0,0,70,70,0,1,0,1,0
54303,80,56289,0,0,1090,1090,0,1,0,1,0
54304,53469,44847,0,0,66,66,0,1,0,1,0
54305,16660,55783,0,0,62,62,0,1,0,1,0
54306,16361,60888,0,0,146,146,0,1,0,1,0
54307,54062,31573,0,0,66,66,0,1,0,1,0
54308,53328,445,0,0,66,66,0,1,0,1,0
54309,57918,445,0,0,70,70,0,1,0,1,0
54310,57915,445,0,0,70,70,0,1,0,1,0
54311,62827,1,0,0,66,66,0,1,0,1,0
54312,50804,1,0,0,62,62,0,1,0,1,0
54313,3270,35440,0,0,62,62,0,1,0,1,0
54314,52930,445,0,0,70,70,0,1,0,1,0
54315,59592,37965,0,0,62,62,0,1,0,1,0
54316,53321,445,0,0,66,66,0,1,0,1,0
54317,52921,445,0,0,70,70,0,1,0,1,0
54318,52919,445,0,0,70,70,0,1,0,1,0
54319,37903,23,0,0,60,60,0,1,0,1,0
54320,52918,445,0,0,70,70,0,1,0,1,0
54321,52917,445,0,0,70,70,0,1,0,1,0
54322,36903,56205,0,0,146,146,0,1,0,1,0
54323,53320,445,0,0,66,66,0,1,0,1,0
54324,8999,32480,0,0,146,146,0,1,0,1,0
54325,57904,445,0,0,70,70,0,1,0,1,0
54326,52914,445,0,0,70,70,0,1,0,1,0
54327,57901,445,0,0,70,70,0,1,0,1,0
54328,57897,445,0,0,70,70,0,1,0,1,0
54329,12608,21247,0,0,66,66,0,1,0,1,0
54330,53317,445,0,0,66,66,0,1,0,1,0
54331,17008,35440,0,0,62,62,0,1,0,1,0
54332,43688,22114,0,0,66,66,0,1,0,1,0
54333,54214,443,38557,443,499,425,74,4,0,3,1
54334,54215,443,45620,443,499,425,74,4,0,3,1
54335,53817,443,41947,443,499,425,74,4,0,3,1
54336,53816,443,52923,443,499,425,74,4,0,3,1
54337,26053,33720,0,0,160,160,0,1,0,1,0
54338,26053,33720,0,0,160,160,0,1,0,1,0
54339,9095,22114,0,0,146,146,0,1,0,1,0
54340,24480,35440,0,0,62,62,0,1,0,1,0
54341,1024,64147,0,0,62,62,0,1,0,1,0
54342,29424,37807,0,0,66,66,0,1,0,1,0
54343,60196,53,0,0,88,88,0,1,0,1,0
54344,57892,445,0,0,70,70,0,1,0,1,0
54345,10006,64147,0,0,62,62,0,1,0,1,0
54346,52907,445,0,0,70,70,0,1,0,1,0
54347,10265,64147,0,0,66,66,0,1,0,1,0
54348,52726,56205,0,0,66,66,0,1,0,1,0
54349,57889,445,0,0,70,70,0,1,0,1,0
54350,57888,445,0,0,70,70,0,1,0,1,0
54351,57885,445,0,0,70,70,0,1,0,1,0
54352,53309,445,0,0,66,66,0,1,0,1,0
54353,34176,51505,0,0,62,62,0,1,0,1,0
54354,53308,445,0,0,66,66,0,1,0,1,0
54355,53304,445,0,0,66,66,0,1,0,1,0
54356,53302,445,0,0,66,66,0,1,0,1,0
54357,10006,64147,0,0,145,145,0,1,0,1,0
54358,55225,11392,0,0,66,66,0,1,0,1,0
54359,53300,445,0,0,66,66,0,1,0,1,0
54360,53301,445,0,0,66,66,0,1,0,1,0
54361,53298,445,0,0,66,66,0,1,0,1,0
54362,21833,22114,0,0,62,62,0,1,0,1,0
54363,30046,15503,0,0,62,62,0,1,0,1,0
54364,1176,64147,0,0,62,62,0,1,0,1,0
54365,52900,445,0,0,70,70,0,1,0,1,0
54366,52898,445,0,0,70,70,0,1,0,1,0
54367,1024,9319,0,0,62,62,0,1,0,1,0
54368,59377,9319,0,0,62,62,0,1,0,1,0
54369,443,51160,0,0,102,102,0,1,0,1,0
54370,63205,9571,0,0,66,66,0,1,0,1,0
54371,58751,9571,0,0,62,62,0,1,0,1,0
54372,54339,23117,0,0,66,66,0,1,0,1,0
54373,57884,445,0,0,70,70,0,1,0,1,0
54374,57882,445,0,0,70,70,0,1,0,1,0
54375,57878,445,0,0,70,70,0,1,0,1,0
54376,6828,64322,0,0,60,60,0,1,0,1,0
54377,443,64347,0,0,60,60,0,1,0,1,0
54378,443,64347,0,0,85,85,0,1,0,1,0
54379,443,64347,0,0,100,100,0,1,0,1,0
54380,53294,445,0,0,66,66,0,1,0,1,0
54381,36966,10387,0,0,159,159,0,1,0,1,0
54382,52893,445,0,0,70,70,0,1,0,1,0
54383,53293,445,0,0,66,66,0,1,0,1,0
54384,52892,445,0,0,70,70,0,1,0,1,0
54385,42241,11392,0,0,66,66,0,1,0,1,0
54386,53290,445,0,0,66,66,0,1,0,1,0
54387,53289,445,0,0,66,66,0,1,0,1,0
54388,53287,445,0,0,66,66,0,1,0,1,0
54389,26053,33720,0,0,160,160,0,1,0,1,0
54390,26053,33720,0,0,160,160,0,1,0,1,0
54391,52888,445,0,0,70,70,0,1,0,1,0
54392,6881,21162,0,0,146,146,0,1,0,1,0
54393,56474,18375,0,0,62,62,0,1,0,1,0
54394,26053,33720,0,0,160,160,0,1,0,1,0
54395,26053,33720,0,0,160,160,0,1,0,1,0
54396,57870,445,0,0,70,70,0,1,0,1,0
54397,26053,33720,0,0,160,160,0,1,0,1,0
54398,52887,445,0,0,70,70,0,1,0,1,0
54399,63852,35440,0,0,62,62,0,1,0,1,0
54400,57864,445,0,0,70,70,0,1,0,1,0
54401,57862,445,0,0,70,70,0,1,0,1,0
54402,22927,48817,0,0,143,143,0,1,0,1,0
54403,0,0,0,0,320,320,0,5,0,5,0
54404,0,0,0,0,274,274,0,2,0,2,0
54405,17640,55442,0,0,66,66,0,1,0,1,0
54406,59168,39004,0,0,62,62,0,1,0,1,0
54407,53278,445,0,0,66,66,0,1,0,1,0
54408,37008,42707,0,0,62,62,0,1,0,1,0
54409,58022,5601,0,0,60,60,0,1,0,1,0
54410,38320,51505,0,0,66,66,0,1,0,1,0
54411,16059,22114,0,0,62,62,0,1,0,1,0
54412,52882,445,0,0,70,70,0,1,0,1,0
54413,50439,64147,0,0,62,62,0,1,0,1,0
54414,53105,42707,0,0,66,66,0,1,0,1,0
54415,53269,445,0,0,66,66,0,1,0,1,0
54416,15959,56205,0,0,66,66,0,1,0,1,0
54417,57850,445,0,0,70,70,0,1,0,1,0
54418,53267,445,0,0,66,66,0,1,0,1,0
54419,64087,50265,0,0,145,145,0,1,0,1,0
54420,22583,9822,0,0,62,62,0,1,0,1,0
54421,38723,15503,0,0,146,146,0,1,0,1,0
54422,52869,445,0,0,70,70,0,1,0,1,0
54423,31021,35440,0,0,62,62,0,1,0,1,0
54424,5357,32468,0,0,66,66,0,1,0,1,0
54425,53258,445,0,0,66,66,0,1,0,1,0
54426,53252,445,0,0,66,66,0,1,0,1,0
54427,443,37338,0,0,118,118,0,1,0,1,0
54428,52866,445,0,0,70,70,0,1,0,1,0
54429,8976,44847,0,0,62,62,0,1,0,1,0
54430,50710,50584,0,0,146,146,0,1,0,1,0
54431,57504,44847,0,0,66,66,0,1,0,1,0
54432,25010,30188,0,0,62,62,0,1,0,1,0
54433,61420,64097,0,0,66,66,0,1,0,1,0
54434,9095,22114,0,0,62,62,0,1,0,1,0
54435,54575,11392,0,0,66,66,0,1,0,1,0
54436,11983,57470,0,0,62,62,0,1,0,1,0
54437,49805,6881,0,0,66,66,0,1,0,1,0
54438,44594,64147,0,0,66,66,0,1,0,1,0
54439,49906,443,16050,443,6754,2219,4535,21,77,11,10
54440,49873,80,19431,80,9540,2954,6586,18,88,8,10
54441,49860,80,9156,80,6892,2154,4738,22,89,12,10
54442,49857,80,39166,80,7800,1743,6057,20,89,11,9
54443,56620,443,7502,443,8033,2013,6020,20,16,11,9
54444,49884,443,34007,443,5265,1647,3618,16,88,9,7
54445,49880,80,21728,80,2087,1215,872,8,88,5,3
54446,38643,443,16669,443,2540,1317,1223,17,28,9,8
54447,56622,443,13170,443,8034,2014,6020,20,15,11,9
54448,56887,53,15975,53,170,87,83,3,56,2,1
54449,49876,80,23793,80,24764,4454,20310,30,88,12,18
54450,49887,443,18602,443,977,590,387,10,87,6,4
54451,38645,443,41278,443,2535,1177,1358,16,28,7,9
54452,38647,443,59827,443,2634,1411,1223,18,28,10,8
54453,50693,443,1637,443,306,120,186,6,23,3,3
54454,62423,443,31493,443,28031,7016,21015,51,45,23,28
54455,36445,443,44215,443,234,234,0,4,12,4,0
54456,49905,443,56801,443,4712,908,3804,18,77,9,9
54457,49874,80,9513,80,9921,2945,6976,19,88,8,11
54458,36500,3142,36500,3142,138,78,60,2,6,1,1
54459,2081,7000,2081,7000,5914,4395,1519,19,15,10,9
54460,30188,53,30188,53,238,95,143,2,30,1,1
54461,49895,80,46026,80,2781,1400,1381,11,87,6,5
54462,38644,443,1255,443,2622,1399,1223,18,28,10,8
54463,2080,7000,2080,7000,754151,15395,738756,762,16,239,523
54464,49858,80,51229,80,1539,674,865,11,89,6,5
54465,49854,80,32743,80,14603,5117,9486,24,89,12,12
54466,49845,80,64041,80,31466,852,30614,32,89,9,23
54467,49913,443,65032,443,976,589,387,10,76,6,4
54468,38646,443,44799,443,2335,1247,1088,15,28,8,7
54469,49861,80,57112,80,4892,1157,3735,16,89,8,8
54470,56623,443,54121,443,7982,1962,6020,20,15,11,9
54471,26843,53,26843,53,209,77,132,2,33,1,1
54472,49852,80,47954,80,8868,3774,5094,20,89,10,10
54473,49850,443,7132,443,7371,1564,5807,18,89,9,9
54474,49879,80,2147,80,2087,1215,872,8,88,5,3
54475,55521,53,35090,53,701,88,613,2,30,1,1
54476,49853,80,30133,80,15055,6439,8616,26,89,14,12
54477,58793,443,33855,443,40456,12307,28149,114,140,58,56
54478,49855,80,46269,80,41720,6568,35152,47,89,17,30
54479,49234,53,38404,53,170,87,83,2,30,1,1
54480,36661,53,36661,53,237,93,144,2,30,1,1
54481,56785,28902,1768,28902,70,70,0,2,8,2,0
54482,53063,443,53063,443,6793,3206,3587,25,52,15,10
54483,56997,53,44658,53,168,86,82,2,30,1,1
54484,40030,80,62413,80,1286,403,883,16,393,4,12
54485,6881,35766,64668,35766,221,111,110,2,1200,1,1
54486,64539,53,5433,53,170,87,83,2,31,1,1
54487,49875,80,61335,80,35824,4558,31266,39,88,13,26
54488,51174,443,5740,443,12037,3531,8506,35,271,18,17
54489,49872,80,54932,80,31938,3363,28575,38,88,15,23
54490,49859,80,31286,80,1529,677,852,11,89,6,5
54491,54269,443,49860,443,5768,3426,2342,22,135,11,11
54492,49856,80,12008,80,13992,1645,12347,23,89,10,13
54493,2082,7000,2082,7000,3022,1567,1455,16,15,8,8
54494,49877,80,36716,80,28450,4547,23903,34,88,13,21
54495,55594,42459,54770,42459,1253,716,537,12,23,7,5
54496,57118,80,7804,80,2404,568,1836,10,75,6,4
54497,37090,443,37090,443,4637,1730,2907,19,30,11,8
54498,60398,443,6115,443,8060,1868,6192,28,16,15,13
54499,44558,443,44558,443,5480,2503,2977,20,15,11,9
54500,49878,80,42487,80,2086,1214,872,8,88,5,3
54501,56621,443,45506,443,7981,1961,6020,20,15,11,9
54502,49863,443,52855,443,7280,1441,5839,17,89,9,8
54503,49844,80,65486,80,18950,788,18162,23,89,8,15
54504,44546,53,44546,53,204,92,112,2,30,1,1
54505,63513,53,63513,53,236,94,142,2,30,1,1
54506,51202,53,51202,53,221,89,132,2,30,1,1
54507,34517,80,7727,80,1056,682,374,10,16,6,4
54508,39119,53,39119,53,221,89,132,2,30,1,1
54509,50107,53,50107,53,216,89,127,2,30,1,1
54510,6881,6881,55325,6881,853,355,498,4,1200,2,2
54511,56876,53,55574,53,711,87,624,2,31,1,1
54512,3382,53,3382,53,220,100,120,2,31,1,1
54513,52795,443,61686,443,7203,2188,5015,23,186,11,12
54514,30960,45691,5004,45691,330,330,0,6,3609,6,0
54515,52862,445,0,0,70,70,0,1,0,1,0
54516,57839,445,0,0,70,70,0,1,0,1,0
54517,57837,445,0,0,70,70,0,1,0,1,0
54518,57836,445,0,0,70,70,0,1,0,1,0
54519,52860,445,0,0,70,70,0,1,0,1,0
54520,53239,445,0,0,66,66,0,1,0,1,0
54521,53241,445,0,0,66,66,0,1,0,1,0
54522,53240,445,0,0,66,66,0,1,0,1,0
54523,53244,445,0,0,66,66,0,1,0,1,0
54524,53243,445,0,0,66,66,0,1,0,1,0
54525,53238,445,0,0,66,66,0,1,0,1,0
54526,53237,445,0,0,66,66,0,1,0,1,0
54527,53236,445,0,0,66,66,0,1,0,1,0
54528,52858,445,0,0,70,70,0,1,0,1,0
54529,43333,50584,0,0,146,146,0,1,0,1,0
54530,24144,57470,0,0,62,62,0,1,0,1,0
54531,30114,65151,0,0,60,60,0,1,0,1,0
54532,53987,57470,0,0,66,66,0,1,0,1,0
54533,12614,22,0,0,60,60,0,1,0,1,0
54534,28498,36237,0,0,62,62,0,1,0,1,0
54535,52913,2767,0,0,66,66,0,1,0,1,0
54536,57828,445,0,0,70,70,0,1,0,1,0
54537,57827,445,0,0,70,70,0,1,0,1,0
54538,57825,445,0,0,70,70,0,1,0,1,0
54539,57500,23,0,0,60,60,0,1,0,1,0
54540,52851,445,0,0,70,70,0,1,0,1,0
54541,59879,55783,0,0,62,62,0,1,0,1,0
54542,52849,445,0,0,70,70,0,1,0,1,0
54543,53223,445,0,0,66,66,0,1,0,1,0
54544,53224,445,0,0,66,66,0,1,0,1,0
54545,53221,445,0,0,66,66,0,1,0,1,0
54546,52848,445,0,0,70,70,0,1,0,1,0
54547,20726,2767,0,0,62,62,0,1,0,1,0
54548,52847,445,0,0,70,70,0,1,0,1,0
54549,52846,445,0,0,70,70,0,1,0,1,0
54550,52843,445,0,0,70,70,0,1,0,1,0
54551,52842,445,0,0,70,70,0,1,0,1,0
54552,53419,28189,0,0,60,60,0,1,0,1,0
54553,57816,445,0,0,70,70,0,1,0,1,0
54554,22724,9822,0,0,66,66,0,1,0,1,0
54555,57810,445,0,0,70,70,0,1,0,1,0
54556,57808,445,0,0,70,70,0,1,0,1,0
54557,57804,445,0,0,70,70,0,1,0,1,0
54558,25360,51505,0,0,62,62,0,1,0,1,0
54559,55157,7302,0,0,66,66,0,1,0,1,0
54560,54617,64147,0,0,62,62,0,1,0,1,0
54561,54276,39004,0,0,62,62,0,1,0,1,0
54562,45941,23388,0,0,60,60,0,1,0,1,0
54563,52828,445,0,0,70,70,0,1,0,1,0
54564,52827,445,0,0,70,70,0,1,0,1,0
54565,32215,22114,0,0,62,62,0,1,0,1,0
54566,52817,445,0,0,70,70,0,1,0,1,0
54567,52818,445,0,0,70,70,0,1,0,1,0
54568,62767,57470,0,0,74,74,0,1,0,1,0
54569,59201,51221,0,0,66,66,0,1,0,1,0
54570,52743,15503,0,0,66,66,0,1,0,1,0
54571,1067,51221,0,0,62,62,0,1,0,1,0
54572,16387,26193,0,0,60,60,0,1,0,1,0
54573,1067,51221,0,0,145,145,0,1,0,1,0
54574,16387,35308,0,0,60,60,0,1,0,1,0
54575,60217,80,16783,80,4050,2838,1212,14,16,7,7
54576,50628,80,65125,80,4349,647,3702,16,22,7,9
54577,59754,53,11671,53,260,86,174,2,30,1,1
54578,40180,443,53378,443,1310,649,661,13,184,7,6
54579,53201,28513,16417,28513,862,562,300,13,145,8,5
54580,46332,443,57498,443,3132,1697,1435,17,15,10,7
54581,56813,53,9920,53,516,136,380,4,40,2,2
54582,50692,443,32817,443,180,60,120,4,15,2,2
54583,65080,53,49569,53,193,102,91,2,29,1,1
54584,27005,1305,58083,1305,855,126,729,2,29,1,1
54585,27005,1308,10914,1308,855,126,729,2,29,1,1
54586,49281,53,58920,53,345,110,235,2,29,1,1
54587,50689,443,64099,443,180,60,120,4,15,2,2
54588,27005,1202,29779,1202,865,126,739,2,29,1,1
54589,27005,1103,52058,1103,822,126,696,2,29,1,1
54590,45935,25,35960,25,511,191,320,9,60,4,5
54591,35377,443,51737,443,15771,2037,13734,39,187,20,19
54592,57140,53,58402,53,177,94,83,2,29,1,1
54593,53113,8372,13040,8372,758,320,438,11,17,6,5
54594,58794,443,45135,443,20298,11977,8321,85,139,45,40
54595,34737,443,45602,443,5586,1338,4248,17,109,9,8
54596,49632,53,31125,53,288,94,194,2,30,1,1
54597,27005,1105,65392,1105,855,126,729,2,29,1,1
54598,56795,35465,29402,35465,70,70,0,1,5,1,0
54599,55653,53,52726,53,94,94,0,1,29,1,0
54600,15111,53,15111,53,210,98,112,2,29,1,1
54601,64212,53,41326,53,215,102,113,2,30,1,1
54602,49234,53,14008,53,177,94,83,2,30,1,1
54603,59755,53,7532,53,211,78,133,2,30,1,1
54604,27005,1106,25259,1106,903,126,777,2,29,1,1
54605,49752,53,10768,53,193,102,91,2,29,1,1
54606,38194,53,38194,53,210,98,112,2,29,1,1
54607,51802,443,19479,443,4426,1518,2908,12,120,6,6
54608,49868,443,36753,443,6251,1706,4545,16,88,9,7
54609,49893,80,42792,80,1376,946,430,8,86,5,3
54610,65384,53,46519,53,197,102,95,2,33,1,1
54611,53666,80,3658,80,3741,3008,733,16,15,10,6
54612,65378,53,49018,53,212,102,110,2,30,1,1
54613,56972,53,28054,53,177,94,83,2,30,1,1
54614,51004,53,15547,53,194,94,100,2,30,1,1
54615,65135,53,23354,53,312,102,210,2,30,1,1
54616,49900,443,38776,443,8417,1173,7244,18,86,9,9
54617,57371,443,2707,443,5619,927,4692,17,15,10,7
54618,36225,443,18751,443,638,350,288,10,26,6,4
54619,56616,80,15252,80,234,234,0,4,12,4,0
54620,36327,80,6199,80,1348,844,504,13,255,8,5
54621,49886,443,58788,443,77867,2411,75456,82,87,27,55
54622,55022,443,12848,443,14634,1801,12833,28,46,14,14
54623,49888,443,29885,443,117085,3435,113650,123,87,43,80
54624,60196,80,43098,80,70,70,0,2,8,2,0
54625,50823,443,51509,443,6601,1120,5481,17,115,9,8
54626,49898,80,5457,80,1550,1157,393,8,86,5,3
54627,51503,443,42971,443,9239,4472,4767,37,39,21,16
54628,65452,53,31972,53,365,102,263,2,30,1,1
54629,43817,443,47281,443,5911,1666,4245,27,18,15,12
54630,51788,35787,52462,35787,70,70,0,2,8,2,0
54631,56972,53,24503,53,177,94,83,2,30,1,1
54632,21859,53,21859,53,242,98,144,2,30,1,1
54633,57272,53,3406,53,373,107,266,4,45,2,2
54634,34670,53,34670,53,257,106,151,2,30,1,1
54635,56997,53,62280,53,86,86,0,1,30,1,0
54636,50568,443,63503,443,15702,3473,12229,50,70,23,27
54637,54167,53,54167,53,242,98,144,2,30,1,1
54638,49891,53,6545,53,375,126,249,2,30,1,1
54639,44242,5228,42163,5228,10823,1636,9187,32,591,11,21
54640,49882,443,5946,443,5019,1424,3595,15,87,9,6
54641,51769,19165,52583,19165,70,70,0,1,5,1,0
54642,56613,443,6770,443,6016,1284,4732,18,984,8,10
54643,53665,80,59537,80,4417,3685,732,16,15,10,6
54644,55072,53,38583,53,86,86,0,1,30,1,0
54645,49757,53,9163,53,177,94,83,2,30,1,1
54646,49234,53,56023,53,177,94,83,2,30,1,1
54647,49647,53,18676,53,361,102,259,2,30,1,1
54648,48817,14888,48817,14888,481,150,331,2,1200,1,1
54649,56796,41431,54757,41431,70,70,0,1,5,1,0
54650,62424,443,60409,443,4650,3116,1534,19,44,10,9
54651,49349,80,23734,80,185645,6753,178892,213,81,89,124
54652,53437,6057,38097,6057,245,245,0,2,30,2,0
54653,56227,53,50602,53,278,102,176,2,30,1,1
54654,40182,443,24953,443,1312,651,661,13,184,7,6
54655,58724,443,33462,443,10179,4285,5894,60,272,31,29
54656,56887,53,8046,53,250,87,163,4,57,2,2
54657,49211,53,35833,53,484,100,384,4,56,2,2
54658,39980,443,30240,443,2674,1386,1288,17,120,8,9
54659,57425,443,33540,443,130,70,60,2,15,1,1
54660,53598,40326,41639,40326,70,70,0,2,7,2,0
54661,55601,44049,44869,44049,504,318,186,8,15,5,3
54662,64448,53,46885,53,353,92,261,4,38,2,2
54663,41193,443,45935,443,6035,782,5253,16,109,8,8
54664,43785,443,28083,443,6017,1285,4732,18,984,8,10
54665,52881,443,3297,443,130,70,60,2,15,1,1
54666,37145,443,8419,443,4578,2334,2244,21,16,12,9
54667,55604,44235,60786,44235,504,318,186,8,15,5,3
54668,51858,443,51858,443,12505,3792,8713,48,255,24,24
54669,37990,49152,47344,49152,156,156,0,3,7,3,0
54670,51236,443,52300,443,7950,2502,5448,38,15,22,16
54671,60394,80,52231,80,2047,701,1346,16,26,5,11
54672,55847,443,25138,443,8443,1430,7013,17,141,8,9
54673,55462,53,36387,53,579,88,491,4,35,2,2
54674,56782,49135,53247,49135,70,70,0,1,5,1,0
54675,62422,443,30175,443,16258,11067,5191,37,45,21,16
54676,49846,80,53092,80,2644,1918,726,11,89,7,4
54677,49881,80,7229,80,1965,1450,515,7,87,5,2
54678,49901,443,33276,443,5583,1567,4016,16,85,9,7
54679,47694,443,24366,443,23751,3197,20554,42,170,19,23
54680,49889,80,51133,80,1376,946,430,8,87,5,3
54681,27005,1306,35061,1306,858,126,732,2,29,1,1
54682,49650,53,14821,53,821,102,719,2,29,1,1
54683,45159,443,45159,443,5329,2082,3247,22,40,13,9
54684,55786,53,63117,53,177,94,83,2,29,1,1
54685,27005,1104,28939,1104,870,126,744,2,29,1,1
54686,65080,53,41733,53,193,102,91,2,29,1,1
54687,49842,80,44778,80,70094,1629,68465,63,89,16,47
54688,64374,53,64374,53,240,98,142,2,30,1,1
54689,64204,53,27061,53,264,102,162,2,31,1,1
54690,34910,443,46197,443,16227,7159,9068,40,524,21,19
54691,58936,80,60272,80,10003,5095,4908,21,76,12,9
54692,52097,443,1702,443,11181,7329,3852,39,53,20,19
54693,54262,53,54262,53,216,82,134,2,33,1,1
54694,49864,80,42240,80,5205,1474,3731,9,88,5,4
54695,63997,53,40711,53,676,192,484,6,84,3,3
54696,40340,53,40340,53,217,90,127,2,30,1,1
54697,56887,53,51812,53,177,94,83,2,30,1,1
54698,34616,53,34616,53,197,90,107,2,30,1,1
54699,55072,53,58133,53,168,86,82,2,30,1,1
54700,51789,40800,21058,40800,70,70,0,2,8,2,0
54701,35945,8080,16769,8080,170,110,60,2,5,1,1
54702,51687,80,38806,80,1517,481,1036,11,15,6,5
54703,55602,22005,13936,22005,504,318,186,8,15,5,3
54704,49847,80,28928,80,4135,2587,1548,10,89,7,3
54705,49849,80,56031,80,9581,2352,7229,14,89,7,7
54706,65195,53,58646,53,249,94,155,2,30,1,1
54707,64944,443,63703,443,48856,4158,44698,65,120,26,39
54708,53667,80,16085,80,5090,4357,733,17,15,11,6
54709,34597,80,9526,80,1540,553,987,10,15,6,4
54710,51787,35661,32624,35661,70,70,0,2,8,2,0
54711,56794,1,30345,1,70,70,0,1,5,1,0
54712,49891,80,47196,80,1376,946,430,8,86,5,3
54713,35371,443,55003,443,304294,8535,295759,302,132,90,212
54714,49907,53,31143,53,363,98,265,4,54,2,2
54715,56880,53,14600,53,216,102,114,2,30,1,1
54716,49626,53,57027,53,226,110,116,2,30,1,1
54717,53325,443,60728,443,6988,1214,5774,29,315,13,16
54718,65489,53,22228,53,242,102,140,2,30,1,1
54719,45852,53,58364,53,164,78,86,2,30,1,1
54720,64539,53,12093,53,177,94,83,2,30,1,1
54721,55232,53,4973,53,177,94,83,2,30,1,1
54722,46904,443,22687,443,1314,653,661,13,184,7,6
54723,57470,1337,11046,1337,132,132,0,3,1199,3,0
54724,57470,51413,20990,51413,132,132,0,3,1199,3,0
54725,46902,443,9815,443,1312,651,661,13,184,7,6
54726,57470,32554,26489,32554,726,726,0,12,1199,12,0
54727,55877,51413,55340,51413,460,150,310,2,1200,1,1
54728,51221,20864,10145,20864,7308,6812,496,71,3243,63,8
54729,49892,443,33274,443,5737,1602,4135,23,86,13,10
54730,49862,443,6856,443,17924,7867,10057,45,88,24,21
54731,57447,443,54490,443,12192,3788,8404,36,18,18,18
54732,59890,443,21509,443,9801,2337,7464,25,47,13,12
54733,54420,443,57977,443,5809,1552,4257,19,74,11,8
54734,52277,443,12555,443,13832,4868,8964,91,364,37,54
54735,64569,443,62686,443,9157,2109,7048,27,32,15,12
54736,49907,443,5295,443,6754,2219,4535,21,76,11,10
54737,49894,443,43523,443,5597,1462,4135,21,86,11,10
54738,59888,443,25489,443,4350,2061,2289,18,47,10,8
54739,52140,80,9768,80,3476,1433,2043,26,418,14,12
54740,49901,53,27916,53,349,108,241,4,35,2,2
54741,41024,443,41024,443,4639,1732,2907,19,30,11,8
54742,40729,123,44305,123,184,94,90,2,30,1,1
54743,59023,64097,0,0,62,62,0,1,0,1,0
54744,16387,56995,0,0,60,60,0,1,0,1,0
54745,22683,39210,0,0,60,60,0,1,0,1,0
54746,50031,44847,0,0,74,74,0,1,0,1,0
54747,53053,64147,0,0,62,62,0,1,0,1,0
54748,50562,37965,0,0,66,66,0,1,0,1,0
54749,21173,37965,0,0,62,62,0,1,0,1,0
54750,57797,445,0,0,70,70,0,1,0,1,0
54751,57798,445,0,0,70,70,0,1,0,1,0
54752,57794,445,0,0,70,70,0,1,0,1,0
54753,52806,445,0,0,70,70,0,1,0,1,0
54754,20083,6881,0,0,62,62,0,1,0,1,0
54755,8191,51221,0,0,62,62,0,1,0,1,0
54756,43584,24748,0,0,156,156,0,1,0,1,0
54757,7285,51221,0,0,66,66,0,1,0,1,0
54758,64279,23718,0,0,62,62,0,1,0,1,0
54759,14260,36829,0,0,62,62,0,1,0,1,0
54760,26480,64147,0,0,62,62,0,1,0,1,0
54761,53201,445,0,0,66,66,0,1,0,1,0
54762,57791,445,0,0,70,70,0,1,0,1,0
54763,57788,445,0,0,70,70,0,1,0,1,0
54764,52802,445,0,0,70,70,0,1,0,1,0
54765,52793,445,0,0,70,70,0,1,0,1,0
54766,52792,445,0,0,70,70,0,1,0,1,0
54767,53815,443,57260,443,499,425,74,4,0,3,1
54768,53799,443,27170,443,499,425,74,4,0,3,1
54769,53814,443,6695,443,499,425,74,4,0,3,1
54770,61804,51505,0,0,66,66,0,1,0,1,0
54771,32395,30188,0,0,62,62,0,1,0,1,0
54772,52790,445,0,0,70,70,0,1,0,1,0
54773,52789,445,0,0,70,70,0,1,0,1,0
54774,64175,56502,0,0,66,66,0,1,0,1,0
54775,53196,445,0,0,66,66,0,1,0,1,0
54776,52785,445,0,0,70,70,0,1,0,1,0
54777,54991,36829,0,0,66,66,0,1,0,1,0
54778,32185,47807,0,0,159,159,0,1,0,1,0
54779,53192,445,0,0,66,66,0,1,0,1,0
54780,57776,445,0,0,70,70,0,1,0,1,0
54781,25015,64147,0,0,66,66,0,1,0,1,0
54782,28668,8696,0,0,60,60,0,1,0,1,0
54783,57774,445,0,0,70,70,0,1,0,1,0
54784,57772,445,0,0,70,70,0,1,0,1,0
54785,57767,445,0,0,70,70,0,1,0,1,0
54786,53189,445,0,0,66,66,0,1,0,1,0
54787,52779,445,0,0,70,70,0,1,0,1,0
54788,45410,1,0,0,62,62,0,1,0,1,0
54789,50321,40284,0,0,348,348,0,1,0,1,0
54790,57763,445,0,0,70,70,0,1,0,1,0
54791,34822,31573,0,0,62,62,0,1,0,1,0
54792,57761,445,0,0,70,70,0,1,0,1,0
54793,57758,445,0,0,70,70,0,1,0,1,0
54794,57757,445,0,0,70,70,0,1,0,1,0
54795,53183,445,0,0,66,66,0,1,0,1,0
54796,26082,26296,0,0,159,159,0,1,0,1,0
54797,27446,30188,0,0,66,66,0,1,0,1,0
54798,53176,445,0,0,66,66,0,1,0,1,0
54799,53179,445,0,0,66,66,0,1,0,1,0
54800,53175,445,0,0,66,66,0,1,0,1,0
54801,40547,24051,0,0,74,74,0,1,0,1,0
54802,52772,445,0,0,70,70,0,1,0,1,0
54803,53173,445,0,0,66,66,0,1,0,1,0
54804,53172,445,0,0,66,66,0,1,0,1,0
54805,53171,445,0,0,66,66,0,1,0,1,0
54806,52769,445,0,0,70,70,0,1,0,1,0
54807,58326,50584,0,0,62,62,0,1,0,1,0
54808,53779,37965,0,0,66,66,0,1,0,1,0
54809,56946,1,0,0,66,66,0,1,0,1,0
54810,18357,51180,0,0,62,62,0,1,0,1,0
54811,57755,445,0,0,70,70,0,1,0,1,0
54812,57753,445,0,0,70,70,0,1,0,1,0
54813,57752,445,0,0,70,70,0,1,0,1,0
54814,52765,445,0,0,70,70,0,1,0,1,0
54815,53169,445,0,0,66,66,0,1,0,1,0
54816,52764,445,0,0,70,70,0,1,0,1,0
54817,57748,445,0,0,70,70,0,1,0,1,0
54818,53807,443,54173,443,499,425,74,4,0,3,1
54819,53796,443,58960,443,499,425,74,4,0,3,1
54820,53804,443,53478,443,499,425,74,4,0,3,1
54821,53802,443,44070,443,499,425,74,4,0,3,1
54822,53812,443,19260,443,499,425,74,4,0,3,1
54823,53805,443,64828,443,499,425,74,4,0,3,1
54824,53801,443,63448,443,499,425,74,4,0,3,1
54825,53810,443,43179,443,499,425,74,4,0,3,1
54826,53813,443,59809,443,499,425,74,4,0,3,1
54827,53806,443,13248,443,499,425,74,4,0,3,1
54828,53809,443,5069,443,499,425,74,4,0,3,1
54829,53798,443,32162,443,499,425,74,4,0,3,1
54830,53811,443,28685,443,499,425,74,4,0,3,1
54831,53800,443,21628,443,499,425,74,4,0,3,1
54832,53797,443,48154,443,499,425,74,4,0,3,1
54833,53808,443,30751,443,499,425,74,4,0,3,1
54834,53795,443,29582,443,499,425,74,4,0,3,1
54835,53791,443,9232,443,499,425,74,4,0,3,1
54836,53803,443,59546,443,499,425,74,4,0,3,1
54837,53794,443,48669,443,499,425,74,4,0,3,1
54838,53793,443,25367,443,499,425,74,4,0,3,1
54839,53790,443,36167,443,499,425,74,4,0,3,1
54840,53789,443,10563,443,499,425,74,4,0,3,1
54841,53792,443,8707,443,499,425,74,4,0,3,1
54842,0,0,0,0,70,70,0,1,0,1,0
54843,53164,445,0,0,66,66,0,1,0,1,0
54844,46093,32661,0,0,74,74,0,1,0,1,0
54845,64324,37807,0,0,62,62,0,1,0,1,0
54846,65153,38303,0,0,66,66,0,1,0,1,0
54847,53163,445,0,0,66,66,0,1,0,1,0
54848,53161,445,0,0,66,66,0,1,0,1,0
54849,53159,445,0,0,66,66,0,1,0,1,0
54850,48676,53395,0,0,60,60,0,1,0,1,0
54851,52760,445,0,0,70,70,0,1,0,1,0
54852,64889,26467,0,0,66,66,0,1,0,1,0
54853,1660,8696,0,0,62,62,0,1,0,1,0
54854,60550,50584,0,0,62,62,0,1,0,1,0
54855,52758,445,0,0,70,70,0,1,0,1,0
54856,1040,6004,0,0,72,72,0,1,0,1,0
54857,57741,445,0,0,70,70,0,1,0,1,0
54858,443,9986,0,0,297,297,0,1,0,1,0
54859,12605,57470,0,0,62,62,0,1,0,1,0
54860,65501,26467,0,0,66,66,0,1,0,1,0
54861,57734,445,0,0,70,70,0,1,0,1,0
54862,57732,445,0,0,70,70,0,1,0,1,0
54863,59136,50584,0,0,66,66,0,1,0,1,0
54864,60875,50584,0,0,66,66,0,1,0,1,0
54865,52754,445,0,0,70,70,0,1,0,1,0
54866,53151,445,0,0,66,66,0,1,0,1,0
54867,61736,50584,0,0,66,66,0,1,0,1,0
54868,443,5920,0,0,66,66,0,1,0,1,0
54869,42034,28189,0,0,62,62,0,1,0,1,0
54870,12471,48817,0,0,62,62,0,1,0,1,0
54871,45964,2225,0,0,60,60,0,1,0,1,0
54872,53141,445,0,0,66,66,0,1,0,1,0
54873,57720,445,0,0,70,70,0,1,0,1,0
54874,51582,48817,0,0,66,66,0,1,0,1,0
54875,46495,4607,0,0,60,60,0,1,0,1,0
54876,26528,51221,0,0,78,78,0,1,0,1,0
54877,48980,15000,3233,15000,130,70,60,2,5,1,1
54878,56618,443,57435,443,8034,2014,6020,20,15,11,9
54879,64568,443,63585,443,25404,2462,22942,47,32,25,22
54880,55232,53,45264,53,170,87,83,2,30,1,1
54881,59880,443,7834,443,16776,7513,9263,42,47,24,18
54882,27350,80,31798,80,3943,1809,2134,21,82,11,10
54883,43112,443,7009,443,3197,1931,1266,19,15,9,10
54884,56619,443,13830,443,7982,1962,6020,20,15,11,9
54885,26457,80,26457,80,17147,1829,15318,28,17,15,13
54886,50122,443,28442,443,130,70,60,2,15,1,1
54887,43111,443,29874,443,3117,1867,1250,19,15,9,10
54888,51768,61765,15043,61765,66,66,0,1,5,1,0
54889,45587,443,45587,443,5523,2276,3247,22,28,13,9
54890,44695,53,44695,53,198,89,109,2,30,1,1
54891,64979,53,23009,53,188,96,92,2,31,1,1
54892,55917,53,56529,53,170,87,83,2,31,1,1
54893,59343,53,0,0,627,72,555,2,30,1,1
54894,51862,22,51862,22,7902,3301,4601,56,40,26,30
54895,52205,5222,24221,5222,684,280,404,11,26,5,6
54896,52375,80,50220,80,234,234,0,4,12,4,0
54897,43601,443,18392,443,10274,3806,6468,26,413,14,12
54898,50239,443,44236,443,9418,2681,6737,39,256,18,21
54899,38329,80,52994,80,350,210,140,6,16,4,2
54900,37271,443,4038,443,51402,5964,45438,86,153,32,54
54901,56295,443,26147,443,8550,1880,6670,22,376,12,10
54902,56617,443,25954,443,7981,1961,6020,20,16,11,9
54903,37536,80,9440,80,3565,1020,2545,16,15,9,7
54904,58454,443,58454,443,4593,1616,2977,19,76,10,9
54905,59270,53,59270,53,825,99,726,2,30,1,1
54906,56813,53,39428,53,711,87,624,2,30,1,1
54907,8888,53,8888,53,214,97,117,2,30,1,1
54908,55106,53,55106,53,200,90,110,2,30,1,1
54909,53035,5228,40515,5228,2725,1610,1115,20,3600,10,10
54910,56366,53,46809,53,754,94,660,2,31,1,1
54911,53713,443,37609,443,4931,957,3974,17,15,10,7
54912,59487,80,24242,80,350,210,140,6,26,4,2
54913,53714,443,10907,443,4933,957,3976,17,15,10,7
54914,57312,53,57312,53,208,94,114,2,30,1,1
54915,49591,53,51142,53,168,86,82,2,30,1,1
54916,3424,53,3424,53,216,88,128,2,30,1,1
54917,2079,7000,2079,7000,3102,1551,1551,16,16,8,8
54918,56775,53,34626,53,763,101,662,2,30,1,1
54919,50328,53,20316,53,783,96,687,2,30,1,1
54920,56268,53,11800,53,711,87,624,2,31,1,1
54921,49353,53,30816,53,738,86,652,2,31,1,1
54922,30960,45690,12118,45690,330,330,0,6,3609,6,0
54923,49597,53,33201,53,168,86,82,2,31,1,1
54924,55836,53,32275,53,178,91,87,2,31,1,1
54925,65366,53,60695,53,198,101,97,2,31,1,1
54926,55040,53,40859,53,762,98,664,2,31,1,1
54927,56620,53,33976,53,216,110,106,2,31,1,1
54928,49883,53,18157,53,170,87,83,2,30,1,1
54929,55011,53,15618,53,760,96,664,2,31,1,1
54930,56373,53,29361,53,200,102,98,2,31,1,1
54931,65153,53,43651,53,168,86,82,2,31,1,1
54932,65177,53,32886,53,256,93,163,2,31,1,1
54933,30960,45689,37422,45689,330,330,0,6,3609,6,0
54934,56091,53,32743,53,738,86,652,2,31,1,1
54935,50475,53,26369,53,772,100,672,2,31,1,1
54936,55698,53,13157,53,742,88,654,2,31,1,1
54937,55656,53,48878,53,212,108,104,2,31,1,1
54938,57397,53,42342,53,256,93,163,2,31,1,1
54939,64980,53,5647,53,200,102,98,2,31,1,1
54940,61041,443,15332,443,77650,64697,12953,148,902,81,67
54941,10115,52700,0,0,62,62,0,1,0,1,0
54942,8933,56205,0,0,62,62,0,1,0,1,0
54943,60294,30188,0,0,66,66,0,1,0,1,0
54944,52459,5555,0,0,60,60,0,1,0,1,0
54945,53139,445,0,0,66,66,0,1,0,1,0
54946,52741,445,0,0,70,70,0,1,0,1,0
54947,59481,41182,0,0,66,66,0,1,0,1,0
54948,1027,11392,0,0,62,62,0,1,0,1,0
54949,59784,42246,0,0,62,62,0,1,0,1,0
54950,58074,11392,0,0,66,66,0,1,0,1,0
54951,51685,57470,0,0,62,62,0,1,0,1,0
54952,52356,55442,0,0,66,66,0,1,0,1,0
54953,64841,53,24677,53,165,86,79,2,30,1,1
54954,55386,53,14835,53,199,102,97,2,30,1,1
54955,49890,443,15513,443,5597,1462,4135,21,86,11,10
54956,52738,445,0,0,70,70,0,1,0,1,0
54957,53132,445,0,0,66,66,0,1,0,1,0
54958,9246,35440,0,0,66,66,0,1,0,1,0
54959,443,20982,0,0,97,97,0,1,0,1,0
54960,53123,445,0,0,66,66,0,1,0,1,0
54961,62859,35440,0,0,66,66,0,1,0,1,0
54962,53371,26467,0,0,66,66,0,1,0,1,0
54963,14715,56205,0,0,62,62,0,1,0,1,0
54964,30496,57470,0,0,62,62,0,1,0,1,0
54965,59235,52700,0,0,145,145,0,1,0,1,0
54966,52734,445,0,0,70,70,0,1,0,1,0
54967,52732,445,0,0,70,70,0,1,0,1,0
54968,44258,25,0,0,74,74,0,1,0,1,0
54969,64756,11392,0,0,62,62,0,1,0,1,0
54970,57711,445,0,0,70,70,0,1,0,1,0
54971,57708,445,0,0,70,70,0,1,0,1,0
54972,57709,445,0,0,70,70,0,1,0,1,0
54973,52728,445,0,0,70,70,0,1,0,1,0
54974,53113,445,0,0,66,66,0,1,0,1,0
54975,53114,445,0,0,66,66,0,1,0,1,0
54976,53108,445,0,0,66,66,0,1,0,1,0
54977,53115,445,0,0,66,66,0,1,0,1,0
54978,53112,445,0,0,66,66,0,1,0,1,0
54979,53110,445,0,0,66,66,0,1,0,1,0
54980,53111,445,0,0,66,66,0,1,0,1,0
54981,53109,445,0,0,66,66,0,1,0,1,0
54982,17009,53733,0,0,66,66,0,1,0,1,0
54983,14459,11848,0,0,148,148,0,1,0,1,0
54984,11464,37965,0,0,62,62,0,1,0,1,0
54985,443,28417,0,0,82,82,0,1,0,1,0
54986,26332,57470,0,0,62,62,0,1,0,1,0
54987,52721,445,0,0,70,70,0,1,0,1,0
54988,64940,36237,0,0,62,62,0,1,0,1,0
54989,57706,445,0,0,70,70,0,1,0,1,0
54990,57701,445,0,0,70,70,0,1,0,1,0
54991,57694,445,0,0,70,70,0,1,0,1,0
54992,52719,445,0,0,70,70,0,1,0,1,0
54993,22587,30188,0,0,66,66,0,1,0,1,0
54994,38645,51221,0,0,62,62,0,1,0,1,0
54995,2923,57470,0,0,66,66,0,1,0,1,0
54996,53096,445,0,0,66,66,0,1,0,1,0
54997,53094,445,0,0,66,66,0,1,0,1,0
54998,53093,445,0,0,66,66,0,1,0,1,0
54999,1227,56205,0,0,66,66,0,1,0,1,0
55000,6712,44818,0,0,66,66,0,1,0,1,0
55001,3564,57470,0,0,62,62,0,1,0,1,0
55002,52718,445,0,0,70,70,0,1,0,1,0
55003,20057,44847,0,0,62,62,0,1,0,1,0
55004,39824,51505,0,0,62,62,0,1,0,1,0
55005,52717,445,0,0,70,70,0,1,0,1,0
55006,52716,445,0,0,70,70,0,1,0,1,0
55007,57691,445,0,0,70,70,0,1,0,1,0
55008,4127,26467,0,0,66,66,0,1,0,1,0
55009,52714,445,0,0,70,70,0,1,0,1,0
55010,49865,443,1213,443,8535,1936,6599,22,87,12,10
55011,49848,443,28970,443,33314,1722,31592,40,88,14,26
55012,49885,443,26423,443,10216,2749,7467,27,86,14,13
55013,64539,53,18826,53,177,94,83,2,29,1,1
55014,49851,80,9497,80,11936,2198,9738,22,88,9,13
55015,53592,23578,40087,23578,70,70,0,2,7,2,0
55016,52118,80,62172,80,3158,1309,1849,28,418,15,13
55017,52126,80,5898,80,3592,2098,1494,26,417,14,12
55018,48220,443,48220,443,4627,1720,2907,18,26,10,8
55019,53664,80,23809,80,3741,3008,733,16,15,10,6
55020,49909,443,16969,443,6754,2219,4535,21,75,11,10
55021,49866,443,6704,443,7128,865,6263,19,87,9,10
55022,49908,443,25535,443,4712,908,3804,18,75,9,9
55023,64380,53,30464,53,196,102,94,2,32,1,1
55024,49342,443,54046,443,10075,6346,3729,48,84,25,23
55025,53604,1046,44060,1046,320,140,180,6,5,3,3
55026,51651,53,58120,53,237,86,151,2,29,1,1
55027,3195,53,3195,53,197,90,107,2,29,1,1
55028,64586,53,31352,53,257,102,155,2,30,1,1
55029,55383,53,13927,53,177,94,83,2,30,1,1
55030,64716,53,5161,53,718,94,624,2,30,1,1
55031,55232,53,8300,53,177,94,83,2,30,1,1
55032,65492,53,43623,53,199,102,97,2,30,1,1
55033,51786,37832,38503,37832,70,70,0,2,8,2,0
55034,51986,80,3605,80,1274,694,580,13,16,6,7
55035,43475,443,10490,443,5578,1646,3932,23,16,13,10
55036,55386,53,64239,53,822,102,720,2,30,1,1
55037,56828,53,33245,53,211,102,109,2,30,1,1
55038,53490,5228,31385,5228,7188,2098,5090,38,113,22,16
55039,46746,443,17806,443,9506,4029,5477,30,330,17,13
55040,35197,443,30510,443,12481,2743,9738,53,20,26,27
55041,50375,80,22563,80,350,210,140,6,15,4,2
55042,51403,443,43951,443,334,70,264,5,17,1,4
55043,49603,53,64849,53,733,94,639,2,30,1,1
55044,59883,443,34270,443,8031,2957,5074,27,46,16,11
55045,65294,53,43260,53,173,94,79,2,30,1,1
55046,65236,53,21854,53,177,94,83,2,30,1,1
55047,65507,53,17701,53,211,102,109,2,30,1,1
55048,65294,53,10566,53,165,86,79,2,30,1,1
55049,65236,53,45022,53,177,94,83,2,30,1,1
55050,51580,80,9107,80,1752,786,966,16,17,9,7
55051,49432,53,25699,53,309,94,215,4,32,2,2
55052,64791,443,54264,443,8580,5765,2815,46,82,22,24
55053,58904,123,61821,123,184,94,90,2,30,1,1
55054,50864,53,14255,53,199,94,105,2,30,1,1
55055,65309,53,31055,53,764,102,662,2,30,1,1
55056,55005,53,64586,53,211,102,109,2,30,1,1
55057,62490,443,60258,443,7206,4320,2886,16,120,8,8
55058,53118,56839,5832,56839,70,70,0,2,8,2,0
55059,49206,80,5739,80,57497,913,56584,52,75,11,41
55060,64967,53,21374,53,389,134,255,2,30,1,1
55061,65492,53,44506,53,822,102,720,2,30,1,1
55062,64113,53,6414,53,216,102,114,2,30,1,1
55063,51832,443,21428,443,2831,740,2091,11,120,5,6
55064,56887,53,53946,53,250,87,163,4,60,2,2
55065,59889,443,40054,443,8305,2325,5980,24,46,13,11
55066,59891,443,64677,443,7718,1947,5771,25,46,14,11
55067,55616,42929,18894,42929,70,70,0,2,8,2,0
55068,55719,8060,46962,8060,70,70,0,1,4,1,0
55069,63782,6969,33183,6969,66,66,0,2,8,2,0
55070,51785,33253,14709,33253,70,70,0,2,8,2,0
55071,53114,32975,63232,32975,70,70,0,1,5,1,0
55072,51792,22318,43615,22318,316,136,180,6,5,3,3
55073,53596,56732,58606,56732,70,70,0,2,7,2,0
55074,55232,53,12562,53,177,94,83,2,29,1,1
55075,60378,11385,17333,11385,1218,774,444,17,26,10,7
55076,52122,80,30528,80,4137,1236,2901,27,418,14,13
55077,49591,53,21458,53,86,86,0,1,29,1,0
55078,49910,443,39120,443,4712,908,3804,18,75,9,9
55079,49869,80,37142,80,2125,1041,1084,11,87,6,5
55080,60403,60092,47131,60092,70,70,0,2,8,2,0
55081,40604,443,31639,443,130,70,60,3,5,2,1
55082,54583,443,25809,443,11307,7633,3674,25,163,18,7
55083,38968,80,48567,80,1280,586,694,10,15,5,5
55084,36535,443,10367,443,416,210,206,7,27,4,3
55085,40511,80,1880,80,1680,950,730,12,15,6,6
55086,46529,80,23858,80,1119,388,731,9,223,5,4
55087,33237,443,28944,443,31065,6730,24335,68,18,37,31
55088,63742,443,58789,443,7444,1915,5529,28,16,16,12
55089,55383,53,49153,53,177,94,83,2,29,1,1
55090,57351,53,48992,53,177,94,83,2,30,1,1
55091,64642,53,40634,53,265,94,171,2,30,1,1
55092,55917,53,40255,53,177,94,83,2,30,1,1
55093,49883,53,14693,53,177,94,83,2,30,1,1
55094,33388,53,33388,53,229,98,131,2,30,1,1
55095,63617,53,24659,53,299,102,197,2,30,1,1
55096,43018,443,63361,443,4664,962,3702,15,120,7,8
55097,65220,53,42472,53,245,94,151,2,30,1,1
55098,59534,53,0,0,627,72,555,2,30,1,1
55099,65396,53,32966,53,178,94,84,2,30,1,1
55100,46730,443,28358,443,7648,1671,5977,25,31,13,12
55101,55917,53,22277,53,177,94,83,2,30,1,1
55102,49597,53,40368,53,86,86,0,1,30,1,0
55103,57351,53,50583,53,177,94,83,2,30,1,1
55104,49890,53,63142,53,767,102,665,2,30,1,1
55105,57152,53,41610,53,733,94,639,2,30,1,1
55106,49591,53,36017,53,168,86,82,2,31,1,1
55107,41816,443,14209,443,88503,3914,84589,114,80,44,70
55108,57589,443,3632,443,2614,1689,925,18,23,10,8
55109,56229,53,12969,53,165,86,79,2,30,1,1
55110,63766,80,33525,80,314,192,122,6,15,4,2
55111,51767,59158,56330,59158,70,70,0,1,5,1,0
55112,26386,53,26386,53,231,90,141,2,30,1,1
55113,64404,53,48455,53,224,94,130,2,30,1,1
55114,64557,53,9245,53,766,102,664,2,30,1,1
55115,57095,53,7010,53,177,94,83,2,30,1,1
55116,39145,443,40241,443,4602,1305,3297,27,183,12,15
55117,56355,53,52899,53,184,94,90,2,31,1,1
55118,6881,6881,44146,6881,502,150,352,2,1199,1,1
55119,52121,443,41012,443,199757,7497,192260,216,45,80,136
55120,64052,53,64052,53,198,90,108,2,30,1,1
55121,59534,53,0,0,216,72,144,2,30,1,1
55122,64841,53,21377,53,173,94,79,2,30,1,1
55123,49883,53,42017,53,177,94,83,2,30,1,1
55124,50233,53,42089,53,748,94,654,2,30,1,1
55125,56196,53,24743,53,498,204,294,6,31,3,3
55126,64979,53,4667,53,194,102,92,2,31,1,1
55127,54967,53,43919,53,178,94,84,2,31,1,1
55128,55617,53,37518,53,194,102,92,2,31,1,1
55129,50594,80,17201,80,3116,452,2664,18,394,5,13
55130,55002,443,31651,443,469783,461079,8704,444,167,329,115
55131,41440,5228,57433,5228,8866,2015,6851,29,4793,14,15
55132,39920,443,36288,443,4552,1255,3297,27,183,12,15
55133,54898,443,38797,443,4559,2054,2505,11,120,6,5
55134,57470,61768,42520,61768,330,330,0,6,1199,6,0
55135,6882,6881,62031,6881,238,118,120,2,1200,1,1
55136,38387,80,17970,80,2008,810,1198,20,394,7,13
55137,15503,26886,1778,26886,481,150,331,2,1200,1,1
55138,44847,31381,18131,31381,150,150,0,1,1200,1,0
55139,57418,443,37526,443,29994,1927,28067,50,20,17,33
55140,52282,80,3560,80,7603,1651,5952,24,16,13,11
55141,34358,80,63755,80,350,210,140,6,16,4,2
55142,29964,53,52267,53,200,86,114,2,30,1,1
55143,53566,8999,11689,8999,3428,1820,1608,21,17,12,9
55144,53576,23505,46519,23505,70,70,0,1,5,1,0
55145,63769,47661,26406,47661,70,70,0,1,5,1,0
55146,59884,443,44531,443,6622,2246,4376,21,46,12,9
55147,51075,80,51075,80,450,246,204,8,26,5,3
55148,52131,443,17836,443,6565,1251,5314,27,31,14,13
55149,33087,443,44739,443,13265,1924,11341,33,201,17,16
55150,63771,7426,20150,7426,70,70,0,1,5,1,0
55151,14431,443,44094,443,2601,1455,1146,18,16,8,10
55152,55089,53,1796,53,199,102,97,2,30,1,1
55153,64308,53,43760,53,181,86,95,2,30,1,1
55154,55089,53,56950,53,199,102,97,2,30,1,1
55155,64599,53,12199,53,767,102,665,2,30,1,1
55156,2362,53,2362,53,225,90,135,2,30,1,1
55157,57095,53,10011,53,177,94,83,2,30,1,1
55158,36255,53,36255,53,197,90,107,2,30,1,1
55159,55346,53,62620,53,177,94,83,2,31,1,1
55160,52710,445,0,0,70,70,0,1,0,1,0
55161,43890,123,0,0,234,234,0,1,0,1,0
55162,17315,11392,0,0,62,62,0,1,0,1,0
55163,57689,445,0,0,70,70,0,1,0,1,0
55164,57679,445,0,0,70,70,0,1,0,1,0
55165,57680,445,0,0,70,70,0,1,0,1,0
55166,57678,445,0,0,70,70,0,1,0,1,0
55167,57441,57470,0,0,66,66,0,1,0,1,0
55168,45941,23386,0,0,60,60,0,1,0,1,0
55169,45941,23386,0,0,60,60,0,1,0,1,0
55170,52698,445,0,0,70,70,0,1,0,1,0
55171,52697,445,0,0,70,70,0,1,0,1,0
55172,52693,445,0,0,70,70,0,1,0,1,0
55173,60480,57470,0,0,62,62,0,1,0,1,0
55174,52687,445,0,0,70,70,0,1,0,1,0
55175,52688,445,0,0,70,70,0,1,0,1,0
55176,56307,52700,0,0,66,66,0,1,0,1,0
55177,52472,7302,0,0,62,62,0,1,0,1,0
55178,61983,50432,0,0,62,62,0,1,0,1,0
55179,46936,35440,0,0,62,62,0,1,0,1,0
55180,53447,44847,0,0,62,62,0,1,0,1,0
55181,7308,50584,0,0,66,66,0,1,0,1,0
55182,38633,51221,0,0,62,62,0,1,0,1,0
55183,58305,51180,0,0,66,66,0,1,0,1,0
55184,12530,35440,0,0,66,66,0,1,0,1,0
55185,57671,445,0,0,70,70,0,1,0,1,0
55186,57669,445,0,0,70,70,0,1,0,1,0
55187,57664,445,0,0,70,70,0,1,0,1,0
55188,54140,43890,0,0,62,62,0,1,0,1,0
55189,52676,445,0,0,70,70,0,1,0,1,0
55190,50820,57470,0,0,66,66,0,1,0,1,0
55191,1024,57470,0,0,62,62,0,1,0,1,0
55192,50067,64147,0,0,66,66,0,1,0,1,0
55193,31112,50584,0,0,66,66,0,1,0,1,0
55194,60196,53,0,0,88,88,0,1,0,1,0
55195,49842,7302,0,0,66,66,0,1,0,1,0
55196,57478,7302,0,0,66,66,0,1,0,1,0
55197,59378,50584,0,0,66,66,0,1,0,1,0
55198,46587,57470,0,0,62,62,0,1,0,1,0
55199,443,10010,0,0,60,60,0,1,0,1,0
55200,3541,22114,0,0,62,62,0,1,0,1,0
55201,61218,22114,0,0,66,66,0,1,0,1,0
55202,44933,23,0,0,60,60,0,1,0,1,0
55203,59701,44847,0,0,62,62,0,1,0,1,0
55204,28668,8696,0,0,60,60,0,1,0,1,0
55205,38976,46824,0,0,62,62,0,1,0,1,0
55206,52671,445,0,0,70,70,0,1,0,1,0
55207,53072,445,0,0,66,66,0,1,0,1,0
55208,57662,445,0,0,70,70,0,1,0,1,0
55209,57661,445,0,0,70,70,0,1,0,1,0
55210,52662,445,0,0,70,70,0,1,0,1,0
55211,52663,445,0,0,70,70,0,1,0,1,0
55212,63547,37965,0,0,66,66,0,1,0,1,0
55213,52658,445,0,0,70,70,0,1,0,1,0
55214,52657,445,0,0,70,70,0,1,0,1,0
55215,1026,30188,0,0,146,146,0,1,0,1,0
55216,63314,57470,0,0,66,66,0,1,0,1,0
55217,51900,48817,0,0,146,146,0,1,0,1,0
55218,52655,445,0,0,70,70,0,1,0,1,0
55219,53065,445,0,0,66,66,0,1,0,1,0
55220,21087,80,21087,80,159790,4676,155114,177,128,67,110
55221,50878,53733,0,0,66,66,0,1,0,1,0
55222,57060,50584,0,0,62,62,0,1,0,1,0
55223,53064,445,0,0,66,66,0,1,0,1,0
55224,56494,15503,0,0,146,146,0,1,0,1,0
55225,57653,445,0,0,70,70,0,1,0,1,0
55226,58468,57587,0,0,66,66,0,1,0,1,0
55227,57645,445,0,0,70,70,0,1,0,1,0
55228,57644,445,0,0,70,70,0,1,0,1,0
55229,57639,445,0,0,70,70,0,1,0,1,0
55230,53062,445,0,0,66,66,0,1,0,1,0
55231,59940,50584,0,0,62,62,0,1,0,1,0
55232,65060,35440,0,0,62,62,0,1,0,1,0
55233,52649,445,0,0,70,70,0,1,0,1,0
55234,9957,32480,0,0,62,62,0,1,0,1,0
55235,53437,44847,0,0,62,62,0,1,0,1,0
55236,8211,28793,0,0,62,62,0,1,0,1,0
55237,57636,445,0,0,70,70,0,1,0,1,0
55238,62804,37965,0,0,62,62,0,1,0,1,0
55239,0,0,0,0,124,64,60,2,0,1,1
55240,57633,445,0,0,70,70,0,1,0,1,0
55241,57632,445,0,0,70,70,0,1,0,1,0
55242,57629,445,0,0,70,70,0,1,0,1,0
55243,53055,445,0,0,66,66,0,1,0,1,0
55244,52642,445,0,0,70,70,0,1,0,1,0
55245,1888,51505,0,0,62,62,0,1,0,1,0
55246,60188,15503,0,0,62,62,0,1,0,1,0
55247,52641,445,0,0,70,70,0,1,0,1,0
55248,53047,445,0,0,66,66,0,1,0,1,0
55249,53048,445,0,0,66,66,0,1,0,1,0
55250,53046,445,0,0,66,66,0,1,0,1,0
55251,63701,46824,0,0,66,66,0,1,0,1,0
55252,53045,445,0,0,66,66,0,1,0,1,0
55253,53043,445,0,0,66,66,0,1,0,1,0
55254,53042,445,0,0,66,66,0,1,0,1,0
55255,50084,26672,0,0,62,62,0,1,0,1,0
55256,52635,445,0,0,70,70,0,1,0,1,0
55257,23274,50584,0,0,62,62,0,1,0,1,0
55258,52103,53733,0,0,66,66,0,1,0,1,0
55259,54062,49813,0,0,62,62,0,1,0,1,0
55260,52634,445,0,0,70,70,0,1,0,1,0
55261,52447,43890,0,0,66,66,0,1,0,1,0
55262,21733,56205,0,0,66,66,0,1,0,1,0
55263,57628,445,0,0,70,70,0,1,0,1,0
55264,57625,445,0,0,70,70,0,1,0,1,0
55265,57621,445,0,0,70,70,0,1,0,1,0
55266,53038,445,0,0,66,66,0,1,0,1,0
55267,57620,445,0,0,70,70,0,1,0,1,0
55268,13654,50584,0,0,146,146,0,1,0,1,0
55269,53037,445,0,0,66,66,0,1,0,1,0
55270,52630,445,0,0,70,70,0,1,0,1,0
55271,59128,44847,0,0,62,62,0,1,0,1,0
55272,53033,445,0,0,66,66,0,1,0,1,0
55273,53035,445,0,0,66,66,0,1,0,1,0
55274,53031,445,0,0,66,66,0,1,0,1,0
55275,52629,445,0,0,70,70,0,1,0,1,0
55276,58396,22114,0,0,66,66,0,1,0,1,0
55277,63615,23,0,0,60,60,0,1,0,1,0
55278,46275,64147,0,0,62,62,0,1,0,1,0
55279,56119,46824,0,0,62,62,0,1,0,1,0
55280,57614,445,0,0,70,70,0,1,0,1,0
55281,29203,26467,0,0,62,62,0,1,0,1,0
55282,54910,32480,0,0,66,66,0,1,0,1,0
55283,50418,80,62798,80,12920,6875,6045,25,27,13,12
55284,50431,80,44826,80,318,192,126,6,27,4,2
55285,50435,80,28947,80,318,192,126,6,27,4,2
55286,2075,7000,2075,7000,5850,4395,1455,18,15,10,8
55287,65287,3389,65287,3389,3409,1454,1955,16,16,8,8
55288,50446,80,5062,80,318,192,126,6,27,4,2
55289,34539,80,34539,80,22098,1602,20496,24,57,6,18
55290,56613,443,29986,443,7981,1961,6020,20,16,11,9
55291,56614,443,40071,443,8034,2014,6020,20,15,11,9
55292,49914,443,44270,443,5895,728,5167,16,27,8,8
55293,52324,443,52324,443,6727,762,5965,15,26,8,7
55294,55089,53,42866,53,198,101,97,2,30,1,1
55295,57257,53,11711,53,764,99,665,2,30,1,1
55296,11295,40040,23656,40040,213,89,124,4,31,2,2
55297,55735,53,17069,53,772,100,672,2,30,1,1
55298,50432,80,29144,80,318,192,126,6,27,4,2
55299,2076,7000,2076,7000,5194,3739,1455,18,15,10,8
55300,51541,3389,51541,3389,3609,1654,1955,19,18,11,8
55301,56615,443,31008,443,7982,1962,6020,20,15,11,9
55302,52322,443,52322,443,6926,828,6098,17,26,9,8
55303,2074,7010,2074,7010,4279,2090,2189,16,15,8,8
55304,57115,53,57910,53,788,108,680,2,30,1,1
55305,57095,53,44244,53,170,87,83,2,30,1,1
55306,56741,53,9430,53,814,110,704,2,30,1,1
55307,50181,80,60161,80,2149,1165,984,15,77,8,7
55308,56357,53,52220,53,172,88,84,2,30,1,1
55309,56616,443,54486,443,8033,2013,6020,20,15,11,9
55310,63760,37264,26706,37264,504,382,122,8,16,6,2
55311,60334,7080,60334,7080,2960,432,2528,11,15,6,5
55312,50427,80,43709,80,312,192,120,6,27,4,2
55313,2078,7000,2078,7000,3006,1615,1391,15,15,8,7
55314,64633,53,4250,53,762,98,664,2,30,1,1
55315,57855,443,34807,443,4370,3370,1000,19,187,10,9
55316,55552,53,38672,53,767,102,665,2,30,1,1
55317,58819,1433,58819,1433,124,60,64,2,5,1,1
55318,55462,53,13103,53,188,96,92,2,30,1,1
55319,56567,53,56060,53,188,96,92,2,31,1,1
55320,58488,3389,58488,3389,3428,1714,1714,16,31,8,8
55321,56771,53,7291,53,270,95,175,4,60,2,2
55322,50755,80,50755,80,450,246,204,8,25,5,3
55323,58054,25,23956,25,1370,496,874,16,16,8,8
55324,65290,3389,65290,3389,3327,1438,1889,15,16,8,7
55325,51784,34568,29870,34568,70,70,0,2,8,2,0
55326,50948,80,50948,80,520,246,274,9,25,5,4
55327,53572,22754,17581,22754,70,70,0,1,5,1,0
55328,2077,7000,2077,7000,3054,1599,1455,16,15,8,8
55329,58509,80,60586,80,1666,1130,536,12,16,7,5
55330,2073,7000,2073,7000,3566,1999,1567,16,15,8,8
55331,55617,18319,24832,18319,320,140,180,6,7,3,3
55332,50966,443,44457,443,7975,3304,4671,19,86,11,8
55333,50428,80,50756,80,312,192,120,6,27,4,2
55334,51765,52862,65009,52862,66,66,0,1,5,1,0
55335,63205,443,63205,443,9324,4240,5084,24,16,13,11
55336,2072,7000,2072,7000,3164,783,2381,15,16,7,8
55337,44805,3389,44805,3389,4870,2631,2239,23,19,13,10
55338,50445,80,48799,80,318,192,126,6,27,4,2
55339,63525,53,0,0,174,77,97,2,30,1,1
55340,55417,53,30758,53,196,100,96,2,30,1,1
55341,56620,53,51991,53,322,110,212,4,30,2,2
55342,65192,53,4438,53,172,88,84,2,30,1,1
55343,55514,53,44502,53,783,96,687,2,30,1,1
55344,55113,53,29716,53,196,100,96,2,31,1,1
55345,56355,53,30971,53,184,94,90,2,31,1,1
55346,56724,53,15012,53,749,89,660,2,31,1,1
55347,55336,53,13699,53,295,101,194,4,31,2,2
55348,56569,53,65375,53,91,91,0,1,31,1,0
55349,55990,53,40258,53,182,93,89,2,30,1,1
55350,52544,19000,32388,19000,492,216,276,2,31,1,1
55351,56386,53,13942,53,170,87,83,2,31,1,1
55352,57040,53,4133,53,810,108,702,2,31,1,1
55353,55282,53,18223,53,771,101,670,2,31,1,1
55354,65188,53,51573,53,731,91,640,2,31,1,1
55355,49432,53,56971,53,170,87,83,2,31,1,1
55356,55582,53,11114,53,778,103,675,2,31,1,1
55357,57350,53,19217,53,771,101,670,2,31,1,1
55358,55826,53,30050,53,86,86,0,1,31,1,0
55359,51221,51413,20920,51413,459,149,310,2,1200,1,1
55360,50584,11830,62858,11830,2118,900,1218,14,4232,7,7
55361,63978,53,11123,53,212,108,104,2,31,1,1
55362,56220,53,22417,53,772,103,669,2,31,1,1
55363,5938,49414,0,0,60,60,0,1,90,1,0
55364,64637,53,20905,53,810,108,702,2,30,1,1
55365,50584,53,43253,53,174,89,85,2,31,1,1
55366,65149,53,43485,53,760,97,663,2,31,1,1
55367,56743,53,42878,53,816,97,719,2,30,1,1
55368,55746,53,61389,53,216,110,106,2,31,1,1
55369,56995,53,58865,53,168,86,82,2,31,1,1
55370,55809,53,62877,53,731,85,646,2,31,1,1
55371,55735,53,65479,53,184,94,90,2,31,1,1
55372,49263,53,10892,53,731,85,646,2,31,1,1
55373,56935,53,37247,53,174,89,85,2,31,1,1
55374,51951,443,56049,443,6633,3485,3148,34,197,19,15
55375,55454,53,60200,53,202,103,99,2,31,1,1
55376,15341,23,0,0,60,60,0,1,90,1,0
55377,10151,19083,54566,19083,489,149,340,2,1200,1,1
55378,55081,53,2837,53,711,87,624,2,31,1,1
55379,56186,53,1999,53,196,100,96,2,31,1,1
55380,55273,53,51928,53,166,85,81,2,31,1,1
55381,56282,53,64449,53,751,95,656,2,31,1,1
55382,56072,53,60907,53,198,101,97,2,31,1,1
55383,57094,53,64941,53,192,98,94,2,31,1,1
55384,45944,443,12806,443,4715,1935,2780,24,183,11,13
55385,57608,445,0,0,70,70,0,1,0,1,0
55386,57604,445,0,0,70,70,0,1,0,1,0
55387,65384,57470,0,0,66,66,0,1,0,1,0
55388,54600,6881,0,0,66,66,0,1,0,1,0
55389,52624,445,0,0,70,70,0,1,0,1,0
55390,26528,51221,0,0,78,78,0,1,0,1,0
55391,63183,64147,0,0,66,66,0,1,0,1,0
55392,443,28417,0,0,82,82,0,1,0,1,0
55393,6881,6881,0,0,146,146,0,1,0,1,0
55394,53023,445,0,0,66,66,0,1,0,1,0
55395,1534,54369,0,0,66,66,0,1,0,1,0
55396,51999,37965,0,0,62,62,0,1,0,1,0
55397,64847,53,37930,53,211,102,109,2,30,1,1
55398,55990,53,28837,53,183,94,89,2,30,1,1
55399,50448,443,40818,443,1119,595,524,12,26,6,6
55400,34489,35440,0,0,62,62,0,1,0,1,0
55401,53013,445,0,0,66,66,0,1,0,1,0
55402,33292,50584,0,0,62,62,0,1,0,1,0
55403,57594,445,0,0,70,70,0,1,0,1,0
55404,48430,22,0,0,60,60,0,1,0,1,0
55405,62189,64147,0,0,145,145,0,1,0,1,0
55406,52611,445,0,0,70,70,0,1,0,1,0
55407,58305,18375,0,0,66,66,0,1,0,1,0
55408,53010,445,0,0,66,66,0,1,0,1,0
55409,61221,35440,0,0,66,66,0,1,0,1,0
55410,52608,445,0,0,70,70,0,1,0,1,0
55411,21420,44847,0,0,66,66,0,1,0,1,0
55412,53591,35889,63951,35889,320,140,180,6,6,3,3
55413,50307,53,50594,53,1370,89,1281,4,33,2,2
55414,27416,53,27416,53,214,82,132,2,32,1,1
55415,56620,53,31427,53,216,110,106,2,30,1,1
55416,64979,53,10691,53,194,102,92,2,30,1,1
55417,50280,53,42526,53,794,102,692,2,30,1,1
55418,51196,443,64591,443,346,140,206,6,130,3,3
55419,49524,443,52573,443,52864,3584,49280,86,95,39,47
55420,56546,443,24280,443,134,60,74,3,5,2,1
55421,55052,80,37545,80,11677266,314362,11362904,12711,129,5174,7537
55422,64776,53,33019,53,935,334,601,8,62,4,4
55423,49202,53,22068,53,498,204,294,6,29,3,3
55424,65357,53,38110,53,194,102,92,2,29,1,1
55425,49229,53,54866,53,178,94,84,2,29,1,1
55426,49320,53,59903,53,177,94,83,2,30,1,1
55427,55417,53,60973,53,198,102,96,2,30,1,1
55428,57201,53,46716,53,214,110,104,2,30,1,1
55429,56229,53,1556,53,173,94,79,2,30,1,1
55430,34360,80,12302,80,494,280,214,8,14,5,3
55431,51009,80,51009,80,450,246,204,8,25,5,3
55432,60750,40010,25363,40010,316,136,180,6,6,3,3
55433,38872,443,38872,443,4480,1573,2907,19,29,11,8
55434,49919,80,50897,80,2821387,64706,2756681,2277,183,418,1859
55435,63779,12226,36658,12226,66,66,0,2,7,2,0
55436,48913,443,1076,443,6922,1618,5304,23,35,12,11
55437,49449,80,49449,80,416,198,218,7,29,4,3
55438,47402,443,25875,443,6118,1180,4938,22,16,11,11
55439,59882,443,38875,443,10017,3031,6986,30,45,17,13
55440,65357,53,40859,53,194,102,92,2,29,1,1
55441,59343,53,0,0,178,72,106,2,29,1,1
55442,50689,80,50689,80,450,246,204,8,25,5,3
55443,50362,53,58174,53,214,110,104,2,29,1,1
55444,38671,443,7350,443,7897,3562,4335,19,16,10,9
55445,49883,53,5470,53,177,94,83,2,29,1,1
55446,65396,53,55502,53,186,102,84,2,29,1,1
55447,55080,53,11951,53,173,94,79,2,29,1,1
55448,52120,443,51831,443,305183,9715,295468,312,44,107,205
55449,40923,53,40923,53,200,90,110,2,29,1,1
55450,4702,53,4702,53,220,90,130,2,29,1,1
55451,53571,19636,6508,19636,70,70,0,1,4,1,0
55452,55089,53,6638,53,199,102,97,2,30,1,1
55453,55346,53,65324,53,177,94,83,2,29,1,1
55454,65192,53,33207,53,178,94,84,2,30,1,1
55455,26447,80,26447,80,12599,1479,11120,28,16,15,13
55456,63630,53,44818,53,278,94,184,2,30,1,1
55457,33243,443,3619,443,35991,3996,31995,58,17,26,32
55458,50450,80,49757,80,26924,4418,22506,34,25,13,21
55459,61364,443,41959,443,8492,2950,5542,27,16,15,12
55460,50437,80,64833,80,314,192,122,6,26,4,2
55461,64730,53,5756,53,261,94,167,2,30,1,1
55462,64836,53,53586,53,241,94,147,2,30,1,1
55463,50440,53,45707,53,216,110,106,2,30,1,1
55464,49597,53,32706,53,168,86,82,2,31,1,1
55465,65030,53,52927,53,785,110,675,2,30,1,1
55466,51406,443,38367,443,8186,2146,6040,29,33,16,13
55467,33242,443,38172,443,14244,2907,11337,33,17,17,16
55468,50426,443,9963,443,5713,1079,4634,15,26,8,7
55469,50421,80,60680,80,7162,3201,3961,19,27,11,8
55470,50462,80,58102,80,4603,2152,2451,14,22,8,6
55471,55836,53,17150,53,181,94,87,2,33,1,1
55472,50438,80,13874,80,314,192,122,6,26,4,2
55473,57095,53,33152,53,177,94,83,2,30,1,1
55474,55735,53,28047,53,184,94,90,2,30,1,1
55475,55101,53,47277,53,197,102,95,2,30,1,1
55476,56719,53,59269,53,185,102,83,2,30,1,1
55477,56719,53,51859,53,185,102,83,2,30,1,1
55478,50440,53,39485,53,216,110,106,2,30,1,1
55479,56567,53,21156,53,194,102,92,2,30,1,1
55480,56373,53,9472,53,200,102,98,2,30,1,1
55481,49422,53,52820,53,719,208,511,6,32,3,3
55482,50449,443,5504,443,7588,1850,5738,19,25,10,9
55483,49353,53,9997,53,237,94,143,2,30,1,1
55484,48409,443,36994,443,5993,1261,4732,18,982,8,10
55485,34355,80,5779,80,416,210,206,7,15,4,3
55486,55746,53,40664,53,216,110,106,2,30,1,1
55487,56386,53,3694,53,177,94,83,2,30,1,1
55488,51487,443,18707,443,10453,3977,6476,27,54,15,12
55489,49432,53,51069,53,177,94,83,2,30,1,1
55490,64980,53,3433,53,200,102,98,2,30,1,1
55491,55990,53,30769,53,183,94,89,2,30,1,1
55492,49564,53,7876,53,168,78,90,2,30,1,1
55493,56995,53,18611,53,168,86,82,2,30,1,1
55494,64840,53,24107,53,356,118,238,2,30,1,1
55495,44587,443,26672,443,16341,3306,13035,42,17,24,18
55496,55077,53,19465,53,277,90,187,4,32,2,2
55497,50439,80,32782,80,318,192,126,6,26,4,2
55498,65291,53,53725,53,889,404,485,10,30,5,5
55499,52704,53,49844,53,168,78,90,2,30,1,1
55500,63067,443,13404,443,2570995,60656,2510339,2538,34,844,1694
55501,34354,80,61619,80,350,210,140,6,15,4,2
55502,51766,48169,32212,48169,70,70,0,1,5,1,0
55503,60038,80,60038,80,12881,767,12114,21,21,9,12
55504,50434,80,31890,80,318,192,126,6,26,4,2
55505,52380,443,20377,443,8659,3601,5058,34,80,18,16
55506,65496,53,6299,53,210,86,124,2,30,1,1
55507,56620,53,63507,53,216,110,106,2,30,1,1
55508,60760,53,0,0,86,86,0,1,30,1,0
55509,56658,53,12429,53,229,94,135,2,30,1,1
55510,49971,53,55758,53,198,102,96,2,30,1,1
55511,57090,53,28237,53,198,102,96,2,30,1,1
55512,34529,443,32303,443,77395,64623,12772,206,188,116,90
55513,37277,80,37277,80,52625,3140,49485,55,52,14,41
55514,49913,443,31997,443,5570,901,4669,16,27,8,8
55515,34359,80,6984,80,350,210,140,6,14,4,2
55516,51764,33432,6081,33432,70,70,0,1,5,1,0
55517,53570,24874,57819,24874,70,70,0,1,4,1,0
55518,53372,443,36591,443,214,140,74,4,20,3,1
55519,63768,55755,10523,55755,70,70,0,1,4,1,0
55520,55417,53,34497,53,198,102,96,2,33,1,1
55521,60402,47094,53695,47094,320,140,180,6,7,3,3
55522,53575,1025,61617,1025,70,70,0,1,4,1,0
55523,50441,80,60802,80,318,192,126,6,26,4,2
55524,50433,80,24726,80,318,192,126,6,26,4,2
55525,65470,443,40363,443,372361,11310,361051,385,16,136,249
55526,50122,443,55695,443,6407,1101,5306,18,26,10,8
55527,49623,53,34250,53,790,110,680,2,29,1,1
55528,50424,443,50613,443,5713,1079,4634,15,26,8,7
55529,53070,53,0,0,168,74,94,2,29,1,1
55530,55080,53,13972,53,165,86,79,2,29,1,1
55531,57201,53,40982,53,214,110,104,2,29,1,1
55532,33246,443,57032,443,8340,2896,5444,28,16,16,12
55533,50362,53,33305,53,214,110,104,2,29,1,1
55534,46159,443,12485,443,124567,6787,117780,175,263,82,93
55535,59321,53,33396,53,209,70,139,2,30,1,1
55536,49320,53,28326,53,185,102,83,2,30,1,1
55537,65130,53,25428,53,646,200,446,6,62,3,3
55538,63942,53,65464,53,214,102,112,2,30,1,1
55539,49405,53,14474,53,94,94,0,1,30,1,0
55540,50106,53,61175,53,209,110,99,2,30,1,1
55541,60375,53,25105,53,226,94,132,2,31,1,1
55542,56386,53,9835,53,177,94,83,2,31,1,1
55543,49068,443,40796,443,8664,2567,6097,20,120,10,10
55544,55439,53,52898,53,209,110,99,2,30,1,1
55545,55776,53,52683,53,216,110,106,2,30,1,1
55546,17481,53,17481,53,198,90,108,2,30,1,1
55547,56567,53,28811,53,194,102,92,2,31,1,1
55548,36157,53,43020,53,164,78,86,2,31,1,1
55549,65366,53,59432,53,199,102,97,2,31,1,1
55550,56186,53,13478,53,198,102,96,2,31,1,1
55551,57094,53,10369,53,196,102,94,2,30,1,1
55552,49591,53,7578,53,168,86,82,2,32,1,1
55553,53117,37529,25510,37529,70,70,0,2,8,2,0
55554,50463,80,9327,80,1718,1247,471,9,15,5,4
55555,50496,443,27297,443,90570,3437,87133,103,90,34,69
55556,50148,80,44851,80,17314,6865,10449,50,79,24,26
55557,33245,443,3684,443,7279,2884,4395,28,16,16,12
55558,63764,12343,45903,12343,504,382,122,8,15,6,2
55559,55462,53,6708,53,194,102,92,2,30,1,1
55560,65366,53,11375,53,199,102,97,2,30,1,1
55561,55107,53,52328,53,214,102,112,2,30,1,1
55562,56373,53,63287,53,200,102,98,2,30,1,1
55563,50613,53,60735,53,814,110,704,2,30,1,1
55564,56373,53,59936,53,200,102,98,2,30,1,1
55565,41886,53,43611,53,168,78,90,2,30,1,1
55566,50440,53,43767,53,216,110,106,2,30,1,1
55567,49971,53,63730,53,198,102,96,2,30,1,1
55568,30188,14432,60719,14432,868,150,718,4,1200,2,2
55569,49433,53,38840,53,167,86,81,2,30,1,1
55570,50922,443,21315,443,6180,1241,4939,18,982,8,10
55571,52321,443,52321,443,6727,762,5965,15,25,8,7
55572,58889,443,61172,443,3956,2519,1437,18,80,10,8
55573,50440,80,41548,80,318,192,126,6,26,4,2
55574,50429,80,32057,80,318,192,126,6,26,4,2
55575,50430,80,29932,80,318,192,126,6,26,4,2
55576,50150,80,7592,80,73454,5461,67993,74,79,22,52
55577,50312,80,40765,80,2699,1007,1692,14,64,7,7
55578,50425,443,34304,443,5653,1079,4574,14,26,8,6
55579,50374,443,61017,443,8485,1804,6681,30,316,14,16
55580,33238,443,21628,443,21538,3952,17586,48,17,27,21
55581,55836,53,27528,53,181,94,87,2,30,1,1
55582,55656,53,37585,53,214,110,104,2,30,1,1
55583,55656,53,7470,53,214,110,104,2,30,1,1
55584,54967,53,27983,53,178,94,84,2,30,1,1
55585,55617,53,59978,53,194,102,92,2,30,1,1
55586,37637,53,37222,53,168,78,90,2,30,1,1
55587,52221,53,10859,53,177,86,91,2,30,1,1
55588,40507,53,2072,53,86,86,0,1,30,1,0
55589,50455,443,11561,443,107749,6262,101487,142,138,58,84
55590,38523,53,38523,53,214,82,132,2,32,1,1
55591,33664,80,55691,80,70,70,0,1,5,1,0
55592,50436,80,19701,80,314,192,122,6,26,4,2
55593,55990,53,6469,53,183,94,89,2,30,1,1
55594,55735,53,52965,53,184,94,90,2,30,1,1
55595,56771,53,2287,53,270,95,175,4,60,2,2
55596,65153,53,29688,53,168,86,82,2,30,1,1
55597,50106,53,26028,53,209,110,99,2,30,1,1
55598,63978,53,60357,53,214,110,104,2,30,1,1
55599,64980,53,54616,53,200,102,98,2,30,1,1
55600,50584,53,20103,53,179,94,85,2,30,1,1
55601,63978,53,35344,53,214,110,104,2,30,1,1
55602,58263,443,17697,443,12494,5331,7163,48,122,21,27
55603,33067,53,0,0,86,86,0,1,30,1,0
55604,55336,53,26759,53,199,102,97,2,31,1,1
55605,50103,53,41648,53,168,86,82,2,31,1,1
55606,56809,53,41798,53,178,94,84,2,31,1,1
55607,64413,443,46827,443,5660875,75934,5584941,4719,141,686,4033
55608,55746,53,54887,53,216,110,106,2,30,1,1
55609,64001,53,4323,53,183,94,89,2,30,1,1
55610,65036,53,40667,53,214,110,104,2,30,1,1
55611,50105,53,29739,53,969,86,883,2,30,1,1
55612,57090,53,19646,53,198,102,96,2,30,1,1
55613,55656,53,44214,53,214,110,104,2,30,1,1
55614,64001,53,1260,53,183,94,89,2,30,1,1
55615,65036,53,28927,53,214,110,104,2,30,1,1
55616,65366,53,12473,53,199,102,97,2,30,1,1
55617,56355,53,13355,53,184,94,90,2,30,1,1
55618,55454,53,12071,53,209,110,99,2,31,1,1
55619,40942,123,62465,123,184,94,90,2,30,1,1
55620,56386,53,21142,53,177,94,83,2,30,1,1
55621,49543,53,11834,53,779,110,669,2,30,1,1
55622,56357,53,34112,53,178,94,84,2,30,1,1
55623,64995,53,33043,53,199,102,97,2,30,1,1
55624,57259,53,43312,53,199,102,97,2,31,1,1
55625,50103,53,21620,53,168,86,82,2,30,1,1
55626,54956,53,56541,53,194,102,92,2,30,1,1
55627,64995,53,32093,53,199,102,97,2,30,1,1
55628,55372,53,55372,53,216,90,126,2,30,1,1
55629,56501,53,9977,53,216,94,122,2,31,1,1
55630,57094,53,18443,53,196,102,94,2,31,1,1
55631,55364,53,26181,53,168,86,82,2,31,1,1
55632,65300,53,9182,53,195,102,93,2,31,1,1
55633,56355,53,43280,53,184,94,90,2,31,1,1
55634,52251,443,26101,443,23328780,730794,22597986,24754,320,8113,16641
55635,35745,443,18614,443,7634,4417,3217,35,197,19,16
55636,55101,53,52227,53,197,102,95,2,31,1,1
55637,49608,53,63046,53,198,110,88,2,31,1,1
55638,49432,53,5253,53,177,94,83,2,31,1,1
55639,56072,53,35892,53,199,102,97,2,31,1,1
55640,8861,443,39985,443,42890,30849,12041,214,420,106,108
55641,39500,443,7473,443,6517,2048,4469,21,90,12,9
55642,50523,443,53596,443,6676,1074,5602,22,84,12,10
55643,38535,443,55811,443,910,358,552,14,47,6,8
55644,43368,80,43368,80,232198,9152,223046,290,21,134,156
55645,50512,443,55722,443,6945,1842,5103,25,87,14,11
55646,54956,53,60675,53,194,102,92,2,31,1,1
55647,63761,25933,42159,25933,436,254,182,7,15,4,3
55648,53593,32022,37169,32022,320,140,180,6,6,3,3
55649,65338,53,10255,53,314,88,226,4,44,2,2
55650,51509,443,60240,443,1307,688,619,14,37,8,6
55651,50586,443,6357,443,2756,1594,1162,20,27,11,9
55652,58703,50584,0,0,66,66,0,1,0,1,0
55653,53004,445,0,0,66,66,0,1,0,1,0
55654,53000,445,0,0,66,66,0,1,0,1,0
55655,21892,15503,0,0,62,62,0,1,0,1,0
55656,21145,11392,0,0,62,62,0,1,0,1,0
55657,39895,26467,0,0,62,62,0,1,0,1,0
55658,52604,445,0,0,70,70,0,1,0,1,0
55659,52602,445,0,0,70,70,0,1,0,1,0
55660,17320,14914,0,0,148,148,0,1,0,1,0
55661,52600,445,0,0,70,70,0,1,0,1,0
55662,62071,22114,0,0,62,62,0,1,0,1,0
55663,56712,46824,0,0,66,66,0,1,0,1,0
55664,60018,64147,0,0,62,62,0,1,0,1,0
55665,57583,445,0,0,70,70,0,1,0,1,0
55666,57581,445,0,0,70,70,0,1,0,1,0
55667,52980,445,0,0,66,66,0,1,0,1,0
55668,52986,445,0,0,66,66,0,1,0,1,0
55669,52983,445,0,0,66,66,0,1,0,1,0
55670,52981,445,0,0,66,66,0,1,0,1,0
55671,52987,445,0,0,66,66,0,1,0,1,0
55672,52988,445,0,0,66,66,0,1,0,1,0
55673,52985,445,0,0,66,66,0,1,0,1,0
55674,52984,445,0,0,66,66,0,1,0,1,0
55675,53469,44847,0,0,66,66,0,1,0,1,0
55676,10533,23,0,0,60,60,0,1,0,1,0
55677,47962,16069,0,0,62,62,0,1,0,1,0
55678,52593,445,0,0,70,70,0,1,0,1,0
55679,52591,445,0,0,70,70,0,1,0,1,0
55680,7905,48817,0,0,146,146,0,1,0,1,0
55681,36906,50584,0,0,62,62,0,1,0,1,0
55682,57579,445,0,0,70,70,0,1,0,1,0
55683,57569,445,0,0,70,70,0,1,0,1,0
55684,57566,445,0,0,70,70,0,1,0,1,0
55685,52590,445,0,0,70,70,0,1,0,1,0
55686,52589,445,0,0,70,70,0,1,0,1,0
55687,52588,445,0,0,70,70,0,1,0,1,0
55688,52968,445,0,0,66,66,0,1,0,1,0
55689,52966,445,0,0,66,66,0,1,0,1,0
55690,52965,445,0,0,66,66,0,1,0,1,0
55691,52586,445,0,0,70,70,0,1,0,1,0
55692,52583,445,0,0,70,70,0,1,0,1,0
55693,62549,64147,0,0,62,62,0,1,0,1,0
55694,58598,50584,0,0,62,62,0,1,0,1,0
55695,443,28417,0,0,82,82,0,1,0,1,0
55696,57562,445,0,0,70,70,0,1,0,1,0
55697,50535,51505,0,0,66,66,0,1,0,1,0
55698,62776,62413,0,0,62,62,0,1,0,1,0
55699,32491,15503,0,0,66,66,0,1,0,1,0
55700,49699,64147,0,0,62,62,0,1,0,1,0
55701,17008,35440,0,0,62,62,0,1,0,1,0
55702,54111,62609,0,0,148,148,0,1,0,1,0
55703,64482,64147,0,0,62,62,0,1,0,1,0
55704,57560,445,0,0,70,70,0,1,0,1,0
55705,24411,12809,0,0,60,60,0,1,0,1,0
55706,52570,445,0,0,70,70,0,1,0,1,0
55707,52569,445,0,0,70,70,0,1,0,1,0
55708,52565,445,0,0,70,70,0,1,0,1,0
55709,57552,445,0,0,70,70,0,1,0,1,0
55710,57550,445,0,0,70,70,0,1,0,1,0
55711,57548,445,0,0,70,70,0,1,0,1,0
55712,52559,445,0,0,70,70,0,1,0,1,0
55713,52560,445,0,0,70,70,0,1,0,1,0
55714,49664,37965,0,0,66,66,0,1,0,1,0
55715,60196,53,0,0,88,88,0,1,0,1,0
55716,55296,23718,0,0,66,66,0,1,0,1,0
55717,12608,21247,0,0,66,66,0,1,0,1,0
55718,57772,50584,0,0,66,66,0,1,0,1,0
55719,29424,37807,0,0,66,66,0,1,0,1,0
55720,60196,53,0,0,88,88,0,1,0,1,0
55721,15274,81,0,0,60,60,0,1,0,1,0
55722,58445,17500,0,0,66,66,0,1,0,1,0
55723,31469,23,0,0,60,60,0,1,0,1,0
55724,40971,1433,0,0,60,60,0,1,0,1,0
55725,28668,8696,0,0,60,60,0,1,0,1,0
55726,21833,22114,0,0,62,62,0,1,0,1,0
55727,52548,445,0,0,70,70,0,1,0,1,0
55728,37902,23718,0,0,146,146,0,1,0,1,0
55729,57543,445,0,0,70,70,0,1,0,1,0
55730,57540,445,0,0,70,70,0,1,0,1,0
55731,57537,445,0,0,70,70,0,1,0,1,0
55732,1176,64147,0,0,62,62,0,1,0,1,0
55733,59592,37965,0,0,62,62,0,1,0,1,0
55734,9412,7302,0,0,66,66,0,1,0,1,0
55735,47910,7454,0,0,60,60,0,1,0,1,0
55736,47910,7454,0,0,60,60,0,1,0,1,0
55737,443,28417,0,0,82,82,0,1,0,1,0
55738,63465,56205,0,0,66,66,0,1,0,1,0
55739,42685,51180,0,0,62,62,0,1,0,1,0
55740,18415,37965,0,0,62,62,0,1,0,1,0
55741,52544,445,0,0,70,70,0,1,0,1,0
55742,58995,443,49054,443,8826,2860,5966,21,9,10,11
55743,26921,37965,0,0,62,62,0,1,0,1,0
55744,37597,50584,0,0,66,66,0,1,0,1,0
55745,51617,21247,0,0,66,66,0,1,0,1,0
55746,59918,44847,0,0,66,66,0,1,0,1,0
55747,36656,64147,0,0,62,62,0,1,0,1,0
55748,52944,445,0,0,66,66,0,1,0,1,0
55749,54343,50584,0,0,66,66,0,1,0,1,0
55750,57533,445,0,0,70,70,0,1,0,1,0
55751,57534,445,0,0,70,70,0,1,0,1,0
55752,80,54605,0,0,66,66,0,1,0,1,0
55753,54471,36237,0,0,66,66,0,1,0,1,0
55754,52533,445,0,0,70,70,0,1,0,1,0
55755,52535,445,0,0,70,70,0,1,0,1,0
55756,52532,445,0,0,70,70,0,1,0,1,0
55757,52531,445,0,0,70,70,0,1,0,1,0
55758,52527,445,0,0,70,70,0,1,0,1,0
55759,1323,64147,0,0,66,66,0,1,0,1,0
55760,443,28417,0,0,82,82,0,1,0,1,0
55761,0,0,0,0,70,70,0,1,0,1,0
55762,0,0,0,0,480,244,236,4,0,2,2
55763,0,0,0,0,182,182,0,1,0,1,0
55764,48087,16069,0,0,62,62,0,1,0,1,0
55765,52940,445,0,0,66,66,0,1,0,1,0
55766,45941,23388,0,0,60,60,0,1,0,1,0
55767,52936,445,0,0,66,66,0,1,0,1,0
55768,16059,22114,0,0,62,62,0,1,0,1,0
55769,57523,445,0,0,70,70,0,1,0,1,0
55770,57515,445,0,0,70,70,0,1,0,1,0
55771,57514,445,0,0,70,70,0,1,0,1,0
55772,57511,445,0,0,70,70,0,1,0,1,0
55773,52522,445,0,0,70,70,0,1,0,1,0
55774,52933,445,0,0,66,66,0,1,0,1,0
55775,61315,48817,0,0,62,62,0,1,0,1,0
55776,57508,445,0,0,70,70,0,1,0,1,0
55777,52514,445,0,0,70,70,0,1,0,1,0
55778,57283,64147,0,0,66,66,0,1,0,1,0
55779,52511,445,0,0,70,70,0,1,0,1,0
55780,57505,445,0,0,70,70,0,1,0,1,0
55781,57504,445,0,0,70,70,0,1,0,1,0
55782,57501,445,0,0,70,70,0,1,0,1,0
55783,20378,23,0,0,60,60,0,1,0,1,0
55784,52926,445,0,0,66,66,0,1,0,1,0
55785,39359,15503,0,0,74,74,0,1,0,1,0
55786,52920,445,0,0,66,66,0,1,0,1,0
55787,52923,445,0,0,66,66,0,1,0,1,0
55788,52919,445,0,0,66,66,0,1,0,1,0
55789,64890,51180,0,0,62,62,0,1,0,1,0
55790,52916,445,0,0,66,66,0,1,0,1,0
55791,52917,445,0,0,66,66,0,1,0,1,0
55792,52915,445,0,0,66,66,0,1,0,1,0
55793,52508,445,0,0,70,70,0,1,0,1,0
55794,31521,57470,0,0,145,145,0,1,0,1,0
55795,52506,445,0,0,70,70,0,1,0,1,0
55796,45908,33330,0,0,60,60,0,1,0,1,0
55797,443,28417,0,0,82,82,0,1,0,1,0
55798,52743,15503,0,0,66,66,0,1,0,1,0
55799,30046,15503,0,0,62,62,0,1,0,1,0
55800,61420,64097,0,0,66,66,0,1,0,1,0
55801,11252,23,0,0,60,60,0,1,0,1,0
55802,57498,445,0,0,70,70,0,1,0,1,0
55803,57499,445,0,0,70,70,0,1,0,1,0
55804,57496,445,0,0,70,70,0,1,0,1,0
55805,52910,445,0,0,66,66,0,1,0,1,0
55806,52502,445,0,0,70,70,0,1,0,1,0
55807,64516,53,13798,53,216,110,106,2,30,1,1
55808,37133,80,37133,80,12799,979,11820,20,17,9,11
55809,57896,443,11349,443,7332,3746,3586,37,176,19,18
55810,51269,36983,55294,36983,70,70,0,2,8,2,0
55811,59819,443,17243,443,1401,864,537,12,29,6,6
55812,63204,443,63204,443,9340,4256,5084,24,16,13,11
55813,40791,443,54664,443,7236,2069,5167,25,25,12,13
55814,57893,443,16617,443,1867,1228,639,18,176,11,7
55815,55943,53,5113,53,1415,94,1321,4,31,2,2
55816,53584,62974,25990,62974,70,70,0,2,8,2,0
55817,49217,53,12085,53,202,103,99,2,31,1,1
55818,49374,53,54400,53,186,95,91,2,31,1,1
55819,55101,53,27553,53,194,99,95,2,30,1,1
55820,35048,80,62136,80,15867,2466,13401,29,33,16,13
55821,53587,32029,60710,32029,70,70,0,2,8,2,0
55822,51780,21130,9712,21130,70,70,0,2,8,2,0
55823,53567,43167,28309,43167,492,306,186,8,16,5,3
55824,65300,53,37068,53,190,97,93,2,31,1,1
55825,59823,443,61551,443,306,180,126,6,29,4,2
55826,51782,10637,37366,10637,70,70,0,2,8,2,0
55827,34166,443,49916,443,8290,2156,6134,24,81,14,10
55828,56611,443,45204,443,7983,1963,6020,20,15,11,9
55829,57884,443,2033,443,3981,1811,2170,26,177,14,12
55830,56809,53,64424,53,172,88,84,2,31,1,1
55831,55364,53,1221,53,168,86,82,2,31,1,1
55832,53564,63344,20702,63344,1721,971,750,15,16,8,7
55833,56610,443,4585,443,8035,2015,6020,20,16,11,9
55834,35567,443,35567,443,5413,2166,3247,22,39,13,9
55835,64680,53,32256,53,768,99,669,2,30,1,1
55836,44913,443,18458,443,414,140,274,7,27,3,4
55837,56612,443,41735,443,8033,2013,6020,20,15,11,9
55838,58992,443,6436,443,3049,1857,1192,20,21,9,11
55839,46684,80,18811,80,4294,1112,3182,15,199,4,11
55840,46982,443,35062,443,3847,2650,1197,22,35,13,9
55841,59817,443,40958,443,1401,864,537,12,29,6,6
55842,59836,443,19606,443,1587,924,663,15,27,7,8
55843,51781,43909,29947,43909,70,70,0,2,8,2,0
55844,53580,48066,41215,48066,70,70,0,2,8,2,0
55845,55655,53,48004,53,304,110,194,4,35,2,2
55846,49888,53,54251,53,196,100,96,2,30,1,1
55847,43597,443,44647,443,47048,9293,37755,63,412,28,35
55848,53246,443,15204,443,134,60,74,3,11,2,1
55849,57901,443,18752,443,3924,1906,2018,26,170,14,12
55850,57892,443,36599,443,6394,3923,2471,42,176,22,20
55851,57905,443,45669,443,1851,1152,699,18,169,10,8
55852,57900,443,44556,443,1798,1159,639,17,170,10,7
55853,50376,53,65518,53,164,84,80,2,31,1,1
55854,64417,53,46438,53,184,94,90,2,31,1,1
55855,55675,53,52778,53,764,99,665,2,31,1,1
55856,54956,53,34992,53,188,96,92,2,31,1,1
55857,44482,443,27809,443,16517,3254,13263,37,271,18,19
55858,34165,443,5648,443,8208,2080,6128,24,81,14,10
55859,45273,53,45273,53,213,79,134,2,32,1,1
55860,39207,80,25613,80,78,78,0,1,5,1,0
55861,57885,443,33287,443,1792,1153,639,17,177,10,7
55862,57904,443,36166,443,4042,2515,1527,28,169,14,14
55863,59818,443,31542,443,1401,864,537,12,29,6,6
55864,57877,443,6198,443,9256443,112898,9143545,7609,178,1428,6181
55865,53579,59332,37605,59332,70,70,0,2,8,2,0
55866,65411,53,35148,53,771,101,670,2,30,1,1
55867,49841,53,53641,53,751,95,656,2,30,1,1
55868,57897,443,36818,443,1865,1226,639,18,176,11,7
55869,64815,53,23371,53,755,94,661,2,30,1,1
55870,56601,53,60579,53,168,78,90,2,30,1,1
55871,64001,53,5288,53,182,93,89,2,30,1,1
55872,56391,53,63935,53,758,93,665,2,31,1,1
55873,55171,53,26173,53,762,97,665,2,31,1,1
55874,65334,443,56103,443,3182,1568,1614,8,120,4,4
55875,43585,443,18767,443,6636,3565,3071,22,187,13,9
55876,64595,53,64819,53,166,85,81,2,31,1,1
55877,55147,53,27402,53,184,94,90,2,31,1,1
55878,64903,53,49771,53,777,87,690,2,31,1,1
55879,52169,443,53007,443,7905,4819,3086,27,139,13,14
55880,56919,53,19863,53,186,95,91,2,31,1,1
55881,5938,51883,0,0,60,60,0,1,91,1,0
55882,5938,16167,0,0,60,60,0,1,91,1,0
55883,55802,443,44281,443,30007,2755,27252,41,136,16,25
55884,56557,53,31623,53,212,108,104,2,31,1,1
55885,56312,53,44683,53,756,95,661,2,31,1,1
55886,55077,53,1629,53,174,89,85,2,31,1,1
55887,64287,53,20763,53,178,91,87,2,31,1,1
55888,55217,53,15991,53,744,89,655,2,31,1,1
55889,57252,53,46137,53,182,93,89,2,31,1,1
55890,56926,53,49989,53,747,93,654,2,31,1,1
55891,21594,22448,0,0,62,62,0,1,61,1,0
55892,5938,39160,0,0,60,60,0,1,91,1,0
55893,54993,53,53914,53,751,95,656,2,31,1,1
55894,5938,35844,0,0,60,60,0,1,91,1,0
55895,64924,53,58224,53,747,93,654,2,31,1,1
55896,56227,53,18236,53,174,89,85,2,31,1,1
55897,64715,53,60812,53,202,103,99,2,31,1,1
55898,65246,53,4675,53,182,93,89,2,31,1,1
55899,65246,53,34223,53,182,93,89,2,31,1,1
55900,49901,53,35015,53,186,95,91,2,31,1,1
55901,55604,53,44456,53,758,93,665,2,31,1,1
55902,43472,5228,13384,5228,2531,1416,1115,17,3600,8,9
55903,57492,445,0,0,70,70,0,1,0,1,0
55904,52909,445,0,0,66,66,0,1,0,1,0
55905,49805,6881,0,0,66,66,0,1,0,1,0
55906,34176,51505,0,0,62,62,0,1,0,1,0
55907,46478,64147,0,0,145,145,0,1,0,1,0
55908,51837,37965,0,0,66,66,0,1,0,1,0
55909,58022,8800,0,0,60,60,0,1,0,1,0
55910,52905,445,0,0,66,66,0,1,0,1,0
55911,52907,445,0,0,66,66,0,1,0,1,0
55912,44594,64147,0,0,66,66,0,1,0,1,0
55913,11648,37965,0,0,145,145,0,1,0,1,0
55914,52501,445,0,0,70,70,0,1,0,1,0
55915,58338,3369,0,0,60,60,0,1,0,1,0
55916,54575,11392,0,0,66,66,0,1,0,1,0
55917,52903,445,0,0,66,66,0,1,0,1,0
55918,42252,33303,0,0,60,60,0,1,0,1,0
55919,28973,30188,0,0,66,66,0,1,0,1,0
55920,57484,445,0,0,70,70,0,1,0,1,0
55921,56609,53,42819,53,199,102,97,2,31,1,1
55922,49573,53,10183,53,770,102,668,2,30,1,1
55923,51763,34121,50527,34121,70,70,0,1,5,1,0
55924,25629,28678,25311,28678,1806,1806,0,22,225,22,0
55925,61345,21247,0,0,66,66,0,1,0,1,0
55926,52496,445,0,0,70,70,0,1,0,1,0
55927,29109,11392,0,0,146,146,0,1,0,1,0
55928,57482,445,0,0,70,70,0,1,0,1,0
55929,57477,445,0,0,70,70,0,1,0,1,0
55930,28498,36237,0,0,62,62,0,1,0,1,0
55931,443,56117,0,0,97,97,0,1,0,1,0
55932,7222,57470,0,0,62,62,0,1,0,1,0
55933,50788,48817,0,0,62,62,0,1,0,1,0
55934,52895,445,0,0,66,66,0,1,0,1,0
55935,11816,50584,0,0,66,66,0,1,0,1,0
55936,52885,445,0,0,66,66,0,1,0,1,0
55937,53553,443,31063,443,3708,1988,1720,20,255,10,10
55938,57898,443,41076,443,240332,6623,233709,258,170,92,166
55939,41699,443,36765,443,40273,3243,37030,60,77,28,32
55940,41689,443,36583,443,1307513,51701,1255812,1486,148,576,910
55941,56344,53,55607,53,167,86,81,2,30,1,1
55942,56430,53,61403,53,193,102,91,2,30,1,1
55943,62880,53,59831,53,248,78,170,2,30,1,1
55944,55336,53,49932,53,199,102,97,2,30,1,1
55945,55273,53,29396,53,167,86,81,2,30,1,1
55946,56082,53,4620,53,182,94,88,2,30,1,1
55947,64945,53,44242,53,243,94,149,2,30,1,1
55948,51342,53,21697,53,199,94,105,2,30,1,1
55949,56609,53,65200,53,199,102,97,2,30,1,1
55950,51512,443,52808,443,626132,21332,604800,730,33,294,436
55951,48304,443,22064,443,6606,2153,4453,22,95,13,9
55952,37695,443,3343,443,1134364,30994,1103370,1170,175,403,767
55953,55113,53,62881,53,198,102,96,2,33,1,1
55954,12945,53,12945,53,233,90,143,2,32,1,1
55955,49176,53,50257,53,528,178,350,6,43,3,3
55956,57890,443,58945,443,3588,1991,1597,27,176,14,13
55957,49433,53,5828,53,167,86,81,2,29,1,1
55958,55776,53,11863,53,216,110,106,2,29,1,1
55959,65138,53,38637,53,765,102,663,2,30,1,1
55960,55988,443,19724,443,14754,7879,6875,37,231,20,17
55961,61363,80,43167,80,1931,752,1179,15,16,8,7
55962,52212,80,6091,80,366,246,120,6,34,4,2
55963,51506,443,52823,443,584947,21842,563105,678,36,286,392
55964,60045,443,35524,443,17161,1619,15542,18,151,4,14
55965,53578,34129,11045,34129,70,70,0,2,7,2,0
55966,56615,80,9225,80,234,234,0,4,11,4,0
55967,51759,55308,19017,55308,70,70,0,1,5,1,0
55968,50531,80,18243,80,1704,799,905,11,83,6,5
55969,50519,443,37665,443,7967,1647,6320,25,85,14,11
55970,64551,53,37333,53,495,127,368,4,33,2,2
55971,50513,443,44199,443,9766,1810,7956,30,86,16,14
55972,51758,31009,29940,31009,70,70,0,1,5,1,0
55973,50604,443,64927,443,1385,783,602,14,23,8,6
55974,51761,19136,25240,19136,70,70,0,1,5,1,0
55975,50602,443,61178,443,3901,1858,2043,19,23,11,8
55976,55615,53,40819,53,225,110,115,2,30,1,1
55977,57257,53,4922,53,173,94,79,2,30,1,1
55978,65285,53,31109,53,294,102,192,2,30,1,1
55979,53017,443,37363,443,15038,4142,10896,48,108,24,24
55980,49456,443,44613,443,939,547,392,11,27,5,6
55981,50022,443,50896,443,70,70,0,2,5,2,0
55982,53028,80,62533,80,70,70,0,1,5,1,0
55983,51760,36558,34247,36558,70,70,0,1,5,1,0
55984,36464,443,36464,443,4373,1466,2907,19,29,11,8
55985,57903,443,52416,443,5465,2653,2812,28,169,14,14
55986,51925,443,7342,443,16797,8530,8267,53,82,30,23
55987,57883,443,47068,443,1786,1147,639,17,177,10,7
55988,50459,53,40007,53,811,94,717,2,30,1,1
55989,49993,53,48809,53,212,102,110,2,30,1,1
55990,55293,53,0,0,166,73,93,2,30,1,1
55991,56186,53,36968,53,198,102,96,2,30,1,1
55992,56809,53,35484,53,178,94,84,2,30,1,1
55993,65246,53,13640,53,767,102,665,2,30,1,1
55994,50542,443,1665,443,5779,1472,4307,22,78,12,10
55995,59828,443,44871,443,306,180,126,6,29,4,2
55996,49851,53,2859,53,306,88,218,4,32,2,2
55997,55480,53,36431,53,378,97,281,4,33,2,2
55998,57872,443,43316,443,183325,10358,172967,289,227,95,194
55999,60397,43129,42698,43129,70,70,0,1,5,1,0
56000,53092,443,13048,443,97276,2756,94520,96,96,21,75
56001,57889,443,40826,443,1851,1212,639,18,177,11,7
56002,56344,53,18094,53,167,86,81,2,30,1,1
56003,56673,443,49966,443,5726,1474,4252,22,81,13,9
56004,50831,443,11343,443,721741,131746,589995,1518,322,787,731
56005,62034,53,62034,53,216,90,126,2,30,1,1
56006,57259,53,43508,53,199,102,97,2,30,1,1
56007,59832,443,5609,443,302,120,182,6,28,3,3
56008,55336,53,7329,53,199,102,97,2,30,1,1
56009,65484,53,31170,53,195,102,93,2,30,1,1
56010,55655,53,10525,53,304,110,194,4,34,2,2
56011,57186,53,41154,53,177,94,83,2,30,1,1
56012,56962,53,9664,53,177,94,83,2,30,1,1
56013,55600,80,5814,80,70,70,0,1,5,1,0
56014,65484,53,32858,53,195,102,93,2,30,1,1
56015,57891,443,65008,443,1856,1217,639,18,176,11,7
56016,55240,53,36394,53,816,102,714,2,30,1,1
56017,64936,53,3056,53,193,102,91,2,30,1,1
56018,41700,443,15367,443,167721,6935,160786,185,77,68,117
56019,49217,53,36290,53,209,110,99,2,30,1,1
56020,53053,443,10274,443,9303,2569,6734,39,106,20,19
56021,53036,443,40328,443,249145,4184,244961,218,107,40,178
56022,51466,4545,51466,4545,156,156,0,3,8,3,0
56023,57888,443,55452,443,113115,8327,104788,184,177,77,107
56024,55454,53,25468,53,209,110,99,2,30,1,1
56025,55273,53,29948,53,167,86,81,2,30,1,1
56026,57186,53,42967,53,177,94,83,2,30,1,1
56027,64516,53,8350,53,216,110,106,2,30,1,1
56028,64652,53,53769,53,198,94,104,2,30,1,1
56029,55077,53,42307,53,179,94,85,2,30,1,1
56030,57369,16881,7618,16881,564,318,246,9,15,5,4
56031,56569,53,5839,53,181,94,87,2,32,1,1
56032,57894,443,52904,443,4544,1112,3432,21,176,12,9
56033,49492,80,50602,80,1680,1210,470,9,15,5,4
56034,49449,443,30580,443,1574,921,653,14,15,7,7
56035,12136,53,12136,53,198,90,108,2,30,1,1
56036,41674,443,45032,443,14424911,433341,13991570,15454,320,5482,9972
56037,53240,443,16717,443,1296713,27754,1268959,1253,118,366,887
56038,55375,53,8307,53,214,110,104,2,30,1,1
56039,55375,53,30516,53,214,110,104,2,30,1,1
56040,36405,53,36515,53,199,94,105,2,30,1,1
56041,49888,53,39344,53,198,102,96,2,30,1,1
56042,55240,53,47282,53,193,102,91,2,30,1,1
56043,50039,53,19771,53,261,110,151,2,30,1,1
56044,64595,53,62622,53,167,86,81,2,30,1,1
56045,60280,443,7130,443,46713,2661,44052,55,120,21,34
56046,45871,443,58048,443,275011,235921,39090,651,350,363,288
56047,56557,53,41528,53,214,110,104,2,30,1,1
56048,37815,443,28606,443,6226,4834,1392,17,125,11,6
56049,64002,53,17468,53,796,105,691,4,59,2,2
56050,55273,53,49246,53,317,85,232,4,60,2,2
56051,49374,53,36144,53,193,102,91,2,30,1,1
56052,51507,443,1531,443,584465,23057,561408,694,36,303,391
56053,40453,443,6651,443,5655,1614,4041,22,30,11,11
56054,35965,443,31855,443,3821,2814,1007,22,17,12,10
56055,52188,443,37924,443,1768,1034,734,16,65,8,8
56056,50511,443,12647,443,6352,1073,5279,22,85,12,10
56057,51516,443,35060,443,1195,634,561,12,21,7,5
56058,51511,443,55401,443,213140,10321,202819,260,33,108,152
56059,50518,443,9409,443,7117,1288,5829,22,84,12,10
56060,53589,40281,13610,40281,70,70,0,2,7,2,0
56061,65469,443,41637,443,92958,4869,88089,109,15,44,65
56062,50514,443,24194,443,11554,3028,8526,34,86,19,15
56063,51498,443,13741,443,134,60,74,3,4,2,1
56064,49345,443,4175,443,61954,10029,51925,114,82,50,64
56065,55655,53,55322,53,304,110,194,4,34,2,2
56066,58027,80,53632,80,1225,711,514,11,15,5,6
56067,55113,53,41095,53,198,102,96,2,29,1,1
56068,55981,53,55529,53,168,78,90,2,30,1,1
56069,51778,60565,25061,60565,70,70,0,2,8,2,0
56070,64980,53,10354,53,200,102,98,2,29,1,1
56071,56935,53,38764,53,179,94,85,2,30,1,1
56072,55375,53,47639,53,214,110,104,2,30,1,1
56073,53016,443,45563,443,50403,2032,48371,66,108,21,45
56074,53583,15354,6378,15354,70,70,0,2,7,2,0
56075,57464,80,36285,80,234,234,0,4,11,4,0
56076,55776,53,40395,53,216,110,106,2,29,1,1
56077,50023,443,17571,443,70,70,0,2,5,2,0
56078,56186,53,3994,53,198,102,96,2,29,1,1
56079,51762,12747,31596,12747,70,70,0,1,5,1,0
56080,64001,53,52493,53,183,94,89,2,29,1,1
56081,64936,53,55896,53,816,102,714,2,30,1,1
56082,65036,53,38858,53,214,110,104,2,29,1,1
56083,49608,53,63386,53,198,110,88,2,29,1,1
56084,64309,53,10386,53,308,94,214,2,30,1,1
56085,55439,53,53595,53,209,110,99,2,29,1,1
56086,57895,443,60971,443,10639,4680,5959,53,176,24,29
56087,64516,53,41634,53,216,110,106,2,30,1,1
56088,63978,53,35845,53,214,110,104,2,30,1,1
56089,56919,53,23336,53,193,102,91,2,30,1,1
56090,45637,443,46378,443,6701,3487,3214,35,196,19,16
56091,55826,53,22161,53,168,86,82,2,30,1,1
56092,55735,53,20718,53,184,94,90,2,30,1,1
56093,64714,53,62163,53,289,134,155,2,30,1,1
56094,58754,53,0,0,258,80,178,2,30,1,1
56095,50458,53,16491,53,458,188,270,6,30,3,3
56096,51543,53,3333,53,78,78,0,1,30,1,0
56097,64839,53,30697,53,443,182,261,6,30,3,3
56098,49259,53,28989,53,168,86,82,2,30,1,1
56099,56246,53,33774,53,209,110,99,2,30,1,1
56100,50121,53,5203,53,152,78,74,2,30,1,1
56101,64287,53,8601,53,181,94,87,2,31,1,1
56102,65420,53,28650,53,166,86,80,2,31,1,1
56103,41690,443,19019,443,1478937,62961,1415976,1678,148,649,1029
56104,54085,443,49010,443,4128,1929,2199,38,48,21,17
56105,64780,443,53095,443,70785,3306,67479,99,80,34,65
56106,51779,49525,24742,49525,70,70,0,2,8,2,0
56107,56779,43137,15198,43137,70,70,0,1,5,1,0
56108,64085,53,10076,53,351,102,249,4,43,2,2
56109,57899,443,40248,443,6115,1035,5080,21,170,11,10
56110,49448,443,34233,443,1574,921,653,14,15,7,7
56111,56430,53,37979,53,193,102,91,2,30,1,1
56112,65429,53,14191,53,200,94,106,2,30,1,1
56113,65265,53,37973,53,821,102,719,2,30,1,1
56114,56072,53,56771,53,199,102,97,2,30,1,1
56115,49693,443,16419,443,12060,4857,7203,25,71,14,11
56116,65192,53,25403,53,249,102,147,2,30,1,1
56117,55364,53,12032,53,168,86,82,2,30,1,1
56118,56962,53,9303,53,177,94,83,2,30,1,1
56119,56252,443,19925,443,6728,1775,4953,25,275,13,12
56120,55918,53,38281,53,184,94,90,2,31,1,1
56121,36826,443,2632,443,6040,1612,4428,21,255,12,9
56122,50636,443,49176,443,7332,1611,5721,17,15,9,8
56123,57902,443,7313,443,1912,1213,699,19,169,11,8
56124,57881,443,48213,443,3486,2064,1422,26,177,14,12
56125,39921,80,15019,80,1151,711,440,10,15,5,5
56126,50420,80,36435,80,5048,4344,704,11,26,6,5
56127,50076,80,31297,80,1052,612,440,10,15,5,5
56128,56072,53,61103,53,199,102,97,2,30,1,1
56129,46827,443,46276,443,8277,1368,6909,31,120,14,17
56130,57882,443,30006,443,22342,1787,20555,38,177,16,22
56131,57880,443,33669,443,1868,1229,639,18,177,11,7
56132,61362,443,33042,443,8167,2671,5496,22,69,11,11
56133,43735,53,12080,53,168,78,90,2,30,1,1
56134,58754,53,0,0,627,80,547,2,30,1,1
56135,56082,53,27828,53,182,94,88,2,30,1,1
56136,64417,53,4241,53,184,94,90,2,30,1,1
56137,59237,53,43242,53,164,78,86,2,30,1,1
56138,49246,53,24337,53,779,86,693,2,30,1,1
56139,55101,53,1606,53,197,102,95,2,30,1,1
56140,56033,443,32455,443,3250,1058,2192,13,136,6,7
56141,49439,53,56004,53,197,102,95,2,31,1,1
56142,49972,53,23300,53,184,94,90,2,30,1,1
56143,55100,53,1559,53,178,94,84,2,30,1,1
56144,56246,53,1913,53,209,110,99,2,30,1,1
56145,49217,53,2129,53,209,110,99,2,31,1,1
56146,54956,53,14576,53,194,102,92,2,31,1,1
56147,49597,53,63650,53,168,86,82,2,31,1,1
56148,56765,53,27082,53,194,102,92,2,31,1,1
56149,49667,53,65196,53,183,94,89,2,30,1,1
56150,49374,53,45816,53,193,102,91,2,30,1,1
56151,41002,53,33121,53,164,78,86,2,30,1,1
56152,49365,53,39023,53,195,102,93,2,30,1,1
56153,64041,53,58555,53,200,102,98,2,31,1,1
56154,49794,53,12589,53,197,102,95,2,30,1,1
56155,56026,53,4908,53,183,94,89,2,31,1,1
56156,50376,53,23494,53,166,86,80,2,31,1,1
56157,55100,53,26652,53,178,94,84,2,31,1,1
56158,65300,53,18303,53,195,102,93,2,31,1,1
56159,58856,443,16403,443,4005,1421,2584,14,136,7,7
56160,45493,5223,26430,5223,4196,1378,2818,21,3002,12,9
56161,19473,32332,63968,32332,481,150,331,2,1200,1,1
56162,48894,53,34771,53,164,78,86,2,31,1,1
56163,50121,53,43532,53,152,78,74,2,31,1,1
56164,56223,53,58545,53,185,102,83,2,31,1,1
56165,64323,53,30451,53,195,102,93,2,31,1,1
56166,44076,443,35127,443,202384,47621,154763,307,198,112,195
56167,15503,37512,24044,37512,528,528,0,9,1199,9,0
56168,64417,53,37642,53,184,94,90,2,31,1,1
56169,60016,443,40510,443,134,60,74,3,6,2,1
56170,64732,53,52596,53,189,102,87,2,30,1,1
56171,57015,53,61760,53,279,94,185,2,30,1,1
56172,51090,53,42988,53,164,78,86,2,30,1,1
56173,57094,53,61596,53,196,102,94,2,30,1,1
56174,55364,53,21776,53,168,86,82,2,31,1,1
56175,56962,53,40705,53,177,94,83,2,31,1,1
56176,59816,443,30172,443,622,310,312,11,29,6,5
56177,51955,443,64636,443,8390,1525,6865,24,26,11,13
56178,50862,443,14909,443,9930,2085,7845,21,318,11,10
56179,33244,443,30372,443,4239,2487,1752,19,16,11,8
56180,49399,80,18487,80,4382,2084,2298,18,66,10,8
56181,49397,80,15765,80,4382,2084,2298,18,66,10,8
56182,57906,443,49224,443,9316,3279,6037,39,186,20,19
56183,60194,80,35341,80,70,70,0,2,8,2,0
56184,33240,443,43731,443,7375,4769,2606,24,16,14,10
56185,49794,53,1835,53,197,102,95,2,30,1,1
56186,64516,53,9042,53,216,110,106,2,30,1,1
56187,49259,53,59958,53,184,102,82,2,30,1,1
56188,49183,53,24061,53,209,110,99,2,31,1,1
56189,57466,445,0,0,70,70,0,1,0,1,0
56190,52483,445,0,0,70,70,0,1,0,1,0
56191,19570,50584,0,0,62,62,0,1,0,1,0
56192,51693,22114,0,0,62,62,0,1,0,1,0
56193,22583,9822,0,0,62,62,0,1,0,1,0
56194,22724,9822,0,0,66,66,0,1,0,1,0
56195,52480,445,0,0,70,70,0,1,0,1,0
56196,52883,445,0,0,66,66,0,1,0,1,0
56197,52459,33890,0,0,60,60,0,1,0,1,0
56198,52876,445,0,0,66,66,0,1,0,1,0
56199,53355,23117,0,0,66,66,0,1,0,1,0
56200,52870,445,0,0,66,66,0,1,0,1,0
56201,52475,445,0,0,70,70,0,1,0,1,0
56202,62767,57470,0,0,74,74,0,1,0,1,0
56203,11983,57470,0,0,62,62,0,1,0,1,0
56204,54631,44847,0,0,70,70,0,1,0,1,0
56205,52474,445,0,0,70,70,0,1,0,1,0
56206,49160,31652,0,0,146,146,0,1,0,1,0
56207,18172,23,0,0,60,60,0,1,0,1,0
56208,52472,445,0,0,70,70,0,1,0,1,0
56209,25101,50584,0,0,146,146,0,1,0,1,0
56210,27442,44847,0,0,62,62,0,1,0,1,0
56211,56778,35440,0,0,62,62,0,1,0,1,0
56212,14872,23,0,0,60,60,0,1,0,1,0
56213,57455,445,0,0,70,70,0,1,0,1,0
56214,57452,445,0,0,70,70,0,1,0,1,0
56215,57453,445,0,0,70,70,0,1,0,1,0
56216,25565,62778,0,0,60,60,0,1,0,1,0
56217,52854,445,0,0,66,66,0,1,0,1,0
56218,52860,445,0,0,66,66,0,1,0,1,0
56219,52855,445,0,0,66,66,0,1,0,1,0
56220,52856,445,0,0,66,66,0,1,0,1,0
56221,52857,445,0,0,66,66,0,1,0,1,0
56222,52859,445,0,0,66,66,0,1,0,1,0
56223,52852,445,0,0,66,66,0,1,0,1,0
56224,52853,445,0,0,66,66,0,1,0,1,0
56225,42951,44847,0,0,66,66,0,1,0,1,0
56226,54773,50584,0,0,66,66,0,1,0,1,0
56227,6980,48543,0,0,139,139,0,1,0,1,0
56228,54684,37965,0,0,62,62,0,1,0,1,0
56229,64279,23718,0,0,62,62,0,1,0,1,0
56230,52465,445,0,0,70,70,0,1,0,1,0
56231,53166,61600,0,0,66,66,0,1,0,1,0
56232,52463,445,0,0,70,70,0,1,0,1,0
56233,45964,2666,0,0,60,60,0,1,0,1,0
56234,9095,22114,0,0,62,62,0,1,0,1,0
56235,7444,57470,0,0,66,66,0,1,0,1,0
56236,48180,143,0,0,60,60,0,1,0,1,0
56237,53783,443,19626,443,499,425,74,4,0,3,1
56238,53782,443,62733,443,499,425,74,4,0,3,1
56239,62678,57470,0,0,62,62,0,1,0,1,0
56240,52462,445,0,0,70,70,0,1,0,1,0
56241,52461,445,0,0,70,70,0,1,0,1,0
56242,32395,30188,0,0,62,62,0,1,0,1,0
56243,57447,445,0,0,70,70,0,1,0,1,0
56244,57442,445,0,0,70,70,0,1,0,1,0
56245,57441,445,0,0,70,70,0,1,0,1,0
56246,52460,445,0,0,70,70,0,1,0,1,0
56247,52454,445,0,0,70,70,0,1,0,1,0
56248,52457,445,0,0,70,70,0,1,0,1,0
56249,14082,50584,0,0,62,62,0,1,0,1,0
56250,6712,5632,0,0,60,60,0,1,0,1,0
56251,52838,445,0,0,66,66,0,1,0,1,0
56252,52840,445,0,0,66,66,0,1,0,1,0
56253,52837,445,0,0,66,66,0,1,0,1,0
56254,48706,23393,0,0,60,60,0,1,0,1,0
56255,55254,50584,0,0,66,66,0,1,0,1,0
56256,28668,8696,0,0,60,60,0,1,0,1,0
56257,57434,445,0,0,70,70,0,1,0,1,0
56258,60875,56205,0,0,66,66,0,1,0,1,0
56259,52442,445,0,0,70,70,0,1,0,1,0
56260,52441,445,0,0,70,70,0,1,0,1,0
56261,52439,445,0,0,70,70,0,1,0,1,0
56262,80,37649,0,0,60,60,0,1,0,1,0
56263,53105,42707,0,0,66,66,0,1,0,1,0
56264,52432,445,0,0,70,70,0,1,0,1,0
56265,52431,445,0,0,70,70,0,1,0,1,0
56266,57432,445,0,0,70,70,0,1,0,1,0
56267,20,17095,0,0,554,554,0,1,0,1,0
56268,37008,42707,0,0,62,62,0,1,0,1,0
56269,57427,445,0,0,70,70,0,1,0,1,0
56270,57426,445,0,0,70,70,0,1,0,1,0
56271,57421,445,0,0,70,70,0,1,0,1,0
56272,27446,30188,0,0,66,66,0,1,0,1,0
56273,80,53945,0,0,60,60,0,1,0,1,0
56274,61241,22114,0,0,66,66,0,1,0,1,0
56275,56453,37965,0,0,62,62,0,1,0,1,0
56276,52420,445,0,0,70,70,0,1,0,1,0
56277,47413,23,0,0,60,60,0,1,0,1,0
56278,46349,51505,0,0,70,70,0,1,0,1,0
56279,57415,445,0,0,70,70,0,1,0,1,0
56280,57413,445,0,0,70,70,0,1,0,1,0
56281,57409,445,0,0,70,70,0,1,0,1,0
56282,3521,6881,0,0,66,66,0,1,0,1,0
56283,53779,37965,0,0,66,66,0,1,0,1,0
56284,45410,1,0,0,62,62,0,1,0,1,0
56285,56946,1,0,0,66,66,0,1,0,1,0
56286,17177,64147,0,0,62,62,0,1,0,1,0
56287,52416,445,0,0,70,70,0,1,0,1,0
56288,34129,11045,0,0,62,62,0,1,0,1,0
56289,65153,38303,0,0,66,66,0,1,0,1,0
56290,63670,64097,0,0,66,66,0,1,0,1,0
56291,52407,445,0,0,70,70,0,1,0,1,0
56292,52405,445,0,0,70,70,0,1,0,1,0
56293,50355,43890,0,0,62,62,0,1,0,1,0
56294,52401,445,0,0,70,70,0,1,0,1,0
56295,52402,445,0,0,70,70,0,1,0,1,0
56296,52816,445,0,0,66,66,0,1,0,1,0
56297,6666,8443,0,0,60,60,0,1,0,1,0
56298,57407,445,0,0,70,70,0,1,0,1,0
56299,57404,445,0,0,70,70,0,1,0,1,0
56300,58022,3000,0,0,60,60,0,1,0,1,0
56301,52399,445,0,0,70,70,0,1,0,1,0
56302,38926,37965,0,0,62,62,0,1,0,1,0
56303,80,9918,0,0,60,60,0,1,0,1,0
56304,5379,37965,0,0,62,62,0,1,0,1,0
56305,59136,50584,0,0,66,66,0,1,0,1,0
56306,33908,48983,0,0,145,145,0,1,0,1,0
56307,1040,6004,0,0,72,72,0,1,0,1,0
56308,52812,445,0,0,66,66,0,1,0,1,0
56309,61736,50584,0,0,66,66,0,1,0,1,0
56310,64406,50584,0,0,66,66,0,1,0,1,0
56311,57452,57470,0,0,62,62,0,1,0,1,0
56312,52808,445,0,0,66,66,0,1,0,1,0
56313,52394,445,0,0,70,70,0,1,0,1,0
56314,57393,445,0,0,70,70,0,1,0,1,0
56315,52749,64147,0,0,66,66,0,1,0,1,0
56316,57390,445,0,0,70,70,0,1,0,1,0
56317,57387,445,0,0,70,70,0,1,0,1,0
56318,57383,445,0,0,70,70,0,1,0,1,0
56319,1660,8696,0,0,62,62,0,1,0,1,0
56320,52807,445,0,0,66,66,0,1,0,1,0
56321,1660,8696,0,0,145,145,0,1,0,1,0
56322,12471,48817,0,0,62,62,0,1,0,1,0
56323,51582,48817,0,0,66,66,0,1,0,1,0
56324,52386,445,0,0,70,70,0,1,0,1,0
56325,59481,41182,0,0,66,66,0,1,0,1,0
56326,52385,445,0,0,70,70,0,1,0,1,0
56327,57379,445,0,0,70,70,0,1,0,1,0
56328,21892,15503,0,0,62,62,0,1,0,1,0
56329,1025,35447,0,0,62,62,0,1,0,1,0
56330,55072,53,57853,53,701,88,613,2,30,1,1
56331,56246,53,65270,53,202,103,99,2,30,1,1
56332,50319,53,28862,53,756,95,661,2,30,1,1
56333,45373,443,33904,443,33357,26315,7042,65,273,38,27
56334,57745,15000,1994,15000,130,70,60,2,5,1,1
56335,55974,53,19851,53,762,98,664,2,30,1,1
56336,55605,53,8941,53,711,87,624,2,30,1,1
56337,49445,53,33858,53,770,101,669,2,30,1,1
56338,45118,15000,63789,15000,130,70,60,2,6,1,1
56339,64311,53,1855,53,198,101,97,2,31,1,1
56340,56406,53,47759,53,749,89,660,2,30,1,1
56341,51757,54657,24157,54657,66,66,0,1,5,1,0
56342,51267,38070,5566,38070,210,140,70,4,14,3,1
56343,55427,53,28517,53,772,103,669,2,30,1,1
56344,65359,53,29324,53,186,95,91,2,30,1,1
56345,65060,53,36666,53,761,100,661,2,30,1,1
56346,56609,53,56720,53,198,101,97,2,30,1,1
56347,59888,80,59888,80,55739,967,54772,53,15,13,40
56348,59417,443,49153,443,2898,1700,1198,16,15,8,8
56349,56607,443,1098,443,7862,1873,5989,20,15,11,9
56350,55918,53,15697,53,184,94,90,2,31,1,1
56351,55117,53,60693,53,756,95,661,2,31,1,1
56352,49851,53,28608,53,164,84,80,2,30,1,1
56353,65283,53,18469,53,732,89,643,2,30,1,1
56354,64831,53,59275,53,216,110,106,2,30,1,1
56355,49439,53,62852,53,194,99,95,2,31,1,1
56356,49197,53,27457,53,751,95,656,2,30,1,1
56357,51775,57887,60310,57887,70,70,0,2,8,2,0
56358,50422,443,13716,443,1389,868,521,12,25,6,6
56359,35047,80,8306,80,7891,2035,5856,17,32,10,7
56360,43033,443,43033,443,10239,2017,8222,23,18,14,9
56361,53834,15000,23428,15000,130,70,60,2,6,1,1
56362,62185,53,27701,53,578,286,292,9,15,5,4
56363,21870,53,21870,53,209,77,132,2,32,1,1
56364,64323,53,38959,53,190,97,93,2,31,1,1
56365,2941,7000,2941,7000,3398,947,2451,18,27,9,9
56366,51783,12296,8284,12296,316,136,180,6,6,3,3
56367,63763,17368,8449,17368,66,66,0,1,5,1,0
56368,49537,53,46669,53,269,96,173,4,59,2,2
56369,56608,443,64637,443,8034,2014,6020,20,15,11,9
56370,35049,80,15791,80,5773,1197,4576,14,32,8,6
56371,50347,53,8937,53,756,95,661,2,30,1,1
56372,5588,5588,0,0,3354,1792,1562,46,194,23,23
56373,56609,443,31583,443,7982,1962,6020,20,15,11,9
56374,56818,53,44106,53,755,94,661,2,30,1,1
56375,64900,53,55374,53,778,103,675,2,30,1,1
56376,56962,53,51903,53,170,87,83,2,30,1,1
56377,50240,53,16161,53,733,93,640,2,30,1,1
56378,55008,53,25566,53,762,98,664,2,30,1,1
56379,49972,53,21304,53,184,94,90,2,30,1,1
56380,64618,53,46697,53,196,100,96,2,31,1,1
56381,64653,53,37901,53,755,93,662,2,31,1,1
56382,64041,53,17809,53,200,102,98,2,30,1,1
56383,49687,53,24599,53,775,103,672,2,31,1,1
56384,44588,443,64745,443,8850,2551,6299,32,369,16,16
56385,49978,53,47119,53,774,101,673,2,31,1,1
56386,64438,53,41293,53,184,94,90,2,31,1,1
56387,49670,53,15548,53,168,86,82,2,31,1,1
56388,49539,53,44717,53,170,87,83,2,31,1,1
56389,65131,53,39663,53,168,86,82,2,31,1,1
56390,65189,27216,23592,27216,226,71,155,2,31,1,1
56391,65514,53,6429,53,212,108,104,2,31,1,1
56392,57306,53,11858,53,170,87,83,2,31,1,1
56393,55049,53,52659,53,733,86,647,2,31,1,1
56394,56987,53,30832,53,192,98,94,2,31,1,1
56395,65380,53,11853,53,176,90,86,2,31,1,1
56396,5938,58817,0,0,60,60,0,1,90,1,0
56397,49997,53,52835,53,418,75,343,2,31,1,1
56398,49290,53,15607,53,760,97,663,2,31,1,1
56399,65189,27241,23433,27241,235,71,164,2,31,1,1
56400,49429,53,19123,53,204,104,100,2,31,1,1
56401,49361,53,45475,53,184,94,90,2,31,1,1
56402,56111,53,53180,53,174,89,85,2,31,1,1
56403,37961,443,30943,443,10229,2777,7452,30,361,15,15
56404,56765,53,13979,53,188,96,92,2,31,1,1
56405,56104,53,20610,53,194,99,95,2,31,1,1
56406,65014,53,3896,53,186,95,91,2,31,1,1
56407,65516,53,26116,53,202,103,99,2,31,1,1
56408,50460,53,61853,53,753,96,657,2,31,1,1
56409,56878,53,21554,53,168,86,82,2,31,1,1
56410,64913,53,27699,53,182,93,89,2,31,1,1
56411,57258,53,12137,53,757,98,659,2,31,1,1
56412,65063,53,62698,53,176,90,86,2,31,1,1
56413,49384,53,31275,53,178,91,87,2,31,1,1
56414,47054,443,53511,443,6803,2164,4639,14,121,7,7
56415,6881,6881,2620,6881,150,150,0,1,1200,1,0
56416,62864,443,56821,443,86513,10300,76213,131,137,54,77
56417,55594,53,11300,53,753,96,657,2,31,1,1
56418,52233,443,57646,443,5479,929,4550,20,360,10,10
56419,65336,53,13952,53,782,105,677,2,31,1,1
56420,33000,53,0,0,82,82,0,1,31,1,0
56421,56332,53,13726,53,202,103,99,2,31,1,1
56422,56494,53,64995,53,793,101,692,2,31,1,1
56423,49861,53,49122,53,196,100,96,2,31,1,1
56424,55517,53,21431,53,174,89,85,2,31,1,1
56425,49785,53,38466,53,206,105,101,2,31,1,1
56426,56071,53,41864,53,186,95,91,2,31,1,1
56427,56552,53,11395,53,190,97,93,2,31,1,1
56428,57251,53,30748,53,780,104,676,2,31,1,1
56429,56477,53,34733,53,198,101,97,2,31,1,1
56430,21133,26760,14164,26760,480,149,331,2,1200,1,1
56431,57377,445,0,0,70,70,0,1,0,1,0
56432,57375,445,0,0,70,70,0,1,0,1,0
56433,57373,445,0,0,70,70,0,1,0,1,0
56434,59020,9600,0,0,60,60,0,1,0,1,0
56435,52799,445,0,0,66,66,0,1,0,1,0
56436,43671,37965,0,0,62,62,0,1,0,1,0
56437,29623,37807,0,0,62,62,0,1,0,1,0
56438,1027,11392,0,0,62,62,0,1,0,1,0
56439,12821,37965,0,0,66,66,0,1,0,1,0
56440,21274,30188,0,0,62,62,0,1,0,1,0
56441,52795,445,0,0,66,66,0,1,0,1,0
56442,52791,445,0,0,66,66,0,1,0,1,0
56443,52790,445,0,0,66,66,0,1,0,1,0
56444,52379,445,0,0,70,70,0,1,0,1,0
56445,52378,445,0,0,70,70,0,1,0,1,0
56446,52789,445,0,0,66,66,0,1,0,1,0
56447,52788,445,0,0,66,66,0,1,0,1,0
56448,52786,445,0,0,66,66,0,1,0,1,0
56449,56100,53,41303,53,177,94,83,2,30,1,1
56450,56705,53,17593,53,168,78,90,2,30,1,1
56451,9246,35440,0,0,66,66,0,1,0,1,0
56452,51829,36134,0,0,66,66,0,1,0,1,0
56453,50143,35253,0,0,66,66,0,1,0,1,0
56454,52374,445,0,0,70,70,0,1,0,1,0
56455,64051,36829,0,0,66,66,0,1,0,1,0
56456,57370,445,0,0,70,70,0,1,0,1,0
56457,57371,445,0,0,70,70,0,1,0,1,0
56458,57366,445,0,0,70,70,0,1,0,1,0
56459,49160,34021,0,0,146,146,0,1,0,1,0
56460,52782,445,0,0,66,66,0,1,0,1,0
56461,57364,445,0,0,70,70,0,1,0,1,0
56462,52373,445,0,0,70,70,0,1,0,1,0
56463,443,14315,0,0,158,158,0,1,0,1,0
56464,52781,445,0,0,66,66,0,1,0,1,0
56465,53298,26467,0,0,62,62,0,1,0,1,0
56466,58468,37965,0,0,66,66,0,1,0,1,0
56467,52779,445,0,0,66,66,0,1,0,1,0
56468,52777,445,0,0,66,66,0,1,0,1,0
56469,52775,445,0,0,66,66,0,1,0,1,0
56470,443,15564,0,0,85,85,0,1,0,1,0
56471,17009,53733,0,0,66,66,0,1,0,1,0
56472,52368,445,0,0,70,70,0,1,0,1,0
56473,65209,57866,0,0,66,66,0,1,0,1,0
56474,59315,35440,0,0,62,62,0,1,0,1,0
56475,64771,53,10938,53,228,110,118,2,30,1,1
56476,55989,443,55989,443,4378,1471,2907,19,29,11,8
56477,55147,53,9806,53,184,94,90,2,30,1,1
56478,64243,53,24679,53,244,94,150,2,30,1,1
56479,55147,53,22954,53,184,94,90,2,30,1,1
56480,49266,53,16843,53,199,102,97,2,30,1,1
56481,39047,443,36034,443,10831,1381,9450,22,19,12,10
56482,49398,80,11997,80,3651,2020,1631,16,65,9,7
56483,50457,443,62733,443,3091,1708,1383,15,21,9,6
56484,55599,80,22870,80,1165,473,692,10,14,5,5
56485,63762,41373,27152,41373,70,70,0,1,4,1,0
56486,50393,53,2809,53,759,94,665,2,29,1,1
56487,49667,53,34670,53,183,94,89,2,29,1,1
56488,11295,40018,57800,40018,213,89,124,4,31,2,2
56489,56883,53,10133,53,184,94,90,2,30,1,1
56490,49400,80,44770,80,3651,2020,1631,16,65,9,7
56491,50384,443,60892,443,7723,2591,5132,23,49,12,11
56492,54168,80,20934,80,1582,1003,579,12,360,6,6
56493,49424,53,45939,53,198,102,96,2,32,1,1
56494,64613,53,15938,53,179,94,85,2,30,1,1
56495,63757,51413,50296,51413,70,70,0,1,4,1,0
56496,25061,53,25061,53,214,82,132,2,32,1,1
56497,33241,443,5641,443,37452,28136,9316,56,15,33,23
56498,59815,443,31852,443,4586,955,3631,17,28,9,8
56499,56765,53,64406,53,194,102,92,2,29,1,1
56500,57257,53,41032,53,173,94,79,2,29,1,1
56501,55605,27274,9607,27274,130,70,60,2,4,1,1
56502,49888,53,1710,53,198,102,96,2,29,1,1
56503,55077,53,32952,53,179,94,85,2,29,1,1
56504,49872,53,49872,53,218,90,128,2,29,1,1
56505,55739,53,37345,53,458,188,270,6,29,3,3
56506,55429,53,62139,53,182,102,80,2,30,1,1
56507,49817,53,35154,53,286,110,176,2,30,1,1
56508,56100,53,9631,53,177,94,83,2,30,1,1
56509,49896,443,39739,443,151170,17408,133762,256,130,118,138
56510,65211,53,54701,53,183,94,89,2,30,1,1
56511,64685,53,15480,53,199,102,97,2,30,1,1
56512,56335,53,48756,53,816,102,714,2,30,1,1
56513,49972,53,40776,53,184,94,90,2,30,1,1
56514,56987,53,21347,53,196,102,94,2,30,1,1
56515,64093,53,8656,53,225,110,115,2,30,1,1
56516,64715,53,47413,53,209,110,99,2,30,1,1
56517,57252,53,53751,53,183,94,89,2,30,1,1
56518,49539,53,50465,53,177,94,83,2,30,1,1
56519,49167,53,55909,53,193,102,91,2,30,1,1
56520,51776,14645,41362,14645,70,70,0,2,8,2,0
56521,51752,7000,51752,7000,3638,2087,1551,17,16,10,7
56522,34079,80,3796,80,5053,4178,875,17,15,9,8
56523,64643,53,40117,53,177,94,83,2,30,1,1
56524,50575,53,5901,53,766,102,664,2,30,1,1
56525,51953,443,64481,443,8900,2020,6880,28,25,15,13
56526,65246,53,37552,53,183,94,89,2,30,1,1
56527,56456,53,8981,53,195,102,93,2,30,1,1
56528,56456,53,17169,53,195,102,93,2,30,1,1
56529,64685,53,31549,53,199,102,97,2,30,1,1
56530,64585,53,51194,53,210,110,100,2,30,1,1
56531,64874,53,28911,53,808,110,698,2,30,1,1
56532,49433,53,41471,53,165,86,79,2,30,1,1
56533,55918,53,24727,53,184,94,90,2,30,1,1
56534,56223,53,26337,53,177,94,83,2,30,1,1
56535,65249,53,5221,53,166,86,80,2,30,1,1
56536,55429,53,31053,53,182,102,80,2,30,1,1
56537,44690,443,54599,443,1648,813,835,17,185,9,8
56538,64585,53,55669,53,210,110,100,2,30,1,1
56539,65189,27015,29892,27015,295,78,217,2,30,1,1
56540,64417,53,47310,53,369,94,275,4,49,2,2
56541,49968,53,46436,53,285,94,191,2,30,1,1
56542,64715,53,35107,53,209,110,99,2,30,1,1
56543,64831,53,56461,53,216,110,106,2,30,1,1
56544,56335,53,52497,53,193,102,91,2,30,1,1
56545,49622,53,47185,53,185,102,83,2,30,1,1
56546,49634,443,60698,443,20860,1618,19242,35,122,15,20
56547,49537,53,59309,53,269,96,173,4,59,2,2
56548,65091,80,65091,80,18499242,314733,18184509,19253,37,4700,14553
56549,50648,80,55586,80,132,132,0,2,8,2,0
56550,51773,23728,42323,23728,70,70,0,2,8,2,0
56551,63366,30365,45991,30365,738,318,420,12,163,5,7
56552,49851,53,3240,53,166,86,80,2,30,1,1
56553,56649,53,35726,53,152,78,74,2,30,1,1
56554,51468,80,31366,80,3389,2054,1335,19,25,11,8
56555,34275,443,58408,443,4880,3216,1664,29,79,15,14
56556,42358,80,63133,80,1081,641,440,9,14,4,5
56557,26833,443,13799,443,21487,16430,5057,39,21,22,17
56558,51774,16930,45672,16930,70,70,0,2,8,2,0
56559,58924,443,13598,443,7783,2690,5093,24,255,13,11
56560,63759,64509,61744,64509,70,70,0,1,4,1,0
56561,57257,80,32555,80,1369,495,874,12,361,6,6
56562,56919,53,23059,53,423,95,328,4,34,2,2
56563,64700,53,51210,53,458,188,270,6,29,3,3
56564,64595,53,24899,53,167,86,81,2,29,1,1
56565,49739,443,63017,443,3085,1404,1681,15,15,7,8
56566,64732,53,44138,53,189,102,87,2,29,1,1
56567,49888,53,17695,53,198,102,96,2,29,1,1
56568,49217,53,20500,53,209,110,99,2,29,1,1
56569,54287,443,51264,443,8603,853,7750,27,92,9,18
56570,51268,47662,5610,47662,70,70,0,2,8,2,0
56571,55596,14795,19064,14795,630,444,186,9,16,6,3
56572,56919,53,16423,53,193,102,91,2,29,1,1
56573,64936,53,18480,53,749,94,655,2,29,1,1
56574,49365,53,27288,53,195,102,93,2,29,1,1
56575,55147,53,48564,53,184,94,90,2,30,1,1
56576,64552,53,41507,53,754,94,660,2,30,1,1
56577,49530,53,54763,53,265,102,163,2,30,1,1
56578,49622,53,45379,53,185,102,83,2,30,1,1
56579,56557,53,49880,53,214,110,104,2,29,1,1
56580,49399,53,15486,53,775,102,673,2,30,1,1
56581,65211,53,44478,53,183,94,89,2,30,1,1
56582,49901,53,39046,53,193,102,91,2,29,1,1
56583,64595,53,55733,53,167,86,81,2,30,1,1
56584,64311,53,39516,53,199,102,97,2,30,1,1
56585,65189,27237,9524,27237,234,78,156,2,30,1,1
56586,56111,53,49193,53,179,94,85,2,31,1,1
56587,64403,53,2532,53,199,102,97,2,31,1,1
56588,56552,53,3851,53,195,102,93,2,31,1,1
56589,51637,443,21678,443,3110,1049,2061,14,136,7,7
56590,49167,53,5532,53,816,102,714,2,30,1,1
56591,56121,53,17284,53,207,86,121,2,30,1,1
56592,56552,53,34046,53,195,102,93,2,30,1,1
56593,1927,53,62865,53,210,78,132,2,30,1,1
56594,65189,27015,61124,27015,250,78,172,2,30,1,1
56595,65189,27015,46211,27015,267,78,189,2,30,1,1
56596,55461,53,35895,53,198,110,88,2,30,1,1
56597,49917,53,18720,53,209,110,99,2,30,1,1
56598,65189,27017,19229,27017,239,78,161,2,30,1,1
56599,65189,27015,18038,27015,257,78,179,2,30,1,1
56600,65189,27207,3306,27207,230,78,152,2,30,1,1
56601,65189,27015,25952,27015,281,78,203,2,30,1,1
56602,55918,53,15262,53,184,94,90,2,31,1,1
56603,65189,27015,36838,27015,257,78,179,2,30,1,1
56604,10089,80,55892,80,130,70,60,2,15,1,1
56605,3303,80,51748,80,2338,1419,919,10,15,5,5
56606,51756,41471,58464,41471,70,70,0,1,5,1,0
56607,51158,443,53566,443,3155111,84086,3071025,3163,75,1072,2091
56608,46438,443,46438,443,5337,2090,3247,22,39,13,9
56609,56026,53,28063,53,183,94,89,2,30,1,1
56610,57252,53,53666,53,183,94,89,2,30,1,1
56611,49433,53,27774,53,173,94,79,2,30,1,1
56612,56104,53,22926,53,197,102,95,2,30,1,1
56613,34947,53,51809,53,168,78,90,2,30,1,1
56614,49860,53,63227,53,184,102,82,2,30,1,1
56615,64026,53,1792,53,211,102,109,2,30,1,1
56616,43693,53,25103,53,164,78,86,2,30,1,1
56617,56649,53,31076,53,168,94,74,2,30,1,1
56618,57252,53,37679,53,183,94,89,2,30,1,1
56619,55512,53,3521,53,458,188,270,6,30,3,3
56620,56809,53,37761,53,178,94,84,2,30,1,1
56621,64311,53,19538,53,199,102,97,2,30,1,1
56622,64585,53,40349,53,210,110,100,2,30,1,1
56623,56246,53,30677,53,209,110,99,2,30,1,1
56624,65359,53,28420,53,193,102,91,2,30,1,1
56625,65249,53,21680,53,182,102,80,2,30,1,1
56626,65529,53,50654,53,821,102,719,2,30,1,1
56627,64715,53,61600,53,209,110,99,2,30,1,1
56628,56227,53,28291,53,179,94,85,2,30,1,1
56629,40193,443,57432,443,1462,735,727,15,185,8,7
56630,45109,443,1117,443,11156,3899,7257,31,234,17,14
56631,64913,53,27503,53,183,94,89,2,30,1,1
56632,53115,40693,38172,40693,70,70,0,2,8,2,0
56633,49728,443,15564,443,7626,1676,5950,29,63,10,19
56634,57249,443,12847,443,7965,2643,5322,42,15,24,18
56635,49183,53,29477,53,209,110,99,2,30,1,1
56636,65420,53,11720,53,166,86,80,2,30,1,1
56637,64643,53,62127,53,177,94,83,2,30,1,1
56638,56557,53,47692,53,214,110,104,2,30,1,1
56639,64287,53,53632,53,181,94,87,2,30,1,1
56640,56004,53,34719,53,177,94,83,2,30,1,1
56641,57152,53,2032,53,183,94,89,2,30,1,1
56642,56126,53,43934,53,183,94,89,2,30,1,1
56643,65189,27015,44891,27015,255,78,177,2,30,1,1
56644,56126,53,32815,53,183,94,89,2,30,1,1
56645,65189,30015,16566,30015,276,78,198,2,30,1,1
56646,49696,53,30519,53,178,94,84,2,30,1,1
56647,56609,53,37814,53,199,102,97,2,30,1,1
56648,56987,53,59227,53,196,102,94,2,30,1,1
56649,65516,53,16518,53,209,110,99,2,31,1,1
56650,57306,53,15056,53,177,94,83,2,31,1,1
56651,55688,53,48185,53,183,94,89,2,31,1,1
56652,57007,53,19153,53,183,94,89,2,31,1,1
56653,64618,53,21647,53,198,102,96,2,30,1,1
56654,56104,53,63968,53,197,102,95,2,30,1,1
56655,64438,53,59049,53,184,94,90,2,30,1,1
56656,56111,53,45505,53,179,94,85,2,30,1,1
56657,55467,53,34377,53,193,102,91,2,30,1,1
56658,65189,28515,39536,28515,266,78,188,2,30,1,1
56659,56883,53,20999,53,184,94,90,2,30,1,1
56660,56071,53,13568,53,193,102,91,2,30,1,1
56661,49361,53,51044,53,184,94,90,2,31,1,1
56662,55517,53,14797,53,179,94,85,2,31,1,1
56663,37965,16153,40075,16153,1320,1320,0,21,1682,21,0
56664,65189,27015,1984,27015,260,78,182,2,30,1,1
56665,56332,53,1947,53,209,110,99,2,31,1,1
56666,65469,53,29881,53,195,102,93,2,31,1,1
56667,54990,53,46533,53,166,86,80,2,31,1,1
56668,64618,53,55916,53,198,102,96,2,31,1,1
56669,57172,53,10868,53,196,102,94,2,31,1,1
56670,49174,53,1263,53,166,86,80,2,31,1,1
56671,59103,443,51275,443,4209,2056,2153,50,277,24,26
56672,38444,443,18273,443,3547,955,2592,13,120,6,7
56673,49204,443,40475,443,1786,172,1614,7,120,3,4
56674,64041,53,11407,53,200,102,98,2,31,1,1
56675,53430,443,50940,443,4383,2064,2319,11,120,6,5
56676,56071,53,32735,53,193,102,91,2,31,1,1
56677,58427,5223,31205,5223,13841,6601,7240,42,622,19,23
56678,61146,443,19937,443,8580941,269463,8311478,9202,122,3016,6186
56679,49160,1025,14161,1025,868,150,718,4,1200,2,2
56680,37965,48782,19115,48782,132,132,0,3,1199,3,0
56681,56601,53,16656,53,239,94,145,2,31,1,1
56682,44839,443,23952,443,3188,2056,1132,23,121,13,10
56683,56033,53,58148,53,213,102,111,2,31,1,1
56684,49861,53,27236,53,198,102,96,2,31,1,1
56685,50326,53,27014,53,720,94,626,2,31,1,1
56686,65359,53,19133,53,193,102,91,2,31,1,1
56687,55461,53,48907,53,198,110,88,2,31,1,1
56688,49384,53,17338,53,181,94,87,2,31,1,1
56689,55857,53,56112,53,199,102,97,2,31,1,1
56690,49901,53,59612,53,193,102,91,2,31,1,1
56691,56783,53,24430,53,199,102,97,2,31,1,1
56692,64831,53,30238,53,216,110,106,2,31,1,1
56693,49860,53,48565,53,168,86,82,2,31,1,1
56694,57172,53,34011,53,196,102,94,2,31,1,1
56695,49972,53,6023,53,314,94,220,4,31,2,2
56696,64288,443,27448,443,252,70,182,3,120,1,2
56697,55688,53,29682,53,183,94,89,2,31,1,1
56698,36366,443,13851,443,6147,910,5237,18,16,10,8
56699,53237,443,53237,443,1210,637,573,14,34,7,7
56700,46167,80,10521,80,78,78,0,1,5,1,0
56701,57007,53,36349,53,183,94,89,2,31,1,1
56702,64403,53,9122,53,199,102,97,2,31,1,1
56703,49537,53,25046,53,269,96,173,4,59,2,2
56704,46052,443,47336,443,9815,5382,4433,51,237,20,31
56705,43357,443,59688,443,1053,566,487,10,15,6,4
56706,53236,443,53236,443,1210,637,573,14,34,7,7
56707,45169,443,45169,443,282,140,142,5,152,3,2
56708,65131,53,4831,53,168,86,82,2,30,1,1
56709,57357,445,0,0,70,70,0,1,0,1,0
56710,33822,57470,0,0,66,66,0,1,0,1,0
56711,57353,445,0,0,70,70,0,1,0,1,0
56712,57349,445,0,0,70,70,0,1,0,1,0
56713,11716,37965,0,0,62,62,0,1,0,1,0
56714,4910,2149,0,0,62,62,0,1,0,1,0
56715,52766,445,0,0,66,66,0,1,0,1,0
56716,51745,30188,0,0,62,62,0,1,0,1,0
56717,52355,445,0,0,70,70,0,1,0,1,0
56718,31845,55777,0,0,62,62,0,1,0,1,0
56719,16293,57470,0,0,62,62,0,1,0,1,0
56720,52757,445,0,0,66,66,0,1,0,1,0
56721,22587,30188,0,0,66,66,0,1,0,1,0
56722,57336,445,0,0,70,70,0,1,0,1,0
56723,19747,37965,0,0,62,62,0,1,0,1,0
56724,9448,57866,0,0,146,146,0,1,0,1,0
56725,52352,445,0,0,70,70,0,1,0,1,0
56726,64341,57470,0,0,62,62,0,1,0,1,0
56727,52755,445,0,0,66,66,0,1,0,1,0
56728,2522,64147,0,0,62,62,0,1,0,1,0
56729,56307,52700,0,0,66,66,0,1,0,1,0
56730,10003,64147,0,0,62,62,0,1,0,1,0
56731,10115,52700,0,0,62,62,0,1,0,1,0
56732,52247,51505,0,0,146,146,0,1,0,1,0
56733,6712,44818,0,0,66,66,0,1,0,1,0
56734,63379,36237,0,0,62,62,0,1,0,1,0
56735,52747,445,0,0,66,66,0,1,0,1,0
56736,52348,445,0,0,70,70,0,1,0,1,0
56737,18357,51180,0,0,62,62,0,1,0,1,0
56738,58305,51180,0,0,66,66,0,1,0,1,0
56739,52346,445,0,0,70,70,0,1,0,1,0
56740,52740,445,0,0,66,66,0,1,0,1,0
56741,12530,35440,0,0,66,66,0,1,0,1,0
56742,7308,50584,0,0,66,66,0,1,0,1,0
56743,52344,445,0,0,70,70,0,1,0,1,0
56744,10586,37965,0,0,62,62,0,1,0,1,0
56745,53777,443,29327,443,495,421,74,4,0,3,1
56746,53769,443,28627,443,499,425,74,4,0,3,1
56747,4540,23,0,0,60,60,0,1,0,1,0
56748,31112,50584,0,0,66,66,0,1,0,1,0
56749,47103,55378,0,0,146,146,0,1,0,1,0
56750,57329,445,0,0,70,70,0,1,0,1,0
56751,57325,445,0,0,70,70,0,1,0,1,0
56752,57324,445,0,0,70,70,0,1,0,1,0
56753,59378,50584,0,0,66,66,0,1,0,1,0
56754,63305,62413,0,0,66,66,0,1,0,1,0
56755,52732,445,0,0,66,66,0,1,0,1,0
56756,52731,445,0,0,66,66,0,1,0,1,0
56757,52730,445,0,0,66,66,0,1,0,1,0
56758,52726,445,0,0,66,66,0,1,0,1,0
56759,52724,445,0,0,66,66,0,1,0,1,0
56760,52729,445,0,0,66,66,0,1,0,1,0
56761,52725,445,0,0,66,66,0,1,0,1,0
56762,52727,445,0,0,66,66,0,1,0,1,0
56763,65250,22114,0,0,66,66,0,1,0,1,0
56764,52337,445,0,0,70,70,0,1,0,1,0
56765,56217,5900,0,0,60,60,0,1,0,1,0
56766,43129,20220,0,0,62,62,0,1,0,1,0
56767,14715,56205,0,0,62,62,0,1,0,1,0
56768,52335,445,0,0,70,70,0,1,0,1,0
56769,58950,5900,0,0,60,60,0,1,0,1,0
56770,64024,57470,0,0,62,62,0,1,0,1,0
56771,52334,445,0,0,70,70,0,1,0,1,0
56772,6881,55108,0,0,143,143,0,1,0,1,0
56773,45941,23386,0,0,60,60,0,1,0,1,0
56774,52333,445,0,0,70,70,0,1,0,1,0
56775,26722,11446,0,0,66,66,0,1,0,1,0
56776,52332,445,0,0,70,70,0,1,0,1,0
56777,63547,37965,0,0,66,66,0,1,0,1,0
56778,52330,445,0,0,70,70,0,1,0,1,0
56779,52328,445,0,0,70,70,0,1,0,1,0
56780,11464,37965,0,0,62,62,0,1,0,1,0
56781,53015,64147,0,0,145,145,0,1,0,1,0
56782,50052,65008,0,0,60,60,0,1,0,1,0
56783,57321,445,0,0,70,70,0,1,0,1,0
56784,57319,445,0,0,70,70,0,1,0,1,0
56785,57317,445,0,0,70,70,0,1,0,1,0
56786,64756,11392,0,0,62,62,0,1,0,1,0
56787,3802,55777,0,0,66,66,0,1,0,1,0
56788,52709,445,0,0,66,66,0,1,0,1,0
56789,52710,445,0,0,66,66,0,1,0,1,0
56790,52712,445,0,0,66,66,0,1,0,1,0
56791,1028,62609,0,0,148,148,0,1,0,1,0
56792,52314,445,0,0,70,70,0,1,0,1,0
56793,52313,445,0,0,70,70,0,1,0,1,0
56794,52309,445,0,0,70,70,0,1,0,1,0
56795,61912,17546,0,0,66,66,0,1,0,1,0
56796,57306,445,0,0,70,70,0,1,0,1,0
56797,52303,445,0,0,70,70,0,1,0,1,0
56798,52304,445,0,0,70,70,0,1,0,1,0
56799,40547,24051,0,0,74,74,0,1,0,1,0
56800,57304,445,0,0,70,70,0,1,0,1,0
56801,50734,37965,0,0,62,62,0,1,0,1,0
56802,57301,445,0,0,70,70,0,1,0,1,0
56803,57294,445,0,0,70,70,0,1,0,1,0
56804,57293,445,0,0,70,70,0,1,0,1,0
56805,43235,23,0,0,60,60,0,1,0,1,0
56806,42745,50011,0,0,62,62,0,1,0,1,0
56807,60480,57470,0,0,62,62,0,1,0,1,0
56808,19610,9571,0,0,62,62,0,1,0,1,0
56809,22541,64147,0,0,62,62,0,1,0,1,0
56810,30598,46824,0,0,62,62,0,1,0,1,0
56811,39810,48817,0,0,148,148,0,1,0,1,0
56812,46093,32661,0,0,74,74,0,1,0,1,0
56813,52292,445,0,0,70,70,0,1,0,1,0
56814,39824,51505,0,0,62,62,0,1,0,1,0
56815,65512,44847,0,0,66,66,0,1,0,1,0
56816,13372,50584,0,0,66,66,0,1,0,1,0
56817,59055,11392,0,0,66,66,0,1,0,1,0
56818,57286,445,0,0,70,70,0,1,0,1,0
56819,57284,445,0,0,70,70,0,1,0,1,0
56820,57281,445,0,0,70,70,0,1,0,1,0
56821,52103,53733,0,0,66,66,0,1,0,1,0
56822,61185,54532,0,0,62,62,0,1,0,1,0
56823,52288,445,0,0,70,70,0,1,0,1,0
56824,49628,35440,0,0,66,66,0,1,0,1,0
56825,52519,44847,0,0,62,62,0,1,0,1,0
56826,1749,64147,0,0,62,62,0,1,0,1,0
56827,25772,7302,0,0,62,62,0,1,0,1,0
56828,52278,445,0,0,70,70,0,1,0,1,0
56829,52277,445,0,0,70,70,0,1,0,1,0
56830,49976,22114,0,0,66,66,0,1,0,1,0
56831,52275,445,0,0,70,70,0,1,0,1,0
56832,52273,445,0,0,70,70,0,1,0,1,0
56833,45079,31573,0,0,66,66,0,1,0,1,0
56834,55413,37965,0,0,62,62,0,1,0,1,0
56835,52271,445,0,0,70,70,0,1,0,1,0
56836,46774,64147,0,0,145,145,0,1,0,1,0
56837,35036,26296,0,0,159,159,0,1,0,1,0
56838,57654,35440,0,0,66,66,0,1,0,1,0
56839,52690,445,0,0,66,66,0,1,0,1,0
56840,57278,445,0,0,70,70,0,1,0,1,0
56841,57276,445,0,0,70,70,0,1,0,1,0
56842,51151,64147,0,0,62,62,0,1,0,1,0
56843,6881,6881,0,0,62,62,0,1,0,1,0
56844,63183,64147,0,0,66,66,0,1,0,1,0
56845,52266,445,0,0,70,70,0,1,0,1,0
56846,52683,445,0,0,66,66,0,1,0,1,0
56847,64252,53,36702,53,198,101,97,2,31,1,1
56848,49696,53,54642,53,172,88,84,2,30,1,1
56849,34114,443,15852,443,6206,1695,4511,25,16,13,12
56850,53560,42459,25720,42459,552,306,246,9,17,5,4
56851,47510,443,50202,443,5149,852,4297,16,15,9,7
56852,64403,53,60359,53,198,101,97,2,30,1,1
56853,47087,15000,40073,15000,138,78,60,2,5,1,1
56854,50930,443,54294,443,134,60,74,3,10,2,1
56855,60395,6890,18737,6890,70,70,0,1,5,1,0
56856,49945,53,48312,53,281,97,184,4,58,2,2
56857,56750,53,47077,53,711,87,624,2,30,1,1
56858,49175,53,59846,53,186,95,91,2,30,1,1
56859,65469,53,59478,53,190,97,93,2,30,1,1
56860,50391,8080,50391,8080,1614,785,829,11,54,6,5
56861,50387,8080,50387,8080,7241,3224,4017,23,61,14,9
56862,49421,443,54717,443,5422,801,4621,21,173,9,12
56863,51614,15000,49065,15000,130,70,60,2,5,1,1
56864,48271,15000,29989,15000,130,70,60,2,5,1,1
56865,56604,443,5643,443,7915,1926,5989,20,15,11,9
56866,65498,53,36093,53,202,103,99,2,31,1,1
56867,57010,53,20752,53,198,101,97,2,30,1,1
56868,56603,443,20013,443,7890,1901,5989,20,16,11,9
56869,53565,58695,4400,58695,70,70,0,1,5,1,0
56870,45554,443,45554,443,4617,1710,2907,19,26,11,8
56871,55317,443,24510,443,5692,1239,4453,23,16,13,10
56872,50388,8080,50388,8080,4417,2499,1918,18,56,10,8
56873,55353,53,50744,53,168,86,82,2,30,1,1
56874,53229,443,53229,443,1402,856,546,12,34,6,6
56875,53232,443,53232,443,1270,697,573,15,33,8,7
56876,15629,53,15629,53,209,77,132,2,32,1,1
56877,56606,443,12642,443,7914,1925,5989,20,15,11,9
56878,40103,443,24820,443,161,101,60,2,5,1,1
56879,55467,53,15072,53,186,95,91,2,30,1,1
56880,55670,53,52397,53,774,101,673,2,30,1,1
56881,65357,53,15221,53,176,90,86,2,30,1,1
56882,57051,443,6628,443,594793,518081,76712,1350,1004,781,569
56883,65231,53,23789,53,200,102,98,2,31,1,1
56884,57007,53,22184,53,182,93,89,2,31,1,1
56885,53165,443,53165,443,208,66,142,4,148,2,2
56886,56605,443,61768,443,7863,1874,5989,20,15,11,9
56887,53234,443,53234,443,1276,703,573,15,33,8,7
56888,65258,53,4624,53,186,95,91,2,31,1,1
56889,59031,80,8208,80,4119,611,3508,12,18,4,8
56890,47164,15000,48096,15000,130,70,60,2,5,1,1
56891,25803,53,25803,53,231,88,143,2,33,1,1
56892,51753,15038,53015,15038,66,66,0,1,5,1,0
56893,19876,53,19876,53,209,77,132,2,33,1,1
56894,51772,59814,12241,59814,70,70,0,2,8,2,0
56895,56918,53,41255,53,778,103,675,2,30,1,1
56896,5588,5588,0,0,3354,1792,1562,46,195,23,23
56897,65131,53,35643,53,168,86,82,2,30,1,1
56898,56883,53,62227,53,184,94,90,2,30,1,1
56899,49676,53,36174,53,733,86,647,2,30,1,1
56900,65189,27015,25924,27015,233,71,162,2,30,1,1
56901,56425,53,17413,53,760,97,663,2,30,1,1
56902,55688,53,32958,53,182,93,89,2,30,1,1
56903,65189,27255,47951,27255,278,71,207,2,30,1,1
56904,59948,443,41928,443,349197,16542,332655,411,129,150,261
56905,49229,53,8820,53,88,88,0,1,31,1,0
56906,57416,53,62592,53,186,95,91,2,31,1,1
56907,49632,443,26348,443,3618,961,2657,13,121,6,7
56908,49486,53,33759,53,170,87,83,2,31,1,1
56909,65040,53,62726,53,176,90,86,2,31,1,1
56910,50604,53,2592,53,752,93,659,2,31,1,1
56911,64885,53,64870,53,753,93,660,2,31,1,1
56912,65048,53,26939,53,188,96,92,2,31,1,1
56913,55634,53,60487,53,204,104,100,2,31,1,1
56914,64216,53,11505,53,182,93,89,2,30,1,1
56915,57172,53,55364,53,192,98,94,2,31,1,1
56916,55796,53,45006,53,192,98,94,2,31,1,1
56917,49777,53,59395,53,164,84,80,2,31,1,1
56918,64986,53,47302,53,176,90,86,2,31,1,1
56919,55705,53,57706,53,202,103,99,2,31,1,1
56920,56802,53,9464,53,753,93,660,2,31,1,1
56921,49917,53,47966,53,752,93,659,2,31,1,1
56922,49369,53,3787,53,182,93,89,2,31,1,1
56923,65179,53,5745,53,184,94,90,2,31,1,1
56924,56901,53,23977,53,710,89,621,2,31,1,1
56925,56167,53,36482,53,172,88,84,2,31,1,1
56926,50265,41071,33048,41071,1716,1716,0,27,2188,27,0
56927,57139,53,1323,53,164,84,80,2,31,1,1
56928,58034,443,61141,443,4553,856,3697,17,362,9,8
56929,49983,53,22293,53,206,105,101,2,31,1,1
56930,65424,53,25204,53,204,104,100,2,31,1,1
56931,55743,53,6640,53,748,106,642,2,31,1,1
56932,64949,53,23952,53,208,106,102,2,31,1,1
56933,34734,443,41689,443,7974,2716,5258,50,7261,26,24
56934,52680,445,0,0,66,66,0,1,0,1,0
56935,1534,54369,0,0,66,66,0,1,0,1,0
56936,57266,445,0,0,70,70,0,1,0,1,0
56937,51105,50584,0,0,62,62,0,1,0,1,0
56938,57262,445,0,0,70,70,0,1,0,1,0
56939,57255,445,0,0,70,70,0,1,0,1,0
56940,54836,443,5754,443,119863,100823,19040,322,229,183,139
56941,50166,53,40117,53,211,78,133,2,30,1,1
56942,50583,53,37919,53,819,102,717,2,30,1,1
56943,56878,53,41614,53,168,86,82,2,30,1,1
56944,49429,53,36318,53,210,110,100,2,30,1,1
56945,56445,53,29245,53,199,102,97,2,30,1,1
56946,56354,53,51631,53,200,94,106,2,30,1,1
56947,53230,443,53230,443,1462,916,546,13,34,7,6
56948,44879,443,44879,443,7123,1020,6103,19,151,11,8
56949,49738,443,52506,443,3085,1404,1681,15,15,7,8
56950,19371,53,19371,53,214,82,132,2,31,1,1
56951,53235,443,53235,443,1270,697,573,15,33,8,7
56952,44368,443,44368,443,7123,1020,6103,19,151,11,8
56953,37109,80,41807,80,763,434,329,8,14,5,3
56954,63672,443,63672,443,4398,1491,2907,19,27,11,8
56955,63203,443,63203,443,9324,4240,5084,24,16,13,11
56956,43218,443,21139,443,7375,2087,5288,24,255,12,12
56957,51413,443,36557,443,202,70,132,3,11,1,2
56958,55609,39869,9261,39869,70,70,0,2,8,2,0
56959,65529,53,6825,53,198,102,96,2,29,1,1
56960,49670,53,58566,53,168,86,82,2,29,1,1
56961,59882,53,29947,53,244,86,158,2,29,1,1
56962,65131,53,1840,53,168,86,82,2,29,1,1
56963,57152,53,61515,53,183,94,89,2,29,1,1
56964,57306,53,25248,53,177,94,83,2,29,1,1
56965,52957,53,50377,53,168,78,90,2,29,1,1
56966,55215,53,18031,53,315,126,189,2,29,1,1
56967,56441,53,35817,53,209,110,99,2,29,1,1
56968,64041,53,24835,53,200,102,98,2,29,1,1
56969,44603,53,44603,53,229,98,131,2,29,1,1
56970,65189,27212,4653,27212,254,78,176,2,29,1,1
56971,55688,53,38445,53,183,94,89,2,29,1,1
56972,49266,53,6643,53,199,102,97,2,29,1,1
56973,65189,28115,45956,28115,284,78,206,2,29,1,1
56974,49917,53,29420,53,209,110,99,2,29,1,1
56975,65189,27015,11223,27015,275,78,197,2,29,1,1
56976,65488,53,4906,53,232,110,122,2,29,1,1
56977,65189,27015,42181,27015,262,78,184,2,29,1,1
56978,56004,53,27325,53,177,94,83,2,29,1,1
56979,65189,27268,56111,27268,232,78,154,2,29,1,1
56980,55857,53,40207,53,199,102,97,2,29,1,1
56981,65189,27016,20619,27016,249,78,171,2,29,1,1
56982,49439,53,40925,53,197,102,95,2,30,1,1
56983,65189,27015,60711,27015,278,78,200,2,29,1,1
56984,65189,28015,14178,28015,240,78,162,2,29,1,1
56985,64011,53,63004,53,228,110,118,2,29,1,1
56986,65189,27202,50060,27202,230,78,152,2,29,1,1
56987,55346,53,11251,53,396,102,294,2,30,1,1
56988,49945,53,50921,53,281,97,184,4,58,2,2
56989,50966,443,34957,443,6350,1072,5278,18,40,10,8
56990,55614,29731,2636,29731,70,70,0,2,8,2,0
56991,55615,13826,16063,13826,70,70,0,2,8,2,0
56992,58053,25,49850,25,1316,442,874,15,16,7,8
56993,65504,53,33205,53,193,102,91,2,30,1,1
56994,56332,53,27865,53,209,110,99,2,30,1,1
56995,49730,53,24529,53,211,110,101,2,30,1,1
56996,50238,53,50499,53,438,180,258,6,30,3,3
56997,56987,53,64863,53,196,102,94,2,30,1,1
56998,65063,53,50094,53,180,94,86,2,30,1,1
56999,57077,53,61276,53,166,86,80,2,30,1,1
57000,55469,443,55469,443,4579,1672,2907,19,29,11,8
57001,57010,53,26340,53,199,102,97,2,30,1,1
57002,57306,53,20608,53,573,186,387,6,71,3,3
57003,56477,53,13759,53,199,102,97,2,30,1,1
57004,65380,53,10002,53,180,94,86,2,30,1,1
57005,41343,443,31271,443,7601,1595,6006,25,35,12,13
57006,56144,53,15210,53,177,94,83,2,30,1,1
57007,49539,53,64502,53,340,87,253,4,50,2,2
57008,56783,53,42766,53,199,102,97,2,30,1,1
57009,56783,21279,18481,21279,70,70,0,2,8,2,0
57010,65357,53,23805,53,180,94,86,2,30,1,1
57011,6040,53,41772,53,323,94,229,2,30,1,1
57012,49968,53,43611,53,751,94,657,2,30,1,1
57013,37889,53,32762,53,199,94,105,2,30,1,1
57014,57331,53,38724,53,166,86,80,2,30,1,1
57015,50583,53,45479,53,196,102,94,2,30,1,1
57016,55502,53,15110,53,194,102,92,2,30,1,1
57017,65014,53,57511,53,193,102,91,2,30,1,1
57018,65380,53,23186,53,180,94,86,2,30,1,1
57019,57010,53,46777,53,199,102,97,2,30,1,1
57020,56357,53,47293,53,196,102,94,2,30,1,1
57021,65516,53,21286,53,209,110,99,2,30,1,1
57022,65063,53,22032,53,180,94,86,2,30,1,1
57023,49486,53,9984,53,177,94,83,2,30,1,1
57024,42936,53,47625,53,199,94,105,2,30,1,1
57025,56006,53,47168,53,210,102,108,2,30,1,1
57026,55353,53,65240,53,168,86,82,2,30,1,1
57027,55705,53,14171,53,209,110,99,2,30,1,1
57028,59424,443,18512,443,252,70,182,3,120,1,2
57029,46451,443,47700,443,350492,17722,332770,449,125,169,280
57030,56477,53,54398,53,199,102,97,2,30,1,1
57031,49384,53,27649,53,181,94,87,2,30,1,1
57032,51771,19103,40132,19103,70,70,0,2,8,2,0
57033,51411,443,11555,443,202,70,132,3,11,1,2
57034,41972,5222,18449,5222,5709,2977,2732,62,621,31,31
57035,37694,443,63637,443,234688,15158,219530,324,173,157,167
57036,64913,53,26175,53,555,195,360,6,62,3,3
57037,57010,53,64390,53,199,102,97,2,30,1,1
57038,65417,53,53892,53,183,94,89,2,30,1,1
57039,54984,53,62420,53,994,86,908,2,30,1,1
57040,49439,53,11369,53,197,102,95,2,30,1,1
57041,59614,53,24145,53,417,78,339,2,30,1,1
57042,56899,53,4081,53,258,102,156,2,30,1,1
57043,56375,53,53548,53,184,102,82,2,30,1,1
57044,55057,53,28179,53,889,404,485,10,30,5,5
57045,65231,53,56850,53,200,102,98,2,30,1,1
57046,51755,24236,52970,24236,136,136,0,3,13,3,0
57047,51754,1182,24029,1182,70,70,0,1,5,1,0
57048,49478,53,32475,53,551,114,437,4,37,2,2
57049,65295,53,41511,53,944,205,739,6,45,3,3
57050,51715,443,35378,443,4175264,89546,4085718,4141,532,1111,3030
57051,49730,53,46996,53,211,110,101,2,30,1,1
57052,55722,53,19688,53,226,110,116,2,30,1,1
57053,41780,53,0,0,86,86,0,1,30,1,0
57054,65131,53,31647,53,168,86,82,2,30,1,1
57055,49183,53,46145,53,817,102,715,2,30,1,1
57056,55502,53,12440,53,817,102,715,2,30,1,1
57057,64913,53,45899,53,183,94,89,2,30,1,1
57058,49885,53,57862,53,786,110,676,2,30,1,1
57059,57416,53,21354,53,193,102,91,2,30,1,1
57060,55706,53,9851,53,258,102,156,2,30,1,1
57061,49638,53,6600,53,210,110,100,2,30,1,1
57062,49638,53,20349,53,210,110,100,2,30,1,1
57063,65014,53,36571,53,193,102,91,2,30,1,1
57064,50017,53,65009,53,741,94,647,2,30,1,1
57065,38317,443,31937,443,9834,4297,5537,26,326,12,14
57066,51322,443,58671,443,6250,1422,4828,20,17,10,10
57067,50716,80,11421,80,1106,326,780,12,140,6,6
57068,35866,80,8550,80,1114,534,580,12,15,7,5
57069,35353,443,65162,443,1833,991,842,14,224,7,7
57070,58362,443,29130,443,13272,2360,10912,37,208,19,18
57071,35354,443,9498,443,2392,917,1475,16,224,8,8
57072,42597,443,21561,443,6131,1399,4732,20,979,10,10
57073,49420,443,10802,443,4932,1046,3886,21,173,10,11
57074,33521,80,30889,80,3429,1679,1750,14,22,8,6
57075,56614,80,65163,80,234,234,0,4,11,4,0
57076,39358,443,53461,443,9115,6806,2309,37,80,20,17
57077,53231,443,53231,443,1402,856,546,12,34,6,6
57078,49288,443,9666,443,7846,2369,5477,23,385,10,13
57079,12162,53,12162,53,233,90,143,2,33,1,1
57080,64287,53,8913,53,280,91,189,4,33,2,2
57081,60400,56243,28136,56243,70,70,0,2,8,2,0
57082,51295,443,27138,443,7448,1737,5711,24,201,13,11
57083,55467,53,6293,53,320,95,225,4,41,2,2
57084,64618,53,41913,53,305,100,205,4,54,2,2
57085,59418,443,19462,443,7222,1633,5589,24,201,13,11
57086,35267,80,35004,80,613,539,74,7,15,6,1
57087,49235,53,43539,53,164,78,86,2,29,1,1
57088,56441,53,4935,53,209,110,99,2,29,1,1
57089,1928,53,30597,53,210,78,132,2,29,1,1
57090,65189,28215,62292,28215,259,78,181,2,29,1,1
57091,56883,53,30894,53,184,94,90,2,29,1,1
57092,65189,27016,36079,27016,78,78,0,1,29,1,0
57093,65189,27257,41492,27257,252,78,174,2,29,1,1
57094,65189,27214,42310,27214,231,78,153,2,29,1,1
57095,50006,53,41506,53,994,86,908,2,29,1,1
57096,64323,53,18965,53,195,102,93,2,30,1,1
57097,55467,53,17631,53,193,102,91,2,29,1,1
57098,61858,10443,43005,10443,10747,2507,8240,26,48,14,12
57099,65514,53,14703,53,214,110,104,2,29,1,1
57100,65056,53,34239,53,199,102,97,2,29,1,1
57101,65189,28125,44608,28125,78,78,0,1,29,1,0
57102,55517,53,26427,53,179,94,85,2,29,1,1
57103,54990,53,62190,53,166,86,80,2,29,1,1
57104,65056,53,26315,53,199,102,97,2,29,1,1
57105,49429,53,17254,53,210,110,100,2,29,1,1
57106,64311,53,4229,53,199,102,97,2,29,1,1
57107,49539,53,25645,53,177,94,83,2,30,1,1
57108,65131,53,44924,53,168,86,82,2,30,1,1
57109,49851,53,9637,53,166,86,80,2,29,1,1
57110,49183,53,53469,53,194,102,92,2,30,1,1
57111,55634,53,8065,53,210,110,100,2,30,1,1
57112,42151,53,3505,53,168,78,90,2,30,1,1
57113,49341,53,47990,53,199,102,97,2,31,1,1
57114,56375,53,4600,53,184,102,82,2,30,1,1
57115,49785,53,52317,53,211,110,101,2,30,1,1
57116,65380,53,28417,53,180,94,86,2,30,1,1
57117,56963,53,26493,53,210,110,100,2,30,1,1
57118,55796,53,36094,53,196,102,94,2,30,1,1
57119,56111,53,5335,53,179,94,85,2,30,1,1
57120,65258,53,48935,53,193,102,91,2,30,1,1
57121,54031,53,23447,53,168,78,90,2,30,1,1
57122,64739,53,35789,53,164,86,78,2,31,1,1
57123,56477,53,18413,53,386,101,285,4,31,2,2
57124,64831,53,42481,53,216,110,106,2,30,1,1
57125,57570,443,58853,443,6226,4213,2013,30,79,18,12
57126,27464,53,27464,53,233,90,143,2,32,1,1
57127,50390,8080,50390,8080,378,180,198,7,54,4,3
57128,64403,53,16361,53,783,197,586,6,70,3,3
57129,65014,53,29342,53,193,102,91,2,30,1,1
57130,65063,53,52560,53,180,94,86,2,30,1,1
57131,49785,53,47696,53,211,110,101,2,30,1,1
57132,65359,53,55689,53,193,102,91,2,30,1,1
57133,56104,53,24374,53,197,102,95,2,30,1,1
57134,64216,53,1409,53,183,94,89,2,30,1,1
57135,49229,53,18433,53,178,94,84,2,31,1,1
57136,49361,53,25462,53,184,94,90,2,30,1,1
57137,50885,80,41376,80,291594,13131,278463,312,159,116,196
57138,60401,30046,28995,30046,70,70,0,2,8,2,0
57139,35790,443,59845,443,6777,1527,5250,24,201,13,11
57140,52404,443,21006,443,132575,6675,125900,206,94,91,115
57141,50389,8080,50389,8080,5724,1509,4215,18,55,10,8
57142,49812,53,36103,53,1411,98,1313,4,52,2,2
57143,65504,53,23026,53,193,102,91,2,30,1,1
57144,65417,53,31307,53,183,94,89,2,30,1,1
57145,60601,53,19741,53,451,86,365,2,30,1,1
57146,56144,53,34369,53,177,94,83,2,30,1,1
57147,64121,53,21027,53,365,102,263,2,31,1,1
57148,55199,443,3846,443,18132,8636,9496,40,176,23,17
57149,48673,443,24154,443,18147,9173,8974,42,175,24,18
57150,51467,443,7148,443,20313,6637,13676,45,24,23,22
57151,55610,23383,23402,23383,70,70,0,2,8,2,0
57152,49562,443,58637,443,9908,4692,5216,30,92,16,14
57153,49361,53,49782,53,166,86,80,2,30,1,1
57154,64323,53,64062,53,195,102,93,2,30,1,1
57155,56357,53,43441,53,819,102,717,2,30,1,1
57156,49175,53,18016,53,193,102,91,2,30,1,1
57157,59645,53,23128,53,263,94,169,2,30,1,1
57158,64438,53,4120,53,184,94,90,2,30,1,1
57159,56332,53,16709,53,209,110,99,2,30,1,1
57160,65514,53,43311,53,214,110,104,2,30,1,1
57161,64216,53,16244,53,183,94,89,2,30,1,1
57162,43326,443,42679,443,10063,2126,7937,36,120,18,18
57163,55353,53,1525,53,168,86,82,2,30,1,1
57164,56605,53,38242,53,341,110,231,2,30,1,1
57165,64252,53,2072,53,199,102,97,2,30,1,1
57166,65258,53,25267,53,193,102,91,2,30,1,1
57167,65469,53,49560,53,195,102,93,2,30,1,1
57168,64235,53,40648,53,197,102,95,2,30,1,1
57169,56963,53,63248,53,210,110,100,2,30,1,1
57170,49983,53,2734,53,211,110,101,2,30,1,1
57171,65448,53,6069,53,264,110,154,2,30,1,1
57172,65498,53,57439,53,209,110,99,2,30,1,1
57173,64216,53,45002,53,295,93,202,4,30,2,2
57174,65040,53,10817,53,180,94,86,2,31,1,1
57175,56326,53,47935,53,177,94,83,2,31,1,1
57176,49670,53,59914,53,168,86,82,2,31,1,1
57177,57470,2710,46091,2710,124,124,0,3,1199,3,0
57178,49732,53,17684,53,178,94,84,2,30,1,1
57179,64986,53,8227,53,180,94,86,2,30,1,1
57180,55958,53,25725,53,209,102,107,2,30,1,1
57181,56765,53,52447,53,194,102,92,2,30,1,1
57182,64254,53,19864,53,197,94,103,2,30,1,1
57183,65498,53,39980,53,209,110,99,2,30,1,1
57184,65424,53,39053,53,210,110,100,2,31,1,1
57185,56953,53,15670,53,421,78,343,2,31,1,1
57186,49486,53,40876,53,177,94,83,2,31,1,1
57187,65514,53,32610,53,214,110,104,2,31,1,1
57188,57172,53,27478,53,196,102,94,2,31,1,1
57189,55145,443,65048,443,13231,6169,7062,38,120,19,19
57190,65498,53,26410,53,209,110,99,2,30,1,1
57191,49785,53,63638,53,211,110,101,2,30,1,1
57192,49777,53,14014,53,166,86,80,2,30,1,1
57193,49429,53,19279,53,210,110,100,2,30,1,1
57194,55796,53,53720,53,196,102,94,2,30,1,1
57195,55975,53,28209,53,195,102,93,2,30,1,1
57196,57007,53,62995,53,183,94,89,2,31,1,1
57197,49670,53,37029,53,168,86,82,2,30,1,1
57198,64420,53,18764,53,386,102,284,2,30,1,1
57199,49831,53,24463,53,364,102,262,2,30,1,1
57200,65024,53,10602,53,196,94,102,2,30,1,1
57201,49696,53,9591,53,178,94,84,2,30,1,1
57202,49862,53,52956,53,715,94,621,2,31,1,1
57203,49861,53,56690,53,198,102,96,2,31,1,1
57204,55975,53,44915,53,195,102,93,2,31,1,1
57205,64677,53,13173,53,195,102,93,2,31,1,1
57206,49175,53,45258,53,193,102,91,2,31,1,1
57207,55286,53,22334,53,194,102,92,2,31,1,1
57208,64517,53,18639,53,194,102,92,2,31,1,1
57209,65231,53,37315,53,200,102,98,2,31,1,1
57210,49696,53,25941,53,178,94,84,2,31,1,1
57211,6881,30096,6963,30096,509,150,359,2,1199,1,1
57212,39402,443,48958,443,6417,1255,5162,24,360,12,12
57213,17750,14132,3203,14132,150,150,0,1,1200,1,0
57214,6881,20326,20950,20326,509,150,359,2,1200,1,1
57215,49478,53,58294,53,164,86,78,2,31,1,1
57216,56279,443,57070,443,97608,4852,92756,108,121,37,71
57217,56445,53,26251,53,199,102,97,2,30,1,1
57218,49861,53,42147,53,198,102,96,2,30,1,1
57219,49486,53,16915,53,177,94,83,2,30,1,1
57220,49369,53,54778,53,183,94,89,2,30,1,1
57221,64531,53,60188,53,183,94,89,2,30,1,1
57222,49983,53,17295,53,211,110,101,2,31,1,1
57223,65258,53,31384,53,193,102,91,2,31,1,1
57224,55796,53,15761,53,196,102,94,2,31,1,1
57225,64873,53,31946,53,195,94,101,2,31,1,1
57226,50022,53,5739,53,179,94,85,2,31,1,1
57227,49777,53,45833,53,166,86,80,2,31,1,1
57228,60384,443,37407,443,39385,3771,35614,67,129,27,40
57229,49803,443,21959,443,9506,1461,8045,20,158,9,11
57230,48847,443,1416,443,2523,1483,1040,19,276,10,9
57231,37965,25180,40858,25180,858,858,0,14,1199,14,0
57232,64408,53,9592,53,257,126,131,2,31,1,1
57233,53558,30815,59383,30815,492,306,186,8,16,5,3
57234,51676,443,25301,443,90135,76061,14074,251,247,132,119
57235,64949,53,48447,53,212,110,102,2,31,1,1
57236,55353,53,50896,53,311,86,225,4,55,2,2
57237,41833,443,22584,443,50425,3972,46453,63,122,25,38
57238,47884,443,47884,443,4672,1765,2907,18,28,10,8
57239,53561,35885,5770,35885,70,70,0,1,5,1,0
57240,57267,443,26309,443,126,60,66,3,6,2,1
57241,57257,445,0,0,70,70,0,1,0,1,0
57242,52678,445,0,0,66,66,0,1,0,1,0
57243,52258,445,0,0,70,70,0,1,0,1,0
57244,52257,445,0,0,70,70,0,1,0,1,0
57245,13747,8887,13747,8887,500,500,0,1,0,1,0
57246,33289,50584,0,0,146,146,0,1,0,1,0
57247,61221,35440,0,0,66,66,0,1,0,1,0
57248,57251,445,0,0,70,70,0,1,0,1,0
57249,58305,18375,0,0,66,66,0,1,0,1,0
57250,62338,50011,0,0,62,62,0,1,0,1,0
57251,57249,445,0,0,70,70,0,1,0,1,0
57252,57248,445,0,0,70,70,0,1,0,1,0
57253,57246,445,0,0,70,70,0,1,0,1,0
57254,52251,445,0,0,70,70,0,1,0,1,0
57255,52671,445,0,0,66,66,0,1,0,1,0
57256,48676,53398,0,0,60,60,0,1,0,1,0
57257,52250,445,0,0,70,70,0,1,0,1,0
57258,52665,445,0,0,66,66,0,1,0,1,0
57259,52666,445,0,0,66,66,0,1,0,1,0
57260,52664,445,0,0,66,66,0,1,0,1,0
57261,58703,50584,0,0,66,66,0,1,0,1,0
57262,26324,30188,0,0,62,62,0,1,0,1,0
57263,52660,445,0,0,66,66,0,1,0,1,0
57264,52661,445,0,0,66,66,0,1,0,1,0
57265,52658,445,0,0,66,66,0,1,0,1,0
57266,52246,445,0,0,70,70,0,1,0,1,0
57267,56703,50584,0,0,62,62,0,1,0,1,0
57268,51191,26467,0,0,66,66,0,1,0,1,0
57269,63583,37965,0,0,62,62,0,1,0,1,0
57270,16393,22114,0,0,66,66,0,1,0,1,0
57271,52245,445,0,0,70,70,0,1,0,1,0
57272,61426,64910,0,0,66,66,0,1,0,1,0
57273,57244,445,0,0,70,70,0,1,0,1,0
57274,57241,445,0,0,70,70,0,1,0,1,0
57275,57240,445,0,0,70,70,0,1,0,1,0
57276,5223,59023,0,0,66,66,0,1,0,1,0
57277,52657,445,0,0,66,66,0,1,0,1,0
57278,30599,46824,0,0,66,66,0,1,0,1,0
57279,57236,445,0,0,70,70,0,1,0,1,0
57280,443,46382,0,0,66,66,0,1,0,1,0
57281,52652,445,0,0,66,66,0,1,0,1,0
57282,52651,445,0,0,66,66,0,1,0,1,0
57283,53772,443,49684,443,499,425,74,4,0,3,1
57284,53770,443,15341,443,499,425,74,4,0,3,1
57285,53768,443,3588,443,499,425,74,4,0,3,1
57286,53755,443,8268,443,499,425,74,4,0,3,1
57287,53771,443,40823,443,499,425,74,4,0,3,1
57288,53760,443,44529,443,499,425,74,4,0,3,1
57289,53765,443,33408,443,499,425,74,4,0,3,1
57290,53759,443,57982,443,499,425,74,4,0,3,1
57291,53763,443,53593,443,499,425,74,4,0,3,1
57292,53773,443,19967,443,499,425,74,4,0,3,1
57293,53766,443,46858,443,499,425,74,4,0,3,1
57294,53774,443,4137,443,499,425,74,4,0,3,1
57295,53761,443,39818,443,499,425,74,4,0,3,1
57296,53762,443,60750,443,499,425,74,4,0,3,1
57297,53750,443,4212,443,499,425,74,4,0,3,1
57298,53757,443,15611,443,499,425,74,4,0,3,1
57299,53767,443,6984,443,499,425,74,4,0,3,1
57300,53764,443,56074,443,499,425,74,4,0,3,1
57301,53752,443,21616,443,499,425,74,4,0,3,1
57302,53753,443,5988,443,499,425,74,4,0,3,1
57303,53758,443,30147,443,499,425,74,4,0,3,1
57304,53754,443,24588,443,499,425,74,4,0,3,1
57305,53756,443,48419,443,499,425,74,4,0,3,1
57306,53751,443,44095,443,499,425,74,4,0,3,1
57307,52649,445,0,0,66,66,0,1,0,1,0
57308,56712,46824,0,0,66,66,0,1,0,1,0
57309,56119,46824,0,0,62,62,0,1,0,1,0
57310,39823,36237,0,0,62,62,0,1,0,1,0
57311,52647,445,0,0,66,66,0,1,0,1,0
57312,64219,51050,0,0,66,66,0,1,0,1,0
57313,52240,445,0,0,70,70,0,1,0,1,0
57314,54062,31573,0,0,66,66,0,1,0,1,0
57315,62071,22114,0,0,62,62,0,1,0,1,0
57316,57232,445,0,0,70,70,0,1,0,1,0
57317,32511,23,0,0,60,60,0,1,0,1,0
57318,3270,35440,0,0,66,66,0,1,0,1,0
57319,57225,445,0,0,70,70,0,1,0,1,0
57320,57224,445,0,0,70,70,0,1,0,1,0
57321,36906,50584,0,0,62,62,0,1,0,1,0
57322,13654,50584,0,0,62,62,0,1,0,1,0
57323,52638,445,0,0,66,66,0,1,0,1,0
57324,40834,50584,0,0,62,62,0,1,0,1,0
57325,52227,445,0,0,70,70,0,1,0,1,0
57326,58486,57470,0,0,66,66,0,1,0,1,0
57327,32491,15503,0,0,66,66,0,1,0,1,0
57328,50535,51505,0,0,66,66,0,1,0,1,0
57329,52224,445,0,0,70,70,0,1,0,1,0
57330,52629,445,0,0,66,66,0,1,0,1,0
57331,42252,33303,0,0,60,60,0,1,0,1,0
57332,57210,445,0,0,70,70,0,1,0,1,0
57333,24480,35440,0,0,66,66,0,1,0,1,0
57334,52497,47967,0,0,143,143,0,1,0,1,0
57335,52626,445,0,0,66,66,0,1,0,1,0
57336,16660,55783,0,0,62,62,0,1,0,1,0
57337,52220,445,0,0,70,70,0,1,0,1,0
57338,52218,445,0,0,70,70,0,1,0,1,0
57339,52618,445,0,0,66,66,0,1,0,1,0
57340,26110,2310,0,0,148,148,0,1,0,1,0
57341,52216,445,0,0,70,70,0,1,0,1,0
57342,52615,445,0,0,66,66,0,1,0,1,0
57343,51265,31652,0,0,72,72,0,1,0,1,0
57344,19156,3846,0,0,145,145,0,1,0,1,0
57345,54339,23117,0,0,66,66,0,1,0,1,0
57346,9412,7302,0,0,66,66,0,1,0,1,0
57347,63465,56205,0,0,66,66,0,1,0,1,0
57348,52209,445,0,0,70,70,0,1,0,1,0
57349,57199,445,0,0,70,70,0,1,0,1,0
57350,57196,445,0,0,70,70,0,1,0,1,0
57351,57197,445,0,0,70,70,0,1,0,1,0
57352,52596,445,0,0,66,66,0,1,0,1,0
57353,52600,445,0,0,66,66,0,1,0,1,0
57354,52603,445,0,0,66,66,0,1,0,1,0
57355,52602,445,0,0,66,66,0,1,0,1,0
57356,52598,445,0,0,66,66,0,1,0,1,0
57357,52601,445,0,0,66,66,0,1,0,1,0
57358,52604,445,0,0,66,66,0,1,0,1,0
57359,52599,445,0,0,66,66,0,1,0,1,0
57360,1024,64147,0,0,62,62,0,1,0,1,0
57361,52207,445,0,0,70,70,0,1,0,1,0
57362,37597,50584,0,0,66,66,0,1,0,1,0
57363,443,31353,0,0,97,97,0,1,0,1,0
57364,443,49313,0,0,97,97,0,1,0,1,0
57365,51617,21247,0,0,66,66,0,1,0,1,0
57366,58445,17500,0,0,66,66,0,1,0,1,0
57367,52206,445,0,0,70,70,0,1,0,1,0
57368,57772,50584,0,0,66,66,0,1,0,1,0
57369,52205,445,0,0,70,70,0,1,0,1,0
57370,52204,445,0,0,70,70,0,1,0,1,0
57371,52200,445,0,0,70,70,0,1,0,1,0
57372,52201,445,0,0,70,70,0,1,0,1,0
57373,44546,32468,0,0,146,146,0,1,0,1,0
57374,62549,64147,0,0,62,62,0,1,0,1,0
57375,54343,50584,0,0,66,66,0,1,0,1,0
57376,1323,64147,0,0,66,66,0,1,0,1,0
57377,60018,64147,0,0,62,62,0,1,0,1,0
57378,63852,35440,0,0,66,66,0,1,0,1,0
57379,0,0,0,0,320,320,0,5,0,5,0
57380,57194,445,0,0,70,70,0,1,0,1,0
57381,57189,445,0,0,70,70,0,1,0,1,0
57382,57181,445,0,0,70,70,0,1,0,1,0
57383,16716,57470,0,0,145,145,0,1,0,1,0
57384,52186,445,0,0,70,70,0,1,0,1,0
57385,52185,445,0,0,70,70,0,1,0,1,0
57386,52179,445,0,0,70,70,0,1,0,1,0
57387,52583,445,0,0,66,66,0,1,0,1,0
57388,52584,445,0,0,66,66,0,1,0,1,0
57389,52582,445,0,0,66,66,0,1,0,1,0
57390,52175,445,0,0,70,70,0,1,0,1,0
57391,52176,445,0,0,70,70,0,1,0,1,0
57392,24375,12809,0,0,60,60,0,1,0,1,0
57393,57179,445,0,0,70,70,0,1,0,1,0
57394,26921,37965,0,0,62,62,0,1,0,1,0
57395,50439,64147,0,0,66,66,0,1,0,1,0
57396,26924,37965,0,0,66,66,0,1,0,1,0
57397,57176,445,0,0,70,70,0,1,0,1,0
57398,57164,445,0,0,70,70,0,1,0,1,0
57399,57168,445,0,0,70,70,0,1,0,1,0
57400,57167,445,0,0,70,70,0,1,0,1,0
57401,11410,36237,0,0,146,146,0,1,0,1,0
57402,52164,445,0,0,70,70,0,1,0,1,0
57403,34756,8055,0,0,159,159,0,1,0,1,0
57404,57283,64147,0,0,66,66,0,1,0,1,0
57405,65384,57470,0,0,66,66,0,1,0,1,0
57406,47910,7454,0,0,60,60,0,1,0,1,0
57407,13864,30718,0,0,60,60,0,1,0,1,0
57408,49831,30188,0,0,62,62,0,1,0,1,0
57409,63667,57470,0,0,145,145,0,1,0,1,0
57410,59168,39004,0,0,62,62,0,1,0,1,0
57411,51815,51221,0,0,74,74,0,1,0,1,0
57412,24592,50584,0,0,62,62,0,1,0,1,0
57413,57157,445,0,0,70,70,0,1,0,1,0
57414,57156,445,0,0,70,70,0,1,0,1,0
57415,57153,445,0,0,70,70,0,1,0,1,0
57416,8976,44847,0,0,66,66,0,1,0,1,0
57417,52160,445,0,0,70,70,0,1,0,1,0
57418,47888,2310,0,0,145,145,0,1,0,1,0
57419,52150,445,0,0,70,70,0,1,0,1,0
57420,52151,445,0,0,70,70,0,1,0,1,0
57421,52146,445,0,0,70,70,0,1,0,1,0
57422,52147,445,0,0,70,70,0,1,0,1,0
57423,52144,445,0,0,70,70,0,1,0,1,0
57424,56445,53,52720,53,198,101,97,2,30,1,1
57425,42135,443,55299,443,6531,1249,5282,24,286,13,11
57426,62228,443,62228,443,296688,57600,239088,332,96,141,191
57427,34366,443,43232,443,1053,566,487,10,16,6,4
57428,42699,5222,6919,5222,420,156,264,7,18,3,4
57429,35052,80,38624,80,350,210,140,6,30,4,2
57430,49341,53,42621,53,198,101,97,2,30,1,1
57431,50022,53,39220,53,174,89,85,2,30,1,1
57432,64631,443,8739,443,8701,3408,5293,48,256,22,26
57433,49332,53,40502,53,281,98,183,4,57,2,2
57434,55046,80,55074,80,1056,682,374,10,16,6,4
57435,11073,3389,11073,3389,4085,1916,2169,21,18,12,9
57436,65115,53,24765,53,186,95,91,2,30,1,1
57437,55975,53,65159,53,190,97,93,2,30,1,1
57438,56326,53,54656,53,170,87,83,2,30,1,1
57439,56830,53,35063,53,752,93,659,2,30,1,1
57440,50881,80,50881,80,13503,1052,12451,23,21,10,13
57441,49699,53,40136,53,266,89,177,4,58,2,2
57442,43108,443,11094,443,3117,1867,1250,19,16,9,10
57443,59416,443,46812,443,2834,1700,1134,16,15,8,8
57444,55598,41565,5694,41565,70,70,0,1,5,1,0
57445,49643,443,30041,443,1640,1089,551,14,15,8,6
57446,56602,443,27563,443,7942,1953,5989,20,15,11,9
57447,31123,53,31123,53,231,88,143,2,34,1,1
57448,35050,80,51635,80,350,210,140,6,30,4,2
57449,63749,13219,47890,13219,504,382,122,8,15,6,2
57450,50566,443,50394,443,11116,4583,6533,39,256,19,20
57451,56774,39553,19722,39553,66,66,0,1,5,1,0
57452,58508,443,23694,443,3386,1894,1492,20,25,10,10
57453,55286,53,55062,53,188,96,92,2,30,1,1
57454,64235,53,36798,53,194,99,95,2,30,1,1
57455,62229,443,62229,443,211574,21152,190422,236,96,92,144
57456,35051,80,55027,80,350,210,140,6,30,4,2
57457,64850,53,42650,53,192,98,94,2,31,1,1
57458,24608,53,24608,53,209,77,132,2,33,1,1
57459,45202,443,49520,443,15153,8118,7035,45,271,22,23
57460,59415,443,30552,443,2854,1700,1154,16,16,8,8
57461,60884,443,11637,443,7411,3022,4389,26,46,15,11
57462,56601,443,9573,443,7889,1900,5989,20,15,11,9
57463,59829,443,18743,443,182,60,122,4,26,2,2
57464,49644,80,17566,80,2950,601,2349,12,15,6,6
57465,38599,443,40890,443,3605,1648,1957,20,255,10,10
57466,57367,443,24702,443,7498,2799,4699,24,17,13,11
57467,56773,53,6473,53,735,88,647,2,30,1,1
57468,56600,443,35329,443,7941,1952,5989,20,15,11,9
57469,52346,5222,7493,5222,3983,1663,2320,40,151,19,21
57470,56868,53,63238,53,752,93,659,2,30,1,1
57471,64531,53,46731,53,182,93,89,2,30,1,1
57472,63943,53,51755,53,274,90,184,4,56,2,2
57473,50069,53,5416,53,174,89,85,2,30,1,1
57474,34070,53,34070,53,250,108,142,2,30,1,1
57475,65451,53,43825,53,172,88,84,2,31,1,1
57476,64997,53,9569,53,164,84,80,2,31,1,1
57477,64517,53,41007,53,188,96,92,2,31,1,1
57478,57470,55000,8797,55000,726,726,0,12,1200,12,0
57479,64677,53,35002,53,190,97,93,2,31,1,1
57480,56744,53,44320,53,740,93,647,2,31,1,1
57481,60366,443,31619,443,14484,7411,7073,26,60,15,11
57482,56066,53,46856,53,208,106,102,2,30,1,1
57483,49635,53,55370,53,204,104,100,2,30,1,1
57484,54998,53,35657,53,174,89,85,2,31,1,1
57485,49297,53,13905,53,182,93,89,2,31,1,1
57486,64914,53,32177,53,168,86,82,2,31,1,1
57487,56320,53,39261,53,182,93,89,2,31,1,1
57488,64546,53,12738,53,182,93,89,2,31,1,1
57489,64608,53,13914,53,208,106,102,2,31,1,1
57490,57102,53,62083,53,761,100,661,2,31,1,1
57491,64689,53,18910,53,182,93,89,2,31,1,1
57492,54943,60038,0,0,66,66,0,1,90,1,0
57493,64982,53,19403,53,190,97,93,2,31,1,1
57494,57470,35667,24783,35667,132,132,0,3,1200,3,0
57495,65098,53,21613,53,740,93,647,2,31,1,1
57496,65371,53,39965,53,198,101,97,2,31,1,1
57497,64726,53,62108,53,172,88,84,2,31,1,1
57498,55964,443,21962,443,4455,798,3657,17,136,7,10
57499,65513,53,35186,53,190,97,93,2,31,1,1
57500,57470,54154,42196,54154,480,149,331,2,1200,1,1
57501,6881,6881,0,0,62,62,0,1,0,1,0
57502,18655,50584,0,0,62,62,0,1,0,1,0
57503,28973,30188,0,0,66,66,0,1,0,1,0
57504,42237,36237,0,0,66,66,0,1,0,1,0
57505,57414,57470,0,0,146,146,0,1,0,1,0
57506,52560,445,0,0,66,66,0,1,0,1,0
57507,51172,443,45149,443,1472,965,507,13,20,7,6
57508,50153,80,50079,80,41846,1261,40585,45,75,13,32
57509,49332,53,38516,53,281,98,183,4,57,2,2
57510,51413,443,51090,443,63766,32148,31618,103,42,51,52
57511,57150,445,0,0,70,70,0,1,0,1,0
57512,57149,445,0,0,70,70,0,1,0,1,0
57513,26531,37965,0,0,62,62,0,1,0,1,0
57514,24144,57470,0,0,62,62,0,1,0,1,0
57515,61345,21247,0,0,66,66,0,1,0,1,0
57516,53987,57470,0,0,66,66,0,1,0,1,0
57517,52137,445,0,0,70,70,0,1,0,1,0
57518,50784,52952,0,0,62,62,0,1,0,1,0
57519,52913,2767,0,0,66,66,0,1,0,1,0
57520,30114,65151,0,0,60,60,0,1,0,1,0
57521,59879,55783,0,0,66,66,0,1,0,1,0
57522,52555,445,0,0,66,66,0,1,0,1,0
57523,64158,53,28086,53,211,102,109,2,30,1,1
57524,55705,53,50083,53,209,110,99,2,30,1,1
57525,54998,53,11974,53,179,94,85,2,30,1,1
57526,49635,53,17449,53,210,110,100,2,30,1,1
57527,49940,443,15585,443,4363,1298,3065,17,127,8,9
57528,49260,53,30297,53,791,85,706,4,57,2,2
57529,65266,53,28016,53,536,113,423,4,56,2,2
57530,62230,443,62230,443,119850,11021,108829,134,95,50,84
57531,50901,80,56736,80,11091,2772,8319,22,154,12,10
57532,51777,63497,24893,63497,316,136,180,6,6,3,3
57533,51177,443,18641,443,154,94,60,2,4,1,1
57534,64252,53,63394,53,381,101,280,4,43,2,2
57535,65040,53,46633,53,180,94,86,2,29,1,1
57536,64999,53,64999,53,230,90,140,2,30,1,1
57537,49228,443,49228,443,32952,11546,21406,60,71,36,24
57538,60775,443,60775,443,4652,1745,2907,19,29,11,8
57539,59978,443,59552,443,10132,5161,4971,42,15,25,17
57540,49175,53,11847,53,193,102,91,2,29,1,1
57541,60749,40010,57224,40010,316,136,180,6,5,3,3
57542,64711,53,52164,53,178,94,84,2,29,1,1
57543,35370,443,45689,443,87183,4177,83006,104,126,34,70
57544,57139,53,34151,53,166,86,80,2,29,1,1
57545,55747,53,57229,53,215,102,113,2,29,1,1
57546,65040,53,64566,53,180,94,86,2,29,1,1
57547,65469,53,34501,53,195,102,93,2,29,1,1
57548,64956,53,13763,53,565,92,473,4,38,2,2
57549,55705,53,38579,53,209,110,99,2,29,1,1
57550,55634,53,37153,53,210,110,100,2,30,1,1
57551,53555,57861,41718,57861,492,306,186,8,15,5,3
57552,55286,53,58993,53,194,102,92,2,29,1,1
57553,57139,53,51563,53,166,86,80,2,30,1,1
57554,55517,53,64032,53,179,94,85,2,29,1,1
57555,49341,53,19411,53,199,102,97,2,29,1,1
57556,51779,3389,21341,3389,62242217,4119315,58122902,123738,4772,43917,79821
57557,2070,53,2070,53,233,90,143,2,32,1,1
57558,36074,80,23733,80,1158,792,366,10,17,6,4
57559,59977,443,64573,443,7971,2647,5324,38,15,24,14
57560,50203,80,15124,80,4020,1978,2042,16,66,9,7
57561,64079,53,36707,53,232,94,138,2,30,1,1
57562,49332,53,50877,53,281,98,183,4,57,2,2
57563,46590,443,20776,443,6665,1130,5535,24,287,13,11
57564,50307,443,50307,443,4378,1471,2907,19,30,11,8
57565,57127,53,41259,53,195,102,93,2,30,1,1
57566,60886,443,34294,443,3855,2679,1176,28,45,15,13
57567,39821,443,37984,443,11179,7205,3974,47,136,26,21
57568,51171,443,60392,443,1532,965,567,14,20,7,7
57569,49367,53,7025,53,548,112,436,4,36,2,2
57570,34239,80,12111,80,1056,682,374,10,15,6,4
57571,63226,443,50931,443,4462,2023,2439,33,125,17,16
57572,64986,53,27800,53,180,94,86,2,30,1,1
57573,55597,7485,34248,7485,70,70,0,1,5,1,0
57574,8984,443,5920,443,13750,4934,8816,64,167,31,33
57575,25776,53,25776,53,233,90,143,2,32,1,1
57576,56167,53,17314,53,178,94,84,2,30,1,1
57577,60405,443,60867,443,6570,1988,4582,19,57,10,9
57578,45564,443,3708,443,69614,5520,64094,100,21,52,48
57579,64739,53,12107,53,172,94,78,2,30,1,1
57580,50149,80,19755,80,78701,4331,74370,77,75,21,56
57581,49920,80,51045,80,3649288,78688,3570600,2923,179,528,2395
57582,57416,53,2716,53,193,102,91,2,30,1,1
57583,65048,53,32798,53,194,102,92,2,30,1,1
57584,63998,53,51868,53,263,126,137,2,30,1,1
57585,64531,53,41084,53,183,94,89,2,30,1,1
57586,49983,53,57759,53,211,110,101,2,30,1,1
57587,64388,53,48927,53,248,102,146,2,30,1,1
57588,49820,53,40891,53,211,102,109,2,30,1,1
57589,64126,53,25754,53,255,102,153,2,30,1,1
57590,60887,443,40935,443,3795,2679,1116,27,45,15,12
57591,45174,443,32047,443,6196,1417,4779,21,665,11,10
57592,43120,80,4226,80,1151,711,440,10,15,5,5
57593,50419,80,40888,80,3664,1440,2224,12,23,6,6
57594,50193,443,31534,443,2404,1121,1283,14,115,7,7
57595,63943,53,16297,53,258,90,168,4,56,2,2
57596,49777,53,60241,53,272,84,188,4,60,2,2
57597,50069,53,27415,53,179,94,85,2,30,1,1
57598,49369,53,21146,53,183,94,89,2,30,1,1
57599,49297,53,2852,53,183,94,89,2,30,1,1
57600,57139,53,32218,53,166,86,80,2,30,1,1
57601,54998,53,33990,53,179,94,85,2,30,1,1
57602,60875,443,9147,443,45373,35377,9996,88,72,48,40
57603,56782,49135,47020,49135,70,70,0,2,8,2,0
57604,60278,80,27803,80,1422,734,688,7,99,4,3
57605,55563,53,20716,53,290,118,172,2,30,1,1
57606,65140,53,14760,53,752,110,642,2,30,1,1
57607,56167,53,49116,53,178,94,84,2,30,1,1
57608,59717,443,16330,443,303966,26201,277765,521,167,208,313
57609,61592,443,6581,443,19544,8237,11307,29,121,13,16
57610,47817,443,11040,443,18158,2080,16078,34,122,19,15
57611,51414,443,43551,443,78740,40216,38524,126,42,66,60
57612,45633,80,23400,80,1573,702,871,12,45,7,5
57613,46341,443,54451,443,9172,3518,5654,39,103,21,18
57614,56521,443,48766,443,8760,3693,5067,20,90,12,8
57615,49699,53,32857,53,266,89,177,4,58,2,2
57616,46974,443,29237,443,5861,1151,4710,18,34,10,8
57617,56552,53,47161,53,195,102,93,2,29,1,1
57618,50016,80,57935,80,827,687,140,6,32,4,2
57619,56071,53,60998,53,193,102,91,2,29,1,1
57620,64986,53,30082,53,180,94,86,2,30,1,1
57621,53447,80,56181,80,1517,481,1036,11,15,6,5
57622,57134,53,48452,53,178,94,84,2,30,1,1
57623,51769,19165,28138,19165,70,70,0,2,8,2,0
57624,65179,53,52575,53,184,94,90,2,30,1,1
57625,55595,33677,1152,33677,210,140,70,4,14,3,1
57626,49341,53,41507,53,199,102,97,2,30,1,1
57627,53537,34901,47127,34901,672,426,246,11,21,7,4
57628,65115,53,52563,53,193,102,91,2,30,1,1
57629,62234,443,62234,443,187597,6822,180775,203,92,67,136
57630,64213,53,34758,53,342,105,237,4,53,2,2
57631,55286,53,38062,53,194,102,92,2,29,1,1
57632,63747,80,64940,80,314,192,122,6,15,4,2
57633,49384,53,28172,53,181,94,87,2,29,1,1
57634,64252,53,2109,53,199,102,97,2,29,1,1
57635,49699,53,7442,53,266,89,177,4,58,2,2
57636,64438,53,9645,53,184,94,90,2,29,1,1
57637,65185,53,26657,53,453,186,267,6,30,3,3
57638,49361,53,37385,53,184,94,90,2,29,1,1
57639,56402,53,29838,53,322,134,188,2,30,1,1
57640,57416,53,8404,53,193,102,91,2,29,1,1
57641,55955,53,39332,53,164,86,78,2,30,1,1
57642,64997,53,31899,53,166,86,80,2,30,1,1
57643,65179,53,63378,53,184,94,90,2,31,1,1
57644,50022,53,26770,53,179,94,85,2,31,1,1
57645,65179,53,56146,53,184,94,90,2,30,1,1
57646,58080,3389,58080,3389,3564,1850,1714,18,32,10,8
57647,55664,53,37409,53,195,102,93,2,30,1,1
57648,64546,53,39505,53,183,94,89,2,31,1,1
57649,49945,53,3434,53,281,97,184,4,57,2,2
57650,64124,80,34060,80,1517,481,1036,11,15,6,5
57651,60883,443,40215,443,11586,5435,6151,46,46,25,21
57652,42790,443,55460,443,13859,3232,10627,50,256,21,29
57653,54932,443,37338,443,84306,6712,77594,156,236,58,98
57654,59814,443,30492,443,1560,977,583,15,30,8,7
57655,36811,80,46728,80,1475,837,638,10,15,5,5
57656,50423,80,33009,80,23470,2457,21013,31,22,13,18
57657,49369,53,36980,53,183,94,89,2,30,1,1
57658,56641,53,52292,53,453,186,267,6,30,3,3
57659,40926,53,16373,53,168,78,90,2,30,1,1
57660,57127,53,41835,53,195,102,93,2,30,1,1
57661,59089,443,40663,443,77560,5020,72540,93,121,34,59
57662,52221,443,62267,443,4567,717,3850,17,148,7,10
57663,60885,443,21890,443,3855,2679,1176,28,45,15,13
57664,56784,23140,27615,23140,70,70,0,1,5,1,0
57665,64783,53,41526,53,561,99,462,4,38,2,2
57666,63227,443,37596,443,1373,734,639,17,125,10,7
57667,56759,53,42507,53,338,118,220,2,30,1,1
57668,55937,53,58356,53,179,94,85,2,30,1,1
57669,57268,53,42841,53,205,94,111,2,30,1,1
57670,56167,53,4828,53,178,94,84,2,30,1,1
57671,64850,53,49939,53,196,102,94,2,30,1,1
57672,55955,53,59392,53,164,86,78,2,30,1,1
57673,65522,53,17756,53,1281,94,1187,2,30,1,1
57674,57323,53,57323,53,216,98,118,2,30,1,1
57675,64859,53,0,0,220,81,139,2,30,1,1
57676,37168,443,5501,443,4871,923,3948,19,360,10,9
57677,56932,53,30512,53,172,94,78,2,30,1,1
57678,55975,53,39571,53,195,102,93,2,30,1,1
57679,31710,53,31710,53,233,90,143,2,32,1,1
57680,60195,80,59592,80,70,70,0,1,5,1,0
57681,56775,20617,21189,20617,70,70,0,1,5,1,0
57682,51752,31677,14033,31677,70,70,0,1,5,1,0
57683,52194,80,42397,80,1151,711,440,10,15,5,5
57684,57134,53,29907,53,178,94,84,2,30,1,1
57685,49229,53,43907,53,178,94,84,2,30,1,1
57686,56326,53,34552,53,177,94,83,2,30,1,1
57687,55634,53,10243,53,210,110,100,2,30,1,1
57688,64303,53,3497,53,212,102,110,2,30,1,1
57689,49478,53,25544,53,172,94,78,2,30,1,1
57690,51459,53,51459,53,256,114,142,2,30,1,1
57691,42758,123,49346,123,184,94,90,2,30,1,1
57692,64235,53,18011,53,197,102,95,2,30,1,1
57693,65231,53,2677,53,200,102,98,2,30,1,1
57694,52088,53,34492,53,168,78,90,2,30,1,1
57695,59475,53,33895,53,179,86,93,2,30,1,1
57696,65451,53,9414,53,178,94,84,2,30,1,1
57697,49635,53,59666,53,210,110,100,2,30,1,1
57698,50022,53,51786,53,179,94,85,2,30,1,1
57699,55664,53,32292,53,195,102,93,2,30,1,1
57700,65371,53,1608,53,199,102,97,2,30,1,1
57701,65424,53,5090,53,210,110,100,2,31,1,1
57702,65513,53,29862,53,195,102,93,2,31,1,1
57703,65048,53,7806,53,194,102,92,2,30,1,1
57704,56066,53,20182,53,212,110,102,2,30,1,1
57705,56418,53,19002,53,183,94,89,2,30,1,1
57706,49442,53,40025,53,198,94,104,2,31,1,1
57707,64850,53,36878,53,196,102,94,2,31,1,1
57708,64677,53,46523,53,195,102,93,2,31,1,1
57709,65451,53,7550,53,178,94,84,2,31,1,1
57710,35685,443,31847,443,2967,876,2091,11,120,5,6
57711,64011,443,26030,443,4196,1407,2789,19,135,9,10
57712,33814,443,5866,443,8601,2870,5731,40,225,22,18
57713,56288,53,49732,53,183,94,89,2,31,1,1
57714,49631,443,48718,443,8558,1006,7552,16,121,7,9
57715,38659,443,10582,443,11202,2200,9002,39,131,20,19
57716,6881,6881,52538,6881,118,118,0,1,1200,1,0
57717,37965,20926,65479,20926,481,150,331,2,1199,1,1
57718,48991,80,63971,80,121475,5644,115831,163,145,81,82
57719,56418,53,28996,53,183,94,89,2,31,1,1
57720,65115,53,25677,53,368,95,273,4,61,2,2
57721,57415,443,15579,443,28216,10325,17891,93,23,42,51
57722,44928,443,35200,443,9345,2224,7121,40,112,22,18
57723,43227,443,48195,443,460628,23936,436692,580,124,264,316
57724,58190,53,48181,53,648,86,562,4,51,2,2
57725,60538,80,60538,80,318,120,198,6,26,3,3
57726,53915,443,38797,443,7917,2410,5507,32,26,18,14
57727,54998,53,29340,53,438,89,349,4,60,2,2
57728,49424,53,11040,53,198,102,96,2,33,1,1
57729,60539,80,60539,80,318,120,198,6,26,3,3
57730,48892,443,58975,443,740,210,530,12,110,4,8
57731,64055,53,48031,53,501,94,407,4,52,2,2
57732,56656,53,3129,53,255,88,167,4,53,2,2
57733,57351,62413,0,0,62,62,0,1,0,1,0
57734,61616,23,0,0,60,60,0,1,0,1,0
57735,52552,445,0,0,66,66,0,1,0,1,0
57736,57140,445,0,0,70,70,0,1,0,1,0
57737,59585,36237,0,0,62,62,0,1,0,1,0
57738,52128,445,0,0,70,70,0,1,0,1,0
57739,57132,445,0,0,70,70,0,1,0,1,0
57740,57130,445,0,0,70,70,0,1,0,1,0
57741,57129,445,0,0,70,70,0,1,0,1,0
57742,52126,445,0,0,70,70,0,1,0,1,0
57743,52549,445,0,0,66,66,0,1,0,1,0
57744,80,37649,0,0,60,60,0,1,0,1,0
57745,20726,2767,0,0,66,66,0,1,0,1,0
57746,11816,50584,0,0,66,66,0,1,0,1,0
57747,80,53945,0,0,60,60,0,1,0,1,0
57748,52121,445,0,0,70,70,0,1,0,1,0
57749,7275,39827,0,0,74,74,0,1,0,1,0
57750,57123,445,0,0,70,70,0,1,0,1,0
57751,60292,7129,0,0,62,62,0,1,0,1,0
57752,52120,445,0,0,70,70,0,1,0,1,0
57753,57121,445,0,0,70,70,0,1,0,1,0
57754,57119,445,0,0,70,70,0,1,0,1,0
57755,57117,445,0,0,70,70,0,1,0,1,0
57756,52543,445,0,0,66,66,0,1,0,1,0
57757,25360,51505,0,0,66,66,0,1,0,1,0
57758,32215,22114,0,0,66,66,0,1,0,1,0
57759,54276,39004,0,0,66,66,0,1,0,1,0
57760,52537,445,0,0,66,66,0,1,0,1,0
57761,52536,445,0,0,66,66,0,1,0,1,0
57762,52534,445,0,0,66,66,0,1,0,1,0
57763,12283,25773,0,0,139,139,0,1,0,1,0
57764,1024,64147,0,0,62,62,0,1,0,1,0
57765,52116,445,0,0,70,70,0,1,0,1,0
57766,52531,445,0,0,66,66,0,1,0,1,0
57767,52533,445,0,0,66,66,0,1,0,1,0
57768,52532,445,0,0,66,66,0,1,0,1,0
57769,59023,64097,0,0,66,66,0,1,0,1,0
57770,43457,31573,0,0,146,146,0,1,0,1,0
57771,53355,23117,0,0,66,66,0,1,0,1,0
57772,52115,445,0,0,70,70,0,1,0,1,0
57773,53053,64147,0,0,66,66,0,1,0,1,0
57774,80,9918,0,0,60,60,0,1,0,1,0
57775,37577,443,55436,443,499,425,74,4,0,3,1
57776,37580,443,1520,443,499,425,74,4,0,3,1
57777,37578,443,38222,443,499,425,74,4,0,3,1
57778,37579,443,43995,443,499,425,74,4,0,3,1
57779,37576,443,42873,443,499,425,74,4,0,3,1
57780,37575,443,28180,443,499,425,74,4,0,3,1
57781,62780,35440,0,0,66,66,0,1,0,1,0
57782,57116,445,0,0,70,70,0,1,0,1,0
57783,57114,445,0,0,70,70,0,1,0,1,0
57784,57110,445,0,0,70,70,0,1,0,1,0
57785,52528,445,0,0,66,66,0,1,0,1,0
57786,22683,39210,0,0,60,60,0,1,0,1,0
57787,57108,445,0,0,70,70,0,1,0,1,0
57788,52524,445,0,0,66,66,0,1,0,1,0
57789,11458,2767,0,0,62,62,0,1,0,1,0
57790,26439,37965,0,0,66,66,0,1,0,1,0
57791,52521,445,0,0,66,66,0,1,0,1,0
57792,52522,445,0,0,66,66,0,1,0,1,0
57793,52110,445,0,0,70,70,0,1,0,1,0
57794,53475,3389,0,0,62,62,0,1,0,1,0
57795,61043,57470,0,0,78,78,0,1,0,1,0
57796,52519,445,0,0,66,66,0,1,0,1,0
57797,42951,44847,0,0,66,66,0,1,0,1,0
57798,12232,41864,0,0,139,139,0,1,0,1,0
57799,14615,57866,0,0,62,62,0,1,0,1,0
57800,53166,61600,0,0,66,66,0,1,0,1,0
57801,54773,50584,0,0,66,66,0,1,0,1,0
57802,53211,22114,0,0,62,62,0,1,0,1,0
57803,57101,445,0,0,70,70,0,1,0,1,0
57804,57097,445,0,0,70,70,0,1,0,1,0
57805,57094,445,0,0,70,70,0,1,0,1,0
57806,58977,37965,0,0,66,66,0,1,0,1,0
57807,45603,35894,0,0,145,145,0,1,0,1,0
57808,61804,51505,0,0,66,66,0,1,0,1,0
57809,52508,445,0,0,66,66,0,1,0,1,0
57810,52097,445,0,0,70,70,0,1,0,1,0
57811,51196,53,0,0,206,83,123,2,0,1,1
57812,49424,53,32316,53,100,100,0,1,0,1,0
57813,6057,51221,0,0,62,62,0,1,0,1,0
57814,59156,50584,0,0,62,62,0,1,0,1,0
57815,19858,64147,0,0,62,62,0,1,0,1,0
57816,55254,50584,0,0,66,66,0,1,0,1,0
57817,52094,445,0,0,70,70,0,1,0,1,0
57818,21777,50584,0,0,62,62,0,1,0,1,0
57819,60875,56205,0,0,66,66,0,1,0,1,0
57820,52501,445,0,0,66,66,0,1,0,1,0
57821,57080,445,0,0,70,70,0,1,0,1,0
57822,52498,445,0,0,66,66,0,1,0,1,0
57823,52089,445,0,0,70,70,0,1,0,1,0
57824,45964,3111,0,0,60,60,0,1,0,1,0
57825,52088,445,0,0,70,70,0,1,0,1,0
57826,42572,995,0,0,60,60,0,1,0,1,0
57827,39941,995,0,0,60,60,0,1,0,1,0
57828,52086,445,0,0,70,70,0,1,0,1,0
57829,58382,50584,0,0,62,62,0,1,0,1,0
57830,52492,445,0,0,66,66,0,1,0,1,0
57831,52486,445,0,0,66,66,0,1,0,1,0
57832,40547,24051,0,0,74,74,0,1,0,1,0
57833,443,23220,0,0,100,100,0,1,0,1,0
57834,3521,6881,0,0,66,66,0,1,0,1,0
57835,52079,445,0,0,70,70,0,1,0,1,0
57836,5575,8889,5575,8889,497,497,0,1,0,1,0
57837,3225,64147,0,0,62,62,0,1,0,1,0
57838,52077,445,0,0,70,70,0,1,0,1,0
57839,57071,445,0,0,70,70,0,1,0,1,0
57840,57070,445,0,0,70,70,0,1,0,1,0
57841,57068,445,0,0,70,70,0,1,0,1,0
57842,52475,445,0,0,66,66,0,1,0,1,0
57843,52476,445,0,0,66,66,0,1,0,1,0
57844,52474,445,0,0,66,66,0,1,0,1,0
57845,52469,445,0,0,66,66,0,1,0,1,0
57846,52470,445,0,0,66,66,0,1,0,1,0
57847,52473,445,0,0,66,66,0,1,0,1,0
57848,52472,445,0,0,66,66,0,1,0,1,0
57849,52471,445,0,0,66,66,0,1,0,1,0
57850,46093,32661,0,0,74,74,0,1,0,1,0
57851,52076,445,0,0,70,70,0,1,0,1,0
57852,63670,64097,0,0,66,66,0,1,0,1,0
57853,52075,445,0,0,70,70,0,1,0,1,0
57854,52074,445,0,0,70,70,0,1,0,1,0
57855,52068,445,0,0,70,70,0,1,0,1,0
57856,52067,445,0,0,70,70,0,1,0,1,0
57857,27368,22114,0,0,62,62,0,1,0,1,0
57858,49516,35894,0,0,62,62,0,1,0,1,0
57859,52055,445,0,0,70,70,0,1,0,1,0
57860,52054,445,0,0,70,70,0,1,0,1,0
57861,52049,445,0,0,70,70,0,1,0,1,0
57862,1284,50584,0,0,62,62,0,1,0,1,0
57863,57063,445,0,0,70,70,0,1,0,1,0
57864,57057,445,0,0,70,70,0,1,0,1,0
57865,57056,445,0,0,70,70,0,1,0,1,0
57866,20844,64147,0,0,66,66,0,1,0,1,0
57867,52045,445,0,0,70,70,0,1,0,1,0
57868,52044,445,0,0,70,70,0,1,0,1,0
57869,62678,57470,0,0,62,62,0,1,0,1,0
57870,64788,43890,0,0,62,62,0,1,0,1,0
57871,52456,445,0,0,66,66,0,1,0,1,0
57872,52455,445,0,0,66,66,0,1,0,1,0
57873,52453,445,0,0,66,66,0,1,0,1,0
57874,64406,50584,0,0,66,66,0,1,0,1,0
57875,57452,57470,0,0,62,62,0,1,0,1,0
57876,36881,56205,0,0,146,146,0,1,0,1,0
57877,57050,445,0,0,70,70,0,1,0,1,0
57878,49800,5900,0,0,60,60,0,1,0,1,0
57879,52749,64147,0,0,66,66,0,1,0,1,0
57880,30307,51505,0,0,62,62,0,1,0,1,0
57881,57048,445,0,0,70,70,0,1,0,1,0
57882,57043,445,0,0,70,70,0,1,0,1,0
57883,57038,445,0,0,70,70,0,1,0,1,0
57884,57039,445,0,0,70,70,0,1,0,1,0
57885,59523,37965,0,0,62,62,0,1,0,1,0
57886,52033,445,0,0,70,70,0,1,0,1,0
57887,46495,4607,0,0,60,60,0,1,0,1,0
57888,29623,37807,0,0,62,62,0,1,0,1,0
57889,8910,62413,0,0,146,146,0,1,0,1,0
57890,55045,53,38947,53,747,92,655,2,30,1,1
57891,54854,443,6189,443,32544,28348,4196,63,332,31,32
57892,5530,80,5530,80,514,246,268,9,91,5,4
57893,43107,443,43113,443,3051,1801,1250,18,16,8,10
57894,50497,443,10813,443,1642025,26957,1615068,1478,17,406,1072
57895,49897,80,15304,80,188,128,60,3,15,2,1
57896,137,137,20437,137,384,384,0,5,51,5,0
57897,56418,53,62864,53,182,93,89,2,30,1,1
57898,55337,53,11833,53,294,106,188,4,56,2,2
57899,58215,443,23391,443,7337,1630,5707,23,256,12,11
57900,51768,61765,18579,61765,70,70,0,2,8,2,0
57901,51751,55855,62891,55855,66,66,0,1,5,1,0
57902,51749,1408,5548,1408,66,66,0,1,5,1,0
57903,55540,53,5728,53,757,98,659,2,31,1,1
57904,50128,53,3916,53,757,98,659,2,30,1,1
57905,59850,443,34758,443,10260,1360,8900,22,18,7,15
57906,63745,39800,55951,39800,504,382,122,8,16,6,2
57907,56376,53,45759,53,196,100,96,2,30,1,1
57908,59800,443,57363,443,94202,5247,88955,115,37,41,74
57909,59846,443,17762,443,23856,3218,20638,40,18,16,24
57910,59849,443,38799,443,8368,1360,7008,19,18,7,12
57911,60962,443,57911,443,50093,8331,41762,75,48,36,39
57912,47822,80,47822,80,1435,1293,142,5,15,3,2
57913,63750,63343,14942,63343,66,66,0,1,5,1,0
57914,56656,53,54597,53,255,88,167,4,53,2,2
57915,59838,443,12869,443,5520,3416,2104,27,22,13,14
57916,45268,443,29338,443,7503,2345,5158,34,256,17,17
57917,60537,80,60537,80,318,120,198,6,25,3,3
57918,56288,53,56709,53,182,93,89,2,31,1,1
57919,59409,443,2486,443,7775,3174,4601,25,16,11,14
57920,59839,443,29303,443,93467,4007,89460,107,22,33,74
57921,56772,61424,62775,61424,66,66,0,1,5,1,0
57922,59725,443,1736,443,89790,6036,83754,112,55,41,71
57923,47150,9339,62687,9339,179194,19657,159537,415,149,202,213
57924,64327,53,64327,53,243,100,143,2,30,1,1
57925,59845,443,19704,443,14702,1976,12726,28,18,10,18
57926,57342,80,40590,80,1056,682,374,10,15,6,4
57927,49631,443,7469,443,11772,5416,6356,25,49,15,10
57928,48556,80,48556,80,19225,817,18408,29,15,13,16
57929,59835,443,54646,443,13306,9499,3807,32,23,17,15
57930,53112,29258,48583,29258,70,70,0,1,5,1,0
57931,4009,53,4009,53,231,88,143,2,33,1,1
57932,54204,443,50779,443,18159,12786,5373,34,270,19,15
57933,59905,443,62793,443,21212,14546,6666,43,362,24,19
57934,42881,443,61289,443,28707,2793,25914,58,115,29,29
57935,49625,443,57635,443,4252,726,3526,13,16,7,6
57936,60391,47212,11970,47212,164,70,94,2,5,1,1
57937,60392,1134,49045,1134,70,70,0,1,5,1,0
57938,61645,443,61645,443,4702,1795,2907,19,28,11,8
57939,39611,443,31755,443,234,234,0,4,12,4,0
57940,55394,53,55394,53,197,76,121,2,30,1,1
57941,65159,53,15273,53,286,103,183,4,52,2,2
57942,64811,53,2888,53,186,95,91,2,30,1,1
57943,64706,53,4952,53,174,89,85,2,30,1,1
57944,55664,53,44957,53,190,97,93,2,30,1,1
57945,49672,53,36267,53,761,100,661,2,30,1,1
57946,33845,53,0,0,82,82,0,1,30,1,0
57947,65372,53,1041,53,196,100,96,2,31,1,1
57948,58035,80,30742,80,100364,4917,95447,133,241,67,66
57949,5938,6987,0,0,60,60,0,1,90,1,0
57950,57614,443,56701,443,25824,14215,11609,65,757,32,33
57951,6882,6889,43478,6889,221,111,110,2,1200,1,1
57952,54677,5228,25400,5228,6679,2730,3949,43,4309,23,20
57953,46844,53,0,0,82,82,0,1,31,1,0
57954,56727,53,26195,53,762,101,661,2,31,1,1
57955,56458,53,36864,53,192,98,94,2,31,1,1
57956,60593,80,31498,80,123436,6053,117383,165,241,83,82
57957,64840,53,31006,53,186,95,91,2,31,1,1
57958,56924,53,30417,53,216,110,106,2,31,1,1
57959,54489,443,33538,443,4263,2019,2244,14,136,7,7
57960,50584,55727,63781,55727,2268,1050,1218,15,5442,8,7
57961,30960,45686,49488,45686,330,330,0,6,3609,6,0
57962,12605,57470,0,0,62,62,0,1,0,1,0
57963,12821,37965,0,0,66,66,0,1,0,1,0
57964,21274,30188,0,0,62,62,0,1,0,1,0
57965,52029,445,0,0,70,70,0,1,0,1,0
57966,51685,57470,0,0,66,66,0,1,0,1,0
57967,62859,35440,0,0,66,66,0,1,0,1,0
57968,56526,443,61934,443,7563,3697,3866,19,15,10,9
57969,29363,443,29363,443,29861,6027,23834,65,37,34,31
57970,57028,445,0,0,70,70,0,1,0,1,0
57971,57026,445,0,0,70,70,0,1,0,1,0
57972,57024,445,0,0,70,70,0,1,0,1,0
57973,64051,36829,0,0,66,66,0,1,0,1,0
57974,52019,445,0,0,70,70,0,1,0,1,0
57975,52020,445,0,0,70,70,0,1,0,1,0
57976,58468,37965,0,0,66,66,0,1,0,1,0
57977,5914,10214,0,0,100,100,0,1,0,1,0
57978,6889,41864,0,0,143,143,0,1,0,1,0
57979,52016,445,0,0,70,70,0,1,0,1,0
57980,52015,445,0,0,70,70,0,1,0,1,0
57981,57165,34101,0,0,62,62,0,1,0,1,0
57982,43671,37965,0,0,62,62,0,1,0,1,0
57983,52012,445,0,0,70,70,0,1,0,1,0
57984,30496,57470,0,0,62,62,0,1,0,1,0
57985,50143,35253,0,0,66,66,0,1,0,1,0
57986,52433,445,0,0,66,66,0,1,0,1,0
57987,1025,35447,0,0,62,62,0,1,0,1,0
57988,57022,445,0,0,70,70,0,1,0,1,0
57989,57021,445,0,0,70,70,0,1,0,1,0
57990,65209,57866,0,0,66,66,0,1,0,1,0
57991,55286,37965,0,0,66,66,0,1,0,1,0
57992,52007,445,0,0,70,70,0,1,0,1,0
57993,6666,6379,0,0,60,60,0,1,0,1,0
57994,26332,57470,0,0,62,62,0,1,0,1,0
57995,52427,445,0,0,66,66,0,1,0,1,0
57996,51999,445,0,0,70,70,0,1,0,1,0
57997,52424,445,0,0,66,66,0,1,0,1,0
57998,51998,445,0,0,70,70,0,1,0,1,0
57999,57010,445,0,0,70,70,0,1,0,1,0
58000,52676,53733,0,0,62,62,0,1,0,1,0
58001,57004,445,0,0,70,70,0,1,0,1,0
58002,57002,445,0,0,70,70,0,1,0,1,0
58003,57001,445,0,0,70,70,0,1,0,1,0
58004,4594,35993,0,0,62,62,0,1,0,1,0
58005,32892,23,0,0,60,60,0,1,0,1,0
58006,56380,80,20906,80,1466,729,737,12,16,7,5
58007,44410,443,17016,443,2359,1436,923,18,38,10,8
58008,64914,53,27750,53,168,86,82,2,30,1,1
58009,56320,53,53678,53,183,94,89,2,30,1,1
58010,51103,53,0,0,174,77,97,2,30,1,1
58011,35991,443,1116,443,10857,4247,6610,27,121,13,14
58012,49332,53,28193,53,281,98,183,4,56,2,2
58013,64235,53,30515,53,321,99,222,4,52,2,2
58014,5234,28162,61929,28162,449555,320,449235,719,50,6,713
58015,60536,80,60536,80,318,120,198,6,25,3,3
58016,51770,37237,29637,37237,316,136,180,6,6,3,3
58017,58682,80,4123,80,1345,726,619,16,362,8,8
58018,55337,53,8346,53,294,106,188,4,56,2,2
58019,48893,443,17087,443,16227,2037,14190,40,109,19,21
58020,56656,53,41327,53,255,88,167,4,52,2,2
58021,49888,443,12324,443,1072526,64733,1007793,1501,232,690,811
58022,57417,443,11340,443,43052,2466,40586,64,18,21,43
58023,55337,53,22307,53,294,106,188,4,55,2,2
58024,47264,443,35933,443,7201,3870,3331,33,315,17,16
58025,63943,53,24441,53,509,176,333,6,56,3,3
58026,58704,80,26628,80,4115,3452,663,13,15,7,6
58027,55719,8060,30409,8060,70,70,0,2,7,2,0
58028,56816,80,41001,80,420340,15216,405124,441,376,163,278
58029,60004,443,3185,443,134,60,74,3,4,2,1
58030,49699,53,17835,53,266,89,177,4,58,2,2
58031,65424,53,57166,53,210,110,100,2,29,1,1
58032,60535,80,60535,80,318,120,198,6,25,3,3
58033,64546,53,11850,53,183,94,89,2,29,1,1
58034,48012,443,51500,443,1429,1295,134,10,29,8,2
58035,51137,80,51137,80,66992,5462,61530,79,26,30,49
58036,56425,80,34044,80,17188,1559,15629,25,31,10,15
58037,64914,53,63909,53,86,86,0,1,29,1,0
58038,56656,53,40908,53,255,88,167,4,53,2,2
58039,64982,53,7068,53,321,97,224,4,57,2,2
58040,28122,443,63914,443,7808,2487,5321,34,446,16,18
58041,123,123,44322,123,184,94,90,2,29,1,1
58042,65159,53,20643,53,286,103,183,4,51,2,2
58043,64939,53,4454,53,199,94,105,2,29,1,1
58044,64531,53,56972,53,183,94,89,2,29,1,1
58045,55931,53,41701,53,294,118,176,2,29,1,1
58046,61041,53,61041,53,214,90,124,2,29,1,1
58047,65532,53,19828,53,819,102,717,2,30,1,1
58048,64689,53,34039,53,183,94,89,2,30,1,1
58049,55372,53,7739,53,448,184,264,6,30,3,3
58050,59811,443,39338,443,36149,11297,24852,56,29,25,31
58051,53209,443,56508,443,11086,2564,8522,42,186,21,21
58052,50945,80,50945,80,78911,2499,76412,88,26,32,56
58053,55013,53,33517,53,821,102,719,2,30,1,1
58054,65168,53,45025,53,749,94,655,2,30,1,1
58055,64982,53,35426,53,195,102,93,2,30,1,1
58056,50165,53,36668,53,211,78,133,2,30,1,1
58057,59416,443,53026,443,10642,3654,6988,26,125,14,12
58058,49830,443,7649,443,6131,1960,4171,18,15,10,8
58059,55013,53,27966,53,198,102,96,2,30,1,1
58060,64823,53,7121,53,199,102,97,2,31,1,1
58061,49418,27015,10254,27015,78,78,0,1,30,1,0
58062,64982,53,7315,53,195,102,93,2,30,1,1
58063,64689,53,48296,53,183,94,89,2,30,1,1
58064,49748,53,20050,53,763,102,661,2,30,1,1
58065,51767,59158,21535,59158,70,70,0,2,8,2,0
58066,12116,53,12116,53,214,82,132,2,33,1,1
58067,64608,53,12446,53,212,110,102,2,30,1,1
58068,50367,53,23115,53,198,102,96,2,30,1,1
58069,56403,443,35663,443,24745,1926,22819,39,170,18,21
58070,51008,80,51008,80,114613,6365,108248,134,26,51,83
58071,56339,53,35770,53,280,78,202,2,30,1,1
58072,56320,53,14969,53,183,94,89,2,30,1,1
58073,56288,53,30293,53,183,94,89,2,30,1,1
58074,64677,53,6467,53,195,102,93,2,30,1,1
58075,50291,53,32259,53,86,86,0,1,30,1,0
58076,49418,27017,44700,27017,78,78,0,1,30,1,0
58077,55038,443,25937,443,11429,4904,6525,33,156,18,15
58078,28064,53,28064,53,233,90,143,2,32,1,1
58079,56023,53,4937,53,338,106,232,4,37,2,2
58080,50880,80,50880,80,163985,6578,157407,188,26,72,116
58081,47400,80,1203,80,1052,612,440,10,15,5,5
58082,49297,53,48060,53,183,94,89,2,30,1,1
58083,5405,53,5405,53,645,90,555,2,30,1,1
58084,5284,53,5284,53,178,82,96,2,30,1,1
58085,64703,53,15968,53,314,92,222,4,31,2,2
58086,61938,443,14944,443,7118,2462,4656,18,75,10,8
58087,49346,53,23031,53,228,110,118,2,30,1,1
58088,64608,53,62804,53,212,110,102,2,30,1,1
58089,64726,53,39418,53,178,94,84,2,30,1,1
58090,56376,53,65133,53,198,102,96,2,30,1,1
58091,44929,443,17835,443,554,280,274,9,111,5,4
58092,50916,80,44611,80,11456216,116932,11339284,9298,139,1683,7615
58093,49267,443,42451,443,19851,15702,4149,63,109,34,29
58094,55337,53,17571,53,294,106,188,4,56,2,2
58095,59813,443,22135,443,23244,13793,9451,50,29,26,24
58096,59937,443,7727,443,8852,1428,7424,22,199,11,11
58097,51658,80,26955,80,39464,2150,37314,81,20,26,55
58098,10018,80,16761,80,1052,612,440,10,15,5,5
58099,52513,443,40002,443,5096,810,4286,15,15,8,7
58100,56767,34578,60694,34578,564,318,246,9,16,5,4
58101,51750,54567,46467,54567,70,70,0,1,5,1,0
58102,54410,443,16745,443,7256,1669,5587,27,318,15,12
58103,51266,16103,36869,16103,70,70,0,1,5,1,0
58104,52640,6881,33244,6881,719,413,306,10,14,5,5
58105,65067,53,43932,53,411,115,296,4,38,2,2
58106,52087,443,46518,443,5780,1646,4134,22,15,11,11
58107,37433,443,8364,443,8641,955,7686,19,259,8,11
58108,53521,443,50004,443,130,70,60,2,15,1,1
58109,57948,443,32601,443,5914,1514,4400,23,15,12,11
58110,56609,80,38761,80,234,234,0,4,12,4,0
58111,37385,443,16177,443,8824,2041,6783,34,255,17,17
58112,59936,443,17847,443,34167,3638,30529,50,200,23,27
58113,65048,53,15306,53,297,96,201,4,42,2,2
58114,64680,53,61021,53,808,272,536,8,78,4,4
58115,56932,53,43209,53,172,94,78,2,29,1,1
58116,64811,53,37013,53,193,102,91,2,29,1,1
58117,49635,53,38499,53,210,110,100,2,29,1,1
58118,50688,80,50688,80,167293,8028,159265,186,26,68,118
58119,46625,80,46625,80,51574,3466,48108,63,156,23,40
58120,46899,80,46899,80,82739,3221,79518,91,156,28,63
58121,49845,443,22803,443,10396,4585,5811,38,54,21,17
58122,55664,53,1350,53,195,102,93,2,30,1,1
58123,65159,53,25271,53,286,103,183,4,52,2,2
58124,56326,53,1837,53,177,94,83,2,29,1,1
58125,65115,53,24571,53,193,102,91,2,29,1,1
58126,49945,53,14331,53,281,97,184,4,56,2,2
58127,64706,53,11232,53,179,94,85,2,29,1,1
58128,49099,53,46349,53,238,94,144,2,30,1,1
58129,49297,53,44299,53,183,94,89,2,30,1,1
58130,1926,53,62848,53,210,78,132,2,30,1,1
58131,49589,53,21247,53,198,94,104,2,30,1,1
58132,64726,53,24139,53,178,94,84,2,30,1,1
58133,65186,27126,54671,27126,268,78,190,2,30,1,1
58134,65183,27126,22289,27126,268,78,190,2,30,1,1
58135,49378,53,33691,53,179,86,93,2,30,1,1
58136,50791,53,50791,53,231,90,141,2,30,1,1
58137,48817,64245,48817,64245,481,150,331,2,1200,1,1
58138,57338,80,37762,80,1420,715,705,12,16,7,5
58139,50367,53,53044,53,821,102,719,2,30,1,1
58140,64914,53,55728,53,168,86,82,2,30,1,1
58141,64546,53,29110,53,183,94,89,2,30,1,1
58142,64706,53,5159,53,179,94,85,2,30,1,1
58143,59848,53,28215,53,239,102,137,2,30,1,1
58144,56320,53,53146,53,183,94,89,2,30,1,1
58145,64689,53,60672,53,183,94,89,2,30,1,1
58146,64811,53,21833,53,193,102,91,2,30,1,1
58147,49418,27015,32814,27015,257,78,179,2,30,1,1
58148,59810,443,31870,443,27370,17071,10299,51,30,26,25
58149,53114,32975,31768,32975,70,70,0,2,8,2,0
58150,61716,80,3411,80,9323,5142,4181,23,20,12,11
58151,53108,7003,16327,7003,512,326,186,9,22,6,3
58152,65468,443,32669,443,421329,12430,408899,433,16,152,281
58153,65451,53,45725,53,178,94,84,2,30,1,1
58154,52483,443,4472,443,12863,8410,4453,22,31,13,9
58155,64726,53,25224,53,178,94,84,2,30,1,1
58156,50386,8080,50386,8080,5533,2632,2901,20,46,12,8
58157,64706,53,6789,53,179,94,85,2,30,1,1
58158,64850,53,16958,53,196,102,94,2,30,1,1
58159,64823,53,51719,53,199,102,97,2,30,1,1
58160,49418,27016,64137,27016,270,78,192,2,30,1,1
58161,56376,53,35947,53,198,102,96,2,30,1,1
58162,64608,53,18292,53,212,110,102,2,30,1,1
58163,42112,443,17056,443,11459,2165,9294,29,259,11,18
58164,56773,28093,43311,28093,70,70,0,1,5,1,0
58165,46624,80,46624,80,34504,2526,31978,45,156,16,29
58166,6712,80,6712,80,514,246,268,9,82,5,4
58167,1925,53,9734,53,210,78,132,2,30,1,1
58168,1923,53,53314,53,260,86,174,2,30,1,1
58169,49667,53,65184,53,448,184,264,6,30,3,3
58170,65185,27126,57830,27126,268,78,190,2,30,1,1
58171,65126,53,60546,53,718,94,624,2,30,1,1
58172,58873,53,50618,53,168,78,90,2,30,1,1
58173,65513,53,15039,53,195,102,93,2,31,1,1
58174,58499,123,31733,123,184,94,90,2,30,1,1
58175,48040,53,11212,53,168,78,90,2,30,1,1
58176,64322,53,52794,53,250,94,156,2,30,1,1
58177,49418,27015,15763,27015,248,78,170,2,30,1,1
58178,56376,53,49970,53,198,102,96,2,31,1,1
58179,56458,53,9119,53,196,102,94,2,31,1,1
58180,34726,53,62948,53,168,78,90,2,30,1,1
58181,56953,443,22328,443,7245,1282,5963,16,135,7,9
58182,64517,53,39078,53,194,102,92,2,31,1,1
58183,65167,443,56897,443,4925,2188,2737,36,360,16,20
58184,44847,6882,30467,6882,502,150,352,2,1200,1,1
58185,55877,39578,13811,39578,150,150,0,1,1200,1,0
58186,64997,53,57263,53,166,86,80,2,31,1,1
58187,65532,53,33764,53,196,102,94,2,30,1,1
58188,49566,53,59606,53,200,94,106,2,30,1,1
58189,39785,443,37102,443,7967,2261,5706,18,121,8,10
58190,46013,80,29418,80,134,60,74,3,6,2,1
58191,52034,80,13450,80,4185,3462,723,14,16,7,7
58192,49828,443,20161,443,5927,1644,4283,18,16,10,8
58193,64139,53,9779,53,498,93,405,4,47,2,2
58194,65011,53,37444,53,183,94,89,2,31,1,1
58195,53575,1025,56604,1025,70,70,0,2,8,2,0
58196,50334,53,13800,53,216,110,106,2,30,1,1
58197,65187,27126,30981,27126,268,78,190,2,30,1,1
58198,49893,443,25504,443,617481,41514,575967,856,221,381,475
58199,65371,53,53875,53,356,101,255,4,55,2,2
58200,57221,443,19947,443,7306,2784,4522,22,202,12,10
58201,43895,443,52101,443,1442,721,721,15,199,8,7
58202,55730,53,15730,53,196,102,94,2,30,1,1
58203,64619,53,62516,53,229,94,135,2,30,1,1
58204,65371,53,17018,53,199,102,97,2,30,1,1
58205,52420,445,0,0,66,66,0,1,0,1,0
58206,64776,50584,0,0,62,62,0,1,0,1,0
58207,51992,445,0,0,70,70,0,1,0,1,0
58208,51991,445,0,0,70,70,0,1,0,1,0
58209,19747,37965,0,0,62,62,0,1,0,1,0
58210,57441,57470,0,0,66,66,0,1,0,1,0
58211,56996,445,0,0,70,70,0,1,0,1,0
58212,56993,445,0,0,70,70,0,1,0,1,0
58213,56990,445,0,0,70,70,0,1,0,1,0
58214,56991,445,0,0,70,70,0,1,0,1,0
58215,52472,7302,0,0,66,66,0,1,0,1,0
58216,38848,11119,0,0,146,146,0,1,0,1,0
58217,52415,445,0,0,66,66,0,1,0,1,0
58218,51987,445,0,0,70,70,0,1,0,1,0
58219,53447,44847,0,0,66,66,0,1,0,1,0
58220,61983,50432,0,0,66,66,0,1,0,1,0
58221,52407,445,0,0,66,66,0,1,0,1,0
58222,52412,445,0,0,66,66,0,1,0,1,0
58223,52406,445,0,0,66,66,0,1,0,1,0
58224,59701,44847,0,0,66,66,0,1,0,1,0
58225,20650,26467,0,0,62,62,0,1,0,1,0
58226,52403,445,0,0,66,66,0,1,0,1,0
58227,52405,445,0,0,66,66,0,1,0,1,0
58228,52404,445,0,0,66,66,0,1,0,1,0
58229,51985,445,0,0,70,70,0,1,0,1,0
58230,1227,56205,0,0,66,66,0,1,0,1,0
58231,56987,445,0,0,70,70,0,1,0,1,0
58232,56986,445,0,0,70,70,0,1,0,1,0
58233,56984,445,0,0,70,70,0,1,0,1,0
58234,54140,43890,0,0,66,66,0,1,0,1,0
58235,52439,35894,0,0,70,70,0,1,0,1,0
58236,9092,26672,0,0,60,60,0,1,0,1,0
58237,52399,445,0,0,66,66,0,1,0,1,0
58238,56980,445,0,0,70,70,0,1,0,1,0
58239,51981,445,0,0,70,70,0,1,0,1,0
58240,58248,50584,0,0,62,62,0,1,0,1,0
58241,55074,53,55407,53,770,101,669,2,0,1,1
58242,52397,445,0,0,66,66,0,1,0,1,0
58243,4903,42873,0,0,70,70,0,1,0,1,0
58244,80,37649,0,0,60,60,0,1,0,1,0
58245,52395,445,0,0,66,66,0,1,0,1,0
58246,52393,445,0,0,66,66,0,1,0,1,0
58247,27010,64147,0,0,62,62,0,1,0,1,0
58248,46587,57470,0,0,66,66,0,1,0,1,0
58249,80,53945,0,0,60,60,0,1,0,1,0
58250,63305,62413,0,0,66,66,0,1,0,1,0
58251,52391,445,0,0,66,66,0,1,0,1,0
58252,28839,30188,0,0,62,62,0,1,0,1,0
58253,17315,11392,0,0,66,66,0,1,0,1,0
58254,59411,37965,0,0,62,62,0,1,0,1,0
58255,56973,445,0,0,70,70,0,1,0,1,0
58256,10248,21247,0,0,62,62,0,1,0,1,0
58257,80,9918,0,0,60,60,0,1,0,1,0
58258,14397,37965,0,0,62,62,0,1,0,1,0
58259,56968,445,0,0,70,70,0,1,0,1,0
58260,56965,445,0,0,70,70,0,1,0,1,0
58261,52208,43890,0,0,62,62,0,1,0,1,0
58262,38976,46824,0,0,62,62,0,1,0,1,0
58263,54305,35440,0,0,62,62,0,1,0,1,0
58264,26722,11446,0,0,66,66,0,1,0,1,0
58265,51968,445,0,0,70,70,0,1,0,1,0
58266,63314,57470,0,0,66,66,0,1,0,1,0
58267,52383,445,0,0,66,66,0,1,0,1,0
58268,16293,57470,0,0,62,62,0,1,0,1,0
58269,51965,445,0,0,70,70,0,1,0,1,0
58270,44538,50584,0,0,62,62,0,1,0,1,0
58271,40547,24051,0,0,74,74,0,1,0,1,0
58272,59940,50584,0,0,66,66,0,1,0,1,0
58273,52373,445,0,0,66,66,0,1,0,1,0
58274,33931,50584,0,0,62,62,0,1,0,1,0
58275,65060,35440,0,0,66,66,0,1,0,1,0
58276,56952,445,0,0,70,70,0,1,0,1,0
58277,9957,32480,0,0,66,66,0,1,0,1,0
58278,38645,51221,0,0,62,62,0,1,0,1,0
58279,53437,44847,0,0,66,66,0,1,0,1,0
58280,51961,445,0,0,70,70,0,1,0,1,0
58281,26365,22,0,0,60,60,0,1,0,1,0
58282,55749,37965,0,0,66,66,0,1,0,1,0
58283,33979,23,0,0,60,60,0,1,0,1,0
58284,18545,23,0,0,60,60,0,1,0,1,0
58285,51959,445,0,0,70,70,0,1,0,1,0
58286,46093,32661,0,0,74,74,0,1,0,1,0
58287,52370,445,0,0,66,66,0,1,0,1,0
58288,30129,37965,0,0,72,72,0,1,0,1,0
58289,62804,37965,0,0,66,66,0,1,0,1,0
58290,0,0,0,0,156,156,0,2,0,2,0
58291,0,0,0,0,244,244,0,2,0,2,0
58292,51957,445,0,0,70,70,0,1,0,1,0
58293,64948,25198,0,0,145,145,0,1,0,1,0
58294,8211,28793,0,0,66,66,0,1,0,1,0
58295,53300,37807,0,0,62,62,0,1,0,1,0
58296,60188,15503,0,0,66,66,0,1,0,1,0
58297,52364,445,0,0,66,66,0,1,0,1,0
58298,65512,44847,0,0,66,66,0,1,0,1,0
58299,52361,445,0,0,66,66,0,1,0,1,0
58300,55937,53,29379,53,174,89,85,2,0,1,1
58301,34531,23117,0,0,62,62,0,1,0,1,0
58302,25602,64147,0,0,62,62,0,1,0,1,0
58303,51760,50584,0,0,66,66,0,1,0,1,0
58304,51244,3855,0,0,100,100,0,1,0,1,0
58305,51815,51221,0,0,74,74,0,1,0,1,0
58306,59055,11392,0,0,66,66,0,1,0,1,0
58307,43129,20220,0,0,62,62,0,1,0,1,0
58308,51950,445,0,0,70,70,0,1,0,1,0
58309,6889,48817,0,0,143,143,0,1,0,1,0
58310,51948,445,0,0,70,70,0,1,0,1,0
58311,25091,64147,0,0,66,66,0,1,0,1,0
58312,49628,35440,0,0,66,66,0,1,0,1,0
58313,59128,44847,0,0,66,66,0,1,0,1,0
58314,56945,445,0,0,70,70,0,1,0,1,0
58315,63701,46824,0,0,66,66,0,1,0,1,0
58316,56941,445,0,0,70,70,0,1,0,1,0
58317,56940,445,0,0,70,70,0,1,0,1,0
58318,51947,445,0,0,70,70,0,1,0,1,0
58319,21733,56205,0,0,66,66,0,1,0,1,0
58320,52347,445,0,0,66,66,0,1,0,1,0
58321,52346,445,0,0,66,66,0,1,0,1,0
58322,52345,445,0,0,66,66,0,1,0,1,0
58323,52342,445,0,0,66,66,0,1,0,1,0
58324,52341,445,0,0,66,66,0,1,0,1,0
58325,52344,445,0,0,66,66,0,1,0,1,0
58326,52348,445,0,0,66,66,0,1,0,1,0
58327,52340,445,0,0,66,66,0,1,0,1,0
58328,51946,445,0,0,70,70,0,1,0,1,0
58329,51945,445,0,0,70,70,0,1,0,1,0
58330,50084,26672,0,0,62,62,0,1,0,1,0
58331,51941,445,0,0,70,70,0,1,0,1,0
58332,51939,445,0,0,70,70,0,1,0,1,0
58333,45079,31573,0,0,66,66,0,1,0,1,0
58334,42632,44847,0,0,62,62,0,1,0,1,0
58335,57654,35440,0,0,66,66,0,1,0,1,0
58336,49976,22114,0,0,66,66,0,1,0,1,0
58337,51927,445,0,0,70,70,0,1,0,1,0
58338,51926,445,0,0,70,70,0,1,0,1,0
58339,15131,50584,0,0,62,62,0,1,0,1,0
58340,51923,445,0,0,70,70,0,1,0,1,0
58341,51914,445,0,0,70,70,0,1,0,1,0
58342,51913,445,0,0,70,70,0,1,0,1,0
58343,59732,443,44274,443,34866,3347,31519,55,54,22,33
58344,53572,22754,38870,22754,70,70,0,2,8,2,0
58345,46714,80,46714,80,83777,2610,81167,90,155,27,63
58346,59407,443,31789,443,3298,2132,1166,16,15,8,8
58347,3697,80,55800,80,6688,1208,5480,20,104,12,8
58348,65011,53,38944,53,182,93,89,2,30,1,1
58349,56769,11155,5156,11155,66,66,0,1,5,1,0
58350,51746,17867,44740,17867,136,136,0,3,14,3,0
58351,49768,80,40790,80,254,128,126,5,15,3,2
58352,49825,443,10152,443,15401,3011,12390,37,65,21,16
58353,44796,443,34897,443,8158,2927,5231,25,85,15,10
58354,44776,443,54500,443,10087,4073,6014,33,88,18,15
58355,56628,53,54812,53,789,110,679,2,30,1,1
58356,49580,53,21716,53,192,98,94,2,30,1,1
58357,48790,443,60676,443,7298,2661,4637,21,19,11,10
58358,59405,443,60870,443,9052,2120,6932,28,23,14,14
58359,64613,53,26326,53,89,89,0,1,30,1,0
58360,58006,443,30394,443,9596,1688,7908,26,255,13,13
58361,56598,443,16755,443,8630,2126,6504,20,15,11,9
58362,40764,443,58656,443,3321,1297,2024,13,28,7,6
58363,57064,443,57064,443,4378,1471,2907,19,29,11,8
58364,33317,53,33317,53,231,88,143,2,32,1,1
58365,59795,443,6313,443,120014,7352,112662,155,37,64,91
58366,52458,53,52458,53,231,88,143,2,33,1,1
58367,51765,52862,26786,52862,70,70,0,2,7,2,0
58368,51747,54301,33615,54301,136,136,0,3,14,3,0
58369,53557,39731,45884,39731,70,70,0,1,5,1,0
58370,51145,80,27456,80,78198970,2041652,76157318,79332,368,28698,50634
58371,42105,53,20788,53,168,78,90,2,30,1,1
58372,56597,443,58985,443,8700,2196,6504,21,16,12,9
58373,50317,443,44223,443,13565,6019,7546,35,112,19,16
58374,54506,443,29033,443,89702,83941,5761,91,181,66,25
58375,56857,53,30246,53,711,87,624,2,30,1,1
58376,59340,53,59340,53,215,90,125,2,30,1,1
58377,49996,53,3392,53,182,93,89,2,31,1,1
58378,49418,27015,26473,27015,280,71,209,2,31,1,1
58379,55577,53,64711,53,198,101,97,2,31,1,1
58380,59408,443,57336,443,2914,1780,1134,16,15,8,8
58381,51649,80,42317,80,1965,1402,563,13,16,7,6
58382,50116,22,50116,22,60,60,0,1,5,1,0
58383,40408,1488,40408,1488,156,156,0,3,8,3,0
58384,59808,443,39380,443,23950,2135,21815,43,35,16,27
58385,52920,443,42636,443,6253,2132,4121,19,16,10,9
58386,59847,443,63269,443,21180,2662,18518,34,17,14,20
58387,59788,443,40327,443,134688,7027,127661,166,37,64,102
58388,65312,53,47796,53,180,92,88,2,30,1,1
58389,49418,27015,16562,27015,269,71,198,2,31,1,1
58390,49418,27018,39372,27018,259,71,188,2,31,1,1
58391,52060,443,18866,443,40726,3421,37305,52,121,20,32
58392,60730,443,28797,443,14776,5238,9538,41,175,21,20
58393,55088,53,2549,53,186,95,91,2,31,1,1
58394,51135,443,21022,443,640504,257235,383269,1476,797,643,833
58395,44219,443,26012,443,35920,26656,9264,60,128,30,30
58396,40893,123,36091,123,184,94,90,2,31,1,1
58397,49418,27018,26196,27018,71,71,0,1,31,1,0
58398,49418,27017,43664,27017,259,71,188,2,31,1,1
58399,49418,27018,46953,27018,249,71,178,2,31,1,1
58400,57949,5228,62651,5228,2655,1540,1115,19,3601,9,10
58401,54316,53,0,0,325,77,248,2,31,1,1
58402,49418,27020,19032,27020,246,71,175,2,31,1,1
58403,49418,27015,41865,27015,242,71,171,2,31,1,1
58404,49418,27014,49598,27014,235,71,164,2,31,1,1
58405,42071,443,52227,443,9366,5830,3536,23,121,12,11
58406,1987,26467,0,0,62,62,0,1,0,1,0
58407,56939,445,0,0,70,70,0,1,0,1,0
58408,56937,445,0,0,70,70,0,1,0,1,0
58409,56926,445,0,0,70,70,0,1,0,1,0
58410,38633,51221,0,0,66,66,0,1,0,1,0
58411,46849,36237,0,0,62,62,0,1,0,1,0
58412,61013,41705,0,0,66,66,0,1,0,1,0
58413,52326,445,0,0,66,66,0,1,0,1,0
58414,52328,445,0,0,66,66,0,1,0,1,0
58415,52327,445,0,0,66,66,0,1,0,1,0
58416,56922,445,0,0,70,70,0,1,0,1,0
58417,25536,50584,0,0,62,62,0,1,0,1,0
58418,49418,27015,24745,27015,270,78,192,2,30,1,1
58419,65463,53,50986,53,177,94,83,2,30,1,1
58420,46275,64147,0,0,62,62,0,1,0,1,0
58421,56920,445,0,0,70,70,0,1,0,1,0
58422,51902,445,0,0,70,70,0,1,0,1,0
58423,33292,50584,0,0,66,66,0,1,0,1,0
58424,39165,23,0,0,60,60,0,1,0,1,0
58425,56911,445,0,0,70,70,0,1,0,1,0
58426,56912,445,0,0,70,70,0,1,0,1,0
58427,56908,445,0,0,70,70,0,1,0,1,0
58428,58022,5555,0,0,60,60,0,1,0,1,0
58429,34489,35440,0,0,66,66,0,1,0,1,0
58430,51999,37965,0,0,62,62,0,1,0,1,0
58431,30084,21247,0,0,146,146,0,1,0,1,0
58432,19610,9571,0,0,62,62,0,1,0,1,0
58433,26324,30188,0,0,62,62,0,1,0,1,0
58434,51895,445,0,0,70,70,0,1,0,1,0
58435,38980,17,0,0,60,60,0,1,0,1,0
58436,80,37649,0,0,60,60,0,1,0,1,0
58437,52975,23718,0,0,62,62,0,1,0,1,0
58438,56458,53,38538,53,196,102,94,2,30,1,1
58439,64997,53,25843,53,166,86,80,2,30,1,1
58440,38604,53,38604,53,203,82,121,2,30,1,1
58441,50089,443,48630,443,12446,2347,10099,44,190,23,21
58442,60747,40010,30374,40010,316,136,180,6,6,3,3
58443,53571,19636,50196,19636,70,70,0,2,7,2,0
58444,49216,53,31679,53,789,110,679,2,29,1,1
58445,49418,27025,65106,27025,240,78,162,2,30,1,1
58446,57968,443,57498,443,6254,1581,4673,21,190,12,9
58447,51062,80,29351,80,36568,23029,13539,94,194,47,47
58448,55084,443,37269,443,5556,1438,4118,22,196,12,10
58449,38570,443,8181,443,6260,1587,4673,21,191,12,9
58450,44099,443,28525,443,6235,1562,4673,21,191,12,9
58451,65513,53,57723,53,195,102,93,2,29,1,1
58452,53559,58968,6999,58968,70,70,0,1,4,1,0
58453,63769,47661,30265,47661,66,66,0,2,7,2,0
58454,53895,53,0,0,86,86,0,1,29,1,0
58455,56215,53,45300,53,168,78,90,2,29,1,1
58456,63771,7426,29432,7426,66,66,0,2,7,2,0
58457,65188,27126,32293,27126,268,78,190,2,29,1,1
58458,14430,443,35759,443,2629,1470,1159,18,15,8,10
58459,64355,53,49915,53,402,118,284,2,29,1,1
58460,47739,53,26929,53,168,78,90,2,29,1,1
58461,56418,53,6346,53,183,94,89,2,29,1,1
58462,64645,53,50507,53,391,96,295,4,49,2,2
58463,56239,53,9531,53,179,86,93,2,29,1,1
58464,56288,53,34669,53,183,94,89,2,30,1,1
58465,65184,27126,4649,27126,268,78,190,2,29,1,1
58466,65463,53,23022,53,177,94,83,2,30,1,1
58467,49418,23010,54751,23010,288,78,210,2,30,1,1
58468,56845,53,40181,53,730,102,628,2,30,1,1
58469,49418,27400,52679,27400,78,78,0,1,30,1,0
58470,40215,443,8042,443,6423,1543,4880,21,191,12,9
58471,51766,48169,62941,48169,70,70,0,2,7,2,0
58472,56924,53,7241,53,216,110,106,2,30,1,1
58473,64527,53,58780,53,228,102,126,2,30,1,1
58474,64871,53,62774,53,263,94,169,2,31,1,1
58475,49418,27017,57316,27017,262,78,184,2,30,1,1
58476,49418,27118,47467,27118,78,78,0,1,30,1,0
58477,49918,443,49171,443,10385,3107,7278,28,16,16,12
58478,32160,53,32160,53,233,90,143,2,32,1,1
58479,51988,53,22023,53,78,78,0,1,30,1,0
58480,41907,53,41907,53,233,90,143,2,33,1,1
58481,49418,27015,40892,27015,250,78,172,2,30,1,1
58482,18837,53,18837,53,233,90,143,2,32,1,1
58483,53551,60444,1391,60444,492,306,186,8,15,5,3
58484,56509,80,38678,80,3697,832,2865,12,15,7,5
58485,35374,443,7317,443,1558,971,587,14,123,8,6
58486,36682,80,24588,80,130,70,60,2,15,1,1
58487,56114,53,2423,53,216,110,106,2,30,1,1
58488,63128,443,30036,443,4994,379,4615,9,15,4,5
58489,44211,53,44211,53,850,114,736,2,30,1,1
58490,65312,53,52827,53,182,94,88,2,30,1,1
58491,65312,53,55577,53,182,94,88,2,30,1,1
58492,57132,53,36267,53,177,94,83,2,30,1,1
58493,56458,53,47423,53,196,102,94,2,30,1,1
58494,57321,53,18718,53,199,102,97,2,30,1,1
58495,51550,53,60452,53,168,78,90,2,30,1,1
58496,37696,443,12389,443,32798,2912,29886,58,170,29,29
58497,56770,52920,10024,52920,70,70,0,1,5,1,0
58498,64145,53,5953,53,504,105,399,4,35,2,2
58499,49230,443,49230,443,123041,10988,112053,185,67,86,99
58500,65372,53,40284,53,198,102,96,2,30,1,1
58501,49301,53,20768,53,214,102,112,2,30,1,1
58502,44116,123,64380,123,184,94,90,2,30,1,1
58503,64840,53,3676,53,193,102,91,2,30,1,1
58504,56924,53,61139,53,216,110,106,2,30,1,1
58505,64281,53,41166,53,492,90,402,4,45,2,2
58506,39042,443,60755,443,3589,1251,2338,15,20,9,6
58507,57321,53,57606,53,199,102,97,2,30,1,1
58508,65312,53,9346,53,182,94,88,2,30,1,1
58509,57367,53,52070,53,177,94,83,2,30,1,1
58510,50550,443,42250,443,8123,1809,6314,22,71,12,10
58511,43893,443,47910,443,1440,719,721,15,198,8,7
58512,49774,443,43328,443,8130,2220,5910,23,16,13,10
58513,36258,443,41571,443,1128432,47396,1081036,1242,142,458,784
58514,3688,80,37150,80,7072,1145,5927,20,105,12,8
58515,53570,24874,32383,24874,70,70,0,2,7,2,0
58516,41210,443,11454,443,234,234,0,4,11,4,0
58517,49418,27015,12745,27015,227,78,149,2,30,1,1
58518,65467,443,32500,443,92244,4799,87445,107,15,43,64
58519,52795,443,15981,443,1444,723,721,15,198,8,7
58520,51105,80,8408,80,366,240,126,7,20,5,2
58521,46989,80,46989,80,82082,3212,78870,90,155,27,63
58522,53556,1024,47936,1024,70,70,0,1,4,1,0
58523,51764,33432,19826,33432,70,70,0,2,8,2,0
58524,46053,443,15914,443,6999,1563,5436,18,186,3,15
58525,53553,2297,50955,2297,70,70,0,1,4,1,0
58526,63768,55755,28718,55755,66,66,0,2,7,2,0
58527,53111,50809,43690,50809,70,70,0,1,4,1,0
58528,52459,33899,52459,33899,66,66,0,1,5,1,0
58529,49418,53,51153,53,379,93,286,4,37,2,2
58530,53576,23505,43782,23505,70,70,0,2,7,2,0
58531,55612,36239,64723,36239,320,140,180,6,5,3,3
58532,30296,53,30296,53,233,90,143,2,33,1,1
58533,35373,443,52870,443,255313,6947,248366,253,123,74,179
58534,46910,443,1706,443,5714,1536,4178,24,21,13,11
58535,51221,64509,12506,64509,3564,3564,0,55,4073,55,0
58536,55730,53,1752,53,819,102,717,2,29,1,1
58537,57731,443,57731,443,5508,2261,3247,22,38,13,9
58538,50334,53,27323,53,216,110,106,2,29,1,1
58539,64811,53,25235,53,193,102,91,2,29,1,1
58540,56114,53,59313,53,216,110,106,2,30,1,1
58541,64517,53,41974,53,194,102,92,2,29,1,1
58542,64877,53,24531,53,309,110,199,2,30,1,1
58543,50164,53,36057,53,260,86,174,2,29,1,1
58544,64580,53,58796,53,200,94,106,2,30,1,1
58545,52652,443,42861,443,283768,16167,267601,384,116,148,236
58546,56924,53,48740,53,216,110,106,2,30,1,1
58547,56431,53,52567,53,323,110,213,2,30,1,1
58548,51120,443,19662,443,2940,787,2153,11,119,5,6
58549,37472,443,30492,443,17764,5080,12684,46,121,22,24
58550,49418,27015,51226,27015,274,78,196,2,30,1,1
58551,49418,27018,13297,27018,259,78,181,2,30,1,1
58552,64320,53,48665,53,199,102,97,2,30,1,1
58553,49418,27018,36116,27018,256,78,178,2,30,1,1
58554,65011,53,28977,53,183,94,89,2,31,1,1
58555,49418,27015,50232,27015,286,78,208,2,31,1,1
58556,35005,53,35005,53,233,90,143,2,33,1,1
58557,24276,53,24276,53,233,90,143,2,33,1,1
58558,56771,43648,21453,43648,70,70,0,1,5,1,0
58559,58552,443,44204,443,28468,2316,26152,43,42,15,28
58560,58541,28678,6280,28678,1806,1806,0,22,224,22,0
58561,51747,7000,51747,7000,3132,815,2317,14,15,7,7
58562,55577,53,12118,53,199,102,97,2,30,1,1
58563,49827,443,50182,443,5863,1580,4283,17,15,9,8
58564,3694,80,3582,80,6919,1220,5699,20,104,12,8
58565,8168,80,8168,80,282487,10736,271751,315,52,124,191
58566,64275,53,2712,53,644,198,446,6,48,3,3
58567,57132,53,31918,53,177,94,83,2,30,1,1
58568,55577,53,47306,53,199,102,97,2,30,1,1
58569,65443,53,31902,53,730,102,628,2,30,1,1
58570,49418,27200,10128,27200,78,78,0,1,30,1,0
58571,55788,53,26476,53,231,110,121,2,30,1,1
58572,49418,27015,52335,27015,295,78,217,2,30,1,1
58573,51715,443,60037,443,4887,2346,2541,16,120,8,8
58574,53888,443,42576,443,8935,4627,4308,22,121,12,10
58575,49418,27015,20814,27015,249,78,171,2,30,1,1
58576,48233,443,29829,443,9759,3896,5863,28,230,15,13
58577,3691,80,6351,80,6826,1214,5612,20,105,12,8
58578,65372,53,29268,53,198,102,96,2,30,1,1
58579,49996,53,62453,53,183,94,89,2,30,1,1
58580,49580,53,4352,53,196,102,94,2,30,1,1
58581,49580,53,60391,53,196,102,94,2,30,1,1
58582,49418,27017,6721,27017,300,78,222,2,30,1,1
58583,49418,27015,7927,27015,295,78,217,2,31,1,1
58584,49418,27018,21489,27018,255,78,177,2,31,1,1
58585,15503,56331,21797,56331,481,150,331,2,1200,1,1
58586,57470,52339,38751,52339,594,594,0,10,1199,10,0
58587,49418,27017,9977,27017,260,78,182,2,31,1,1
58588,49418,52013,42400,52013,278,78,200,2,31,1,1
58589,49418,27016,31344,27016,250,78,172,2,31,1,1
58590,53541,443,39871,443,10583,1889,8694,28,251,10,18
58591,57470,53377,9260,53377,594,594,0,10,1199,10,0
58592,45294,443,12924,443,6290,4832,1458,18,120,11,7
58593,49759,53,30943,53,216,110,106,2,31,1,1
58594,49418,27017,45242,27017,259,78,181,2,31,1,1
58595,57268,443,29567,443,11546,3604,7942,38,120,20,18
58596,49418,27017,22257,27017,271,78,193,2,31,1,1
58597,49418,27018,42742,27018,274,78,196,2,31,1,1
58598,55461,443,1970,443,6314,4856,1458,18,120,11,7
58599,64336,443,26343,443,10099,4296,5803,30,124,13,17
58600,49418,27035,7817,27035,250,78,172,2,31,1,1
58601,64613,53,60043,53,179,94,85,2,30,1,1
58602,57661,53,46284,53,70,70,0,1,30,1,0
58603,49418,27015,20912,27015,302,78,224,2,30,1,1
58604,49418,27016,50703,27016,258,78,180,2,31,1,1
58605,55593,80,19208,80,3276,404,2872,11,15,5,6
58606,51104,80,56002,80,1524,1028,496,10,21,7,3
58607,34217,443,35043,443,6650,1556,5094,23,18,13,10
58608,65318,80,50736,80,2356,499,1857,10,134,6,4
58609,64613,53,44378,53,179,94,85,2,30,1,1
58610,49418,27016,1873,27016,281,78,203,2,31,1,1
58611,65449,53,65266,53,507,193,314,6,57,3,3
58612,55608,17425,43686,17425,320,140,180,6,7,3,3
58613,39799,443,18557,443,5597,3595,2002,42,68,23,19
58614,55577,53,3000,53,699,204,495,6,57,3,3
58615,5115,53,5115,53,216,90,126,2,30,1,1
58616,55519,53,47075,53,193,102,91,2,30,1,1
58617,57271,53,58158,53,288,94,194,2,30,1,1
58618,6666,8888,0,0,60,60,0,1,0,1,0
58619,80,53945,0,0,60,60,0,1,0,1,0
58620,50422,50584,0,0,62,62,0,1,0,1,0
58621,51887,445,0,0,70,70,0,1,0,1,0
58622,51886,445,0,0,70,70,0,1,0,1,0
58623,56901,445,0,0,70,70,0,1,0,1,0
58624,56900,445,0,0,70,70,0,1,0,1,0
58625,56896,445,0,0,70,70,0,1,0,1,0
58626,80,9918,0,0,60,60,0,1,0,1,0
58627,59943,37807,0,0,146,146,0,1,0,1,0
58628,51880,445,0,0,70,70,0,1,0,1,0
58629,51881,445,0,0,70,70,0,1,0,1,0
58630,51877,445,0,0,70,70,0,1,0,1,0
58631,16393,22114,0,0,66,66,0,1,0,1,0
58632,60960,49049,0,0,62,62,0,1,0,1,0
58633,62930,21247,0,0,66,66,0,1,0,1,0
58634,30920,64147,0,0,62,62,0,1,0,1,0
58635,64982,50584,0,0,146,146,0,1,0,1,0
58636,34228,45129,0,0,148,148,0,1,0,1,0
58637,6881,6881,0,0,62,62,0,1,0,1,0
58638,54062,31573,0,0,66,66,0,1,0,1,0
58639,50181,64147,0,0,66,66,0,1,0,1,0
58640,52303,445,0,0,66,66,0,1,0,1,0
58641,56895,445,0,0,70,70,0,1,0,1,0
58642,56894,445,0,0,70,70,0,1,0,1,0
58643,51872,445,0,0,70,70,0,1,0,1,0
58644,3270,35440,0,0,66,66,0,1,0,1,0
58645,48478,49903,0,0,62,62,0,1,0,1,0
58646,51864,445,0,0,70,70,0,1,0,1,0
58647,34916,51185,0,0,62,62,0,1,0,1,0
58648,51861,445,0,0,70,70,0,1,0,1,0
58649,52298,445,0,0,66,66,0,1,0,1,0
58650,38053,50584,0,0,146,146,0,1,0,1,0
58651,35657,48637,0,0,62,62,0,1,0,1,0
58652,25523,35974,0,0,62,62,0,1,0,1,0
58653,52296,445,0,0,66,66,0,1,0,1,0
58654,56881,445,0,0,70,70,0,1,0,1,0
58655,58598,50584,0,0,66,66,0,1,0,1,0
58656,56878,445,0,0,70,70,0,1,0,1,0
58657,56874,445,0,0,70,70,0,1,0,1,0
58658,56872,445,0,0,70,70,0,1,0,1,0
58659,443,43775,0,0,97,97,0,1,0,1,0
58660,49699,64147,0,0,66,66,0,1,0,1,0
58661,52294,445,0,0,66,66,0,1,0,1,0
58662,51858,445,0,0,70,70,0,1,0,1,0
58663,51856,445,0,0,70,70,0,1,0,1,0
58664,60923,49903,0,0,66,66,0,1,0,1,0
58665,62392,15503,0,0,62,62,0,1,0,1,0
58666,5575,8889,5575,8889,498,498,0,1,0,1,0
58667,9092,26672,0,0,60,60,0,1,0,1,0
58668,56869,445,0,0,70,70,0,1,0,1,0
58669,49664,37965,0,0,66,66,0,1,0,1,0
58670,24480,35440,0,0,66,66,0,1,0,1,0
58671,51852,445,0,0,70,70,0,1,0,1,0
58672,56865,445,0,0,70,70,0,1,0,1,0
58673,56864,445,0,0,70,70,0,1,0,1,0
58674,56861,445,0,0,70,70,0,1,0,1,0
58675,55296,23718,0,0,66,66,0,1,0,1,0
58676,52287,445,0,0,66,66,0,1,0,1,0
58677,47962,16069,0,0,62,62,0,1,0,1,0
58678,51851,445,0,0,70,70,0,1,0,1,0
58679,52282,445,0,0,66,66,0,1,0,1,0
58680,52283,445,0,0,66,66,0,1,0,1,0
58681,52280,445,0,0,66,66,0,1,0,1,0
58682,52276,445,0,0,66,66,0,1,0,1,0
58683,52277,445,0,0,66,66,0,1,0,1,0
58684,52275,445,0,0,66,66,0,1,0,1,0
58685,62452,21247,0,0,62,62,0,1,0,1,0
58686,64482,64147,0,0,66,66,0,1,0,1,0
58687,16387,26193,0,0,60,60,0,1,0,1,0
58688,16387,35308,0,0,60,60,0,1,0,1,0
58689,16387,56995,0,0,60,60,0,1,0,1,0
58690,23528,44847,0,0,146,146,0,1,0,1,0
58691,51846,445,0,0,70,70,0,1,0,1,0
58692,56860,445,0,0,70,70,0,1,0,1,0
58693,56858,445,0,0,70,70,0,1,0,1,0
58694,56854,445,0,0,70,70,0,1,0,1,0
58695,56967,35440,0,0,66,66,0,1,0,1,0
58696,61426,64910,0,0,66,66,0,1,0,1,0
58697,52273,445,0,0,66,66,0,1,0,1,0
58698,54339,23117,0,0,66,66,0,1,0,1,0
58699,56852,445,0,0,70,70,0,1,0,1,0
58700,52269,445,0,0,66,66,0,1,0,1,0
58701,52267,445,0,0,66,66,0,1,0,1,0
58702,52265,445,0,0,66,66,0,1,0,1,0
58703,37876,5900,0,0,60,60,0,1,0,1,0
58704,52263,445,0,0,66,66,0,1,0,1,0
58705,50668,58833,0,0,62,62,0,1,0,1,0
58706,30303,19391,0,0,181,181,0,1,0,1,0
58707,80,37649,0,0,60,60,0,1,0,1,0
58708,80,53945,0,0,60,60,0,1,0,1,0
58709,54471,36237,0,0,66,66,0,1,0,1,0
58710,56844,445,0,0,70,70,0,1,0,1,0
58711,33832,55108,0,0,148,148,0,1,0,1,0
58712,59918,44847,0,0,66,66,0,1,0,1,0
58713,51833,445,0,0,70,70,0,1,0,1,0
58714,43580,57470,0,0,145,145,0,1,0,1,0
58715,443,11135,0,0,66,66,0,1,0,1,0
58716,80,9918,0,0,60,60,0,1,0,1,0
58717,56836,445,0,0,70,70,0,1,0,1,0
58718,56837,445,0,0,70,70,0,1,0,1,0
58719,46557,57866,0,0,62,62,0,1,0,1,0
58720,63852,35440,0,0,66,66,0,1,0,1,0
58721,0,0,0,0,60,60,0,1,0,1,0
58722,48087,16069,0,0,66,66,0,1,0,1,0
58723,52255,445,0,0,66,66,0,1,0,1,0
58724,5223,44091,0,0,220,220,0,1,0,1,0
58725,34211,23,0,0,60,60,0,1,0,1,0
58726,52245,445,0,0,66,66,0,1,0,1,0
58727,50439,64147,0,0,66,66,0,1,0,1,0
58728,51826,445,0,0,70,70,0,1,0,1,0
58729,56825,445,0,0,70,70,0,1,0,1,0
58730,1024,64147,0,0,62,62,0,1,0,1,0
58731,51824,445,0,0,70,70,0,1,0,1,0
58732,42685,51180,0,0,62,62,0,1,0,1,0
58733,1431,30041,0,0,62,62,0,1,0,1,0
58734,51822,445,0,0,70,70,0,1,0,1,0
58735,39217,31573,0,0,146,146,0,1,0,1,0
58736,31748,56205,0,0,146,146,0,1,0,1,0
58737,13654,50584,0,0,62,62,0,1,0,1,0
58738,52243,445,0,0,66,66,0,1,0,1,0
58739,44491,50584,0,0,146,146,0,1,0,1,0
58740,40834,50584,0,0,62,62,0,1,0,1,0
58741,52236,445,0,0,66,66,0,1,0,1,0
58742,64890,51180,0,0,66,66,0,1,0,1,0
58743,52231,445,0,0,66,66,0,1,0,1,0
58744,24592,50584,0,0,62,62,0,1,0,1,0
58745,25880,44847,0,0,146,146,0,1,0,1,0
58746,51815,445,0,0,70,70,0,1,0,1,0
58747,60192,35440,0,0,62,62,0,1,0,1,0
58748,8976,44847,0,0,66,66,0,1,0,1,0
58749,51815,51221,0,0,74,74,0,1,0,1,0
58750,56327,44512,0,0,66,66,0,1,0,1,0
58751,51813,445,0,0,70,70,0,1,0,1,0
58752,49418,27016,14268,27016,236,71,165,2,30,1,1
58753,49418,27016,42028,27016,246,71,175,2,30,1,1
58754,49418,52013,5997,52013,257,71,186,2,30,1,1
58755,39396,443,4891,443,7531,2720,4811,24,331,13,11
58756,61459,80,3928,80,4671,2593,2078,15,85,9,6
58757,43106,443,35974,443,3259,1913,1346,18,16,8,10
58758,44740,443,62303,443,5954,1454,4500,22,142,13,9
58759,49418,27015,34023,27015,249,71,178,2,30,1,1
58760,49418,27015,33472,27015,71,71,0,1,30,1,0
58761,49418,27015,48509,27015,266,71,195,2,31,1,1
58762,49418,27013,52057,27013,230,71,159,2,31,1,1
58763,65339,53,50441,53,186,95,91,2,31,1,1
58764,49418,27019,50504,27019,71,71,0,1,30,1,0
58765,43105,443,31281,443,3115,1849,1266,18,16,8,10
58766,64992,53,63333,53,170,87,83,2,30,1,1
58767,49418,27016,27118,27016,231,71,160,2,30,1,1
58768,55231,443,25575,443,10684454,328574,10355880,11599,77,3693,7906
58769,65317,80,47905,80,1014,507,507,8,133,5,3
58770,55519,53,8879,53,186,95,91,2,30,1,1
58771,49418,27016,26293,27016,257,71,186,2,30,1,1
58772,51117,60038,0,0,66,66,0,1,90,1,0
58773,51101,80,9411,80,366,240,126,7,20,5,2
58774,53974,53,45539,53,578,286,292,9,15,5,4
58775,60022,443,60022,443,18674,1910,16764,32,18,17,15
58776,49759,53,28731,53,216,110,106,2,30,1,1
58777,50614,443,33140,443,3499,1732,1767,15,16,9,6
58778,50447,443,44649,443,12362,3372,8990,34,143,18,16
58779,49418,27017,46358,27017,252,71,181,2,30,1,1
58780,57367,53,62826,53,170,87,83,2,30,1,1
58781,45713,53,45713,53,217,87,130,2,30,1,1
58782,6354,53,6354,53,217,87,130,2,30,1,1
58783,49418,27019,38743,27019,251,71,180,2,30,1,1
58784,49418,27018,61835,27018,248,71,177,2,30,1,1
58785,51425,53,0,0,194,87,107,2,30,1,1
58786,49418,27016,46428,27016,249,71,178,2,30,1,1
58787,49418,27015,56301,27015,258,71,187,2,30,1,1
58788,49418,27017,12752,27017,283,71,212,2,31,1,1
58789,49418,27015,14381,27015,248,71,177,2,31,1,1
58790,51744,1678,56992,1678,66,66,0,1,5,1,0
58791,51341,7000,51341,7000,3132,815,2317,14,16,7,7
58792,51745,2572,3211,2572,66,66,0,1,5,1,0
58793,54631,443,58856,443,8367,3945,4422,81,616,42,39
58794,28470,80,28470,80,355544,12402,343142,378,26,134,244
58795,35647,3389,35647,3389,4575,2400,2175,20,18,11,9
58796,50496,443,2792,443,751676,8792,742884,617,16,123,494
58797,43230,80,43230,80,6776,692,6084,16,20,8,8
58798,64320,53,33961,53,198,101,97,2,30,1,1
58799,49418,27016,22907,27016,254,71,183,2,30,1,1
58800,10001,40041,23223,40041,151,89,62,2,30,1,1
58801,28858,80,28858,80,83253,4938,78315,99,26,39,60
58802,49418,27017,63792,27017,256,71,185,2,30,1,1
58803,53670,53,0,0,82,82,0,1,30,1,0
58804,29245,80,29245,80,27233,4047,23186,44,27,20,24
58805,49418,27017,33582,27017,71,71,0,1,30,1,0
58806,49418,27015,17910,27015,232,71,161,2,31,1,1
58807,63810,443,22948,443,8243,4867,3376,33,137,16,17
58808,62524,123,21935,123,184,94,90,2,31,1,1
58809,60354,443,37287,443,10223,3933,6290,49,115,22,27
58810,61143,443,58972,443,6391,3788,2603,14,121,7,7
58811,53442,443,36564,443,28728581,857403,27871178,29322,132,8944,20378
58812,61475,443,7125,443,198481,12339,186142,247,64,112,135
58813,23151,53,23151,53,194,87,107,2,31,1,1
58814,60962,53,0,0,180,80,100,2,31,1,1
58815,59455,53,0,0,221,81,140,2,31,1,1
58816,30960,45673,1133,45673,462,462,0,8,3633,8,0
58817,64025,24855,0,0,66,66,0,1,90,1,0
58818,51812,445,0,0,70,70,0,1,0,1,0
58819,61315,48817,0,0,62,62,0,1,0,1,0
58820,51811,445,0,0,70,70,0,1,0,1,0
58821,51810,445,0,0,70,70,0,1,0,1,0
58822,64897,2323,0,0,60,60,0,1,0,1,0
58823,51806,445,0,0,70,70,0,1,0,1,0
58824,51807,445,0,0,70,70,0,1,0,1,0
58825,56815,445,0,0,70,70,0,1,0,1,0
58826,56813,445,0,0,70,70,0,1,0,1,0
58827,56812,445,0,0,70,70,0,1,0,1,0
58828,18655,50584,0,0,62,62,0,1,0,1,0
58829,52214,445,0,0,66,66,0,1,0,1,0
58830,52220,445,0,0,66,66,0,1,0,1,0
58831,51837,37965,0,0,66,66,0,1,0,1,0
58832,52219,445,0,0,66,66,0,1,0,1,0
58833,52217,445,0,0,66,66,0,1,0,1,0
58834,52215,445,0,0,66,66,0,1,0,1,0
58835,52216,445,0,0,66,66,0,1,0,1,0
58836,52213,445,0,0,66,66,0,1,0,1,0
58837,52212,445,0,0,66,66,0,1,0,1,0
58838,36656,64147,0,0,62,62,0,1,0,1,0
58839,51792,445,0,0,70,70,0,1,0,1,0
58840,51791,445,0,0,70,70,0,1,0,1,0
58841,51788,445,0,0,70,70,0,1,0,1,0
58842,49418,27017,35147,27017,78,78,0,1,30,1,0
58843,40583,80,60376,80,898,543,355,10,255,6,4
58844,28275,80,28275,80,303421,10894,292527,324,26,116,208
58845,20898,53,20898,53,233,90,143,2,32,1,1
58846,51758,31009,36831,31009,70,70,0,2,8,2,0
58847,45057,443,53651,443,1394,733,661,14,80,8,6
58848,49418,27017,15205,27017,252,78,174,2,30,1,1
58849,49996,53,6579,53,183,94,89,2,30,1,1
58850,55899,443,47257,443,4819,2304,2515,16,135,8,8
58851,49418,27016,47902,27016,245,78,167,2,30,1,1
58852,65319,80,8384,80,2284,484,1800,10,133,6,4
58853,58052,25,34376,25,540,256,284,9,30,5,4
58854,63741,36776,9191,36776,70,70,0,1,4,1,0
58855,10002,40012,52638,40012,261,198,63,2,29,1,1
58856,49418,27015,8182,27015,252,78,174,2,29,1,1
58857,49418,27016,33402,27016,259,78,181,2,29,1,1
58858,49418,27015,20028,27015,264,78,186,2,29,1,1
58859,49418,27015,52265,27015,266,78,188,2,30,1,1
58860,49418,27015,32130,27015,260,78,182,2,30,1,1
58861,49418,49000,14471,49000,270,78,192,2,30,1,1
58862,51060,80,61015,80,4632,2660,1972,49,193,26,23
58863,51231,443,1331,443,1396,735,661,14,80,8,6
58864,41502,443,22197,443,1053,566,487,10,48,6,4
58865,50448,443,27905,443,10382,3262,7120,30,142,16,14
58866,50912,80,58684,80,9578491,119422,9459069,8079,137,1689,6390
58867,57886,80,60119,80,6526,1210,5316,15,17,8,7
58868,41999,80,10138,80,38137,1920,36217,51,81,24,27
58869,63742,26305,40966,26305,70,70,0,1,4,1,0
58870,50048,80,54605,80,2140,1030,1110,22,149,8,14
58871,38091,7275,44065,7275,350,210,140,6,15,4,2
58872,65011,53,20412,53,183,94,89,2,29,1,1
58873,56955,53,20294,53,184,86,98,2,29,1,1
58874,64520,53,44752,53,184,86,98,2,29,1,1
58875,38211,123,28193,123,184,94,90,2,29,1,1
58876,49418,27015,10652,27015,224,78,146,2,30,1,1
58877,57367,53,51549,53,177,94,83,2,29,1,1
58878,49815,53,18819,53,212,102,110,2,29,1,1
58879,49418,27015,65524,27015,287,78,209,2,30,1,1
58880,49527,53,19400,53,200,94,106,2,30,1,1
58881,55088,53,55518,53,193,102,91,2,30,1,1
58882,49418,27015,2773,27015,243,78,165,2,30,1,1
58883,64828,53,62244,53,260,102,158,2,30,1,1
58884,56018,443,53493,443,162,102,60,2,5,1,1
58885,58876,80,60067,80,32098,2435,29663,47,75,24,23
58886,47812,443,45871,443,25864,15150,10714,105,217,54,51
58887,44861,443,26247,443,1053,566,487,10,47,6,4
58888,34183,443,44472,443,10459,2529,7930,31,375,13,18
58889,60139,53,31222,53,218,78,140,2,30,1,1
58890,45601,443,27195,443,5378,984,4394,18,17,10,8
58891,63112,443,43251,443,3695,2713,982,21,82,12,9
58892,46342,53,46342,53,233,90,143,2,32,1,1
58893,56335,53,31703,53,260,102,158,2,30,1,1
58894,63770,24466,46194,24466,312,132,180,6,6,3,3
58895,51495,443,20935,443,55465,11462,44003,89,31,43,46
58896,55971,53,55971,53,233,90,143,2,33,1,1
58897,51760,36558,43821,36558,70,70,0,2,8,2,0
58898,10092,443,29539,443,130,70,60,3,5,2,1
58899,60329,7000,60329,7000,3959,1738,2221,15,15,8,7
58900,35735,80,48997,80,1155,781,374,10,15,6,4
58901,50597,443,31048,443,8031,1915,6116,24,17,12,12
58902,54889,53,54889,53,832,106,726,2,30,1,1
58903,50579,443,37078,443,2707,1383,1324,29,36,16,13
58904,28391,80,28391,80,12237,2818,9419,27,26,14,13
58905,57298,8765,45553,8765,2466,1350,1116,37,569,19,18
58906,60397,43129,12174,43129,70,70,0,2,8,2,0
58907,64320,53,61236,53,199,102,97,2,30,1,1
58908,55377,53,9978,53,228,110,118,2,30,1,1
58909,62877,53,36980,53,248,78,170,2,30,1,1
58910,64891,53,17816,53,211,102,109,2,30,1,1
58911,49418,27015,23061,27015,256,78,178,2,30,1,1
58912,49482,53,59102,53,196,94,102,2,30,1,1
58913,55088,53,58589,53,193,102,91,2,30,1,1
58914,65147,53,52735,53,323,102,221,2,30,1,1
58915,49418,27015,26438,27015,78,78,0,1,30,1,0
58916,64314,53,49422,53,319,126,193,2,30,1,1
58917,49418,27025,2656,27025,250,78,172,2,30,1,1
58918,49418,27015,42227,27015,251,78,173,2,30,1,1
58919,40500,53,40500,53,203,82,121,2,30,1,1
58920,49807,53,0,0,218,77,141,2,30,1,1
58921,56650,53,58049,53,253,102,151,2,30,1,1
58922,59112,53,0,0,296,76,220,2,30,1,1
58923,49418,27018,53537,27018,256,78,178,2,30,1,1
58924,49418,27016,30888,27016,255,78,177,2,30,1,1
58925,65381,53,45140,53,241,110,131,2,30,1,1
58926,49418,27015,37811,27015,236,78,158,2,30,1,1
58927,51761,19136,54705,19136,70,70,0,2,8,2,0
58928,50444,80,3294,80,378,192,186,7,19,4,3
58929,65399,53,0,0,191,75,116,2,30,1,1
58930,61320,53,0,0,194,80,114,2,30,1,1
58931,49418,27015,40733,27015,242,78,164,2,30,1,1
58932,65339,53,24574,53,193,102,91,2,30,1,1
58933,57040,53,51890,53,236,94,142,2,30,1,1
58934,50533,443,28213,443,3518,1654,1864,10,120,5,5
58935,51221,19072,17591,19072,330,330,0,6,1200,6,0
58936,44516,443,57254,443,4709,2451,2258,18,304,8,10
58937,49418,27111,53348,27111,258,78,180,2,30,1,1
58938,6881,8999,10252,8999,502,150,352,2,1199,1,1
58939,49418,27016,45260,27016,255,78,177,2,30,1,1
58940,49418,27015,38539,27015,249,78,171,2,30,1,1
58941,65256,53,29045,53,357,105,252,4,57,2,2
58942,64946,53,64946,53,233,90,143,2,33,1,1
58943,49418,27019,26998,27019,242,78,164,2,30,1,1
58944,63744,47106,28036,47106,70,70,0,1,4,1,0
58945,65316,80,11827,80,2430,531,1899,10,133,6,4
58946,53549,40826,14418,40826,492,306,186,8,14,5,3
58947,49418,27333,30238,27333,254,78,176,2,30,1,1
58948,61717,80,65373,80,6160,2912,3248,17,18,9,8
58949,63743,46081,6085,46081,70,70,0,1,4,1,0
58950,50443,80,16210,80,378,192,186,7,19,4,3
58951,47123,443,37885,443,1053,566,487,10,43,6,4
58952,49759,53,16085,53,216,110,106,2,29,1,1
58953,49903,53,18446,53,215,102,113,2,29,1,1
58954,50445,443,50834,443,14431,2090,12341,42,142,20,22
58955,48568,443,2828,443,56258,45661,10597,165,244,88,77
58956,53547,27759,47610,27759,684,432,252,10,16,6,4
58957,49575,53,59647,53,244,102,142,2,29,1,1
58958,49418,27016,34441,27016,263,78,185,2,29,1,1
58959,49418,27015,32548,27015,255,78,177,2,29,1,1
58960,56779,43137,58075,43137,70,70,0,2,8,2,0
58961,64654,53,63011,53,240,110,130,2,30,1,1
58962,55600,80,11201,80,70,70,0,2,8,2,0
58963,51763,34121,10888,34121,70,70,0,2,8,2,0
58964,59794,443,46382,443,408,78,330,6,25,1,5
58965,57367,53,32502,53,177,94,83,2,30,1,1
58966,49996,53,8571,53,183,94,89,2,30,1,1
58967,49418,27017,24547,27017,258,78,180,2,29,1,1
58968,49580,53,62367,53,196,102,94,2,30,1,1
58969,49418,27016,62306,27016,261,78,183,2,30,1,1
58970,49810,53,13654,53,244,94,150,2,30,1,1
58971,55088,53,3753,53,193,102,91,2,29,1,1
58972,49418,27016,5778,27016,263,78,185,2,29,1,1
58973,49418,31000,20791,31000,78,78,0,1,30,1,0
58974,49640,53,5967,53,402,118,284,2,30,1,1
58975,54987,53,61181,53,215,102,113,2,30,1,1
58976,49115,443,63602,443,361013,18864,342149,392,296,110,282
58977,60383,16881,9133,16881,564,318,246,9,18,5,4
58978,45055,443,37161,443,1392,731,661,14,80,8,6
58979,60390,56494,54167,56494,70,70,0,1,5,1,0
58980,52953,80,11532,80,3247,1730,1517,12,36,7,5
58981,40465,443,49132,443,1053,566,487,10,47,6,4
58982,51607,53,31669,53,284,86,198,2,30,1,1
58983,49418,27016,58886,27016,242,78,164,2,30,1,1
58984,49418,27020,23482,27020,248,78,170,2,30,1,1
58985,49418,31000,56556,31000,260,78,182,2,30,1,1
58986,52751,443,8615,443,5378,984,4394,18,17,10,8
58987,49174,443,55183,443,524887,14310,510577,546,18,201,345
58988,49759,53,4425,53,381,110,271,4,32,2,2
58989,51759,55308,58744,55308,70,70,0,2,8,2,0
58990,63563,24096,60999,24096,198,198,0,1,5,1,0
58991,47651,443,48756,443,1053,566,487,10,43,6,4
58992,50416,80,7917,80,11343,3864,7479,22,21,11,11
58993,50442,80,8641,80,378,192,186,7,19,4,3
58994,55627,53,18188,53,240,110,130,2,30,1,1
58995,50912,443,28892,443,8527,2387,6140,21,31,11,10
58996,49418,27015,19557,27015,255,78,177,2,30,1,1
58997,49418,27015,62235,27015,258,78,180,2,30,1,1
58998,64992,53,56297,53,177,94,83,2,30,1,1
58999,123,123,4741,123,184,94,90,2,30,1,1
59000,55167,443,39745,443,12946,5235,7711,38,185,21,17
59001,49545,443,58325,443,7189,1694,5495,31,131,14,17
59002,59836,443,35828,443,1394,733,661,14,80,8,6
59003,51762,12747,44025,12747,70,70,0,2,8,2,0
59004,47894,443,64449,443,70,70,0,2,5,2,0
59005,53225,443,23994,443,6659,1215,5444,17,15,9,8
59006,28608,80,28608,80,602483,18143,584340,627,27,219,408
59007,64320,53,46178,53,199,102,97,2,30,1,1
59008,49418,27016,26183,27016,262,78,184,2,30,1,1
59009,49418,27018,39364,27018,247,78,169,2,30,1,1
59010,49418,30000,55086,30000,280,78,202,2,30,1,1
59011,3027,53,3027,53,199,90,109,2,30,1,1
59012,49418,27222,49485,27222,245,78,167,2,30,1,1
59013,49418,27015,26832,27015,248,78,170,2,30,1,1
59014,45225,443,59513,443,11233,3101,8132,37,150,18,19
59015,49418,27017,11133,27017,247,78,169,2,30,1,1
59016,37525,443,14541,443,9082,3492,5590,26,61,15,11
59017,57333,53,41487,53,258,110,148,2,31,1,1
59018,49246,53,63715,53,286,102,184,2,31,1,1
59019,49561,53,53882,53,211,102,109,2,30,1,1
59020,49160,63307,39518,63307,854,150,704,4,1200,2,2
59021,10151,55149,20876,55149,481,150,331,2,1200,1,1
59022,51221,27417,45430,27417,481,150,331,2,1200,1,1
59023,65339,53,13346,53,949,285,664,8,39,4,4
59024,53110,8830,57205,8830,70,70,0,1,5,1,0
59025,53464,443,61601,443,6550,1555,4995,25,53,13,12
59026,57470,10748,14210,10748,594,594,0,10,1200,10,0
59027,53554,8999,45352,8999,130,70,60,2,5,1,1
59028,59635,7275,39827,7275,448,78,370,6,25,1,5
59029,64090,53,12119,53,227,102,125,2,30,1,1
59030,57470,6881,51127,6881,594,594,0,10,1200,10,0
59031,63762,41373,50271,41373,66,66,0,2,8,2,0
59032,50690,443,43818,443,354,294,60,2,5,1,1
59033,49418,27015,50177,27015,78,78,0,1,30,1,0
59034,7222,57470,0,0,62,62,0,1,0,1,0
59035,51782,445,0,0,70,70,0,1,0,1,0
59036,51781,445,0,0,70,70,0,1,0,1,0
59037,55056,56205,0,0,62,62,0,1,0,1,0
59038,53987,57470,0,0,66,66,0,1,0,1,0
59039,24144,57470,0,0,62,62,0,1,0,1,0
59040,16660,55783,0,0,62,62,0,1,0,1,0
59041,45908,3383,0,0,60,60,0,1,0,1,0
59042,50877,30041,0,0,62,62,0,1,0,1,0
59043,56805,445,0,0,70,70,0,1,0,1,0
59044,56804,445,0,0,70,70,0,1,0,1,0
59045,56797,445,0,0,70,70,0,1,0,1,0
59046,52913,2767,0,0,66,66,0,1,0,1,0
59047,50788,48817,0,0,66,66,0,1,0,1,0
59048,52200,445,0,0,66,66,0,1,0,1,0
59049,52199,445,0,0,66,66,0,1,0,1,0
59050,52197,445,0,0,66,66,0,1,0,1,0
59051,59879,55783,0,0,66,66,0,1,0,1,0
59052,56794,445,0,0,70,70,0,1,0,1,0
59053,51770,445,0,0,70,70,0,1,0,1,0
59054,20726,2767,0,0,66,66,0,1,0,1,0
59055,56792,445,0,0,70,70,0,1,0,1,0
59056,19570,50584,0,0,66,66,0,1,0,1,0
59057,56791,445,0,0,70,70,0,1,0,1,0
59058,56784,445,0,0,70,70,0,1,0,1,0
59059,56783,445,0,0,70,70,0,1,0,1,0
59060,51766,445,0,0,70,70,0,1,0,1,0
59061,61764,57470,0,0,146,146,0,1,0,1,0
59062,54276,39004,0,0,66,66,0,1,0,1,0
59063,59168,39004,0,0,62,62,0,1,0,1,0
59064,3783,40740,0,0,160,160,0,1,0,1,0
59065,32215,22114,0,0,66,66,0,1,0,1,0
59066,51755,445,0,0,70,70,0,1,0,1,0
59067,51756,445,0,0,70,70,0,1,0,1,0
59068,56778,35440,0,0,66,66,0,1,0,1,0
59069,1027,44847,0,0,62,62,0,1,0,1,0
59070,59023,64097,0,0,66,66,0,1,0,1,0
59071,51754,445,0,0,70,70,0,1,0,1,0
59072,51753,445,0,0,70,70,0,1,0,1,0
59073,49001,65473,0,0,174,174,0,1,0,1,0
59074,51749,445,0,0,70,70,0,1,0,1,0
59075,56773,445,0,0,70,70,0,1,0,1,0
59076,56771,445,0,0,70,70,0,1,0,1,0
59077,56768,445,0,0,70,70,0,1,0,1,0
59078,54631,44847,0,0,74,74,0,1,0,1,0
59079,53053,64147,0,0,66,66,0,1,0,1,0
59080,25360,51505,0,0,66,66,0,1,0,1,0
59081,1024,64147,0,0,62,62,0,1,0,1,0
59082,4366,51505,0,0,62,62,0,1,0,1,0
59083,61865,35440,0,0,66,66,0,1,0,1,0
59084,53406,44847,0,0,62,62,0,1,0,1,0
59085,27442,44847,0,0,62,62,0,1,0,1,0
59086,47173,35440,0,0,62,62,0,1,0,1,0
59087,51744,445,0,0,70,70,0,1,0,1,0
59088,16221,50584,0,0,62,62,0,1,0,1,0
59089,52174,445,0,0,66,66,0,1,0,1,0
59090,52802,56205,0,0,62,62,0,1,0,1,0
59091,56767,445,0,0,70,70,0,1,0,1,0
59092,56766,445,0,0,70,70,0,1,0,1,0
59093,51734,445,0,0,70,70,0,1,0,1,0
59094,9092,26672,0,0,60,60,0,1,0,1,0
59095,7444,57470,0,0,66,66,0,1,0,1,0
59096,51733,445,0,0,70,70,0,1,0,1,0
59097,19858,38211,0,0,145,145,0,1,0,1,0
59098,8023,64147,0,0,146,146,0,1,0,1,0
59099,2467,2767,0,0,62,62,0,1,0,1,0
59100,42345,443,8962,443,7593,2146,5447,21,10,12,9
59101,52172,445,0,0,66,66,0,1,0,1,0
59102,61804,51505,0,0,66,66,0,1,0,1,0
59103,14082,50584,0,0,66,66,0,1,0,1,0
59104,52168,445,0,0,66,66,0,1,0,1,0
59105,56754,445,0,0,70,70,0,1,0,1,0
59106,51723,445,0,0,70,70,0,1,0,1,0
59107,54684,37965,0,0,62,62,0,1,0,1,0
59108,51722,445,0,0,70,70,0,1,0,1,0
59109,56751,445,0,0,70,70,0,1,0,1,0
59110,56747,445,0,0,70,70,0,1,0,1,0
59111,56746,445,0,0,70,70,0,1,0,1,0
59112,52167,445,0,0,66,66,0,1,0,1,0
59113,61566,44847,0,0,62,62,0,1,0,1,0
59114,51718,445,0,0,70,70,0,1,0,1,0
59115,56739,445,0,0,70,70,0,1,0,1,0
59116,56247,23,0,0,60,60,0,1,0,1,0
59117,51717,445,0,0,70,70,0,1,0,1,0
59118,56737,445,0,0,70,70,0,1,0,1,0
59119,56735,445,0,0,70,70,0,1,0,1,0
59120,56733,445,0,0,70,70,0,1,0,1,0
59121,52159,445,0,0,66,66,0,1,0,1,0
59122,62696,50584,0,0,62,62,0,1,0,1,0
59123,63065,54369,0,0,66,66,0,1,0,1,0
59124,52156,445,0,0,66,66,0,1,0,1,0
59125,52150,445,0,0,66,66,0,1,0,1,0
59126,52154,445,0,0,66,66,0,1,0,1,0
59127,61241,22114,0,0,66,66,0,1,0,1,0
59128,52148,445,0,0,66,66,0,1,0,1,0
59129,52149,445,0,0,66,66,0,1,0,1,0
59130,52146,445,0,0,66,66,0,1,0,1,0
59131,1873,37965,0,0,62,62,0,1,0,1,0
59132,56453,37965,0,0,66,66,0,1,0,1,0
59133,1025,35447,0,0,62,62,0,1,0,1,0
59134,6881,26296,0,0,143,143,0,1,0,1,0
59135,8999,64910,0,0,146,146,0,1,0,1,0
59136,58382,50584,0,0,62,62,0,1,0,1,0
59137,45941,23388,0,0,60,60,0,1,0,1,0
59138,51712,445,0,0,70,70,0,1,0,1,0
59139,56732,445,0,0,70,70,0,1,0,1,0
59140,56728,445,0,0,70,70,0,1,0,1,0
59141,56727,445,0,0,70,70,0,1,0,1,0
59142,6904,30228,0,0,146,146,0,1,0,1,0
59143,46349,51505,0,0,74,74,0,1,0,1,0
59144,52143,445,0,0,66,66,0,1,0,1,0
59145,56724,445,0,0,70,70,0,1,0,1,0
59146,11951,45026,0,0,60,60,0,1,0,1,0
59147,19642,23,0,0,60,60,0,1,0,1,0
59148,52141,445,0,0,66,66,0,1,0,1,0
59149,52139,445,0,0,66,66,0,1,0,1,0
59150,52138,445,0,0,66,66,0,1,0,1,0
59151,52135,445,0,0,66,66,0,1,0,1,0
59152,16524,22114,0,0,62,62,0,1,0,1,0
59153,50355,43890,0,0,66,66,0,1,0,1,0
59154,51699,445,0,0,70,70,0,1,0,1,0
59155,12471,31573,0,0,62,62,0,1,0,1,0
59156,56716,445,0,0,70,70,0,1,0,1,0
59157,56715,445,0,0,70,70,0,1,0,1,0
59158,56707,445,0,0,70,70,0,1,0,1,0
59159,51696,445,0,0,70,70,0,1,0,1,0
59160,58338,3375,0,0,60,60,0,1,0,1,0
59161,38926,37965,0,0,62,62,0,1,0,1,0
59162,1811,35440,0,0,62,62,0,1,0,1,0
59163,5379,37965,0,0,66,66,0,1,0,1,0
59164,52127,445,0,0,66,66,0,1,0,1,0
59165,51691,445,0,0,70,70,0,1,0,1,0
59166,51690,445,0,0,70,70,0,1,0,1,0
59167,52117,445,0,0,66,66,0,1,0,1,0
59168,56696,445,0,0,70,70,0,1,0,1,0
59169,51688,445,0,0,70,70,0,1,0,1,0
59170,63925,37965,0,0,62,62,0,1,0,1,0
59171,52115,445,0,0,66,66,0,1,0,1,0
59172,52108,445,0,0,66,66,0,1,0,1,0
59173,50972,3544,39467,3544,258,107,151,2,30,1,1
59174,37616,443,9088,443,702409,17257,685152,698,32,233,465
59175,49418,27017,55350,27017,275,71,204,2,31,1,1
59176,49418,27015,13881,27015,237,71,166,2,31,1,1
59177,49418,27015,34985,27015,239,71,168,2,31,1,1
59178,57086,53,16252,53,711,87,624,2,30,1,1
59179,61476,443,42404,443,230640,12863,217777,253,62,98,155
59180,49418,27015,42209,27015,234,71,163,2,31,1,1
59181,37584,80,39013,80,3587,2484,1103,19,135,10,9
59182,51741,48440,47763,48440,136,136,0,3,14,3,0
59183,51740,35988,5363,35988,136,136,0,3,14,3,0
59184,38659,15000,47156,15000,138,78,60,2,5,1,1
59185,49418,27022,63608,27022,229,71,158,2,31,1,1
59186,49418,27015,37107,27015,223,71,152,2,31,1,1
59187,49418,27015,14560,27015,71,71,0,1,30,1,0
59188,45859,443,65407,443,5508,999,4509,20,255,11,9
59189,54144,443,45159,443,5736,1990,3746,25,16,14,11
59190,49418,27015,52121,27015,232,71,161,2,31,1,1
59191,58851,443,62485,443,15848,13507,2341,37,32,19,18
59192,49418,27015,37886,27015,219,71,148,2,31,1,1
59193,49418,27016,40313,27016,71,71,0,1,30,1,0
59194,56683,443,56683,443,4533,1626,2907,19,28,11,8
59195,52096,443,15286,443,283,163,120,4,15,2,2
59196,50458,80,53639,80,1426,865,561,9,15,5,4
59197,57385,80,37415,80,2546,1294,1252,17,138,9,8
59198,55363,443,55363,443,5458,2211,3247,22,39,13,9
59199,58506,53,0,0,192,86,106,2,30,1,1
59200,5588,5588,0,0,3354,1792,1562,46,193,23,23
59201,57477,53,0,0,186,83,103,2,30,1,1
59202,49418,27018,3626,27018,71,71,0,1,30,1,0
59203,65518,53,19504,53,701,88,613,2,30,1,1
59204,5938,20273,0,0,60,60,0,1,90,1,0
59205,44277,443,64665,443,36026,28458,7568,70,407,30,40
59206,49418,27015,36683,27015,251,71,180,2,31,1,1
59207,49418,27017,34824,27017,255,71,184,2,31,1,1
59208,43103,443,44934,443,3149,1899,1250,19,15,9,10
59209,43104,443,41004,443,3067,1817,1250,18,15,8,10
59210,51757,54657,4096,54657,70,70,0,2,8,2,0
59211,63763,17368,13988,17368,66,66,0,2,8,2,0
59212,50532,443,27098,443,7416,1777,5639,23,74,12,11
59213,53550,1,57289,1,70,70,0,1,5,1,0
59214,46339,443,43068,443,4392,1781,2611,21,20,12,9
59215,59793,443,27595,443,840,456,384,14,25,8,6
59216,7487,443,7487,443,4265,1184,3081,18,16,9,9
59217,8978,443,11135,443,49938,20855,29083,165,216,81,84
59218,41643,443,51338,443,16032,13508,2524,37,36,19,18
59219,62731,443,62731,443,9938,3644,6294,31,18,18,13
59220,48889,443,65230,443,87648,6895,80753,131,364,66,65
59221,62108,443,7391,443,9652,2914,6738,22,124,11,11
59222,19473,6889,63001,6889,480,149,331,2,1200,1,1
59223,65306,443,3584,443,5756,1781,3975,23,136,11,12
59224,51681,445,0,0,70,70,0,1,0,1,0
59225,6881,6881,0,0,62,62,0,1,0,1,0
59226,52099,445,0,0,66,66,0,1,0,1,0
59227,26211,1433,0,0,60,60,0,1,0,1,0
59228,51679,445,0,0,70,70,0,1,0,1,0
59229,62859,35440,0,0,66,66,0,1,0,1,0
59230,49418,27015,49804,27015,248,78,170,2,30,1,1
59231,49766,80,16081,80,254,128,126,5,15,3,2
59232,6712,123,0,0,90,90,0,1,0,1,0
59233,51678,445,0,0,70,70,0,1,0,1,0
59234,61000,15503,0,0,146,146,0,1,0,1,0
59235,51677,445,0,0,70,70,0,1,0,1,0
59236,51676,445,0,0,70,70,0,1,0,1,0
59237,51673,445,0,0,70,70,0,1,0,1,0
59238,51672,445,0,0,70,70,0,1,0,1,0
59239,39715,35440,0,0,146,146,0,1,0,1,0
59240,11404,64147,0,0,62,62,0,1,0,1,0
59241,53298,26467,0,0,66,66,0,1,0,1,0
59242,30111,2323,0,0,60,60,0,1,0,1,0
59243,56687,445,0,0,70,70,0,1,0,1,0
59244,56686,445,0,0,70,70,0,1,0,1,0
59245,56683,445,0,0,70,70,0,1,0,1,0
59246,29706,50584,0,0,62,62,0,1,0,1,0
59247,52088,445,0,0,66,66,0,1,0,1,0
59248,52090,445,0,0,66,66,0,1,0,1,0
59249,52084,445,0,0,66,66,0,1,0,1,0
59250,51650,80,36691,80,141348,4210,137138,161,17,58,103
59251,53300,443,53300,443,4406,1499,2907,19,30,11,8
59252,49256,53,47190,53,177,94,83,2,30,1,1
59253,63609,53,0,0,182,81,101,2,30,1,1
59254,55216,53,0,0,192,86,106,2,30,1,1
59255,46893,443,27910,443,622,70,552,10,180,2,8
59256,64112,443,40510,443,4116645,96572,4020073,4029,58,1356,2673
59257,55606,21802,21715,21802,320,140,180,6,5,3,3
59258,49767,80,10412,80,70,70,0,1,4,1,0
59259,50979,80,12190,80,576971,8128,568843,497,38,114,383
59260,37267,443,16640,443,3296,1636,1660,17,255,9,8
59261,49892,443,4679,443,6966,1436,5530,32,600,13,19
59262,49540,443,8159,443,7454,2377,5077,33,130,15,18
59263,36151,443,3051,443,22856,2980,19876,43,116,19,24
59264,56033,443,58131,443,8396,1919,6477,27,116,12,15
59265,10080,443,4270,443,130,70,60,3,5,2,1
59266,36209,443,44738,443,656609,25419,631190,752,62,322,430
59267,51738,47483,4479,47483,70,70,0,1,5,1,0
59268,40334,443,51232,443,8296,3123,5173,40,132,14,26
59269,51656,80,50242,80,152651,4700,147951,174,17,65,109
59270,32053,443,32053,443,28195,6044,22151,58,17,30,28
59271,58941,80,60543,80,1114,534,580,12,15,7,5
59272,53574,23650,56670,23650,320,140,180,6,5,3,3
59273,63759,64509,33605,64509,66,66,0,2,7,2,0
59274,51743,40358,22101,40358,136,136,0,3,14,3,0
59275,56602,80,9300,80,234,234,0,4,11,4,0
59276,49418,27015,54748,27015,78,78,0,1,29,1,0
59277,61723,443,17384,443,6962,979,5983,19,15,10,9
59278,63675,123,55630,123,184,94,90,2,29,1,1
59279,49418,27015,38933,27015,78,78,0,1,29,1,0
59280,64992,53,39214,53,177,94,83,2,29,1,1
59281,49418,27015,35776,27015,78,78,0,1,29,1,0
59282,64992,53,21333,53,177,94,83,2,29,1,1
59283,42307,443,58231,443,101673,5966,95707,121,178,47,74
59284,56928,80,39650,80,526,304,222,8,35,5,3
59285,49418,27015,60296,27015,253,78,175,2,31,1,1
59286,50520,443,34844,443,9942,1211,8731,26,77,14,12
59287,49418,27018,24351,27018,240,78,162,2,30,1,1
59288,53286,443,1896,443,123194,68738,54456,402,287,167,235
59289,49214,443,4327,443,17273,11238,6035,73,919,36,37
59290,56781,17548,14113,17548,70,70,0,1,5,1,0
59291,47705,443,21979,443,25643,2181,23462,44,363,18,26
59292,51756,41471,23556,41471,70,70,0,2,8,2,0
59293,47832,80,56253,80,1151,711,440,10,15,5,5
59294,51407,443,57078,443,202,70,132,3,11,1,2
59295,65178,53,0,0,190,85,105,2,30,1,1
59296,59573,443,39847,443,289380,13628,275752,335,70,142,193
59297,49418,27015,5163,27015,265,78,187,2,31,1,1
59298,64532,53,56480,53,258,110,148,2,30,1,1
59299,56927,80,6442,80,214,140,74,4,35,3,1
59300,49418,27015,55530,27015,244,78,166,2,30,1,1
59301,55146,53,47576,53,277,110,167,2,30,1,1
59302,56709,53,55050,53,211,102,109,2,30,1,1
59303,43032,443,31725,443,6792,3009,3783,20,46,12,8
59304,55312,443,20877,443,7952,3638,4314,36,149,17,19
59305,49418,27015,12957,27015,271,78,193,2,31,1,1
59306,49418,27015,22382,27015,243,78,165,2,31,1,1
59307,49418,27013,52000,27013,241,78,163,2,30,1,1
59308,49418,27444,10177,27444,258,78,180,2,30,1,1
59309,45292,443,27457,443,26444,2671,23773,52,363,25,27
59310,59937,443,12788,443,70,70,0,1,5,1,0
59311,54346,443,30268,443,12594,5098,7496,32,36,17,15
59312,58530,53,0,0,188,84,104,2,30,1,1
59313,49256,53,12893,53,177,94,83,2,30,1,1
59314,59431,443,29795,443,12756,3596,9160,31,299,16,15
59315,61721,443,43568,443,9676,2327,7349,25,16,15,10
59316,57357,53,10860,53,231,94,137,2,30,1,1
59317,58110,53,0,0,178,79,99,2,30,1,1
59318,50972,3544,44578,3544,409,107,302,4,30,2,2
59319,49418,27015,47175,27015,234,78,156,2,30,1,1
59320,49418,27016,3773,27016,242,78,164,2,30,1,1
59321,56744,31151,15345,31151,1703,524,1179,9,30,5,4
59322,49522,80,55749,80,6908,1652,5256,26,225,12,14
59323,59957,443,65089,443,8677,2714,5963,21,114,13,8
59324,55611,53,41439,53,768,200,568,6,53,3,3
59325,52496,443,9919,443,9500,4662,4838,20,16,11,9
59326,51652,80,57447,80,141220,4280,136940,159,17,59,100
59327,51499,443,1743,443,6848,769,6079,17,15,9,8
59328,54528,443,20055,443,6256,1871,4385,20,45,12,8
59329,53573,14856,10337,14856,320,140,180,6,5,3,3
59330,47893,443,63291,443,172,172,0,2,4,2,0
59331,49418,27014,18652,27014,249,78,171,2,31,1,1
59332,49418,27015,11506,27015,248,78,170,2,30,1,1
59333,50208,1688,43148,1688,70,70,0,1,5,1,0
59334,46822,443,53756,443,71073,4403,66670,99,116,41,58
59335,53548,23310,59949,23310,70,70,0,1,4,1,0
59336,53298,443,53298,443,4348,1441,2907,19,29,11,8
59337,33841,443,9860,443,12521,6232,6289,43,80,22,21
59338,53552,8999,43016,8999,70,70,0,1,4,1,0
59339,35428,443,14497,443,9592,2361,7231,25,15,14,11
59340,55605,27274,38364,27274,130,70,60,3,5,2,1
59341,56468,80,52689,80,214,140,74,4,26,3,1
59342,63757,51413,7176,51413,66,66,0,2,7,2,0
59343,59938,443,3054,443,70,70,0,1,5,1,0
59344,51742,20110,30208,20110,136,136,0,3,14,3,0
59345,47892,443,55293,443,172,172,0,2,5,2,0
59346,50521,443,9816,443,11880,1972,9908,29,78,15,14
59347,57287,53,47799,53,305,102,203,2,29,1,1
59348,55807,53,4924,53,257,102,155,2,29,1,1
59349,58331,443,26953,443,31515,26798,4717,91,82,49,42
59350,55851,53,42151,53,277,110,167,2,30,1,1
59351,65339,53,32222,53,193,102,91,2,29,1,1
59352,49418,27015,18735,27015,244,78,166,2,30,1,1
59353,40329,80,42227,80,2128,798,1330,14,46,7,7
59354,64843,443,36183,443,13583,4157,9426,26,120,11,15
59355,55267,53,26990,53,214,102,112,2,29,1,1
59356,64201,53,27931,53,200,94,106,2,29,1,1
59357,64785,53,44600,53,281,94,187,2,29,1,1
59358,65057,53,8165,53,211,94,117,2,30,1,1
59359,64236,53,6587,53,211,102,109,2,30,1,1
59360,53483,443,14059,443,8333,2292,6041,27,360,15,12
59361,49418,4444,6124,4444,238,78,160,2,31,1,1
59362,51498,443,60787,443,7211,823,6388,16,15,10,6
59363,56760,48386,9485,48386,268,70,198,4,19,1,3
59364,59308,443,6790,443,12169,4963,7206,60,262,31,29
59365,49211,443,58097,443,9739,3414,6325,59,928,30,29
59366,53821,53,5224,53,199,94,105,2,30,1,1
59367,46758,123,10814,123,184,94,90,2,30,1,1
59368,56374,53,9778,53,212,102,110,2,30,1,1
59369,57664,443,45877,443,5111,2193,2918,19,120,9,10
59370,33107,443,39338,443,35031,3490,31541,60,363,28,32
59371,44155,443,5461,443,5157,917,4240,20,360,10,10
59372,49418,27015,33694,27015,246,78,168,2,31,1,1
59373,50464,80,5838,80,26020,2247,23773,47,18,23,24
59374,40243,443,64916,443,284,164,120,4,15,2,2
59375,49418,27017,12250,27017,239,78,161,2,30,1,1
59376,58420,443,23233,443,17161,1619,15542,18,149,4,14
59377,26805,443,51742,443,21055,15996,5059,39,22,22,17
59378,64027,53,2870,53,360,97,263,4,38,2,2
59379,62757,123,11526,123,184,94,90,2,30,1,1
59380,50089,53,56216,53,718,94,624,2,30,1,1
59381,64194,53,10058,53,262,126,136,2,30,1,1
59382,64114,53,0,0,200,90,110,2,30,1,1
59383,56120,53,44279,53,177,94,83,2,30,1,1
59384,56120,53,38603,53,177,94,83,2,30,1,1
59385,41485,443,16482,443,29513,23962,5551,40,121,24,16
59386,49418,29999,25371,29999,244,78,166,2,31,1,1
59387,58721,443,55162,443,7973,4166,3807,28,141,14,14
59388,64494,443,46008,443,2872,717,2155,14,135,6,8
59389,60711,443,38043,443,12258,1451,10807,27,360,13,14
59390,6881,39927,58260,39927,228,118,110,2,1199,1,1
59391,56035,443,61035,443,10622,4094,6528,29,514,16,13
59392,52556,443,21958,443,5696,2392,3304,23,135,10,13
59393,43108,443,38121,443,7578,2358,5220,18,121,8,10
59394,36192,443,26140,443,4555,859,3696,17,360,9,8
59395,57470,14806,59723,14806,132,132,0,3,1199,3,0
59396,43345,443,34624,443,7767,1069,6698,23,3971,7,16
59397,57470,33159,38691,33159,594,594,0,10,1199,10,0
59398,6881,6881,22683,6881,502,150,352,2,1200,1,1
59399,46697,5228,40766,5228,9263,549,8714,17,3638,5,12
59400,14667,443,14667,443,20280,2078,18202,35,17,19,16
59401,61376,443,37067,443,31612,3374,28238,59,271,29,30
59402,51204,123,19622,123,184,94,90,2,30,1,1
59403,55326,53,27995,53,177,94,83,2,30,1,1
59404,56096,443,56096,443,5493,2246,3247,22,39,13,9
59405,50036,53,50623,53,353,118,235,2,31,1,1
59406,49418,27001,19678,27001,274,78,196,2,31,1,1
59407,59787,443,59787,443,5525,2278,3247,22,40,13,9
59408,55366,53,65278,53,79,79,0,2,35,2,0
59409,50907,80,50964,80,16037318,218904,15818414,13595,136,2976,10619
59410,65347,53,20093,53,352,94,258,2,30,1,1
59411,54576,443,43696,443,5670,3091,2579,16,121,8,8
59412,52092,445,0,0,66,66,0,1,0,1,0
59413,52087,445,0,0,66,66,0,1,0,1,0
59414,52091,445,0,0,66,66,0,1,0,1,0
59415,52085,445,0,0,66,66,0,1,0,1,0
59416,52086,445,0,0,66,66,0,1,0,1,0
59417,51658,445,0,0,70,70,0,1,0,1,0
59418,51657,445,0,0,70,70,0,1,0,1,0
59419,51655,445,0,0,70,70,0,1,0,1,0
59420,51648,445,0,0,70,70,0,1,0,1,0
59421,51647,445,0,0,70,70,0,1,0,1,0
59422,51829,36134,0,0,66,66,0,1,0,1,0
59423,59315,35440,0,0,66,66,0,1,0,1,0
59424,17177,64147,0,0,62,62,0,1,0,1,0
59425,20389,64147,0,0,62,62,0,1,0,1,0
59426,28124,37965,0,0,145,145,0,1,0,1,0
59427,12311,6881,0,0,62,62,0,1,0,1,0
59428,42946,31573,0,0,146,146,0,1,0,1,0
59429,1227,56205,0,0,66,66,0,1,0,1,0
59430,56678,445,0,0,70,70,0,1,0,1,0
59431,56675,445,0,0,70,70,0,1,0,1,0
59432,56669,445,0,0,70,70,0,1,0,1,0
59433,4910,2149,0,0,66,66,0,1,0,1,0
59434,57441,57470,0,0,66,66,0,1,0,1,0
59435,52072,445,0,0,66,66,0,1,0,1,0
59436,52071,445,0,0,66,66,0,1,0,1,0
59437,52070,445,0,0,66,66,0,1,0,1,0
59438,30496,57470,0,0,62,62,0,1,0,1,0
59439,51636,445,0,0,70,70,0,1,0,1,0
59440,42128,54532,0,0,60,60,0,1,0,1,0
59441,64000,44847,0,0,62,62,0,1,0,1,0
59442,56666,445,0,0,70,70,0,1,0,1,0
59443,60246,44612,0,0,62,62,0,1,0,1,0
59444,50052,65008,0,0,60,60,0,1,0,1,0
59445,27368,22114,0,0,62,62,0,1,0,1,0
59446,11136,15503,0,0,62,62,0,1,0,1,0
59447,56663,445,0,0,70,70,0,1,0,1,0
59448,58329,62413,0,0,62,62,0,1,0,1,0
59449,56654,445,0,0,70,70,0,1,0,1,0
59450,56655,445,0,0,70,70,0,1,0,1,0
59451,56652,445,0,0,70,70,0,1,0,1,0
59452,40082,22,0,0,60,60,0,1,0,1,0
59453,51632,445,0,0,70,70,0,1,0,1,0
59454,64341,57470,0,0,62,62,0,1,0,1,0
59455,31845,55777,0,0,62,62,0,1,0,1,0
59456,59597,37965,0,0,66,66,0,1,0,1,0
59457,38681,15503,0,0,74,74,0,1,0,1,0
59458,53447,44847,0,0,66,66,0,1,0,1,0
59459,51623,445,0,0,70,70,0,1,0,1,0
59460,51622,445,0,0,70,70,0,1,0,1,0
59461,63379,36237,0,0,66,66,0,1,0,1,0
59462,51617,445,0,0,70,70,0,1,0,1,0
59463,51620,445,0,0,70,70,0,1,0,1,0
59464,52472,7302,0,0,66,66,0,1,0,1,0
59465,51616,445,0,0,70,70,0,1,0,1,0
59466,10003,64147,0,0,62,62,0,1,0,1,0
59467,30307,51505,0,0,62,62,0,1,0,1,0
59468,56641,445,0,0,70,70,0,1,0,1,0
59469,56640,445,0,0,70,70,0,1,0,1,0
59470,56639,445,0,0,70,70,0,1,0,1,0
59471,9067,44847,0,0,62,62,0,1,0,1,0
59472,54140,43890,0,0,66,66,0,1,0,1,0
59473,9092,26672,0,0,60,60,0,1,0,1,0
59474,61983,50432,0,0,66,66,0,1,0,1,0
59475,51963,22114,0,0,62,62,0,1,0,1,0
59476,51609,445,0,0,70,70,0,1,0,1,0
59477,1024,22114,0,0,146,146,0,1,0,1,0
59478,12605,57470,0,0,62,62,0,1,0,1,0
59479,10586,37965,0,0,62,62,0,1,0,1,0
59480,46587,57470,0,0,66,66,0,1,0,1,0
59481,51732,50584,0,0,146,146,0,1,0,1,0
59482,28839,30188,0,0,62,62,0,1,0,1,0
59483,65016,37965,0,0,66,66,0,1,0,1,0
59484,17315,11392,0,0,66,66,0,1,0,1,0
59485,52050,445,0,0,66,66,0,1,0,1,0
59486,56638,445,0,0,70,70,0,1,0,1,0
59487,56637,445,0,0,70,70,0,1,0,1,0
59488,60617,64147,0,0,62,62,0,1,0,1,0
59489,27010,64147,0,0,62,62,0,1,0,1,0
59490,51602,445,0,0,70,70,0,1,0,1,0
59491,51599,445,0,0,70,70,0,1,0,1,0
59492,10248,21247,0,0,62,62,0,1,0,1,0
59493,59701,44847,0,0,66,66,0,1,0,1,0
59494,58458,17,0,0,60,60,0,1,0,1,0
59495,2522,64147,0,0,62,62,0,1,0,1,0
59496,64024,57470,0,0,66,66,0,1,0,1,0
59497,48386,9485,0,0,60,60,0,1,0,1,0
59498,61148,37965,0,0,66,66,0,1,0,1,0
59499,26332,57470,0,0,62,62,0,1,0,1,0
59500,63314,57470,0,0,66,66,0,1,0,1,0
59501,52041,445,0,0,66,66,0,1,0,1,0
59502,51596,445,0,0,70,70,0,1,0,1,0
59503,51594,445,0,0,70,70,0,1,0,1,0
59504,52040,445,0,0,66,66,0,1,0,1,0
59505,56628,445,0,0,70,70,0,1,0,1,0
59506,3802,55777,0,0,66,66,0,1,0,1,0
59507,52788,64147,0,0,62,62,0,1,0,1,0
59508,55966,57866,0,0,62,62,0,1,0,1,0
59509,29313,48817,0,0,145,145,0,1,0,1,0
59510,56620,445,0,0,70,70,0,1,0,1,0
59511,56618,445,0,0,70,70,0,1,0,1,0
59512,56616,445,0,0,70,70,0,1,0,1,0
59513,52037,445,0,0,66,66,0,1,0,1,0
59514,25595,2323,0,0,60,60,0,1,0,1,0
59515,50116,22,0,0,60,60,0,1,0,1,0
59516,51590,445,0,0,70,70,0,1,0,1,0
59517,59940,50584,0,0,66,66,0,1,0,1,0
59518,65060,35440,0,0,66,66,0,1,0,1,0
59519,33931,50584,0,0,62,62,0,1,0,1,0
59520,9957,32480,0,0,66,66,0,1,0,1,0
59521,51589,445,0,0,70,70,0,1,0,1,0
59522,53437,44847,0,0,66,66,0,1,0,1,0
59523,51339,50584,0,0,62,62,0,1,0,1,0
59524,56613,445,0,0,70,70,0,1,0,1,0
59525,44538,50584,0,0,62,62,0,1,0,1,0
59526,56608,445,0,0,70,70,0,1,0,1,0
59527,56606,445,0,0,70,70,0,1,0,1,0
59528,56604,445,0,0,70,70,0,1,0,1,0
59529,30129,37965,0,0,72,72,0,1,0,1,0
59530,52188,1433,0,0,60,60,0,1,0,1,0
59531,62804,37965,0,0,66,66,0,1,0,1,0
59532,0,0,0,0,60,60,0,1,0,1,0
59533,52029,445,0,0,66,66,0,1,0,1,0
59534,3001,28680,0,0,148,148,0,1,0,1,0
59535,8211,28793,0,0,66,66,0,1,0,1,0
59536,46389,27098,0,0,66,66,0,1,0,1,0
59537,52027,445,0,0,66,66,0,1,0,1,0
59538,52025,445,0,0,66,66,0,1,0,1,0
59539,52022,445,0,0,66,66,0,1,0,1,0
59540,60188,15503,0,0,66,66,0,1,0,1,0
59541,8889,19777,0,0,60,60,0,1,0,1,0
59542,22541,64147,0,0,66,66,0,1,0,1,0
59543,52020,445,0,0,66,66,0,1,0,1,0
59544,52021,445,0,0,66,66,0,1,0,1,0
59545,55468,23,0,0,60,60,0,1,0,1,0
59546,51584,445,0,0,70,70,0,1,0,1,0
59547,52690,7302,0,0,66,66,0,1,0,1,0
59548,56601,445,0,0,70,70,0,1,0,1,0
59549,56600,445,0,0,70,70,0,1,0,1,0
59550,56598,445,0,0,70,70,0,1,0,1,0
59551,52017,445,0,0,66,66,0,1,0,1,0
59552,32710,22114,0,0,62,62,0,1,0,1,0
59553,56595,445,0,0,70,70,0,1,0,1,0
59554,5223,34403,0,0,220,220,0,1,0,1,0
59555,21733,56205,0,0,66,66,0,1,0,1,0
59556,52012,445,0,0,66,66,0,1,0,1,0
59557,30598,46824,0,0,62,62,0,1,0,1,0
59558,52519,44847,0,0,66,66,0,1,0,1,0
59559,53408,50243,0,0,145,145,0,1,0,1,0
59560,1749,64147,0,0,66,66,0,1,0,1,0
59561,52010,445,0,0,66,66,0,1,0,1,0
59562,52009,445,0,0,66,66,0,1,0,1,0
59563,50734,37965,0,0,62,62,0,1,0,1,0
59564,59128,44847,0,0,66,66,0,1,0,1,0
59565,25772,7302,0,0,66,66,0,1,0,1,0
59566,52007,445,0,0,66,66,0,1,0,1,0
59567,50084,26672,0,0,62,62,0,1,0,1,0
59568,54894,9571,0,0,66,66,0,1,0,1,0
59569,51571,445,0,0,70,70,0,1,0,1,0
59570,55413,37965,0,0,66,66,0,1,0,1,0
59571,42632,44847,0,0,62,62,0,1,0,1,0
59572,61185,54532,0,0,62,62,0,1,0,1,0
59573,42745,50011,0,0,62,62,0,1,0,1,0
59574,50084,26672,0,0,145,145,0,1,0,1,0
59575,56587,445,0,0,70,70,0,1,0,1,0
59576,51568,445,0,0,70,70,0,1,0,1,0
59577,63701,46824,0,0,66,66,0,1,0,1,0
59578,38976,46824,0,0,62,62,0,1,0,1,0
59579,35347,20238,0,0,62,62,0,1,0,1,0
59580,56583,445,0,0,70,70,0,1,0,1,0
59581,56581,445,0,0,70,70,0,1,0,1,0
59582,15131,50584,0,0,62,62,0,1,0,1,0
59583,51151,64147,0,0,66,66,0,1,0,1,0
59584,38645,51221,0,0,62,62,0,1,0,1,0
59585,42209,36237,0,0,146,146,0,1,0,1,0
59586,51413,32480,0,0,72,72,0,1,0,1,0
59587,4515,37807,0,0,146,146,0,1,0,1,0
59588,49418,27025,19302,27025,71,71,0,1,30,1,0
59589,49418,27021,53913,27021,232,71,161,2,30,1,1
59590,49418,27015,47844,27015,214,71,143,2,30,1,1
59591,49418,23333,56641,23333,244,71,173,2,30,1,1
59592,50502,123,48233,123,184,94,90,2,30,1,1
59593,61699,443,44016,443,16358,3103,13255,39,19,19,20
59594,50605,443,19181,443,13409,3033,10376,29,124,15,14
59595,64567,443,24686,443,24984,2042,22942,41,32,19,22
59596,49418,37579,44074,37579,239,71,168,2,30,1,1
59597,60395,6890,41049,6890,70,70,0,2,8,2,0
59598,55326,53,8434,53,170,87,83,2,30,1,1
59599,51164,443,40341,443,7569,2113,5456,26,361,14,12
59600,49418,30007,64637,30007,242,71,171,2,30,1,1
59601,53538,33791,33383,33791,618,432,186,9,17,6,3
59602,49418,37569,43147,37569,237,71,166,2,30,1,1
59603,37174,443,43183,443,752907,69016,683891,1372,231,537,835
59604,49418,27026,25116,27026,71,71,0,1,30,1,0
59605,49418,27022,21779,27022,71,71,0,1,30,1,0
59606,49418,30006,39633,30006,244,71,173,2,30,1,1
59607,62995,3389,62995,3389,4213,2429,1784,18,32,9,9
59608,32971,443,32971,443,18895,2061,16834,34,17,18,16
59609,18796,443,17365,443,2227,1018,1209,17,15,8,9
59610,53574,443,38690,443,117116,5692,111424,153,18,56,97
59611,52625,53,52625,53,231,88,143,2,32,1,1
59612,53565,58695,57027,58695,70,70,0,2,8,2,0
59613,35065,443,35065,443,5537,2290,3247,22,39,13,9
59614,28539,53,28539,53,231,88,143,2,32,1,1
59615,50622,53,42098,53,202,83,119,2,30,1,1
59616,46327,25903,25335,25903,332,192,140,6,25,4,2
59617,39207,80,48256,80,234,234,0,4,12,4,0
59618,36712,53,0,0,138,69,69,2,30,1,1
59619,50437,3389,50437,3389,3444,1730,1714,16,31,8,8
59620,49418,27019,20347,27019,71,71,0,1,30,1,0
59621,49418,27015,42779,27015,227,71,156,2,30,1,1
59622,49418,27015,63577,27015,71,71,0,1,30,1,0
59623,49418,12345,11846,12345,249,71,178,2,30,1,1
59624,49418,30010,58880,30010,238,71,167,2,30,1,1
59625,14469,443,14469,443,274,132,142,5,15,3,2
59626,50501,443,19632,443,1499,930,569,16,78,9,7
59627,42040,5228,16525,5228,60,60,0,1,5,1,0
59628,47091,443,36299,443,6326,4367,1959,31,144,17,14
59629,51753,15038,3918,15038,70,70,0,2,7,2,0
59630,44206,53,19423,53,202,83,119,2,30,1,1
59631,50172,443,41441,443,161,101,60,2,5,1,1
59632,53760,80,45731,80,1667,619,1048,10,45,6,4
59633,49418,30003,43016,30003,71,71,0,1,30,1,0
59634,49418,27015,44388,27015,71,71,0,1,30,1,0
59635,49418,27016,19249,27016,240,71,169,2,30,1,1
59636,49418,16666,10447,16666,71,71,0,1,30,1,0
59637,65348,53,36995,53,170,87,83,2,30,1,1
59638,49418,30002,50815,30002,242,71,171,2,30,1,1
59639,5938,19141,0,0,60,60,0,1,91,1,0
59640,50895,443,43273,443,14584,6798,7786,37,181,18,19
59641,30960,45684,7454,45684,330,330,0,6,3609,6,0
59642,37965,22343,64266,22343,1307,594,713,17,1657,10,7
59643,51997,445,0,0,66,66,0,1,0,1,0
59644,21492,51505,0,0,62,62,0,1,0,1,0
59645,11716,37965,0,0,62,62,0,1,0,1,0
59646,51563,445,0,0,70,70,0,1,0,1,0
59647,38633,51221,0,0,66,66,0,1,0,1,0
59648,54424,50584,0,0,146,146,0,1,0,1,0
59649,25536,50584,0,0,62,62,0,1,0,1,0
59650,51562,445,0,0,70,70,0,1,0,1,0
59651,443,9986,0,0,352,352,0,1,0,1,0
59652,51105,50584,0,0,66,66,0,1,0,1,0
59653,35644,67,0,0,60,60,0,1,0,1,0
59654,51560,445,0,0,70,70,0,1,0,1,0
59655,49418,26259,63056,26259,254,78,176,2,30,1,1
59656,49418,27016,30078,27016,78,78,0,1,30,1,0
59657,49418,30008,26844,30008,236,78,158,2,30,1,1
59658,34464,443,64076,443,1402,910,492,11,360,6,5
59659,57370,443,5735,443,7211,823,6388,16,15,10,6
59660,48252,443,35978,443,283034,39462,243572,536,224,257,279
59661,49418,37569,8517,37569,246,78,168,2,30,1,1
59662,52555,443,31121,443,4362,1826,2536,18,134,8,10
59663,55015,443,30029,443,8133,2402,5731,35,255,17,18
59664,49400,80,14888,80,40119,2475,37644,49,84,16,33
59665,52122,443,45457,443,5841,1986,3855,19,15,11,8
59666,49224,443,16302,443,93540,22718,70822,155,918,65,90
59667,7686,80,7686,80,176670,11287,165383,216,46,96,120
59668,38136,443,41208,443,3919,1099,2820,35,627,9,26
59669,49233,443,34014,443,9622,3524,6098,59,916,29,30
59670,49201,443,23062,443,13738,6378,7360,70,981,33,37
59671,49189,443,36551,443,15611,1501,14110,32,361,14,18
59672,55326,53,39375,53,177,94,83,2,29,1,1
59673,49418,27015,35116,27015,78,78,0,1,30,1,0
59674,49418,27001,35049,27001,256,78,178,2,30,1,1
59675,40232,53,19769,53,205,86,119,2,29,1,1
59676,49418,27015,31380,27015,239,78,161,2,30,1,1
59677,49418,33086,18224,33086,237,78,159,2,30,1,1
59678,56739,42421,49450,42421,2810,1382,1428,12,31,6,6
59679,49418,27015,24624,27015,78,78,0,1,30,1,0
59680,55594,53,28823,53,168,78,90,2,30,1,1
59681,56845,443,17798,443,16207,6355,9852,84,195,43,41
59682,60386,9136,45378,9136,624,318,306,10,16,5,5
59683,57714,53,57714,53,233,90,143,2,32,1,1
59684,63758,57825,49491,57825,312,132,180,6,6,3,3
59685,51739,62163,32244,62163,70,70,0,1,5,1,0
59686,63737,80,37849,80,314,192,122,6,15,4,2
59687,37352,80,54268,80,1115,562,553,13,362,6,7
59688,49418,27015,22086,27015,78,78,0,1,30,1,0
59689,49418,28002,23648,28002,271,78,193,2,30,1,1
59690,42128,80,52556,80,1139,506,633,10,15,6,4
59691,49418,27053,45679,27053,78,78,0,1,30,1,0
59692,56843,443,16451,443,54661,36820,17841,266,201,128,138
59693,51399,443,28295,443,642,582,60,2,5,1,1
59694,65198,53,6063,53,448,94,354,4,49,2,2
59695,49418,33032,30338,33032,78,78,0,1,30,1,0
59696,49418,27015,38880,27015,78,78,0,1,30,1,0
59697,47808,53,24079,53,168,78,90,2,30,1,1
59698,34465,443,9083,443,1402,910,492,11,360,6,5
59699,34466,443,32529,443,1402,910,492,11,360,6,5
59700,49418,33098,30068,33098,78,78,0,1,30,1,0
59701,56844,443,48471,443,10878,4815,6063,60,196,31,29
59702,65426,53,23528,53,706,195,511,6,52,3,3
59703,39356,443,35388,443,7134,2290,4844,29,80,15,14
59704,56541,443,9751,443,130,70,60,2,15,1,1
59705,49418,27015,59160,27015,78,78,0,1,30,1,0
59706,49418,30050,47158,30050,78,78,0,1,30,1,0
59707,64805,53,57151,53,215,102,113,2,30,1,1
59708,49418,33058,55897,33058,244,78,166,2,30,1,1
59709,57144,8525,57144,8525,138,78,60,2,5,1,1
59710,50550,443,50550,443,5642,2395,3247,22,38,13,9
59711,42686,443,38351,443,190,70,120,4,15,2,2
59712,44320,443,12809,443,7244,1861,5383,26,330,14,12
59713,57598,443,10245,443,12463,6762,5701,28,31,14,14
59714,49418,27015,25961,27015,234,78,156,2,30,1,1
59715,49418,27015,26023,27015,78,78,0,1,30,1,0
59716,49418,32036,34122,32036,243,78,165,2,30,1,1
59717,49418,27056,31810,27056,269,78,191,2,30,1,1
59718,56846,443,26374,443,9370,3805,5565,43,181,21,22
59719,44512,443,54023,443,1101393,30310,1071083,1137,109,381,756
59720,50516,443,49495,443,12855,2077,10778,30,78,15,15
59721,38653,443,63492,443,6969,2162,4807,20,15,11,9
59722,49228,443,26216,443,13758,6577,7181,66,918,34,32
59723,55212,443,36417,443,10500,5056,5444,23,143,11,12
59724,60964,443,25466,443,2080,1376,704,17,30,9,8
59725,44516,443,18408,443,156324,6993,149331,192,108,81,111
59726,44514,443,59227,443,448741,15805,432936,491,109,181,310
59727,51774,80,22011,80,240,120,120,5,27,3,2
59728,45619,80,13038,80,1052,612,440,10,15,5,5
59729,50497,443,60901,443,1322,725,597,14,78,7,7
59730,46291,443,48252,443,70,70,0,1,5,1,0
59731,49418,27015,58093,27015,78,78,0,1,30,1,0
59732,50996,443,60752,443,12654,1719,10935,28,21,15,13
59733,59770,443,37125,443,7316,1933,5383,27,16,15,12
59734,49418,29999,18255,29999,239,78,161,2,30,1,1
59735,35164,443,44026,443,5505,995,4510,20,255,11,9
59736,53227,53,29917,53,205,86,119,2,29,1,1
59737,49260,53,27595,53,177,86,91,2,29,1,1
59738,60384,64170,40565,64170,504,318,186,8,16,5,3
59739,49619,53,1376,53,184,86,98,2,30,1,1
59740,49418,27015,11221,27015,240,78,162,2,30,1,1
59741,65348,53,2839,53,177,94,83,2,30,1,1
59742,49418,27015,25593,27015,258,78,180,2,30,1,1
59743,49418,27080,21881,27080,238,78,160,2,30,1,1
59744,49418,27054,42342,27054,272,78,194,2,30,1,1
59745,49418,26169,6616,26169,78,78,0,1,30,1,0
59746,49418,32038,58741,32038,235,78,157,2,30,1,1
59747,49418,32058,6170,32058,78,78,0,1,30,1,0
59748,58663,53,40233,53,167,78,89,2,30,1,1
59749,55454,443,35001,443,1784,247,1537,7,120,4,3
59750,55455,443,13171,443,1786,172,1614,7,120,3,4
59751,50540,443,25941,443,134507,6585,127922,148,121,51,97
59752,50265,13302,54682,13302,2118,858,1260,28,1267,14,14
59753,51754,1182,55646,1182,70,70,0,2,7,2,0
59754,54020,53,54020,53,233,90,143,2,32,1,1
59755,51398,443,32490,443,322,262,60,2,5,1,1
59756,51942,443,54861,443,2646,1322,1324,28,36,15,13
59757,51620,443,24957,443,3330,2281,1049,17,16,9,8
59758,49418,27017,19640,27017,78,78,0,1,30,1,0
59759,49418,33071,57943,33071,78,78,0,1,30,1,0
59760,64133,53,49082,53,225,110,115,2,30,1,1
59761,49418,50019,9812,50019,268,78,190,2,30,1,1
59762,53084,443,55326,443,490914,83866,407048,1048,332,526,522
59763,38993,443,34045,443,7089,1290,5799,24,16,12,12
59764,23589,53,23589,53,220,90,130,2,30,1,1
59765,34294,53,17102,53,168,78,90,2,30,1,1
59766,53860,53,53860,53,197,90,107,2,30,1,1
59767,57235,443,36461,443,8954,3404,5550,34,46,19,15
59768,55326,53,7571,53,177,94,83,2,30,1,1
59769,56841,443,47510,443,156805,44621,112184,289,215,137,152
59770,49418,27015,63355,27015,244,78,166,2,30,1,1
59771,49418,33056,16028,33056,237,78,159,2,30,1,1
59772,49418,27058,37318,27058,263,78,185,2,30,1,1
59773,49418,27055,11921,27055,269,78,191,2,30,1,1
59774,49418,32056,18212,32056,245,78,167,2,30,1,1
59775,51221,27048,22916,27048,132,132,0,3,1200,3,0
59776,54659,443,56106,443,1773,1038,735,17,278,9,8
59777,21133,6085,5257,6085,481,150,331,2,1199,1,1
59778,50096,53,50096,53,197,90,107,2,30,1,1
59779,55440,53,55440,53,220,90,130,2,30,1,1
59780,48755,53,17288,53,168,78,90,2,30,1,1
59781,58662,53,17171,53,167,78,89,2,31,1,1
59782,63926,53,50565,53,260,102,158,2,31,1,1
59783,65183,53,44616,53,718,94,624,2,31,1,1
59784,59124,443,60758,443,27431,19413,8018,71,175,36,35
59785,63627,443,58785,443,17242,3015,14227,19,143,5,14
59786,63584,443,24147,443,3182,1568,1614,8,120,4,4
59787,6881,51413,35496,51413,475,150,325,2,1200,1,1
59788,49664,443,7925,443,134,60,74,3,6,2,1
59789,52495,443,36037,443,32875,8836,24039,37,16,15,22
59790,63425,443,8137,443,22815,20019,2796,55,81,31,24
59791,50913,80,46319,80,12767608,157856,12609752,11936,135,2227,9709
59792,50906,80,26380,80,13949172,164502,13784670,11537,135,2287,9250
59793,58837,3389,58837,3389,4429,2581,1848,21,33,11,10
59794,56680,8100,35918,8100,78,78,0,1,5,1,0
59795,53544,22051,5386,22051,70,70,0,1,5,1,0
59796,50488,443,22994,443,9765,2106,7659,27,83,14,13
59797,49449,80,5830,80,1948,912,1036,13,56,7,6
59798,50382,443,9728,443,10423,2542,7881,48,20,24,24
59799,50897,80,4903,80,13981183,155668,13825515,11482,136,2194,9288
59800,44187,53,44187,53,233,90,143,2,32,1,1
59801,65367,443,29972,443,5666,4417,1249,23,86,12,11
59802,50910,80,20207,80,14877069,179445,14697624,12450,135,2531,9919
59803,50900,80,32944,80,14423569,189925,14233644,12194,135,2586,9608
59804,49624,53,37843,53,216,94,122,2,30,1,1
59805,57082,53,1107,53,211,102,109,2,30,1,1
59806,39054,53,31083,53,168,78,90,2,30,1,1
59807,65348,53,40565,53,177,94,83,2,30,1,1
59808,51989,445,0,0,66,66,0,1,0,1,0
59809,35516,22,0,0,60,60,0,1,0,1,0
59810,56564,9571,0,0,78,78,0,1,0,1,0
59811,56567,445,0,0,70,70,0,1,0,1,0
59812,33292,50584,0,0,66,66,0,1,0,1,0
59813,34489,35440,0,0,66,66,0,1,0,1,0
59814,51986,445,0,0,66,66,0,1,0,1,0
59815,62338,50011,0,0,66,66,0,1,0,1,0
59816,62532,57354,0,0,159,159,0,1,0,1,0
59817,47013,37965,0,0,62,62,0,1,0,1,0
59818,51553,445,0,0,70,70,0,1,0,1,0
59819,54976,2273,0,0,60,60,0,1,0,1,0
59820,51977,445,0,0,66,66,0,1,0,1,0
59821,51549,445,0,0,70,70,0,1,0,1,0
59822,51975,445,0,0,66,66,0,1,0,1,0
59823,51548,445,0,0,70,70,0,1,0,1,0
59824,51547,445,0,0,70,70,0,1,0,1,0
59825,12694,12446,0,0,62,62,0,1,0,1,0
59826,56703,50584,0,0,66,66,0,1,0,1,0
59827,51546,445,0,0,70,70,0,1,0,1,0
59828,51328,30228,0,0,109,109,0,1,0,1,0
59829,58003,1433,0,0,60,60,0,1,0,1,0
59830,51544,445,0,0,70,70,0,1,0,1,0
59831,51540,445,0,0,70,70,0,1,0,1,0
59832,51191,26467,0,0,66,66,0,1,0,1,0
59833,63583,37965,0,0,66,66,0,1,0,1,0
59834,30599,46824,0,0,66,66,0,1,0,1,0
59835,56556,445,0,0,70,70,0,1,0,1,0
59836,56555,445,0,0,70,70,0,1,0,1,0
59837,51528,445,0,0,70,70,0,1,0,1,0
59838,51527,445,0,0,70,70,0,1,0,1,0
59839,51961,445,0,0,66,66,0,1,0,1,0
59840,51962,445,0,0,66,66,0,1,0,1,0
59841,51963,445,0,0,66,66,0,1,0,1,0
59842,51960,445,0,0,66,66,0,1,0,1,0
59843,51959,445,0,0,66,66,0,1,0,1,0
59844,51957,445,0,0,66,66,0,1,0,1,0
59845,51956,445,0,0,66,66,0,1,0,1,0
59846,3964,51505,0,0,62,62,0,1,0,1,0
59847,51525,445,0,0,70,70,0,1,0,1,0
59848,64166,35440,0,0,62,62,0,1,0,1,0
59849,51517,445,0,0,70,70,0,1,0,1,0
59850,51518,445,0,0,70,70,0,1,0,1,0
59851,64219,51050,0,0,66,66,0,1,0,1,0
59852,51953,37965,0,0,66,66,0,1,0,1,0
59853,42128,54532,0,0,60,60,0,1,0,1,0
59854,39823,36237,0,0,66,66,0,1,0,1,0
59855,57098,1,0,0,78,78,0,1,0,1,0
59856,34531,23117,0,0,62,62,0,1,0,1,0
59857,61845,11392,0,0,62,62,0,1,0,1,0
59858,56553,445,0,0,70,70,0,1,0,1,0
59859,56547,445,0,0,70,70,0,1,0,1,0
59860,56539,445,0,0,70,70,0,1,0,1,0
59861,51506,445,0,0,70,70,0,1,0,1,0
59862,8622,64147,0,0,66,66,0,1,0,1,0
59863,51943,445,0,0,66,66,0,1,0,1,0
59864,51940,445,0,0,66,66,0,1,0,1,0
59865,51941,445,0,0,66,66,0,1,0,1,0
59866,56537,445,0,0,70,70,0,1,0,1,0
59867,58598,50584,0,0,66,66,0,1,0,1,0
59868,56535,445,0,0,70,70,0,1,0,1,0
59869,49699,64147,0,0,66,66,0,1,0,1,0
59870,51502,445,0,0,70,70,0,1,0,1,0
59871,56531,445,0,0,70,70,0,1,0,1,0
59872,56527,445,0,0,70,70,0,1,0,1,0
59873,56524,445,0,0,70,70,0,1,0,1,0
59874,14613,12446,0,0,66,66,0,1,0,1,0
59875,49664,37965,0,0,66,66,0,1,0,1,0
59876,51999,37965,0,0,62,62,0,1,0,1,0
59877,18085,26467,0,0,62,62,0,1,0,1,0
59878,55296,23718,0,0,66,66,0,1,0,1,0
59879,51491,445,0,0,70,70,0,1,0,1,0
59880,51493,445,0,0,70,70,0,1,0,1,0
59881,42463,56205,0,0,146,146,0,1,0,1,0
59882,51489,445,0,0,70,70,0,1,0,1,0
59883,51488,445,0,0,70,70,0,1,0,1,0
59884,51486,445,0,0,70,70,0,1,0,1,0
59885,8999,43109,0,0,146,146,0,1,0,1,0
59886,46275,64147,0,0,62,62,0,1,0,1,0
59887,64482,64147,0,0,66,66,0,1,0,1,0
59888,56516,445,0,0,70,70,0,1,0,1,0
59889,56514,445,0,0,70,70,0,1,0,1,0
59890,56511,445,0,0,70,70,0,1,0,1,0
59891,24351,57470,0,0,62,62,0,1,0,1,0
59892,51774,29434,0,0,146,146,0,1,0,1,0
59893,51480,445,0,0,70,70,0,1,0,1,0
59894,43129,20220,0,0,62,62,0,1,0,1,0
59895,8999,1,0,0,62,62,0,1,0,1,0
59896,54280,3359,0,0,60,60,0,1,0,1,0
59897,54826,56205,0,0,62,62,0,1,0,1,0
59898,51472,445,0,0,70,70,0,1,0,1,0
59899,51918,445,0,0,66,66,0,1,0,1,0
59900,56510,445,0,0,70,70,0,1,0,1,0
59901,56508,445,0,0,70,70,0,1,0,1,0
59902,51471,445,0,0,70,70,0,1,0,1,0
59903,59918,44847,0,0,66,66,0,1,0,1,0
59904,54471,36237,0,0,66,66,0,1,0,1,0
59905,8999,1,0,0,146,146,0,1,0,1,0
59906,5200,6643,0,0,145,145,0,1,0,1,0
59907,51463,445,0,0,70,70,0,1,0,1,0
59908,50853,50584,0,0,62,62,0,1,0,1,0
59909,51462,445,0,0,70,70,0,1,0,1,0
59910,37571,443,14290,443,499,425,74,4,0,3,1
59911,37574,443,27983,443,499,425,74,4,0,3,1
59912,37573,443,61773,443,499,425,74,4,0,3,1
59913,37572,443,25877,443,499,425,74,4,0,3,1
59914,37570,443,49846,443,499,425,74,4,0,3,1
59915,37569,443,25156,443,499,425,74,4,0,3,1
59916,0,0,0,0,320,320,0,5,0,5,0
59917,51914,445,0,0,66,66,0,1,0,1,0
59918,48087,16069,0,0,66,66,0,1,0,1,0
59919,47962,16069,0,0,62,62,0,1,0,1,0
59920,14309,56205,0,0,62,62,0,1,0,1,0
59921,51911,445,0,0,66,66,0,1,0,1,0
59922,56495,445,0,0,70,70,0,1,0,1,0
59923,58876,57470,0,0,66,66,0,1,0,1,0
59924,56490,445,0,0,70,70,0,1,0,1,0
59925,56489,445,0,0,70,70,0,1,0,1,0
59926,56488,445,0,0,70,70,0,1,0,1,0
59927,51458,445,0,0,70,70,0,1,0,1,0
59928,51908,445,0,0,66,66,0,1,0,1,0
59929,51457,445,0,0,70,70,0,1,0,1,0
59930,56482,445,0,0,70,70,0,1,0,1,0
59931,56480,445,0,0,70,70,0,1,0,1,0
59932,56477,445,0,0,70,70,0,1,0,1,0
59933,56478,445,0,0,70,70,0,1,0,1,0
59934,51534,26467,0,0,62,62,0,1,0,1,0
59935,51902,445,0,0,66,66,0,1,0,1,0
59936,51452,445,0,0,70,70,0,1,0,1,0
59937,51893,445,0,0,66,66,0,1,0,1,0
59938,51896,445,0,0,66,66,0,1,0,1,0
59939,51897,445,0,0,66,66,0,1,0,1,0
59940,51891,445,0,0,66,66,0,1,0,1,0
59941,51892,445,0,0,66,66,0,1,0,1,0
59942,51889,445,0,0,66,66,0,1,0,1,0
59943,42685,51180,0,0,62,62,0,1,0,1,0
59944,56753,44847,0,0,62,62,0,1,0,1,0
59945,49831,30188,0,0,66,66,0,1,0,1,0
59946,64890,51180,0,0,66,66,0,1,0,1,0
59947,50200,44847,0,0,70,70,0,1,0,1,0
59948,56474,445,0,0,70,70,0,1,0,1,0
59949,56471,445,0,0,70,70,0,1,0,1,0
59950,56469,445,0,0,70,70,0,1,0,1,0
59951,51887,445,0,0,66,66,0,1,0,1,0
59952,56467,445,0,0,70,70,0,1,0,1,0
59953,443,10010,0,0,60,60,0,1,0,1,0
59954,51884,445,0,0,66,66,0,1,0,1,0
59955,51882,445,0,0,66,66,0,1,0,1,0
59956,51881,445,0,0,66,66,0,1,0,1,0
59957,37616,443,4256,443,18611,3046,15565,41,362,20,21
59958,61385,80,34601,80,30257,2427,27830,45,255,22,23
59959,61390,80,4844,80,13706,1388,12318,26,255,14,12
59960,51318,443,40980,443,11191,4657,6534,32,129,14,18
59961,57512,80,20735,80,1377,881,496,12,48,7,5
59962,65381,80,14160,80,1630,982,648,13,78,7,6
59963,49736,443,37577,443,378,192,186,7,15,4,3
59964,54688,443,54688,443,149676,25300,124376,220,110,122,98
59965,51265,63960,62847,63960,70,70,0,1,5,1,0
59966,56778,35292,48198,35292,70,70,0,1,5,1,0
59967,65387,443,41173,443,2289,1583,706,14,18,8,6
59968,61389,80,44525,80,17407,1529,15878,30,255,16,14
59969,61388,80,19899,80,14158,1392,12766,26,255,14,12
59970,17750,6881,6103,6881,149,149,0,1,1200,1,0
59971,5938,26428,0,0,60,60,0,1,90,1,0
59972,61706,80,6564,80,1840,1242,598,11,16,6,5
59973,62462,53,62462,53,238,99,139,2,30,1,1
59974,51564,443,53413,443,2888,1566,1322,17,18,9,8
59975,61387,80,56509,80,28791,2297,26494,41,255,20,21
59976,17861,443,17861,443,1155,728,427,11,26,7,4
59977,65362,80,32536,80,1347,771,576,11,86,7,4
59978,58046,53,58046,53,231,88,143,2,32,1,1
59979,7665,80,7665,80,110567,7016,103551,135,46,60,75
59980,42213,443,21488,443,4622,926,3696,18,255,10,8
59981,52629,53,0,0,232,77,155,2,33,1,1
59982,41322,443,7553,443,153,93,60,2,5,1,1
59983,55598,41565,26251,41565,70,70,0,2,8,2,0
59984,52540,443,62112,443,153,93,60,2,5,1,1
59985,49175,2710,9134,2710,66,66,0,1,5,1,0
59986,54614,443,21022,443,36109,16793,19316,62,19,32,30
59987,50475,443,44824,443,3893,1910,1983,36,255,17,19
59988,43422,80,45475,80,3863,875,2988,12,16,8,4
59989,56981,443,53338,443,7238,2601,4637,20,22,10,10
59990,33911,53,0,0,82,82,0,1,30,1,0
59991,5588,5588,0,0,3498,1872,1626,48,205,24,24
59992,51953,443,6688,443,7571,3372,4199,33,88,17,16
59993,52000,80,35865,80,3495,1150,2345,17,18,8,9
59994,55744,80,6834,80,5146,3694,1452,20,249,10,10
59995,61386,80,24052,80,17583,1529,16054,30,255,16,14
59996,56774,39553,10646,39553,70,70,0,2,8,2,0
59997,54105,443,23340,443,2227,1018,1209,17,16,8,9
59998,49285,53,48057,53,168,78,90,2,30,1,1
59999,60419,53,60419,53,217,87,130,2,30,1,1
60000,55890,53,46214,53,711,87,624,2,30,1,1
60001,57568,53,57568,53,235,98,137,2,30,1,1
60002,57371,53,40591,53,728,96,632,2,30,1,1
60003,59204,443,10417,443,9335,3052,6283,25,125,11,14
60004,40631,53,40631,53,262,107,155,2,30,1,1
60005,41426,443,52242,443,3396,1964,1432,16,361,8,8
60006,54397,443,59448,443,1786,172,1614,7,120,3,4
60007,50265,27034,40304,27034,480,149,331,2,1200,1,1
60008,42119,36237,0,0,66,66,0,1,0,1,0
60009,51439,445,0,0,70,70,0,1,0,1,0
60010,51837,37965,0,0,66,66,0,1,0,1,0
60011,51878,445,0,0,66,66,0,1,0,1,0
60012,49386,64147,0,0,62,62,0,1,0,1,0
60013,10262,11392,0,0,62,62,0,1,0,1,0
60014,64767,51221,0,0,62,62,0,1,0,1,0
60015,51464,23,0,0,60,60,0,1,0,1,0
60016,51436,445,0,0,70,70,0,1,0,1,0
60017,8999,15503,0,0,146,146,0,1,0,1,0
60018,1128,44847,0,0,62,62,0,1,0,1,0
60019,50102,17546,0,0,66,66,0,1,0,1,0
60020,45394,443,62065,443,1314,653,661,13,185,7,6
60021,49772,80,25587,80,1155,781,374,10,15,6,4
60022,49526,53,60849,53,402,118,284,2,30,1,1
60023,64998,27037,61288,27037,3287,2072,1215,12,30,6,6
60024,57009,53,8536,53,177,94,83,2,30,1,1
60025,49988,443,49988,443,1466,696,770,20,120,10,10
60026,50896,80,56677,80,11459959,142694,11317265,9719,135,1994,7725
60027,50917,80,57551,80,11626518,135099,11491419,9627,134,1907,7720
60028,50509,443,29330,443,9535,1246,8289,29,77,15,14
60029,53561,35885,64999,35885,70,70,0,2,7,2,0
60030,45540,8100,64668,8100,78,78,0,1,4,1,0
60031,51736,34343,51970,34343,70,70,0,1,5,1,0
60032,65366,443,3510,443,4319,2473,1846,24,85,10,14
60033,53505,8102,48744,8102,1495,843,652,10,30,5,5
60034,21909,53,21909,53,197,90,107,2,30,1,1
60035,50941,443,22406,443,12831,2277,10554,37,145,17,20
60036,57224,53,20310,53,532,198,334,6,50,3,3
60037,55067,443,14245,443,1146,360,786,20,75,7,13
60038,50899,80,62536,80,13974043,173337,13800706,11715,134,2429,9286
60039,50508,443,43933,443,5938,1012,4926,20,77,11,9
60040,43837,443,27944,443,70,70,0,1,4,1,0
60041,50507,443,55208,443,7171,1729,5442,24,78,13,11
60042,60746,40010,7294,40010,316,136,180,6,6,3,3
60043,53543,51819,47777,51819,70,70,0,1,4,1,0
60044,33730,443,53132,443,5947,1579,4368,22,315,12,10
60045,35343,80,43757,80,953,538,415,11,318,6,5
60046,57223,443,27688,443,24283,14945,9338,46,318,26,20
60047,50679,443,24042,443,14172,2714,11458,32,637,13,19
60048,55946,443,34803,443,9274,5282,3992,42,186,22,20
60049,65273,53,14991,53,338,110,228,2,29,1,1
60050,64338,53,55215,53,292,102,190,2,29,1,1
60051,44883,53,44883,53,216,90,126,2,29,1,1
60052,65348,53,17423,53,177,94,83,2,29,1,1
60053,56776,18318,59158,18318,70,70,0,1,5,1,0
60054,43483,443,14734,443,144138,17538,126600,275,300,115,160
60055,58659,53,58909,53,167,78,89,2,30,1,1
60056,54322,27015,10656,27015,924,924,0,3,30,3,0
60057,55154,443,28417,443,1610,771,839,22,120,11,11
60058,56176,53,8371,53,194,102,92,2,30,1,1
60059,65263,80,27562,80,7440,4032,3408,48,629,25,23
60060,56775,20617,28248,20617,70,70,0,2,8,2,0
60061,51748,15177,40687,15177,70,70,0,2,9,2,0
60062,56601,80,22349,80,234,234,0,4,12,4,0
60063,43488,443,22133,443,6817,1221,5596,26,285,14,12
60064,44847,46972,13667,46972,150,150,0,1,1200,1,0
60065,36961,443,20198,443,7326,1399,5927,29,280,15,14
60066,57396,53,39255,53,358,102,256,2,30,1,1
60067,55114,53,53852,53,392,100,292,4,33,2,2
60068,51576,443,13071,443,9753,2821,6932,39,201,22,17
60069,8986,443,12105,443,8062,2804,5258,43,161,20,23
60070,46442,80,6730,80,1373,669,704,10,16,5,5
60071,49774,53,5014,53,236,94,142,2,30,1,1
60072,41418,443,15753,443,6670,1576,5094,23,200,13,10
60073,64706,27065,37449,27065,924,924,0,3,30,3,0
60074,55229,53,55587,53,199,94,105,2,30,1,1
60075,59175,53,63239,53,168,78,90,2,30,1,1
60076,57009,53,48433,53,177,94,83,2,30,1,1
60077,50714,443,52657,443,9477,1950,7527,31,181,14,17
60078,44252,443,6888,443,14455,6007,8448,45,120,26,19
60079,51735,50794,12843,50794,70,70,0,1,5,1,0
60080,56395,443,48597,443,77506,2940,74566,100,80,38,62
60081,39527,443,33957,443,8447,3506,4941,28,333,15,13
60082,54321,27015,6955,27015,924,924,0,3,30,3,0
60083,54320,27016,28839,27016,924,924,0,3,30,3,0
60084,35587,123,5043,123,184,94,90,2,30,1,1
60085,6882,8999,49067,8999,238,118,120,2,1200,1,1
60086,65262,80,27207,80,8814,4800,4014,52,629,27,25
60087,61384,80,43597,80,2526,843,1683,12,255,7,5
60088,63264,53,63264,53,197,90,107,2,30,1,1
60089,49796,53,34008,53,238,102,136,2,30,1,1
60090,61256,443,47931,443,2680,255,2425,9,120,4,5
60091,65427,443,32092,443,14205,1527,12678,13,147,2,11
60092,50901,80,6668,80,14661588,141996,14519592,11768,134,2012,9756
60093,55597,7485,9099,7485,70,70,0,2,8,2,0
60094,50903,80,42549,80,13644327,154437,13489890,11257,134,2201,9056
60095,51752,31677,2687,31677,70,70,0,2,8,2,0
60096,7595,80,7595,80,34707,1796,32911,45,45,20,25
60097,57353,443,32586,443,150,150,0,1,5,1,0
60098,56777,42486,21252,42486,70,70,0,1,5,1,0
60099,56964,53,13707,53,267,87,180,4,57,2,2
60100,28989,53,28989,53,197,90,107,2,29,1,1
60101,61492,80,29860,80,901,398,503,10,15,5,5
60102,62109,443,64847,443,21219,1329,19890,32,122,13,19
60103,65287,53,32403,53,222,86,136,2,30,1,1
60104,56126,53,59441,53,336,110,226,2,29,1,1
60105,55567,53,55567,53,216,90,126,2,30,1,1
60106,49553,53,5635,53,614,239,375,6,53,3,3
60107,58664,53,10827,53,167,78,89,2,29,1,1
60108,49419,53,3552,53,343,100,243,4,52,2,2
60109,43484,443,55073,443,130,70,60,2,15,1,1
60110,49610,53,9285,53,168,78,90,2,30,1,1
60111,57588,443,16925,443,9109,2044,7065,25,22,14,11
60112,50645,53,27805,53,177,94,83,2,30,1,1
60113,50500,443,60385,443,12556,1134,11422,28,78,13,15
60114,50502,443,59383,443,11323,3376,7947,29,77,16,13
60115,50504,443,47105,443,5476,1073,4403,22,78,12,10
60116,52629,53,0,0,418,154,264,4,33,2,2
60117,46641,8100,2386,8100,78,78,0,1,4,1,0
60118,64657,53,35491,53,370,96,274,4,39,2,2
60119,4184,53,4184,53,216,90,126,2,29,1,1
60120,59179,53,29104,53,260,86,174,2,30,1,1
60121,50209,53,40978,53,86,86,0,1,30,1,0
60122,56174,443,33268,443,1310,649,661,13,185,7,6
60123,45392,443,53669,443,1312,651,661,13,185,7,6
60124,65251,80,48445,80,6352,4052,2300,44,630,23,21
60125,65466,443,13984,443,478996,13760,465236,490,16,171,319
60126,61712,80,5502,80,1864,1024,840,10,16,6,4
60127,51667,25826,43364,25826,9372,9372,0,11,30,11,0
60128,56291,53,51569,53,260,102,158,2,30,1,1
60129,58658,53,27150,53,260,86,174,2,30,1,1
60130,46297,80,56497,80,1155,781,374,10,15,6,4
60131,43482,443,29764,443,2316,1280,1036,20,278,11,9
60132,35509,3389,35509,3389,4224,2055,2169,22,21,13,9
60133,50645,53,59508,53,177,94,83,2,30,1,1
60134,54807,53,14408,53,206,86,120,2,30,1,1
60135,50825,443,30672,443,252960,10277,242683,301,209,119,182
60136,52321,443,49472,443,10320,5152,5168,45,15,25,20
60137,43487,443,8725,443,6886,1291,5595,27,285,15,12
60138,41296,80,53379,80,1056,682,374,10,15,6,4
60139,65379,443,56474,443,4514,2844,1670,29,84,14,15
60140,65264,80,41866,80,7440,4032,3408,48,629,25,23
60141,17532,53,17532,53,233,90,143,2,31,1,1
60142,52322,53,58058,53,86,86,0,1,30,1,0
60143,60163,443,11476,443,3041,1745,1296,28,3600,15,13
60144,56176,443,9976,443,1312,651,661,13,185,7,6
60145,55928,443,33892,443,5433,3275,2158,16,135,8,8
60146,53541,59939,18832,59939,70,70,0,1,5,1,0
60147,65465,443,59471,443,92040,4799,87241,107,16,43,64
60148,61835,443,61835,443,21703,2433,19270,44,76,18,26
60149,51797,80,9284,80,1929,796,1133,21,135,11,10
60150,61834,443,61834,443,220115,6038,214077,231,76,78,153
60151,50229,443,13758,443,6846,2479,4367,41,256,19,22
60152,50915,80,27954,80,10548172,142265,10405907,9105,134,1982,7123
60153,63968,53,61368,53,310,142,168,2,30,1,1
60154,58562,3389,58562,3389,5387,1909,3478,22,21,10,12
60155,50911,80,6093,80,13780884,170419,13610465,11542,134,2387,9155
60156,44187,443,10571,443,12382,2688,9694,37,361,19,18
60157,56462,445,0,0,70,70,0,1,0,1,0
60158,56454,445,0,0,70,70,0,1,0,1,0
60159,56450,445,0,0,70,70,0,1,0,1,0
60160,26531,37965,0,0,62,62,0,1,0,1,0
60161,51431,445,0,0,70,70,0,1,0,1,0
60162,50784,52952,0,0,66,66,0,1,0,1,0
60163,37568,443,2020,443,499,425,74,4,0,3,1
60164,37564,443,36169,443,499,425,74,4,0,3,1
60165,37567,443,17651,443,499,425,74,4,0,3,1
60166,37566,443,23464,443,499,425,74,4,0,3,1
60167,37563,443,52126,443,499,425,74,4,0,3,1
60168,37565,443,6723,443,499,425,74,4,0,3,1
60169,55865,64147,0,0,66,66,0,1,0,1,0
60170,61315,48817,0,0,62,62,0,1,0,1,0
60171,51870,445,0,0,66,66,0,1,0,1,0
60172,51430,445,0,0,70,70,0,1,0,1,0
60173,50788,48817,0,0,66,66,0,1,0,1,0
60174,51428,445,0,0,70,70,0,1,0,1,0
60175,34382,26314,0,0,143,143,0,1,0,1,0
60176,51244,16474,0,0,100,100,0,1,0,1,0
60177,59584,36237,0,0,66,66,0,1,0,1,0
60178,51244,21162,0,0,100,100,0,1,0,1,0
60179,58597,35440,0,0,62,62,0,1,0,1,0
60180,51244,29517,0,0,100,100,0,1,0,1,0
60181,51244,52290,0,0,100,100,0,1,0,1,0
60182,36656,64147,0,0,62,62,0,1,0,1,0
60183,51244,14984,0,0,100,100,0,1,0,1,0
60184,30114,65151,0,0,60,60,0,1,0,1,0
60185,51859,445,0,0,66,66,0,1,0,1,0
60186,51244,59353,0,0,100,100,0,1,0,1,0
60187,51244,57099,0,0,100,100,0,1,0,1,0
60188,56439,445,0,0,70,70,0,1,0,1,0
60189,36339,50584,0,0,62,62,0,1,0,1,0
60190,19570,50584,0,0,66,66,0,1,0,1,0
60191,1025,40108,0,0,146,146,0,1,0,1,0
60192,52802,56205,0,0,66,66,0,1,0,1,0
60193,60292,7129,0,0,62,62,0,1,0,1,0
60194,9659,81,0,0,60,60,0,1,0,1,0
60195,51856,445,0,0,66,66,0,1,0,1,0
60196,51421,445,0,0,70,70,0,1,0,1,0
60197,27328,21247,0,0,62,62,0,1,0,1,0
60198,51419,445,0,0,70,70,0,1,0,1,0
60199,54071,50265,0,0,62,62,0,1,0,1,0
60200,51848,445,0,0,66,66,0,1,0,1,0
60201,42128,54532,0,0,60,60,0,1,0,1,0
60202,51418,445,0,0,70,70,0,1,0,1,0
60203,51840,445,0,0,66,66,0,1,0,1,0
60204,51417,445,0,0,70,70,0,1,0,1,0
60205,51416,445,0,0,70,70,0,1,0,1,0
60206,51411,445,0,0,70,70,0,1,0,1,0
60207,54631,44847,0,0,74,74,0,1,0,1,0
60208,62780,35440,0,0,66,66,0,1,0,1,0
60209,11458,2767,0,0,66,66,0,1,0,1,0
60210,51398,445,0,0,70,70,0,1,0,1,0
60211,51397,445,0,0,70,70,0,1,0,1,0
60212,51391,445,0,0,70,70,0,1,0,1,0
60213,27442,44847,0,0,62,62,0,1,0,1,0
60214,26802,50584,0,0,146,146,0,1,0,1,0
60215,47173,35440,0,0,62,62,0,1,0,1,0
60216,51388,445,0,0,70,70,0,1,0,1,0
60217,51387,445,0,0,70,70,0,1,0,1,0
60218,26406,37965,0,0,66,66,0,1,0,1,0
60219,56430,445,0,0,70,70,0,1,0,1,0
60220,56428,445,0,0,70,70,0,1,0,1,0
60221,56427,445,0,0,70,70,0,1,0,1,0
60222,51832,445,0,0,66,66,0,1,0,1,0
60223,51833,445,0,0,66,66,0,1,0,1,0
60224,51834,445,0,0,66,66,0,1,0,1,0
60225,51831,445,0,0,66,66,0,1,0,1,0
60226,51827,445,0,0,66,66,0,1,0,1,0
60227,51829,445,0,0,66,66,0,1,0,1,0
60228,51828,445,0,0,66,66,0,1,0,1,0
60229,51826,445,0,0,66,66,0,1,0,1,0
60230,53475,3389,0,0,66,66,0,1,0,1,0
60231,22683,39210,0,0,60,60,0,1,0,1,0
60232,30443,44847,0,0,62,62,0,1,0,1,0
60233,14615,57866,0,0,66,66,0,1,0,1,0
60234,443,12105,0,0,66,66,0,1,0,1,0
60235,65501,57470,0,0,72,72,0,1,0,1,0
60236,62787,51221,0,0,66,66,0,1,0,1,0
60237,53211,22114,0,0,66,66,0,1,0,1,0
60238,6676,63836,0,0,145,145,0,1,0,1,0
60239,58977,37965,0,0,66,66,0,1,0,1,0
60240,51376,445,0,0,70,70,0,1,0,1,0
60241,53745,443,56954,443,499,425,74,4,0,3,1
60242,53744,443,46972,443,499,425,74,4,0,3,1
60243,7444,57470,0,0,66,66,0,1,0,1,0
60244,7222,57470,0,0,62,62,0,1,0,1,0
60245,6895,57354,0,0,148,148,0,1,0,1,0
60246,56422,445,0,0,70,70,0,1,0,1,0
60247,56417,445,0,0,70,70,0,1,0,1,0
60248,56412,445,0,0,70,70,0,1,0,1,0
60249,58748,80,58748,80,6516,564,5952,16,25,7,9
60250,14082,50584,0,0,66,66,0,1,0,1,0
60251,44258,25,0,0,74,74,0,1,0,1,0
60252,51814,445,0,0,66,66,0,1,0,1,0
60253,51813,445,0,0,66,66,0,1,0,1,0
60254,51812,445,0,0,66,66,0,1,0,1,0
60255,19858,64147,0,0,62,62,0,1,0,1,0
60256,56410,445,0,0,70,70,0,1,0,1,0
60257,33822,57470,0,0,66,66,0,1,0,1,0
60258,7301,14914,0,0,157,157,0,1,0,1,0
60259,51372,445,0,0,70,70,0,1,0,1,0
60260,56407,445,0,0,70,70,0,1,0,1,0
60261,56406,445,0,0,70,70,0,1,0,1,0
60262,56403,445,0,0,70,70,0,1,0,1,0
60263,56395,445,0,0,70,70,0,1,0,1,0
60264,33289,50584,0,0,62,62,0,1,0,1,0
60265,48676,53395,0,0,60,60,0,1,0,1,0
60266,51361,445,0,0,70,70,0,1,0,1,0
60267,51363,445,0,0,70,70,0,1,0,1,0
60268,56778,35440,0,0,66,66,0,1,0,1,0
60269,51359,445,0,0,70,70,0,1,0,1,0
60270,51358,445,0,0,70,70,0,1,0,1,0
60271,8999,57470,0,0,146,146,0,1,0,1,0
60272,51355,445,0,0,70,70,0,1,0,1,0
60273,20961,35440,0,0,62,62,0,1,0,1,0
60274,51074,80,51074,80,168467,7348,161119,184,8,67,117
60275,61241,22114,0,0,66,66,0,1,0,1,0
60276,54684,37965,0,0,62,62,0,1,0,1,0
60277,56453,37965,0,0,66,66,0,1,0,1,0
60278,6889,24748,0,0,143,143,0,1,0,1,0
60279,59156,50584,0,0,66,66,0,1,0,1,0
60280,60894,50584,0,0,62,62,0,1,0,1,0
60281,56390,445,0,0,70,70,0,1,0,1,0
60282,56385,445,0,0,70,70,0,1,0,1,0
60283,56383,445,0,0,70,70,0,1,0,1,0
60284,51350,445,0,0,70,70,0,1,0,1,0
60285,18291,37807,0,0,146,146,0,1,0,1,0
60286,46349,51505,0,0,74,74,0,1,0,1,0
60287,0,0,0,0,480,244,236,4,0,2,2
60288,3225,64147,0,0,66,66,0,1,0,1,0
60289,16221,50584,0,0,62,62,0,1,0,1,0
60290,51342,445,0,0,70,70,0,1,0,1,0
60291,51340,445,0,0,70,70,0,1,0,1,0
60292,51788,445,0,0,66,66,0,1,0,1,0
60293,56380,445,0,0,70,70,0,1,0,1,0
60294,16387,26193,0,0,60,60,0,1,0,1,0
60295,1027,44847,0,0,62,62,0,1,0,1,0
60296,50355,43890,0,0,66,66,0,1,0,1,0
60297,16387,35308,0,0,60,60,0,1,0,1,0
60298,16387,56995,0,0,60,60,0,1,0,1,0
60299,6712,123,0,0,90,90,0,1,0,1,0
60300,16524,22114,0,0,62,62,0,1,0,1,0
60301,61524,23,0,0,60,60,0,1,0,1,0
60302,51335,445,0,0,70,70,0,1,0,1,0
60303,51334,445,0,0,70,70,0,1,0,1,0
60304,5379,37965,0,0,66,66,0,1,0,1,0
60305,38926,37965,0,0,62,62,0,1,0,1,0
60306,1811,35440,0,0,62,62,0,1,0,1,0
60307,1024,64147,0,0,109,109,0,1,0,1,0
60308,51783,445,0,0,66,66,0,1,0,1,0
60309,1284,50584,0,0,66,66,0,1,0,1,0
60310,35269,61903,0,0,145,145,0,1,0,1,0
60311,28584,37965,0,0,62,62,0,1,0,1,0
60312,20844,64147,0,0,66,66,0,1,0,1,0
60313,64788,43890,0,0,66,66,0,1,0,1,0
60314,51782,445,0,0,66,66,0,1,0,1,0
60315,51330,445,0,0,70,70,0,1,0,1,0
60316,56368,445,0,0,70,70,0,1,0,1,0
60317,13188,35440,0,0,62,62,0,1,0,1,0
60318,56364,445,0,0,70,70,0,1,0,1,0
60319,56361,445,0,0,70,70,0,1,0,1,0
60320,56360,445,0,0,70,70,0,1,0,1,0
60321,51329,445,0,0,70,70,0,1,0,1,0
60322,51781,445,0,0,66,66,0,1,0,1,0
60323,45941,23388,0,0,60,60,0,1,0,1,0
60324,45941,23388,0,0,60,60,0,1,0,1,0
60325,59523,37965,0,0,62,62,0,1,0,1,0
60326,49516,35894,0,0,62,62,0,1,0,1,0
60327,63433,57866,0,0,62,62,0,1,0,1,0
60328,55618,56205,0,0,62,62,0,1,0,1,0
60329,56354,445,0,0,70,70,0,1,0,1,0
60330,56352,445,0,0,70,70,0,1,0,1,0
60331,56351,445,0,0,70,70,0,1,0,1,0
60332,56348,445,0,0,70,70,0,1,0,1,0
60333,51324,445,0,0,70,70,0,1,0,1,0
60334,57750,37965,0,0,146,146,0,1,0,1,0
60335,39475,443,29487,443,3310,2291,1019,17,16,10,7
60336,33968,443,15691,443,10073,4379,5694,33,42,17,16
60337,50306,443,54494,443,9889,2800,7089,28,82,17,11
60338,63750,63343,38388,63343,66,66,0,2,8,2,0
60339,51731,39392,29228,39392,66,66,0,1,5,1,0
60340,59738,443,4655,443,510,164,346,2,31,1,1
60341,57849,443,35072,443,11893,6064,5829,29,92,15,14
60342,39473,443,25041,443,11226,3340,7886,28,16,16,12
60343,43071,80,63845,80,808,480,328,13,158,9,4
60344,50696,80,3909,80,55872,28838,27034,234,175,117,117
60345,47932,443,21603,443,9467,2741,6726,24,20,15,9
60346,61622,80,61622,80,48702,2799,45903,74,110,38,36
60347,38283,443,38283,443,6981,948,6033,17,54,10,7
60348,50574,80,53098,80,2734,1250,1484,16,15,10,6
60349,60391,47212,53433,47212,258,70,188,4,8,2,2
60350,38085,443,1147,443,78,78,0,1,5,1,0
60351,56964,53,45347,53,267,87,180,4,54,2,2
60352,49465,443,57765,443,11184,6821,4363,27,53,14,13
60353,123,123,62754,123,184,94,90,2,30,1,1
60354,50692,80,35406,80,57678,29714,27964,241,175,120,121
60355,52452,80,35444,80,5582,591,4991,14,75,7,7
60356,50693,80,37544,80,56849,29352,27497,239,175,120,119
60357,39477,443,24151,443,3655,2308,1347,18,15,10,8
60358,60392,1134,52281,1134,70,70,0,2,8,2,0
60359,61836,443,61836,443,132180,4407,127773,146,75,51,95
60360,64530,53,55254,53,261,87,174,4,45,2,2
60361,49523,53,10736,53,728,96,632,2,30,1,1
60362,50695,80,60576,80,58726,30286,28440,246,175,123,123
60363,56559,443,41687,443,2723,1564,1159,15,17,9,6
60364,23317,443,22656,443,2227,1018,1209,17,15,8,9
60365,57470,44224,31554,44224,480,149,331,2,1200,1,1
60366,52454,80,19961,80,2425,529,1896,11,75,6,5
60367,52065,80,16889,80,81670,2359,79311,89,621,30,59
60368,50685,80,30111,80,60374,30984,29390,250,175,123,127
60369,53112,29258,11040,29258,70,70,0,2,8,2,0
60370,49171,443,1136,443,15437,8368,7069,40,361,19,21
60371,51946,443,31314,443,2666,1542,1124,17,17,9,8
60372,62111,443,62044,443,3262,256,3006,9,121,4,5
60373,51749,1408,51950,1408,70,70,0,1,5,1,0
60374,59737,53,18837,53,382,164,218,2,31,1,1
60375,61340,443,7462,443,31549,6352,25197,64,206,26,38
60376,56923,53,49262,53,711,87,624,2,30,1,1
60377,56772,61424,18304,61424,70,70,0,2,8,2,0
60378,39871,53,52816,53,198,93,105,2,31,1,1
60379,30960,45683,56128,45683,330,330,0,6,3609,6,0
60380,30960,45670,41313,45670,462,462,0,8,3632,8,0
60381,61030,443,16792,443,109010,37307,71703,152,895,62,90
60382,21365,23718,0,0,62,62,0,1,0,1,0
60383,51773,445,0,0,66,66,0,1,0,1,0
60384,51769,445,0,0,66,66,0,1,0,1,0
60385,51768,445,0,0,66,66,0,1,0,1,0
60386,51764,445,0,0,66,66,0,1,0,1,0
60387,52514,23,0,0,60,60,0,1,0,1,0
60388,28914,26296,0,0,159,159,0,1,0,1,0
60389,51763,445,0,0,66,66,0,1,0,1,0
60390,51762,445,0,0,66,66,0,1,0,1,0
60391,51761,445,0,0,66,66,0,1,0,1,0
60392,46495,4607,0,0,60,60,0,1,0,1,0
60393,1182,23,0,0,60,60,0,1,0,1,0
60394,61693,443,50704,443,12203,3519,8684,65,18,35,30
60395,50689,80,10754,80,54757,28216,26541,229,175,114,115
60396,50697,80,44763,80,54775,28230,26545,230,175,115,115
60397,50582,80,62835,80,53959,2683,51276,69,16,30,39
60398,31871,53,40960,53,209,86,123,2,29,1,1
60399,64375,53,1918,53,228,110,118,2,29,1,1
60400,57305,53,63466,53,177,94,83,2,30,1,1
60401,55054,443,7526,443,6903,1481,5422,33,612,12,21
60402,43214,443,49896,443,1563663,41030,1522633,1538,40,479,1059
60403,56734,45086,42195,45086,1640,460,1180,8,30,4,4
60404,50909,80,20271,80,12826704,145724,12680980,10558,133,2024,8534
60405,50902,80,26223,80,12578792,132594,12446198,10198,133,1845,8353
60406,52453,443,8871,443,6650,950,5700,18,75,9,9
60407,51733,30688,11073,30688,70,70,0,1,4,1,0
60408,53539,6881,61115,6881,492,306,186,8,14,5,3
60409,42922,80,60551,80,78,78,0,1,4,1,0
60410,52210,443,33908,443,6294,1716,4578,27,23,16,11
60411,51604,443,37096,443,7086,2173,4913,20,16,10,10
60412,57747,80,27520,80,2754,1602,1152,17,22,9,8
60413,34760,443,55387,443,70,70,0,1,4,1,0
60414,39948,5223,55367,5223,5551,1338,4213,28,1323,11,17
60415,64882,53,49587,53,279,126,153,2,30,1,1
60416,57470,8100,10100,8100,3281,894,2387,14,1200,7,7
60417,49848,53,60109,53,260,102,158,2,30,1,1
60418,60380,55125,31447,55125,70,70,0,1,5,1,0
60419,60382,62582,16978,62582,70,70,0,1,5,1,0
60420,51266,16103,3760,16103,70,70,0,2,8,2,0
60421,60062,53,61702,53,168,78,90,2,30,1,1
60422,38321,80,40490,80,543,469,74,6,16,5,1
60423,64530,53,18888,53,261,87,174,4,45,2,2
60424,64573,53,58393,53,558,104,454,4,49,2,2
60425,60385,59696,6029,59696,70,70,0,1,5,1,0
60426,43215,443,55751,443,3245691,49693,3195998,2856,38,666,2190
60427,59016,443,23931,443,12676,4222,8454,36,87,20,16
60428,50501,123,36469,123,184,94,90,2,30,1,1
60429,49621,443,55607,443,46983,4167,42816,66,44,28,38
60430,57305,53,33562,53,177,94,83,2,30,1,1
60431,60895,443,6009,443,9387,2961,6426,38,18,23,15
60432,9129,53,56648,53,205,86,119,2,30,1,1
60433,59739,443,20531,443,304,86,218,2,30,1,1
60434,12433,53,7842,53,208,86,122,2,30,1,1
60435,55339,443,4853,443,2552065,30474,2521591,2074,129,236,1838
60436,23560,53,25867,53,219,86,133,2,30,1,1
60437,60381,26312,40513,26312,70,70,0,1,5,1,0
60438,51734,59825,48074,59825,70,70,0,1,5,1,0
60439,51582,443,29660,443,9080,2186,6894,27,108,14,13
60440,62947,53,18275,53,213,86,127,2,30,1,1
60441,55596,53,49236,53,177,94,83,2,30,1,1
60442,51233,443,5696,443,9925,2939,6986,30,46,17,13
60443,39640,53,64225,53,168,78,90,2,30,1,1
60444,15503,42638,40530,42638,1367,664,703,16,1200,9,7
60445,50908,80,37284,80,14077960,171956,13906004,11755,133,2437,9318
60446,50694,80,5032,80,54760,27837,26923,229,175,114,115
60447,52455,443,34682,443,7356,1014,6342,20,75,10,10
60448,59419,80,51819,80,3442,1672,1770,19,22,10,9
60449,36065,443,10379,443,3171,1490,1681,22,21,12,10
60450,34856,443,47870,443,7524,1903,5621,31,22,18,13
60451,51750,54567,18193,54567,70,70,0,2,7,2,0
60452,46167,80,23731,80,234,234,0,4,11,4,0
60453,57416,66,12942,66,70,70,0,1,4,1,0
60454,7322,80,9945,80,950,485,465,9,16,5,4
60455,50824,443,63186,443,337727,11283,326444,367,208,126,241
60456,56964,53,17076,53,267,87,180,4,53,2,2
60457,61837,443,61837,443,18398,2360,16038,39,75,17,22
60458,47110,80,30489,80,436,222,214,7,19,4,3
60459,50602,443,33341,443,572966,109738,463228,1277,624,639,638
60460,33649,123,62077,123,184,94,90,2,30,1,1
60461,65248,53,8659,53,197,94,103,2,30,1,1
60462,64218,53,41220,53,212,94,118,2,30,1,1
60463,49915,53,47403,53,225,102,123,2,30,1,1
60464,34285,53,45642,53,168,78,90,2,30,1,1
60465,51798,80,50477,80,1825,824,1001,21,134,11,10
60466,56661,53,1967,53,900,110,790,2,30,1,1
60467,48362,443,23544,443,8075,1766,6309,22,78,13,9
60468,57165,53,9169,53,216,102,114,2,30,1,1
60469,41882,53,0,0,86,86,0,1,29,1,0
60470,28481,53,51837,53,205,86,119,2,30,1,1
60471,59740,53,42403,53,304,86,218,2,30,1,1
60472,52495,443,27354,443,787462,10645,776817,653,131,87,566
60473,59727,443,28777,443,304,86,218,2,31,1,1
60474,59725,443,21996,443,304,86,218,2,31,1,1
60475,37965,40840,26004,40840,150,150,0,1,1199,1,0
60476,49501,443,35522,443,13077,4380,8697,34,1881,17,17
60477,59731,443,4869,443,384,166,218,2,31,1,1
60478,51732,54299,38142,54299,70,70,0,1,5,1,0
60479,52907,80,17763,80,1659,653,1006,10,16,6,4
60480,44929,443,44929,443,5469,2222,3247,22,38,13,9
60481,41811,443,11732,443,28899,3134,25765,66,271,32,34
60482,59742,53,55013,53,448,166,282,2,30,1,1
60483,56207,53,30514,53,260,102,158,2,30,1,1
60484,39039,443,46475,443,3159,1237,1922,14,19,8,6
60485,56773,28093,5962,28093,70,70,0,2,8,2,0
60486,53220,80,25607,80,17976,840,17136,21,16,6,15
60487,56964,53,61136,53,267,87,180,4,59,2,2
60488,59741,443,12538,443,384,166,218,2,30,1,1
60489,54743,443,47896,443,166136,7244,158892,202,149,76,126
60490,52784,443,47288,443,2802,1626,1176,18,72,9,9
60491,64720,53,3807,53,216,102,114,2,30,1,1
60492,60044,443,17036,443,15769,1619,14150,17,141,4,13
60493,53069,443,18651,443,13074,8472,4602,31,135,16,15
60494,36936,443,13188,443,490,210,280,8,131,4,4
60495,36934,443,62872,443,490,210,280,8,131,4,4
60496,63171,5228,60967,5228,3535,1973,1562,36,3961,18,18
60497,62110,443,43597,443,10390,3051,7339,16,121,6,10
60498,53562,8999,49942,8999,320,140,180,6,6,3,3
60499,53540,34134,25153,34134,70,70,0,1,5,1,0
60500,50609,80,26280,80,4163,2891,1272,17,17,9,8
60501,50691,80,17442,80,55050,28089,26961,228,175,112,116
60502,42451,443,55087,443,4886,895,3991,16,31,9,7
60503,57264,53,9791,53,214,102,112,2,30,1,1
60504,50112,123,33230,123,184,94,90,2,30,1,1
60505,52493,443,57807,443,32907,8900,24007,38,16,16,22
60506,64530,53,39688,53,261,87,174,4,46,2,2
60507,63733,47013,29294,47013,70,70,0,1,5,1,0
60508,39486,80,4046,80,1184,524,660,7,78,4,3
60509,63530,3389,63530,3389,3489,1534,1955,17,19,9,8
60510,50482,443,21793,443,2520,1267,1253,17,83,9,8
60511,50481,443,21430,443,1258,716,542,13,83,7,6
60512,50684,80,24128,80,57576,29602,27974,239,175,118,121
60513,53214,80,58168,80,19877,856,19021,22,16,6,16
60514,123,123,8140,123,184,94,90,2,30,1,1
60515,56378,53,11573,53,214,102,112,2,30,1,1
60516,123,123,42021,123,184,94,90,2,30,1,1
60517,55704,53,11582,53,260,102,158,2,30,1,1
60518,59733,53,57614,53,384,166,218,2,30,1,1
60519,49777,443,42531,443,35152,27056,8096,56,104,31,25
60520,53556,1024,53867,1024,70,70,0,2,8,2,0
60521,63732,40642,2876,40642,70,70,0,1,5,1,0
60522,50703,80,3596,80,54304,27807,26497,227,175,113,114
60523,50978,80,46474,80,1442,700,742,12,35,6,6
60524,2980,53,2980,53,216,90,126,2,30,1,1
60525,62113,443,7270,443,3262,256,3006,9,121,4,5
60526,33109,443,18483,443,6749,1593,5156,23,123,12,11
60527,62865,443,23097,443,21313,7245,14068,48,128,22,26
60528,56345,445,0,0,70,70,0,1,0,1,0
60529,56343,445,0,0,70,70,0,1,0,1,0
60530,56342,445,0,0,70,70,0,1,0,1,0
60531,51948,37965,0,0,62,62,0,1,0,1,0
60532,51759,445,0,0,66,66,0,1,0,1,0
60533,52401,623,0,0,60,60,0,1,0,1,0
60534,56339,445,0,0,70,70,0,1,0,1,0
60535,51755,445,0,0,66,66,0,1,0,1,0
60536,51311,445,0,0,70,70,0,1,0,1,0
60537,57165,34101,0,0,66,66,0,1,0,1,0
60538,51753,445,0,0,66,66,0,1,0,1,0
60539,51752,445,0,0,66,66,0,1,0,1,0
60540,5180,57866,0,0,62,62,0,1,0,1,0
60541,53298,26467,0,0,66,66,0,1,0,1,0
60542,49501,11392,0,0,62,62,0,1,0,1,0
60543,51749,445,0,0,66,66,0,1,0,1,0
60544,51308,445,0,0,70,70,0,1,0,1,0
60545,59315,35440,0,0,66,66,0,1,0,1,0
60546,5223,5025,0,0,220,220,0,1,0,1,0
60547,6916,9822,0,0,100,100,0,1,0,1,0
60548,56335,445,0,0,70,70,0,1,0,1,0
60549,52650,36237,0,0,62,62,0,1,0,1,0
60550,56330,445,0,0,70,70,0,1,0,1,0
60551,56324,445,0,0,70,70,0,1,0,1,0
60552,55286,37965,0,0,66,66,0,1,0,1,0
60553,17177,64147,0,0,62,62,0,1,0,1,0
60554,29682,44847,0,0,62,62,0,1,0,1,0
60555,62148,37965,0,0,62,62,0,1,0,1,0
60556,51304,445,0,0,70,70,0,1,0,1,0
60557,51829,36134,0,0,66,66,0,1,0,1,0
60558,51302,445,0,0,70,70,0,1,0,1,0
60559,21998,51221,0,0,62,62,0,1,0,1,0
60560,51737,445,0,0,66,66,0,1,0,1,0
60561,51300,445,0,0,70,70,0,1,0,1,0
60562,4910,2149,0,0,66,66,0,1,0,1,0
60563,8999,50432,0,0,62,62,0,1,0,1,0
60564,42128,54532,0,0,60,60,0,1,0,1,0
60565,36538,64147,0,0,62,62,0,1,0,1,0
60566,4594,35993,0,0,66,66,0,1,0,1,0
60567,45941,23386,0,0,60,60,0,1,0,1,0
60568,62392,15503,0,0,146,146,0,1,0,1,0
60569,12471,31573,0,0,62,62,0,1,0,1,0
60570,51730,445,0,0,66,66,0,1,0,1,0
60571,28832,36237,0,0,62,62,0,1,0,1,0
60572,56311,445,0,0,70,70,0,1,0,1,0
60573,64776,50584,0,0,66,66,0,1,0,1,0
60574,1025,64147,0,0,62,62,0,1,0,1,0
60575,51293,445,0,0,70,70,0,1,0,1,0
60576,51727,445,0,0,66,66,0,1,0,1,0
60577,51291,445,0,0,70,70,0,1,0,1,0
60578,25565,54864,0,0,60,60,0,1,0,1,0
60579,52676,53733,0,0,66,66,0,1,0,1,0
60580,57837,64147,0,0,62,62,0,1,0,1,0
60581,51290,445,0,0,70,70,0,1,0,1,0
60582,51289,445,0,0,70,70,0,1,0,1,0
60583,51720,445,0,0,66,66,0,1,0,1,0
60584,51288,445,0,0,70,70,0,1,0,1,0
60585,63379,36237,0,0,66,66,0,1,0,1,0
60586,20650,26467,0,0,66,66,0,1,0,1,0
60587,51286,445,0,0,70,70,0,1,0,1,0
60588,51283,445,0,0,70,70,0,1,0,1,0
60589,58849,64147,0,0,62,62,0,1,0,1,0
60590,51713,445,0,0,66,66,0,1,0,1,0
60591,58486,57470,0,0,66,66,0,1,0,1,0
60592,9067,44847,0,0,62,62,0,1,0,1,0
60593,41908,1433,0,0,60,60,0,1,0,1,0
60594,53743,443,64755,443,495,421,74,4,1,3,1
60595,51270,445,0,0,70,70,0,1,0,1,0
60596,51268,445,0,0,70,70,0,1,0,1,0
60597,52439,35894,0,0,74,74,0,1,0,1,0
60598,51264,445,0,0,70,70,0,1,0,1,0
60599,51260,445,0,0,70,70,0,1,0,1,0
60600,51259,445,0,0,70,70,0,1,0,1,0
60601,52135,2790,0,0,66,66,0,1,0,1,0
60602,56303,445,0,0,70,70,0,1,0,1,0
60603,56301,445,0,0,70,70,0,1,0,1,0
60604,56299,445,0,0,70,70,0,1,0,1,0
60605,4041,50584,0,0,62,62,0,1,0,1,0
60606,51702,445,0,0,66,66,0,1,0,1,0
60607,51704,445,0,0,66,66,0,1,0,1,0
60608,51701,445,0,0,66,66,0,1,0,1,0
60609,51699,445,0,0,66,66,0,1,0,1,0
60610,51697,445,0,0,66,66,0,1,0,1,0
60611,51705,445,0,0,66,66,0,1,0,1,0
60612,51700,445,0,0,66,66,0,1,0,1,0
60613,51698,445,0,0,66,66,0,1,0,1,0
60614,51085,56205,0,0,66,66,0,1,0,1,0
60615,27084,50584,0,0,66,66,0,1,0,1,0
60616,60184,37965,0,0,66,66,0,1,0,1,0
60617,3352,50584,0,0,62,62,0,1,0,1,0
60618,51248,445,0,0,70,70,0,1,0,1,0
60619,64024,57470,0,0,66,66,0,1,0,1,0
60620,64341,57470,0,0,62,62,0,1,0,1,0
60621,54305,35440,0,0,62,62,0,1,0,1,0
60622,7889,48817,0,0,146,146,0,1,0,1,0
60623,52208,43890,0,0,66,66,0,1,0,1,0
60624,56298,445,0,0,70,70,0,1,0,1,0
60625,56292,445,0,0,70,70,0,1,0,1,0
60626,56285,445,0,0,70,70,0,1,0,1,0
60627,14397,37965,0,0,62,62,0,1,0,1,0
60628,51685,445,0,0,66,66,0,1,0,1,0
60629,51684,445,0,0,66,66,0,1,0,1,0
60630,51682,445,0,0,66,66,0,1,0,1,0
60631,3802,55777,0,0,66,66,0,1,0,1,0
60632,31845,55777,0,0,62,62,0,1,0,1,0
60633,50292,62413,0,0,146,146,0,1,0,1,0
60634,51244,445,0,0,70,70,0,1,0,1,0
60635,56282,445,0,0,70,70,0,1,0,1,0
60636,45941,23388,0,0,60,60,0,1,0,1,0
60637,56279,445,0,0,70,70,0,1,0,1,0
60638,51235,445,0,0,70,70,0,1,0,1,0
60639,51233,445,0,0,70,70,0,1,0,1,0
60640,56278,445,0,0,70,70,0,1,0,1,0
60641,56269,445,0,0,70,70,0,1,0,1,0
60642,56267,445,0,0,70,70,0,1,0,1,0
60643,51229,445,0,0,70,70,0,1,0,1,0
60644,51231,445,0,0,70,70,0,1,0,1,0
60645,1114,37965,0,0,62,62,0,1,0,1,0
60646,51227,445,0,0,70,70,0,1,0,1,0
60647,1024,44847,0,0,146,146,0,1,0,1,0
60648,55749,37965,0,0,66,66,0,1,0,1,0
60649,59411,37965,0,0,66,66,0,1,0,1,0
60650,53300,37807,0,0,66,66,0,1,0,1,0
60651,51745,30188,0,0,66,66,0,1,0,1,0
60652,22541,64147,0,0,66,66,0,1,0,1,0
60653,10003,64147,0,0,62,62,0,1,0,1,0
60654,8999,49001,0,0,146,146,0,1,0,1,0
60655,57360,18375,0,0,66,66,0,1,0,1,0
60656,51222,445,0,0,70,70,0,1,0,1,0
60657,32710,22114,0,0,62,62,0,1,0,1,0
60658,56262,445,0,0,70,70,0,1,0,1,0
60659,56259,445,0,0,70,70,0,1,0,1,0
60660,56255,445,0,0,70,70,0,1,0,1,0
60661,62970,44847,0,0,62,62,0,1,0,1,0
60662,53542,9192,0,0,148,148,0,1,0,1,0
60663,25091,64147,0,0,66,66,0,1,0,1,0
60664,52519,44847,0,0,66,66,0,1,0,1,0
60665,25602,64147,0,0,62,62,0,1,0,1,0
60666,1749,64147,0,0,66,66,0,1,0,1,0
60667,51214,445,0,0,70,70,0,1,0,1,0
60668,51212,445,0,0,70,70,0,1,0,1,0
60669,53960,30041,0,0,62,62,0,1,0,1,0
60670,25772,7302,0,0,66,66,0,1,0,1,0
60671,54894,9571,0,0,66,66,0,1,0,1,0
60672,11967,57470,0,0,62,62,0,1,0,1,0
60673,55413,37965,0,0,66,66,0,1,0,1,0
60674,10586,37965,0,0,62,62,0,1,0,1,0
60675,51661,445,0,0,66,66,0,1,0,1,0
60676,56279,23,0,0,60,60,0,1,0,1,0
60677,56251,445,0,0,70,70,0,1,0,1,0
60678,56246,445,0,0,70,70,0,1,0,1,0
60679,51207,445,0,0,70,70,0,1,0,1,0
60680,61185,54532,0,0,62,62,0,1,0,1,0
60681,51206,445,0,0,70,70,0,1,0,1,0
60682,61185,54532,0,0,145,145,0,1,0,1,0
60683,2522,64147,0,0,62,62,0,1,0,1,0
60684,51151,64147,0,0,66,66,0,1,0,1,0
60685,51202,445,0,0,70,70,0,1,0,1,0
60686,49744,80,36258,80,2455,475,1980,9,81,5,4
60687,50478,443,64929,443,36345,2308,34037,52,83,23,29
60688,52494,443,23008,443,5782,1008,4774,17,15,8,9
60689,64663,53,18610,53,578,286,292,9,15,5,4
60690,51139,80,1947,80,124,64,60,2,15,1,1
60691,49841,80,51896,80,3126,469,2657,9,75,5,4
60692,39474,443,60202,443,9766,2050,7716,23,15,12,11
60693,30960,45679,3682,45679,396,396,0,7,3615,7,0
60694,48817,6881,48817,6881,490,149,341,2,1200,1,1
60695,61696,443,54803,443,9097,2123,6974,25,16,15,10
60696,44910,443,16825,443,2841,1916,925,18,26,10,8
60697,50700,80,20685,80,55825,28792,27033,234,174,117,117
60698,54033,443,51149,443,43491,8521,34970,69,50,34,35
60699,50698,80,42687,80,54871,28320,26551,231,174,116,115
60700,50690,80,44292,80,56951,28706,28245,236,174,116,120
60701,24208,53,24208,53,231,88,143,2,32,1,1
60702,56769,11155,9985,11155,70,70,0,2,8,2,0
60703,50702,80,54989,80,55224,28254,26970,230,174,114,116
60704,22680,443,22680,443,18490,7811,10679,47,81,27,20
60705,55596,53,61686,53,170,87,83,2,30,1,1
60706,53533,22642,24303,22642,612,306,306,10,16,5,5
60707,60521,443,45323,443,45001,3799,41202,74,331,35,39
60708,39472,443,61496,443,9767,2138,7629,22,16,12,10
60709,43014,53,60826,53,198,93,105,2,30,1,1
60710,59729,53,2967,53,303,85,218,2,30,1,1
60711,56321,443,18769,443,4704,2423,2281,16,135,8,8
60712,53557,39731,46000,39731,70,70,0,2,8,2,0
60713,51378,3027,51378,3027,156,156,0,3,8,3,0
60714,50477,443,35054,443,2604,1413,1191,15,83,9,6
60715,51357,80,45603,80,124,64,60,2,16,1,1
60716,59730,443,46246,443,303,85,218,2,30,1,1
60717,44654,80,35775,80,2121,1558,563,13,16,7,6
60718,56704,53,33003,53,711,87,624,2,30,1,1
60719,51655,445,0,0,66,66,0,1,0,1,0
60720,21492,51505,0,0,62,62,0,1,0,1,0
60721,51653,445,0,0,66,66,0,1,0,1,0
60722,993,4281,0,0,66,66,0,1,0,1,0
60723,56239,445,0,0,70,70,0,1,0,1,0
60724,51200,445,0,0,70,70,0,1,0,1,0
60725,61013,41705,0,0,66,66,0,1,0,1,0
60726,49711,14984,0,0,66,66,0,1,0,1,0
60727,56237,445,0,0,70,70,0,1,0,1,0
60728,56234,445,0,0,70,70,0,1,0,1,0
60729,56232,445,0,0,70,70,0,1,0,1,0
60730,7842,23,0,0,60,60,0,1,0,1,0
60731,51651,445,0,0,66,66,0,1,0,1,0
60732,6666,3389,0,0,60,60,0,1,0,1,0
60733,38484,48637,0,0,60,60,0,1,0,1,0
60734,51105,50584,0,0,66,66,0,1,0,1,0
60735,53233,51221,0,0,66,66,0,1,0,1,0
60736,62331,61689,0,0,62,62,0,1,0,1,0
60737,35957,51185,0,0,60,60,0,1,0,1,0
60738,50994,35974,0,0,60,60,0,1,0,1,0
60739,51196,445,0,0,70,70,0,1,0,1,0
60740,56225,445,0,0,70,70,0,1,0,1,0
60741,42745,50011,0,0,62,62,0,1,0,1,0
60742,56224,445,0,0,70,70,0,1,0,1,0
60743,56222,445,0,0,70,70,0,1,0,1,0
60744,56220,445,0,0,70,70,0,1,0,1,0
60745,62338,50011,0,0,66,66,0,1,0,1,0
60746,51643,445,0,0,66,66,0,1,0,1,0
60747,30598,46824,0,0,62,62,0,1,0,1,0
60748,51641,445,0,0,66,66,0,1,0,1,0
60749,51640,445,0,0,66,66,0,1,0,1,0
60750,51639,445,0,0,66,66,0,1,0,1,0
60751,20371,35440,0,0,62,62,0,1,0,1,0
60752,51634,445,0,0,66,66,0,1,0,1,0
60753,51632,445,0,0,66,66,0,1,0,1,0
60754,51633,445,0,0,66,66,0,1,0,1,0
60755,52910,51221,0,0,78,78,0,1,0,1,0
60756,52975,23718,0,0,66,66,0,1,0,1,0
60757,50422,50584,0,0,66,66,0,1,0,1,0
60758,50734,37965,0,0,62,62,0,1,0,1,0
60759,56703,50584,0,0,66,66,0,1,0,1,0
60760,56218,445,0,0,70,70,0,1,0,1,0
60761,11582,41599,40027,41599,70,70,0,1,5,1,0
60762,51643,80,38570,80,499,192,307,6,38,4,2
60763,49836,53,62893,53,168,78,90,2,30,1,1
60764,6881,19215,41309,19215,509,150,359,2,1199,1,1
60765,50699,80,28391,80,54318,27824,26494,227,174,113,114
60766,34692,443,49759,443,3386,1833,1553,17,255,9,8
60767,63734,28221,28610,28221,70,70,0,1,4,1,0
60768,53536,34200,55165,34200,70,70,0,1,4,1,0
60769,50662,443,7273,443,4606,3263,1343,19,304,10,9
60770,65426,443,27740,443,14205,1527,12678,13,145,2,11
60771,59379,443,58325,443,4518,1784,2734,30,23,15,15
60772,53213,80,60340,80,18040,904,17136,22,15,7,15
60773,51657,80,10496,80,318,192,126,6,37,4,2
60774,49565,443,37074,443,378,192,186,7,14,4,3
60775,53563,17355,37621,17355,320,140,180,6,5,3,3
60776,14422,443,38791,443,1857,1218,639,18,95,11,7
60777,51658,80,29469,80,318,192,126,6,37,4,2
60778,56770,52920,52041,52920,70,70,0,2,8,2,0
60779,53559,58968,7595,58968,70,70,0,2,7,2,0
60780,51645,80,57006,80,318,192,126,6,38,4,2
60781,51632,80,60453,80,502,256,246,9,39,5,4
60782,55878,53,24199,53,260,102,158,2,29,1,1
60783,59736,53,9602,53,571,166,405,2,29,1,1
60784,59735,443,11235,443,512,166,346,2,29,1,1
60785,55596,53,19558,53,177,94,83,2,30,1,1
60786,56046,53,22169,53,289,160,129,3,29,2,1
60787,62112,443,63604,443,4655,1649,3006,10,120,5,5
60788,56732,10271,46976,10271,3090,1706,1384,16,30,10,6
60789,51650,80,16811,80,312,192,120,6,37,4,2
60790,51635,80,49291,80,318,192,126,6,39,4,2
60791,56665,53,16180,53,216,102,114,2,30,1,1
60792,56546,53,5266,53,177,94,83,2,30,1,1
60793,56060,53,26992,53,224,102,122,2,30,1,1
60794,64945,53,32076,53,733,94,639,2,30,1,1
60795,51654,80,46130,80,318,192,126,6,37,4,2
60796,48297,443,9986,443,7320,1817,5503,41,106,16,25
60797,53715,443,59918,443,70,70,0,1,5,1,0
60798,53111,50809,36816,50809,70,70,0,2,8,2,0
60799,56600,80,32176,80,234,234,0,4,12,4,0
60800,46415,443,41654,443,9307,2265,7042,31,325,13,18
60801,36676,443,44727,443,7636,3367,4269,24,319,13,11
60802,51634,80,59507,80,378,192,186,7,39,4,3
60803,59166,123,2980,123,184,94,90,2,30,1,1
60804,56912,53,43272,53,216,94,122,2,30,1,1
60805,35688,53,49808,53,199,94,105,2,30,1,1
60806,47302,53,19968,53,168,78,90,2,30,1,1
60807,33196,53,25269,53,181,86,95,2,30,1,1
60808,53864,53,19118,53,168,78,90,2,30,1,1
60809,56546,53,1301,53,177,94,83,2,30,1,1
60810,36932,443,8229,443,280,140,140,5,130,3,2
60811,39458,443,56911,443,1053,566,487,10,31,6,4
60812,51647,80,60876,80,378,192,186,7,38,4,3
60813,51444,443,44166,443,7658,1309,6349,24,75,13,11
60814,49723,80,53474,80,2367,557,1810,10,82,6,4
60815,39310,53,33057,53,199,94,105,2,30,1,1
60816,63628,53,35423,53,289,86,203,2,30,1,1
60817,53772,53,7783,53,70,70,0,1,30,1,0
60818,56920,53,48525,53,184,78,106,2,30,1,1
60819,51646,80,56559,80,378,192,186,7,38,4,3
60820,50483,443,29109,443,10050,1192,8858,28,81,14,14
60821,65371,443,38245,443,34653,2523,32130,65,83,26,39
60822,51653,80,24193,80,454,262,192,8,37,5,3
60823,29176,7000,29176,7000,4731,2270,2461,18,15,10,8
60824,54418,443,37950,443,3350,1804,1546,19,255,10,9
60825,48000,443,53560,443,7193,1890,5303,22,37,15,7
60826,40360,443,31288,443,3146,766,2380,10,120,5,5
60827,52965,443,12004,443,8602,1050,7552,16,120,7,9
60828,10976,22,10976,22,9240,3413,5827,59,37,26,33
60829,51637,80,27014,80,378,192,186,7,39,4,3
60830,39532,443,10682,443,345779,9537,336242,359,26,123,236
60831,35710,443,47207,443,1053,566,487,10,31,6,4
60832,30188,59035,2297,59035,1794,750,1044,12,4220,6,6
60833,53462,443,47212,443,6384,1091,5293,18,30,10,8
60834,35897,443,1439,443,6692,1642,5050,24,275,11,13
60835,51659,80,25484,80,318,192,126,6,37,4,2
60836,51102,443,49198,443,3402,1258,2144,13,135,6,7
60837,50014,80,33183,80,810,670,140,6,34,4,2
60838,51652,80,59640,80,454,262,192,8,37,5,3
60839,51644,80,3834,80,499,192,307,6,38,4,2
60840,50064,443,33198,443,6376,2499,3877,20,16,10,10
60841,60195,80,26973,80,3059,1869,1190,17,105,13,4
60842,51655,80,54219,80,318,192,126,6,37,4,2
60843,64530,53,20478,53,261,87,174,4,44,2,2
60844,35422,443,35422,443,5172,1925,3247,22,39,13,9
60845,39983,80,39983,80,6416,997,5419,17,30,8,9
60846,51636,80,6805,80,318,192,126,6,39,4,2
60847,52735,443,43904,443,41870,3567,38303,68,15,34,34
60848,53553,2297,8843,2297,70,70,0,2,7,2,0
60849,53215,443,56280,443,6983,1629,5354,17,15,9,8
60850,52064,80,62647,80,65658,3155,62503,76,621,26,50
60851,60393,46347,14352,46347,320,140,180,6,7,3,3
60852,51638,80,60451,80,318,192,126,6,39,4,2
60853,55596,53,2008,53,177,94,83,2,29,1,1
60854,48006,443,61488,443,1429,1295,134,10,30,8,2
60855,51497,443,32306,443,4710,699,4011,12,15,8,4
60856,53566,80,56289,80,2270749,47314,2223435,2132,99,651,1481
60857,58711,53,20725,53,277,78,199,2,30,1,1
60858,65235,53,39902,53,216,94,122,2,30,1,1
60859,59734,443,60915,443,512,166,346,2,29,1,1
60860,59178,53,27947,53,260,86,174,2,30,1,1
60861,59732,53,64408,53,384,166,218,2,30,1,1
60862,57629,443,51109,443,14555,5048,9507,82,134,33,49
60863,55877,47528,12404,47528,491,150,341,2,1200,1,1
60864,59728,53,43809,53,304,86,218,2,30,1,1
60865,59726,53,53950,53,304,86,218,2,30,1,1
60866,44979,443,39259,443,10311,2186,8125,26,186,14,12
60867,41039,443,10141,443,1053,566,487,10,31,6,4
60868,58046,443,22923,443,1536,1089,447,11,56,7,4
60869,56421,53,8309,53,177,94,83,2,30,1,1
60870,49160,51413,10192,51413,800,150,650,4,1200,2,2
60871,44404,443,27524,443,9060,3523,5537,27,319,15,12
60872,51633,80,4651,80,502,256,246,9,39,5,4
60873,46236,53,38054,53,199,94,105,2,30,1,1
60874,56261,53,65402,53,199,94,105,2,30,1,1
60875,11295,40033,17184,40033,156,94,62,2,30,1,1
60876,49872,53,15358,53,216,94,122,2,30,1,1
60877,51640,80,25604,80,2895,1428,1467,12,38,7,5
60878,52657,80,31996,80,26073,2868,23205,41,110,17,24
60879,51656,80,3808,80,318,192,126,6,37,4,2
60880,56771,43648,30018,43648,70,70,0,2,8,2,0
60881,50479,443,28335,443,1654,1011,643,16,82,9,7
60882,59724,53,63001,53,304,86,218,2,30,1,1
60883,59723,443,40207,443,304,86,218,2,30,1,1
60884,57173,53,39121,53,168,78,90,2,30,1,1
60885,55008,53,19602,53,215,102,113,2,30,1,1
60886,46970,443,52704,443,8394,3155,5239,28,271,16,12
60887,51221,65264,24402,65264,870,330,540,12,1573,6,6
60888,63744,47106,38855,47106,66,66,0,2,8,2,0
60889,60740,80,7735,80,254,128,126,5,16,3,2
60890,65109,53,42813,53,229,102,127,2,30,1,1
60891,56759,53,36247,53,733,94,639,2,31,1,1
60892,50353,443,35772,443,7397,1784,5613,27,306,13,14
60893,63741,36776,34457,36776,66,66,0,2,8,2,0
60894,57076,5222,34364,5222,15600,7789,7811,155,169,82,73
60895,51198,443,22207,443,8075,2723,5352,42,117,24,18
60896,57880,80,31507,80,13028,3246,9782,29,30,16,13
60897,7068,53,7068,53,197,90,107,2,30,1,1
60898,35132,53,35132,53,469,165,304,4,31,2,2
60899,51514,443,43958,443,2188,1329,859,23,19,13,10
60900,58701,27030,9286,27030,70,70,0,1,5,1,0
60901,65388,80,37790,80,1498,392,1106,10,16,5,5
60902,51466,443,4846,443,1878,1050,828,9,16,5,4
60903,49923,53,8519,53,702,194,508,6,67,3,3
60904,53785,53,12230,53,167,78,89,2,31,1,1
60905,56215,445,0,0,70,70,0,1,0,1,0
60906,56212,445,0,0,70,70,0,1,0,1,0
60907,45964,7778,0,0,60,60,0,1,0,1,0
60908,51183,445,0,0,70,70,0,1,0,1,0
60909,63583,37965,0,0,66,66,0,1,0,1,0
60910,51191,26467,0,0,66,66,0,1,0,1,0
60911,51628,445,0,0,66,66,0,1,0,1,0
60912,30599,46824,0,0,66,66,0,1,0,1,0
60913,56211,445,0,0,70,70,0,1,0,1,0
60914,53030,56205,0,0,66,66,0,1,0,1,0
60915,51625,445,0,0,66,66,0,1,0,1,0
60916,60960,49049,0,0,66,66,0,1,0,1,0
60917,62930,21247,0,0,66,66,0,1,0,1,0
60918,51623,445,0,0,66,66,0,1,0,1,0
60919,51622,445,0,0,66,66,0,1,0,1,0
60920,51180,445,0,0,70,70,0,1,0,1,0
60921,2904,44847,0,0,78,78,0,1,0,1,0
60922,46116,51505,0,0,62,62,0,1,0,1,0
60923,51619,445,0,0,66,66,0,1,0,1,0
60924,21294,57470,0,0,62,62,0,1,0,1,0
60925,46849,36237,0,0,66,66,0,1,0,1,0
60926,64219,51050,0,0,66,66,0,1,0,1,0
60927,48815,22114,0,0,146,146,0,1,0,1,0
60928,14084,43890,0,0,62,62,0,1,0,1,0
60929,37234,44847,0,0,62,62,0,1,0,1,0
60930,56206,445,0,0,70,70,0,1,0,1,0
60931,51176,445,0,0,70,70,0,1,0,1,0
60932,39823,36237,0,0,66,66,0,1,0,1,0
60933,51174,445,0,0,70,70,0,1,0,1,0
60934,56200,445,0,0,70,70,0,1,0,1,0
60935,56192,445,0,0,70,70,0,1,0,1,0
60936,1987,26467,0,0,62,62,0,1,0,1,0
60937,11716,37965,0,0,62,62,0,1,0,1,0
60938,10736,6112,0,0,60,60,0,1,0,1,0
60939,51172,445,0,0,70,70,0,1,0,1,0
60940,6666,8530,0,0,60,60,0,1,0,1,0
60941,51608,445,0,0,66,66,0,1,0,1,0
60942,34916,51185,0,0,62,62,0,1,0,1,0
60943,51601,445,0,0,66,66,0,1,0,1,0
60944,60923,49903,0,0,66,66,0,1,0,1,0
60945,51165,445,0,0,70,70,0,1,0,1,0
60946,56183,445,0,0,70,70,0,1,0,1,0
60947,35657,48637,0,0,62,62,0,1,0,1,0
60948,25523,35974,0,0,62,62,0,1,0,1,0
60949,48478,49903,0,0,62,62,0,1,0,1,0
60950,51163,445,0,0,70,70,0,1,0,1,0
60951,33405,37965,0,0,62,62,0,1,0,1,0
60952,51599,445,0,0,66,66,0,1,0,1,0
60953,58715,57470,0,0,62,62,0,1,0,1,0
60954,51162,445,0,0,70,70,0,1,0,1,0
60955,51161,445,0,0,70,70,0,1,0,1,0
60956,51160,445,0,0,70,70,0,1,0,1,0
60957,51157,445,0,0,70,70,0,1,0,1,0
60958,51156,445,0,0,70,70,0,1,0,1,0
60959,1036,64147,0,0,62,62,0,1,0,1,0
60960,51590,445,0,0,66,66,0,1,0,1,0
60961,62452,21247,0,0,66,66,0,1,0,1,0
60962,51586,445,0,0,66,66,0,1,0,1,0
60963,13279,10387,0,0,159,159,0,1,0,1,0
60964,6057,51221,0,0,62,62,0,1,0,1,0
60965,53737,443,15661,443,499,425,74,4,0,3,1
60966,53738,443,58635,443,499,425,74,4,0,3,1
60967,53739,443,35645,443,499,425,74,4,0,3,1
60968,53735,443,34476,443,499,425,74,4,0,3,1
60969,53736,443,20137,443,499,425,74,4,0,3,1
60970,53733,443,35168,443,499,425,74,4,0,3,1
60971,53734,443,22403,443,499,425,74,4,0,3,1
60972,53732,443,58255,443,499,425,74,4,0,3,1
60973,53730,443,15340,443,499,425,74,4,0,3,1
60974,53729,443,15910,443,499,425,74,4,0,3,1
60975,53731,443,61889,443,499,425,74,4,0,3,1
60976,53727,443,53687,443,499,425,74,4,0,3,1
60977,35092,22,0,0,60,60,0,1,0,1,0
60978,51142,445,0,0,70,70,0,1,0,1,0
60979,51140,445,0,0,70,70,0,1,0,1,0
60980,51136,445,0,0,70,70,0,1,0,1,0
60981,51132,445,0,0,70,70,0,1,0,1,0
60982,51131,445,0,0,70,70,0,1,0,1,0
60983,53728,443,11260,443,499,425,74,4,0,3,1
60984,53725,443,12003,443,499,425,74,4,0,3,1
60985,53726,443,39961,443,499,425,74,4,0,3,1
60986,53721,443,9349,443,499,425,74,4,0,3,1
60987,53724,443,54768,443,499,425,74,4,0,3,1
60988,53723,443,16354,443,499,425,74,4,0,3,1
60989,53722,443,25032,443,499,425,74,4,0,3,1
60990,53720,443,24279,443,499,425,74,4,0,3,1
60991,53716,443,47571,443,499,425,74,4,0,3,1
60992,53717,443,51020,443,499,425,74,4,0,3,1
60993,53718,443,3459,443,499,425,74,4,0,3,1
60994,53719,443,17807,443,499,425,74,4,0,3,1
60995,56967,35440,0,0,66,66,0,1,0,1,0
60996,61600,56205,0,0,62,62,0,1,0,1,0
60997,56174,445,0,0,70,70,0,1,0,1,0
60998,56173,445,0,0,70,70,0,1,0,1,0
60999,56171,445,0,0,70,70,0,1,0,1,0
61000,51576,445,0,0,66,66,0,1,0,1,0
61001,51568,445,0,0,66,66,0,1,0,1,0
61002,51575,445,0,0,66,66,0,1,0,1,0
61003,51574,445,0,0,66,66,0,1,0,1,0
61004,51573,445,0,0,66,66,0,1,0,1,0
61005,51570,445,0,0,66,66,0,1,0,1,0
61006,51571,445,0,0,66,66,0,1,0,1,0
61007,51569,445,0,0,66,66,0,1,0,1,0
61008,50668,58833,0,0,66,66,0,1,0,1,0
61009,30920,64147,0,0,62,62,0,1,0,1,0
61010,51120,445,0,0,70,70,0,1,0,1,0
61011,6666,21,0,0,60,60,0,1,0,1,0
61012,2791,7302,0,0,62,62,0,1,0,1,0
61013,46557,57866,0,0,66,66,0,1,0,1,0
61014,56327,44512,0,0,66,66,0,1,0,1,0
61015,56168,445,0,0,70,70,0,1,0,1,0
61016,56165,445,0,0,70,70,0,1,0,1,0
61017,56156,445,0,0,70,70,0,1,0,1,0
61018,53771,37965,0,0,66,66,0,1,0,1,0
61019,56703,22,0,0,60,60,0,1,0,1,0
61020,51115,445,0,0,70,70,0,1,0,1,0
61021,25570,35440,0,0,62,62,0,1,0,1,0
61022,51553,445,0,0,66,66,0,1,0,1,0
61023,51555,445,0,0,66,66,0,1,0,1,0
61024,51554,445,0,0,66,66,0,1,0,1,0
61025,45941,23386,0,0,60,60,0,1,0,1,0
61026,54346,44847,0,0,62,62,0,1,0,1,0
61027,14309,56205,0,0,62,62,0,1,0,1,0
61028,56153,445,0,0,70,70,0,1,0,1,0
61029,51103,445,0,0,70,70,0,1,0,1,0
61030,51104,445,0,0,70,70,0,1,0,1,0
61031,51101,445,0,0,70,70,0,1,0,1,0
61032,51100,445,0,0,70,70,0,1,0,1,0
61033,43129,20220,0,0,62,62,0,1,0,1,0
61034,56151,445,0,0,70,70,0,1,0,1,0
61035,51097,445,0,0,70,70,0,1,0,1,0
61036,5637,23,0,0,60,60,0,1,0,1,0
61037,31061,23,0,0,60,60,0,1,0,1,0
61038,56148,445,0,0,70,70,0,1,0,1,0
61039,56145,445,0,0,70,70,0,1,0,1,0
61040,56144,445,0,0,70,70,0,1,0,1,0
61041,57226,51505,0,0,66,66,0,1,0,1,0
61042,57723,45129,0,0,148,148,0,1,0,1,0
61043,40480,30317,0,0,146,146,0,1,0,1,0
61044,63786,35440,0,0,62,62,0,1,0,1,0
61045,62569,44847,0,0,66,66,0,1,0,1,0
61046,51090,445,0,0,70,70,0,1,0,1,0
61047,56753,44847,0,0,62,62,0,1,0,1,0
61048,49831,30188,0,0,66,66,0,1,0,1,0
61049,15274,19473,0,0,62,62,0,1,0,1,0
61050,1114,37965,0,0,62,62,0,1,0,1,0
61051,56131,445,0,0,70,70,0,1,0,1,0
61052,56129,445,0,0,70,70,0,1,0,1,0
61053,56128,445,0,0,70,70,0,1,0,1,0
61054,60192,35440,0,0,66,66,0,1,0,1,0
61055,57729,19750,0,0,66,66,0,1,0,1,0
61056,51083,445,0,0,70,70,0,1,0,1,0
61057,51080,445,0,0,70,70,0,1,0,1,0
61058,59914,65473,0,0,145,145,0,1,0,1,0
61059,51076,445,0,0,70,70,0,1,0,1,0
61060,53395,50321,40284,50321,7546,4168,3378,37,53,24,13
61061,61460,80,11498,80,1507,1184,323,11,79,7,4
61062,58429,53,0,0,1254,160,1094,4,49,2,2
61063,57470,31381,16195,31381,792,792,0,13,1200,13,0
61064,57356,53,56372,53,815,95,720,2,30,1,1
61065,45434,443,37816,443,74123,16210,57913,106,57,52,54
61066,51730,33399,18349,33399,66,66,0,1,5,1,0
61067,61458,443,40730,443,3505,2042,1463,27,82,15,12
61068,42090,443,46273,443,5041,817,4224,20,373,8,12
61069,43098,443,63074,443,3133,1883,1250,19,16,9,10
61070,51745,2572,13644,2572,70,70,0,2,8,2,0
61071,49308,53,0,0,180,80,100,2,30,1,1
61072,51724,25807,42911,25807,66,66,0,1,5,1,0
61073,43735,53,43735,53,216,88,128,2,30,1,1
61074,49650,53,63255,53,322,110,212,4,30,2,2
61075,56421,53,23965,53,170,87,83,2,30,1,1
61076,51870,53,51870,53,825,99,726,2,30,1,1
61077,57061,53,26951,53,711,87,624,2,30,1,1
61078,53227,443,53227,443,4107,2486,1621,20,24,10,10
61079,53228,443,53228,443,4456,2436,2020,19,24,10,9
61080,38363,15000,1161,15000,130,70,60,2,6,1,1
61081,63751,17102,12860,17102,312,132,180,6,6,3,3
61082,49045,80,27391,80,1105,624,481,13,316,7,6
61083,54817,443,47884,443,12861,6761,6100,34,164,20,14
61084,54818,443,9214,443,13069,6969,6100,37,164,23,14
61085,51727,1024,54726,1024,66,66,0,1,5,1,0
61086,51744,1678,51884,1678,70,70,0,2,8,2,0
61087,50068,53,50068,53,240,96,144,2,30,1,1
61088,49650,53,21786,53,216,110,106,2,30,1,1
61089,56980,53,43925,53,701,88,613,2,30,1,1
61090,60913,443,14058,443,18805,1162,17643,28,135,11,17
61091,54032,53,0,0,195,79,116,2,31,1,1
61092,64933,53,1484,53,738,86,652,2,31,1,1
61093,19229,53,19229,53,213,87,126,2,31,1,1
61094,57281,53,58597,53,711,87,624,2,31,1,1
61095,56760,53,60380,53,760,96,664,2,31,1,1
61096,61716,443,60379,443,3168,1038,2130,16,136,8,8
61097,30960,45682,63379,45682,330,330,0,6,3609,6,0
61098,15503,27645,52952,27645,480,149,331,2,1200,1,1
61099,6881,6881,14545,6881,492,150,342,2,1200,1,1
61100,51075,445,0,0,70,70,0,1,0,1,0
61101,51530,445,0,0,66,66,0,1,0,1,0
61102,38484,48637,0,0,60,60,0,1,0,1,0
61103,56124,445,0,0,70,70,0,1,0,1,0
61104,56118,445,0,0,70,70,0,1,0,1,0
61105,42119,36237,0,0,66,66,0,1,0,1,0
61106,41156,53,41156,53,216,82,134,2,31,1,1
61107,49162,53,61794,53,371,94,277,2,29,1,1
61108,49650,53,24810,53,216,110,106,2,29,1,1
61109,123,123,13833,123,184,94,90,2,30,1,1
61110,57470,43155,32052,43155,594,594,0,10,1199,10,0
61111,58429,53,0,0,360,160,200,4,49,2,2
61112,64114,443,8780,443,1411,852,559,13,24,7,6
61113,51751,80,4770,80,1854,1360,494,12,15,7,5
61114,54350,443,6406,443,2402,1444,958,18,167,10,8
61115,60078,80,2527,80,1114,534,580,12,15,7,5
61116,54535,80,13360,80,4162,3455,707,14,15,8,6
61117,64574,53,64558,53,388,95,293,4,32,2,2
61118,60377,65054,58961,65054,624,318,306,10,15,5,5
61119,63743,46081,59158,46081,66,66,0,2,7,2,0
61120,55787,53,59622,53,229,102,127,2,29,1,1
61121,55488,53,31385,53,210,94,116,2,29,1,1
61122,49650,53,11402,53,216,110,106,2,30,1,1
61123,64742,53,25271,53,165,86,79,2,29,1,1
61124,52996,443,47538,443,22513,15188,7325,69,517,31,38
61125,61448,443,1765,443,6109,1902,4207,33,141,19,14
61126,34499,443,29656,443,19518,11774,7744,46,168,26,20
61127,50413,80,12074,80,8388,2010,6378,17,23,8,9
61128,50338,80,9655,80,2668,870,1798,13,47,7,6
61129,43206,443,34471,443,4550611,95139,4455472,4046,217,935,3111
61130,61953,443,64547,443,15246,5574,9672,60,391,27,33
61131,56143,53,42893,53,195,94,101,2,30,1,1
61132,52466,443,10561,443,5082,896,4186,16,70,8,8
61133,56356,2710,17176,2710,1222,747,475,10,23,5,5
61134,50409,443,27908,443,5386,4374,1012,18,34,11,7
61135,52944,53,19420,53,168,78,90,2,30,1,1
61136,53287,80,8055,80,2881,1001,1880,12,52,7,5
61137,56939,53,33751,53,351,94,257,2,30,1,1
61138,36390,443,36390,443,4563,1656,2907,19,28,11,8
61139,56998,53,2449,53,199,94,105,2,30,1,1
61140,64746,53,10441,53,260,86,174,2,30,1,1
61141,65313,53,33070,53,193,102,91,2,30,1,1
61142,59613,443,9064,443,10366,4530,5836,21,135,10,11
61143,53111,80,26592,80,45904,3904,42000,65,16,33,32
61144,49501,80,23659,80,183116,16652,166464,279,486,59,220
61145,8430,53,21349,53,80361,77433,2928,946,89,930,16
61146,64676,53,19072,53,276,94,182,2,30,1,1
61147,58853,443,38782,443,59754,9493,50261,131,367,68,63
61148,54954,443,24434,443,469752,21060,448692,589,64,265,324
61149,40890,53,0,0,86,86,0,1,30,1,0
61150,64123,53,16597,53,325,102,223,2,30,1,1
61151,60376,58302,44068,58302,624,318,306,10,15,5,5
61152,33588,443,49965,443,6382,2331,4051,24,109,13,11
61153,49268,443,60948,443,77368,9874,67494,139,100,65,74
61154,52711,443,64979,443,107997,3957,104040,135,80,51,84
61155,63742,26305,43986,26305,66,66,0,2,7,2,0
61156,49735,443,35310,443,6292,1682,4610,21,15,9,12
61157,51401,443,9077,443,130,70,60,2,4,1,1
61158,51729,63553,6792,63553,70,70,0,1,5,1,0
61159,52127,443,33029,443,18360,1198,17162,27,25,9,18
61160,56799,443,34365,443,5057,880,4177,16,70,8,8
61161,59636,80,29464,80,1352,848,504,13,169,8,5
61162,60807,443,39155,443,9127,2506,6621,38,146,20,18
61163,60874,443,2065,443,777438,37182,740256,940,64,407,533
61164,64742,53,28467,53,173,94,79,2,29,1,1
61165,60517,53,55123,53,215,94,121,2,29,1,1
61166,50408,443,29487,443,5638,4258,1380,19,34,11,8
61167,56421,53,33128,53,177,94,83,2,29,1,1
61168,64021,53,10744,53,339,118,221,2,29,1,1
61169,49308,53,0,0,627,80,547,2,29,1,1
61170,55367,443,46972,443,101466,17775,83691,225,74,112,113
61171,65313,53,6135,53,193,102,91,2,30,1,1
61172,64747,53,25665,53,167,78,89,2,30,1,1
61173,49397,53,28669,53,365,94,271,2,30,1,1
61174,1100,27540,17868,27540,132,70,62,2,30,1,1
61175,39312,443,51370,443,10148,2203,7945,37,120,19,18
61176,57238,53,58179,53,165,86,79,2,30,1,1
61177,49603,53,2204,53,238,110,128,2,30,1,1
61178,49965,53,21038,53,285,110,175,2,30,1,1
61179,50415,443,63011,443,2542,1504,1038,16,20,9,7
61180,51465,80,10875,80,913,410,503,10,15,5,5
61181,46799,443,46799,443,22215,2460,19755,39,198,15,24
61182,60390,56494,64175,56494,70,70,0,2,8,2,0
61183,51725,32787,46505,32787,70,70,0,1,5,1,0
61184,40648,443,10699,443,130,70,60,3,5,2,1
61185,55588,49737,20798,49737,504,318,186,8,15,5,3
61186,49503,80,52162,80,121857,7431,114426,166,486,38,128
61187,49500,80,17093,80,309313,41646,267667,433,486,113,320
61188,65527,53,57886,53,194,94,100,2,30,1,1
61189,41858,53,0,0,86,86,0,1,30,1,0
61190,35132,53,35132,53,86,86,0,1,30,1,0
61191,50265,55637,31401,55637,528,528,0,9,1200,9,0
61192,50417,80,26233,80,1658,1247,411,8,15,5,3
61193,60742,20010,30698,20010,70,70,0,1,5,1,0
61194,49493,80,3964,80,143422,12598,130824,226,487,52,174
61195,35287,443,46797,443,47587,20536,27051,345,581,173,172
61196,33444,53,33346,53,168,78,90,2,30,1,1
61197,55800,53,32257,53,177,94,83,2,30,1,1
61198,55800,53,5218,53,177,94,83,2,30,1,1
61199,6881,6881,60771,6881,150,150,0,1,1200,1,0
61200,51689,80,35961,80,16205,2525,13680,31,139,15,16
61201,55450,53,40253,53,213,102,111,2,30,1,1
61202,57238,53,29243,53,165,86,79,2,30,1,1
61203,56421,53,57015,53,177,94,83,2,30,1,1
61204,57240,53,54621,53,180,94,86,2,30,1,1
61205,33823,443,20715,443,8237,1724,6513,31,270,16,15
61206,39545,443,12909,443,5596,3797,1799,27,96,14,13
61207,65382,53,20411,53,274,94,180,2,30,1,1
61208,63847,443,57992,443,8012,4410,3602,20,135,10,10
61209,64655,53,25772,53,225,102,123,2,30,1,1
61210,55545,53,22001,53,177,94,83,2,30,1,1
61211,58932,53,21682,53,168,78,90,2,31,1,1
61212,44725,443,58969,443,7998,1347,6651,49,1647,10,39
61213,6881,6881,40959,6881,238,118,120,2,1200,1,1
61214,57470,64919,63117,64919,594,594,0,10,1199,10,0
61215,57470,56432,6012,56432,132,132,0,3,1199,3,0
61216,64966,53,51667,53,458,188,270,6,31,3,3
61217,53554,8999,6458,8999,130,70,60,3,6,2,1
61218,60745,40010,27877,40010,316,136,180,6,6,3,3
61219,48975,443,52782,443,130,70,60,3,5,2,1
61220,49767,80,33888,80,70,70,0,2,8,2,0
61221,63422,443,21466,443,10617247,317598,10299649,11317,243,4141,7176
61222,49435,443,3627,443,10377,3140,7237,23,52,11,12
61223,64631,53,54731,53,351,93,258,4,50,2,2
61224,64399,53,19303,53,373,90,283,4,53,2,2
61225,52731,443,19807,443,10819,5326,5493,45,16,27,18
61226,52277,80,52277,80,259496,6676,252820,249,28,74,175
61227,53548,23310,1766,23310,70,70,0,2,8,2,0
61228,55545,53,60601,53,177,94,83,2,30,1,1
61229,65276,53,46929,53,212,102,110,2,30,1,1
61230,49853,53,48467,53,811,94,717,2,30,1,1
61231,35957,51185,0,0,60,60,0,1,0,1,0
61232,1431,30041,0,0,62,62,0,1,0,1,0
61233,50994,35974,0,0,60,60,0,1,0,1,0
61234,6881,55108,0,0,148,148,0,1,0,1,0
61235,59584,36237,0,0,66,66,0,1,0,1,0
61236,55056,56205,0,0,66,66,0,1,0,1,0
61237,51071,445,0,0,70,70,0,1,0,1,0
61238,13567,23684,0,0,168,168,0,1,0,1,0
61239,40500,48817,0,0,143,143,0,1,0,1,0
61240,51070,445,0,0,70,70,0,1,0,1,0
61241,51528,445,0,0,66,66,0,1,0,1,0
61242,50877,30041,0,0,66,66,0,1,0,1,0
61243,50784,52952,0,0,66,66,0,1,0,1,0
61244,1128,44847,0,0,62,62,0,1,0,1,0
61245,1128,44847,0,0,146,146,0,1,0,1,0
61246,51524,445,0,0,66,66,0,1,0,1,0
61247,56115,445,0,0,70,70,0,1,0,1,0
61248,56109,445,0,0,70,70,0,1,0,1,0
61249,56105,445,0,0,70,70,0,1,0,1,0
61250,56104,445,0,0,70,70,0,1,0,1,0
61251,11842,35440,0,0,62,62,0,1,0,1,0
61252,51522,445,0,0,66,66,0,1,0,1,0
61253,58912,11392,0,0,62,62,0,1,0,1,0
61254,51065,445,0,0,70,70,0,1,0,1,0
61255,36339,50584,0,0,62,62,0,1,0,1,0
61256,17702,6881,0,0,62,62,0,1,0,1,0
61257,56098,445,0,0,70,70,0,1,0,1,0
61258,56096,445,0,0,70,70,0,1,0,1,0
61259,56095,445,0,0,70,70,0,1,0,1,0
61260,56092,445,0,0,70,70,0,1,0,1,0
61261,51514,445,0,0,66,66,0,1,0,1,0
61262,57351,62413,0,0,66,66,0,1,0,1,0
61263,51511,445,0,0,66,66,0,1,0,1,0
61264,51510,445,0,0,66,66,0,1,0,1,0
61265,51505,445,0,0,66,66,0,1,0,1,0
61266,18461,19473,0,0,66,66,0,1,0,1,0
61267,51503,445,0,0,66,66,0,1,0,1,0
61268,51504,445,0,0,66,66,0,1,0,1,0
61269,51502,445,0,0,66,66,0,1,0,1,0
61270,64106,64147,0,0,62,62,0,1,0,1,0
61271,45964,7776,0,0,60,60,0,1,0,1,0
61272,17916,48817,0,0,148,148,0,1,0,1,0
61273,51052,445,0,0,70,70,0,1,0,1,0
61274,56090,445,0,0,70,70,0,1,0,1,0
61275,56089,445,0,0,70,70,0,1,0,1,0
61276,56086,445,0,0,70,70,0,1,0,1,0
61277,51499,445,0,0,66,66,0,1,0,1,0
61278,56083,445,0,0,70,70,0,1,0,1,0
61279,51049,445,0,0,70,70,0,1,0,1,0
61280,62780,35440,0,0,66,66,0,1,0,1,0
61281,51495,445,0,0,66,66,0,1,0,1,0
61282,53406,44847,0,0,66,66,0,1,0,1,0
61283,26531,37965,0,0,62,62,0,1,0,1,0
61284,11458,2767,0,0,66,66,0,1,0,1,0
61285,61865,35440,0,0,66,66,0,1,0,1,0
61286,51494,445,0,0,66,66,0,1,0,1,0
61287,51491,445,0,0,66,66,0,1,0,1,0
61288,26406,37965,0,0,66,66,0,1,0,1,0
61289,59477,36829,0,0,62,62,0,1,0,1,0
61290,51490,445,0,0,66,66,0,1,0,1,0
61291,14615,57866,0,0,66,66,0,1,0,1,0
61292,30443,44847,0,0,62,62,0,1,0,1,0
61293,55196,10387,0,0,159,159,0,1,0,1,0
61294,53475,3389,0,0,66,66,0,1,0,1,0
61295,51535,64147,0,0,62,62,0,1,0,1,0
61296,4366,51505,0,0,62,62,0,1,0,1,0
61297,51043,445,0,0,70,70,0,1,0,1,0
61298,51041,445,0,0,70,70,0,1,0,1,0
61299,50113,51505,0,0,62,62,0,1,0,1,0
61300,56077,445,0,0,70,70,0,1,0,1,0
61301,60292,7129,0,0,62,62,0,1,0,1,0
61302,51038,445,0,0,70,70,0,1,0,1,0
61303,53211,22114,0,0,66,66,0,1,0,1,0
61304,56074,445,0,0,70,70,0,1,0,1,0
61305,56069,445,0,0,70,70,0,1,0,1,0
61306,19394,44847,0,0,62,62,0,1,0,1,0
61307,20706,37965,0,0,62,62,0,1,0,1,0
61308,65501,57470,0,0,72,72,0,1,0,1,0
61309,50972,443,8971,443,469,403,66,4,0,3,1
61310,37906,37965,0,0,62,62,0,1,0,1,0
61311,50081,57470,0,0,66,66,0,1,0,1,0
61312,6890,34729,0,0,146,146,0,1,0,1,0
61313,51480,445,0,0,66,66,0,1,0,1,0
61314,2467,2767,0,0,66,66,0,1,0,1,0
61315,45941,23386,0,0,60,60,0,1,0,1,0
61316,20133,2767,0,0,62,62,0,1,0,1,0
61317,58977,37965,0,0,66,66,0,1,0,1,0
61318,12668,42707,0,0,62,62,0,1,0,1,0
61319,51973,44847,0,0,62,62,0,1,0,1,0
61320,10262,11392,0,0,62,62,0,1,0,1,0
61321,1114,37965,0,0,62,62,0,1,0,1,0
61322,51031,445,0,0,70,70,0,1,0,1,0
61323,31136,50584,0,0,62,62,0,1,0,1,0
61324,51471,445,0,0,66,66,0,1,0,1,0
61325,51029,445,0,0,70,70,0,1,0,1,0
61326,56056,445,0,0,70,70,0,1,0,1,0
61327,61566,44847,0,0,66,66,0,1,0,1,0
61328,51028,445,0,0,70,70,0,1,0,1,0
61329,51027,445,0,0,70,70,0,1,0,1,0
61330,51468,445,0,0,66,66,0,1,0,1,0
61331,51026,445,0,0,70,70,0,1,0,1,0
61332,51023,445,0,0,70,70,0,1,0,1,0
61333,51020,445,0,0,70,70,0,1,0,1,0
61334,62696,50584,0,0,66,66,0,1,0,1,0
61335,51461,445,0,0,66,66,0,1,0,1,0
61336,13164,39033,0,0,145,145,0,1,0,1,0
61337,51008,445,0,0,70,70,0,1,0,1,0
61338,51007,445,0,0,70,70,0,1,0,1,0
61339,51453,445,0,0,66,66,0,1,0,1,0
61340,51001,445,0,0,70,70,0,1,0,1,0
61341,20961,35440,0,0,62,62,0,1,0,1,0
61342,50997,445,0,0,70,70,0,1,0,1,0
61343,50998,445,0,0,70,70,0,1,0,1,0
61344,59156,50584,0,0,66,66,0,1,0,1,0
61345,5200,6643,0,0,145,145,0,1,0,1,0
61346,56047,445,0,0,70,70,0,1,0,1,0
61347,56045,445,0,0,70,70,0,1,0,1,0
61348,56043,445,0,0,70,70,0,1,0,1,0
61349,3225,64147,0,0,66,66,0,1,0,1,0
61350,51443,445,0,0,66,66,0,1,0,1,0
61351,51446,445,0,0,66,66,0,1,0,1,0
61352,51444,445,0,0,66,66,0,1,0,1,0
61353,51438,445,0,0,66,66,0,1,0,1,0
61354,51445,445,0,0,66,66,0,1,0,1,0
61355,51439,445,0,0,66,66,0,1,0,1,0
61356,51441,445,0,0,66,66,0,1,0,1,0
61357,51440,445,0,0,66,66,0,1,0,1,0
61358,1873,37965,0,0,62,62,0,1,0,1,0
61359,50986,445,0,0,70,70,0,1,0,1,0
61360,3407,57866,0,0,66,66,0,1,0,1,0
61361,63503,42707,0,0,66,66,0,1,0,1,0
61362,64191,44847,0,0,62,62,0,1,0,1,0
61363,45964,2666,0,0,60,60,0,1,0,1,0
61364,47910,7454,0,0,60,60,0,1,0,1,0
61365,1025,35447,0,0,62,62,0,1,0,1,0
61366,5223,44091,0,0,220,220,0,1,0,1,0
61367,56041,445,0,0,70,70,0,1,0,1,0
61368,56040,445,0,0,70,70,0,1,0,1,0
61369,56028,445,0,0,70,70,0,1,0,1,0
61370,50982,445,0,0,70,70,0,1,0,1,0
61371,1284,50584,0,0,66,66,0,1,0,1,0
61372,51426,445,0,0,66,66,0,1,0,1,0
61373,51425,445,0,0,66,66,0,1,0,1,0
61374,51423,445,0,0,66,66,0,1,0,1,0
61375,45941,23388,0,0,60,60,0,1,0,1,0
61376,64788,43890,0,0,66,66,0,1,0,1,0
61377,50973,445,0,0,70,70,0,1,0,1,0
61378,50971,445,0,0,70,70,0,1,0,1,0
61379,56025,445,0,0,70,70,0,1,0,1,0
61380,50969,445,0,0,70,70,0,1,0,1,0
61381,50970,445,0,0,70,70,0,1,0,1,0
61382,50964,445,0,0,70,70,0,1,0,1,0
61383,56023,445,0,0,70,70,0,1,0,1,0
61384,20844,64147,0,0,66,66,0,1,0,1,0
61385,19858,64147,0,0,62,62,0,1,0,1,0
61386,56013,445,0,0,70,70,0,1,0,1,0
61387,56012,445,0,0,70,70,0,1,0,1,0
61388,56014,445,0,0,70,70,0,1,0,1,0
61389,30654,51221,0,0,72,72,0,1,0,1,0
61390,63925,37965,0,0,66,66,0,1,0,1,0
61391,33215,37965,0,0,62,62,0,1,0,1,0
61392,40885,23,0,0,60,60,0,1,0,1,0
61393,32974,37965,0,0,66,66,0,1,0,1,0
61394,21365,23718,0,0,62,62,0,1,0,1,0
61395,52802,56205,0,0,66,66,0,1,0,1,0
61396,53535,1393,14227,1393,70,70,0,1,5,1,0
61397,50285,80,56429,80,4064,607,3457,12,45,6,6
61398,57240,53,16899,53,176,90,86,2,30,1,1
61399,49708,443,54037,443,456387,11878,444509,427,81,121,306
61400,56759,55201,40009,55201,66,66,0,1,5,1,0
61401,53799,80,41607,80,1056,682,374,10,15,6,4
61402,50283,80,41911,80,5689,1015,4674,16,45,8,8
61403,59401,443,58968,443,3010,1892,1118,16,15,8,8
61404,51689,443,47234,443,8488,2174,6314,23,255,12,11
61405,51946,443,39002,443,8670,1805,6865,28,26,15,13
61406,40662,443,40662,443,4624,1717,2907,19,28,11,8
61407,59404,443,10904,443,2962,1844,1118,16,15,8,8
61408,63846,443,9201,443,3811,1538,2273,20,135,10,10
61409,34885,443,20315,443,80828,20592,60236,124,180,54,70
61410,51464,443,29786,443,575,326,249,10,15,6,4
61411,39338,443,49574,443,7624,1384,6240,23,17,12,11
61412,25150,53,25150,53,217,87,130,2,30,1,1
61413,52273,80,52273,80,156876,7015,149861,158,28,49,109
61414,60534,80,60534,80,84558,3469,81089,94,16,34,60
61415,52275,80,52275,80,210890,8286,202604,208,28,64,144
61416,52276,80,52276,80,222010,7236,214774,216,28,66,150
61417,60531,80,48244,80,2122,1559,563,13,16,7,6
61418,59402,443,55166,443,4821,1882,2939,19,15,9,10
61419,53892,443,40316,443,9312,4088,5224,23,76,13,10
61420,52274,80,52274,80,852970,14195,838775,769,28,207,562
61421,46858,15000,17792,15000,130,70,60,2,5,1,1
61422,2487,53,2487,53,235,90,145,2,33,1,1
61423,44956,443,44956,443,5220,1973,3247,22,38,13,9
61424,47388,443,27845,443,350,210,140,6,15,4,2
61425,41793,53,3227,53,168,78,90,2,30,1,1
61426,55545,53,10302,53,170,87,83,2,30,1,1
61427,55450,443,1835,443,4275,2479,1796,22,316,11,11
61428,60855,443,10736,443,598135,40549,557586,873,251,326,547
61429,15792,3478,30536,3478,428935914,213443641,215492273,635946,2242,308738,327208
61430,59403,443,13461,443,2866,1684,1182,16,15,8,8
61431,53550,1,56985,1,70,70,0,2,8,2,0
61432,59399,443,48462,443,66108,6145,59963,93,16,41,52
61433,49705,443,51038,443,156357,6403,149954,155,81,44,111
61434,50116,22,50116,22,184,120,64,4,11,3,1
61435,37460,443,55415,443,2885,1732,1153,16,256,9,7
61436,43681,443,58156,443,7235,1097,6138,21,27,10,11
61437,59400,443,43611,443,6489,2731,3758,19,16,10,9
61438,65261,53,13380,53,168,86,82,2,30,1,1
61439,55926,53,35022,53,184,94,90,2,30,1,1
61440,55401,53,40210,53,168,86,82,2,31,1,1
61441,60320,443,1355,443,4679,2232,2447,15,136,7,8
61442,63626,443,34704,443,15769,1619,14150,17,138,4,13
61443,53983,443,37079,443,2571,330,2241,12,135,5,7
61444,46663,53,46663,53,209,83,126,2,30,1,1
61445,40603,53,40603,53,240,96,144,2,31,1,1
61446,39166,53,0,0,82,82,0,1,31,1,0
61447,64180,53,16774,53,176,90,86,2,31,1,1
61448,51584,443,13301,443,12641,5741,6900,26,362,12,14
61449,65428,443,7165,443,14203,1525,12678,13,143,2,11
61450,39414,443,32057,443,4179,1480,2699,18,124,9,9
61451,51160,8090,0,0,60,60,0,1,0,1,0
61452,50958,445,0,0,70,70,0,1,0,1,0
61453,51159,8090,0,0,60,60,0,1,0,1,0
61454,21332,23,0,0,60,60,0,1,0,1,0
61455,46090,50584,0,0,62,62,0,1,0,1,0
61456,64382,44847,0,0,62,62,0,1,0,1,0
61457,50486,443,8859,443,5791,3692,2099,21,78,13,8
61458,61681,443,6029,443,5922,1917,4005,24,18,14,10
61459,38484,48637,0,0,60,60,0,1,0,1,0
61460,35957,51185,0,0,60,60,0,1,0,1,0
61461,50994,35974,0,0,60,60,0,1,0,1,0
61462,56006,445,0,0,70,70,0,1,0,1,0
61463,56005,445,0,0,70,70,0,1,0,1,0
61464,56001,445,0,0,70,70,0,1,0,1,0
61465,50951,445,0,0,70,70,0,1,0,1,0
61466,61216,12250,0,0,148,148,0,1,0,1,0
61467,50949,445,0,0,70,70,0,1,0,1,0
61468,33289,50584,0,0,62,62,0,1,0,1,0
61469,59037,51505,0,0,62,62,0,1,0,1,0
61470,57165,34101,0,0,66,66,0,1,0,1,0
61471,29706,50584,0,0,66,66,0,1,0,1,0
61472,50944,445,0,0,70,70,0,1,0,1,0
61473,50943,445,0,0,70,70,0,1,0,1,0
61474,39161,17,0,0,60,60,0,1,0,1,0
61475,46640,3780,0,0,60,60,0,1,0,1,0
61476,7744,32480,0,0,62,62,0,1,0,1,0
61477,51403,445,0,0,66,66,0,1,0,1,0
61478,45908,3383,0,0,60,60,0,1,0,1,0
61479,55997,445,0,0,70,70,0,1,0,1,0
61480,55990,445,0,0,70,70,0,1,0,1,0
61481,44147,64147,0,0,62,62,0,1,0,1,0
61482,29682,44847,0,0,62,62,0,1,0,1,0
61483,50937,445,0,0,70,70,0,1,0,1,0
61484,48600,23718,0,0,66,66,0,1,0,1,0
61485,23807,44847,0,0,62,62,0,1,0,1,0
61486,6881,10104,0,0,107,107,0,1,0,1,0
61487,52650,36237,0,0,62,62,0,1,0,1,0
61488,59523,37965,0,0,62,62,0,1,0,1,0
61489,50902,80,25107,80,5166,1278,3888,14,144,8,6
61490,57936,443,57936,443,18738,1904,16834,33,17,17,16
61491,45987,123,19536,123,184,94,90,2,30,1,1
61492,64169,53,57112,53,212,102,110,2,30,1,1
61493,57344,53,65328,53,177,94,83,2,30,1,1
61494,8430,53,61822,53,239209,233954,5255,2850,88,2822,28
61495,52272,80,52272,80,237488,7574,229914,231,27,71,160
61496,57240,53,32655,53,180,94,86,2,29,1,1
61497,51880,8001,48278,8001,86,86,0,1,29,1,0
61498,50238,53,16273,53,164,78,86,2,29,1,1
61499,49563,53,57038,53,199,94,105,2,29,1,1
61500,56236,443,26673,443,9597,2488,7109,32,287,16,16
61501,42385,443,55838,443,321621,14025,307596,408,41,185,223
61502,56326,80,40390,80,2541,689,1852,13,60,8,5
61503,49513,80,22592,80,476333,9582,466751,453,225,135,318
61504,49567,443,12074,443,6260,3089,3171,27,142,13,14
61505,52128,443,43146,443,16113,2152,13961,35,20,18,17
61506,54971,443,20430,443,13124,8442,4682,40,43,24,16
61507,55926,53,47769,53,184,94,90,2,29,1,1
61508,65074,53,7213,53,227,94,133,2,29,1,1
61509,57046,53,24095,53,234,94,140,2,29,1,1
61510,65330,53,59699,53,766,102,664,2,29,1,1
61511,53110,8830,31632,8830,70,70,0,2,8,2,0
61512,58478,53,13215,53,332,102,230,2,29,1,1
61513,53552,8999,58202,8999,70,70,0,2,7,2,0
61514,51880,8000,41455,8000,172,94,78,2,29,1,1
61515,49722,53,29083,53,215,94,121,2,30,1,1
61516,49477,53,25866,53,183,86,97,2,30,1,1
61517,61680,443,50542,443,12015,3771,8244,41,18,23,18
61518,56950,53,15623,53,363,109,254,4,46,2,2
61519,53529,17130,52813,17130,492,306,186,8,15,5,3
61520,37202,53,37202,53,216,90,126,2,30,1,1
61521,26900,443,4352,443,24703,16382,8321,49,21,28,21
61522,57902,443,28629,443,20509,7660,12849,54,131,28,26
61523,49930,53,51940,53,258,110,148,2,30,1,1
61524,38009,443,41561,443,130,70,60,3,5,2,1
61525,56424,80,11869,80,17135,1507,15628,24,22,9,15
61526,57344,53,21861,53,177,94,83,2,30,1,1
61527,54761,443,53919,443,103367,3730,99637,117,170,42,75
61528,65405,53,15243,53,210,102,108,2,30,1,1
61529,53108,80,57072,80,1797,1070,727,10,15,5,5
61530,52492,443,60482,443,33131,9092,24039,41,15,19,22
61531,46342,53,46342,53,220,90,130,2,30,1,1
61532,50903,80,4352,80,8600,1437,7163,18,144,10,8
61533,50575,443,24477,443,5197,3181,2016,50,261,26,24
61534,45396,53,7036,53,168,78,90,2,30,1,1
61535,49496,53,24067,53,194,102,92,2,30,1,1
61536,64806,53,2007,53,273,94,179,2,30,1,1
61537,57339,53,58719,53,248,94,154,2,30,1,1
61538,10151,6881,61137,6881,469,150,319,2,1200,1,1
61539,55314,53,61384,53,279,110,169,2,30,1,1
61540,57584,443,53316,443,915797,52405,863392,1231,269,604,627
61541,50934,443,50934,443,5661,2414,3247,22,37,13,9
61542,56755,53,8890,53,663,212,451,6,63,3,3
61543,64137,53,55466,53,228,94,134,2,30,1,1
61544,49787,53,45265,53,196,94,102,2,30,1,1
61545,60097,53,60097,53,193,90,103,2,30,1,1
61546,64874,53,41940,53,324,94,230,2,30,1,1
61547,62119,53,18352,53,239,102,137,2,30,1,1
61548,52706,53,0,0,82,82,0,2,40,2,0
61549,46056,80,34041,80,5066,4404,662,11,30,6,5
61550,61417,80,18297,80,214,140,74,4,55,3,1
61551,50320,53,20919,53,168,78,90,2,30,1,1
61552,56785,53,13080,53,213,102,111,2,30,1,1
61553,65466,53,26406,53,248,94,154,2,30,1,1
61554,63016,53,49407,53,243,94,149,2,30,1,1
61555,15503,11731,3627,11731,1188,1188,0,19,2298,19,0
61556,64566,443,6952,443,8573,2039,6534,25,31,14,11
61557,42440,443,11681,443,9412,2994,6418,27,48,16,11
61558,58753,443,28125,443,70,70,0,1,5,1,0
61559,51405,80,23596,80,1510,481,1029,11,20,6,5
61560,50208,1688,32119,1688,70,70,0,2,8,2,0
61561,55586,17332,8583,17332,70,70,0,1,5,1,0
61562,56464,443,4268,443,5058,913,4145,17,25,10,7
61563,53448,5223,10796,5223,134,60,74,3,4,2,1
61564,57183,53,5484,53,199,94,105,2,29,1,1
61565,49496,53,27238,53,194,102,92,2,30,1,1
61566,65016,53,63384,53,215,94,121,2,29,1,1
61567,57340,53,50973,53,258,110,148,2,30,1,1
61568,56782,53,60829,53,227,94,133,2,29,1,1
61569,64277,53,1694,53,337,110,227,2,30,1,1
61570,50000,53,40875,53,263,110,153,2,30,1,1
61571,49602,53,44779,53,247,102,145,2,30,1,1
61572,55926,53,60455,53,184,94,90,2,30,1,1
61573,55545,53,31002,53,177,94,83,2,30,1,1
61574,49430,53,18362,53,279,94,185,2,30,1,1
61575,55401,53,24581,53,168,86,82,2,30,1,1
61576,49973,53,45350,53,309,110,199,2,30,1,1
61577,36061,4500,28501,4500,12526,5944,6582,24,3599,11,13
61578,55635,53,55876,53,177,94,83,2,30,1,1
61579,64180,53,29611,53,180,94,86,2,31,1,1
61580,53109,80,20052,80,8176,1443,6733,20,15,10,10
61581,56599,80,32983,80,234,234,0,4,12,4,0
61582,59669,80,64457,80,2026957,42480,1984477,1975,80,655,1320
61583,50491,443,45806,443,1304,878,426,12,78,7,5
61584,55665,53,45679,53,229,94,135,2,30,1,1
61585,50433,53,61618,53,770,102,668,2,30,1,1
61586,65261,53,34538,53,168,86,82,2,30,1,1
61587,50870,80,58385,80,7313,1684,5629,15,148,8,7
61588,53526,45046,24762,45046,552,306,246,9,15,5,4
61589,63729,6969,28915,6969,70,70,0,1,5,1,0
61590,63725,80,55530,80,374,192,182,7,15,4,3
61591,52488,443,19422,443,7165,1099,6066,16,18,9,7
61592,58392,3389,58392,3389,4624,1524,3100,17,17,9,8
61593,50490,443,43169,443,1353,903,450,12,78,7,5
61594,55585,48063,18600,48063,70,70,0,1,5,1,0
61595,50542,443,10876,443,86426,3497,82929,102,170,38,64
61596,53521,8999,10502,8999,312,186,126,5,15,3,2
61597,40252,443,46211,443,543828,50144,493684,682,172,254,428
61598,44414,123,11306,123,184,94,90,2,30,1,1
61599,56103,53,56052,53,279,94,185,2,30,1,1
61600,57240,53,1415,53,180,94,86,2,30,1,1
61601,57123,53,38680,53,811,94,717,2,30,1,1
61602,55447,53,41152,53,194,102,92,2,30,1,1
61603,51221,57254,65381,57254,491,150,341,2,1200,1,1
61604,57347,443,57555,443,1081375,19607,1061768,921,122,142,779
61605,49722,53,50235,53,168,78,90,2,30,1,1
61606,49444,53,27495,53,199,94,105,2,30,1,1
61607,55317,53,59583,53,244,94,150,2,31,1,1
61608,57071,53,47529,53,274,110,164,2,31,1,1
61609,57366,53,60542,53,458,188,270,6,31,3,3
61610,55184,53,55740,53,443,92,351,4,31,2,2
61611,45726,443,49906,443,3068,1678,1390,17,242,9,8
61612,52292,443,35142,443,21680,2897,18783,35,120,15,20
61613,58143,443,15049,443,17812,8128,9684,55,343,27,28
61614,64611,53,46299,53,189,102,87,2,30,1,1
61615,43542,53,13639,53,168,78,90,2,30,1,1
61616,56631,53,31631,53,199,94,105,2,30,1,1
61617,50691,443,45100,443,152,86,66,2,6,1,1
61618,52491,443,12140,443,22753,7559,15194,31,16,16,15
61619,56970,53,18773,53,230,110,120,2,30,1,1
61620,55151,53,16947,53,285,102,183,2,30,1,1
61621,55956,53,7528,53,200,94,106,2,30,1,1
61622,51408,443,60315,443,8774,3355,5419,19,36,11,8
61623,38495,443,26566,443,7778,1724,6054,29,17,16,13
61624,65170,53,60576,53,771,102,669,2,30,1,1
61625,65414,53,10727,53,197,102,95,2,31,1,1
61626,64825,53,28794,53,184,94,90,2,31,1,1
61627,20389,64147,0,0,66,66,0,1,0,1,0
61628,11404,64147,0,0,62,62,0,1,0,1,0
61629,55286,37965,0,0,66,66,0,1,0,1,0
61630,41271,50584,0,0,146,146,0,1,0,1,0
61631,51130,61689,0,0,62,62,0,1,0,1,0
61632,50936,445,0,0,70,70,0,1,0,1,0
61633,44411,37965,0,0,62,62,0,1,0,1,0
61634,51397,445,0,0,66,66,0,1,0,1,0
61635,4594,35993,0,0,66,66,0,1,0,1,0
61636,51393,445,0,0,66,66,0,1,0,1,0
61637,55984,445,0,0,70,70,0,1,0,1,0
61638,43815,50584,0,0,146,146,0,1,0,1,0
61639,55979,445,0,0,70,70,0,1,0,1,0
61640,55978,445,0,0,70,70,0,1,0,1,0
61641,55976,445,0,0,70,70,0,1,0,1,0
61642,64000,44847,0,0,66,66,0,1,0,1,0
61643,50931,445,0,0,70,70,0,1,0,1,0
61644,51389,445,0,0,66,66,0,1,0,1,0
61645,60246,44612,0,0,66,66,0,1,0,1,0
61646,11136,15503,0,0,62,62,0,1,0,1,0
61647,52676,53733,0,0,66,66,0,1,0,1,0
61648,61495,37965,0,0,66,66,0,1,0,1,0
61649,55972,445,0,0,70,70,0,1,0,1,0
61650,64776,50584,0,0,66,66,0,1,0,1,0
61651,14360,64147,0,0,145,145,0,1,0,1,0
61652,55968,445,0,0,70,70,0,1,0,1,0
61653,55967,445,0,0,70,70,0,1,0,1,0
61654,55964,445,0,0,70,70,0,1,0,1,0
61655,51383,445,0,0,66,66,0,1,0,1,0
61656,59597,37965,0,0,66,66,0,1,0,1,0
61657,4431,32480,0,0,66,66,0,1,0,1,0
61658,51380,445,0,0,66,66,0,1,0,1,0
61659,51378,445,0,0,66,66,0,1,0,1,0
61660,51375,445,0,0,66,66,0,1,0,1,0
61661,47132,1433,0,0,60,60,0,1,0,1,0
61662,59241,62413,0,0,62,62,0,1,0,1,0
61663,53051,44847,0,0,62,62,0,1,0,1,0
61664,51372,445,0,0,66,66,0,1,0,1,0
61665,51373,445,0,0,66,66,0,1,0,1,0
61666,51371,445,0,0,66,66,0,1,0,1,0
61667,50917,445,0,0,70,70,0,1,0,1,0
61668,20650,26467,0,0,66,66,0,1,0,1,0
61669,42995,26467,0,0,62,62,0,1,0,1,0
61670,50914,445,0,0,70,70,0,1,0,1,0
61671,55962,445,0,0,70,70,0,1,0,1,0
61672,55960,445,0,0,70,70,0,1,0,1,0
61673,55956,445,0,0,70,70,0,1,0,1,0
61674,51369,445,0,0,66,66,0,1,0,1,0
61675,54204,443,58891,443,499,425,74,4,0,3,1
61676,54196,443,33780,443,499,425,74,4,0,3,1
61677,54195,443,37622,443,499,425,74,4,0,3,1
61678,54199,443,31908,443,499,425,74,4,0,3,1
61679,54198,443,37713,443,499,425,74,4,0,3,1
61680,52439,35894,0,0,74,74,0,1,0,1,0
61681,36906,50584,0,0,146,146,0,1,0,1,0
61682,55955,445,0,0,70,70,0,1,0,1,0
61683,42252,33303,0,0,60,60,0,1,0,1,0
61684,49516,35894,0,0,62,62,0,1,0,1,0
61685,443,48120,0,0,97,97,0,1,0,1,0
61686,51365,445,0,0,66,66,0,1,0,1,0
61687,49516,35894,0,0,145,145,0,1,0,1,0
61688,38681,15503,0,0,74,74,0,1,0,1,0
61689,51963,22114,0,0,66,66,0,1,0,1,0
61690,51363,445,0,0,66,66,0,1,0,1,0
61691,51362,445,0,0,66,66,0,1,0,1,0
61692,37998,26467,0,0,66,66,0,1,0,1,0
61693,47132,1433,0,0,60,60,0,1,0,1,0
61694,50910,445,0,0,70,70,0,1,0,1,0
61695,50908,445,0,0,70,70,0,1,0,1,0
61696,65016,37965,0,0,66,66,0,1,0,1,0
61697,42075,36237,0,0,62,62,0,1,0,1,0
61698,43099,5900,0,0,60,60,0,1,0,1,0
61699,50906,445,0,0,70,70,0,1,0,1,0
61700,17777,30188,0,0,62,62,0,1,0,1,0
61701,55953,445,0,0,70,70,0,1,0,1,0
61702,55940,445,0,0,70,70,0,1,0,1,0
61703,55938,445,0,0,70,70,0,1,0,1,0
61704,54202,443,43752,443,499,425,74,4,0,3,1
61705,54203,443,21798,443,499,425,74,4,0,3,1
61706,54201,443,55731,443,499,425,74,4,0,3,1
61707,54200,443,47040,443,499,425,74,4,0,3,1
61708,54197,443,1352,443,499,425,74,4,0,3,1
61709,54194,443,16208,443,499,425,74,4,0,3,1
61710,54305,35440,0,0,62,62,0,1,0,1,0
61711,58248,50584,0,0,66,66,0,1,0,1,0
61712,52208,43890,0,0,66,66,0,1,0,1,0
61713,61148,37965,0,0,66,66,0,1,0,1,0
61714,51351,445,0,0,66,66,0,1,0,1,0
61715,42917,52952,0,0,62,62,0,1,0,1,0
61716,33822,57470,0,0,66,66,0,1,0,1,0
61717,54094,5900,0,0,60,60,0,1,0,1,0
61718,50899,445,0,0,70,70,0,1,0,1,0
61719,52788,64147,0,0,66,66,0,1,0,1,0
61720,50897,445,0,0,70,70,0,1,0,1,0
61721,55966,57866,0,0,66,66,0,1,0,1,0
61722,51341,445,0,0,66,66,0,1,0,1,0
61723,55929,445,0,0,70,70,0,1,0,1,0
61724,57107,64147,0,0,62,62,0,1,0,1,0
61725,50896,445,0,0,70,70,0,1,0,1,0
61726,50895,445,0,0,70,70,0,1,0,1,0
61727,50894,445,0,0,70,70,0,1,0,1,0
61728,43398,25604,0,0,146,146,0,1,0,1,0
61729,50888,445,0,0,70,70,0,1,0,1,0
61730,50889,445,0,0,70,70,0,1,0,1,0
61731,51339,50584,0,0,66,66,0,1,0,1,0
61732,51338,445,0,0,66,66,0,1,0,1,0
61733,59411,37965,0,0,66,66,0,1,0,1,0
61734,0,0,0,0,156,156,0,2,0,2,0
61735,0,0,0,0,156,156,0,2,0,2,0
61736,0,0,0,0,156,156,0,2,0,2,0
61737,0,0,0,0,156,156,0,2,0,2,0
61738,53300,37807,0,0,66,66,0,1,0,1,0
61739,55749,37965,0,0,66,66,0,1,0,1,0
61740,14397,37965,0,0,62,62,0,1,0,1,0
61741,50876,445,0,0,70,70,0,1,0,1,0
61742,50875,445,0,0,70,70,0,1,0,1,0
61743,50872,445,0,0,70,70,0,1,0,1,0
61744,51330,445,0,0,66,66,0,1,0,1,0
61745,50866,445,0,0,70,70,0,1,0,1,0
61746,50865,445,0,0,70,70,0,1,0,1,0
61747,52690,7302,0,0,66,66,0,1,0,1,0
61748,51325,445,0,0,66,66,0,1,0,1,0
61749,62970,44847,0,0,62,62,0,1,0,1,0
61750,52451,56205,0,0,66,66,0,1,0,1,0
61751,56006,23,0,0,60,60,0,1,0,1,0
61752,46389,27098,0,0,66,66,0,1,0,1,0
61753,41852,35440,0,0,62,62,0,1,0,1,0
61754,25091,64147,0,0,66,66,0,1,0,1,0
61755,25602,64147,0,0,62,62,0,1,0,1,0
61756,16387,56995,0,0,60,60,0,1,0,1,0
61757,55918,445,0,0,70,70,0,1,0,1,0
61758,55915,445,0,0,70,70,0,1,0,1,0
61759,55916,445,0,0,70,70,0,1,0,1,0
61760,14484,39004,0,0,145,145,0,1,0,1,0
61761,50854,445,0,0,70,70,0,1,0,1,0
61762,14255,2767,0,0,62,62,0,1,0,1,0
61763,51310,445,0,0,66,66,0,1,0,1,0
61764,51311,445,0,0,66,66,0,1,0,1,0
61765,51313,445,0,0,66,66,0,1,0,1,0
61766,51312,445,0,0,66,66,0,1,0,1,0
61767,51315,445,0,0,66,66,0,1,0,1,0
61768,51314,445,0,0,66,66,0,1,0,1,0
61769,51308,445,0,0,66,66,0,1,0,1,0
61770,51309,445,0,0,66,66,0,1,0,1,0
61771,45964,14444,0,0,60,60,0,1,0,1,0
61772,35347,20238,0,0,66,66,0,1,0,1,0
61773,50849,445,0,0,70,70,0,1,0,1,0
61774,49555,443,34197,443,740109,22948,717161,800,54,311,489
61775,49963,53,30474,53,279,96,183,4,58,2,2
61776,59774,443,17301,443,846,420,426,15,29,8,7
61777,59791,443,43640,443,6603,1085,5518,23,28,11,12
61778,59398,443,65413,443,3730,1956,1774,16,15,8,8
61779,42821,53,25927,53,168,78,90,2,30,1,1
61780,59759,443,40820,443,13342,1221,12121,33,41,15,18
61781,59747,443,56102,443,1991,1190,801,21,32,11,10
61782,49475,80,53528,80,1548,847,701,10,16,5,5
61783,52791,80,25328,80,82430,3774,78656,108,67,49,59
61784,53831,80,61237,80,5774,1483,4291,14,162,8,6
61785,51945,443,60723,443,8830,1950,6880,27,25,14,13
61786,46654,80,33249,80,1518,954,564,14,320,8,6
61787,59798,443,49371,443,1887,1152,735,18,28,9,9
61788,55920,53,58162,53,770,102,668,2,30,1,1
61789,59397,443,43163,443,3218,1700,1518,16,15,8,8
61790,35112,8635,35112,8635,138,78,60,2,5,1,1
61791,63728,11785,51708,11785,66,66,0,1,5,1,0
61792,51667,80,5248,80,20457,4742,15715,37,139,20,17
61793,54649,443,1081,443,355822,186974,168848,1039,1626,433,606
61794,59757,443,13672,443,11663,1141,10522,30,41,14,16
61795,52309,80,52309,80,450,246,204,8,29,5,3
61796,59775,443,41953,443,4951,711,4240,15,29,8,7
61797,52308,80,52308,80,14704,1558,13146,25,29,11,14
61798,49476,80,51976,80,5000,4058,942,15,15,8,7
61799,59770,443,53384,443,9630,1304,8326,28,30,14,14
61800,59646,5223,55530,5223,70,70,0,1,5,1,0
61801,56689,53,22159,53,738,86,652,2,30,1,1
61802,59624,443,22456,443,18261,2059,16202,40,31,20,20
61803,42566,53,42566,53,216,98,118,2,30,1,1
61804,52311,80,52311,80,450,246,204,8,29,5,3
61805,49498,443,36900,443,267319,11446,255873,336,192,117,219
61806,56520,53,14015,53,757,98,659,2,30,1,1
61807,56223,53,26065,53,768,99,669,2,30,1,1
61808,52175,443,52175,443,506908,20303,486605,548,25,204,344
61809,64825,53,38972,53,184,94,90,2,30,1,1
61810,41974,443,41974,443,214163,29159,185004,242,20,108,134
61811,53208,443,19606,443,11664,7921,3743,23,16,14,9
61812,58077,36653,2343,36653,204,64,140,4,10,2,2
61813,59787,443,40007,443,1457,816,641,15,28,7,8
61814,9278,23,9278,23,146,60,86,2,10,1,1
61815,59805,443,46522,443,2334,1113,1221,19,27,9,10
61816,59777,443,29457,443,966,480,486,17,29,9,8
61817,59771,443,63690,443,7672,1164,6508,24,30,12,12
61818,59799,443,7688,443,10642,1102,9540,25,27,11,14
61819,55635,53,27124,53,170,87,83,2,30,1,1
61820,55048,53,59185,53,780,104,676,2,30,1,1
61821,56176,53,4646,53,188,96,92,2,30,1,1
61822,6882,59689,61028,59689,221,111,110,2,1200,1,1
61823,43096,443,6075,443,3063,1813,1250,18,16,8,10
61824,50851,80,30396,80,1123758,19319,1104439,1037,133,278,759
61825,64706,443,64706,443,274,132,142,5,76,3,2
61826,56727,53,56099,53,168,86,82,3,50,2,1
61827,52095,443,20736,443,325846,10609,315237,326,38,106,220
61828,53398,443,48527,443,5196,2308,2888,34,137,16,18
61829,50802,80,54812,80,3874,684,3190,11,141,6,5
61830,52100,443,47301,443,298527,11814,286713,310,37,107,203
61831,60745,123,31928,123,184,94,90,2,30,1,1
61832,49846,443,59260,443,278883,9002,269881,313,72,115,198
61833,55732,53,62249,53,188,96,92,2,31,1,1
61834,63965,53,30693,53,192,90,102,2,31,1,1
61835,58770,53,51678,53,168,78,90,2,31,1,1
61836,57334,53,29836,53,204,104,100,2,31,1,1
61837,64989,53,14791,53,756,95,661,2,31,1,1
61838,49892,443,11967,443,5930,910,5020,18,36,9,9
61839,49848,443,21903,443,5997,976,5021,19,72,10,9
61840,49850,443,7446,443,147320,5771,141549,184,72,73,111
61841,57372,53,34702,53,756,95,661,2,31,1,1
61842,50265,61668,33376,61668,132,132,0,3,1201,3,0
61843,54753,443,7702,443,84945,5052,79893,120,360,61,59
61844,65349,53,30593,53,772,103,669,2,31,1,1
61845,56050,53,45848,53,172,88,84,2,30,1,1
61846,64359,53,39260,53,192,98,94,2,31,1,1
61847,49847,443,53706,443,6117,976,5141,21,72,10,11
61848,49849,443,49569,443,6117,976,5141,21,72,10,11
61849,49866,443,16607,443,6058,1038,5020,20,56,11,9
61850,49865,443,25068,443,6177,1038,5139,22,56,11,11
61851,57173,53,42104,53,216,110,106,2,31,1,1
61852,55896,53,50702,53,184,94,90,2,31,1,1
61853,53006,443,46019,443,17711,5894,11817,47,96,24,23
61854,52968,80,9235,80,4004,1347,2657,29,114,15,14
61855,52868,80,24153,80,54968,1915,53053,71,125,24,47
61856,52902,443,33545,443,13263,7381,5882,51,118,26,25
61857,49824,53,9699,53,172,88,84,2,31,1,1
61858,65049,53,32515,53,204,104,100,2,31,1,1
61859,57173,53,12903,53,216,110,106,2,31,1,1
61860,49864,443,13446,443,5930,910,5020,18,56,9,9
61861,49859,443,23944,443,6065,1045,5020,20,60,11,9
61862,55605,53,47383,53,772,103,669,2,31,1,1
61863,49862,443,63314,443,819841,23462,796379,897,56,298,599
61864,49863,443,31339,443,6057,1038,5019,20,56,11,9
61865,49861,443,11860,443,5995,974,5021,19,56,10,9
61866,49844,443,42026,443,6117,976,5141,21,72,10,11
61867,49845,443,44493,443,5996,976,5020,19,72,10,9
61868,56478,53,58747,53,200,102,98,2,31,1,1
61869,55921,53,12219,53,747,92,655,2,31,1,1
61870,50111,443,14390,443,60978,3794,57184,73,137,26,47
61871,55907,445,0,0,70,70,0,1,0,1,0
61872,55906,445,0,0,70,70,0,1,0,1,0
61873,55900,445,0,0,70,70,0,1,0,1,0
61874,50839,445,0,0,70,70,0,1,0,1,0
61875,50840,445,0,0,70,70,0,1,0,1,0
61876,56103,21247,0,0,66,66,0,1,0,1,0
61877,51296,445,0,0,66,66,0,1,0,1,0
61878,51295,445,0,0,66,66,0,1,0,1,0
61879,51293,445,0,0,66,66,0,1,0,1,0
61880,50838,445,0,0,70,70,0,1,0,1,0
61881,50837,445,0,0,70,70,0,1,0,1,0
61882,10965,22114,0,0,62,62,0,1,0,1,0
61883,58012,5555,0,0,60,60,0,1,0,1,0
61884,29623,37807,0,0,146,146,0,1,0,1,0
61885,50833,445,0,0,70,70,0,1,0,1,0
61886,5222,21212,0,0,66,66,0,1,0,1,0
61887,61013,41705,0,0,66,66,0,1,0,1,0
61888,55897,445,0,0,70,70,0,1,0,1,0
61889,32520,50265,0,0,145,145,0,1,0,1,0
61890,6889,41615,0,0,143,143,0,1,0,1,0
61891,38484,48637,0,0,60,60,0,1,0,1,0
61892,53314,64097,0,0,62,62,0,1,0,1,0
61893,35957,51185,0,0,60,60,0,1,0,1,0
61894,55895,445,0,0,70,70,0,1,0,1,0
61895,53330,443,1024,443,5454,1157,4297,15,22,9,6
61896,56176,53,62297,53,102,102,0,1,30,1,0
61897,55926,53,56818,53,184,94,90,2,29,1,1
61898,49567,53,58916,53,244,94,150,2,29,1,1
61899,64858,53,57701,53,196,102,94,2,30,1,1
61900,50994,35974,0,0,60,60,0,1,0,1,0
61901,29145,8168,0,0,62,62,0,1,0,1,0
61902,60617,64147,0,0,62,62,0,1,0,1,0
61903,45908,3383,0,0,60,60,0,1,0,1,0
61904,57959,21247,0,0,66,66,0,1,0,1,0
61905,55892,445,0,0,70,70,0,1,0,1,0
61906,55888,445,0,0,70,70,0,1,0,1,0
61907,55883,445,0,0,70,70,0,1,0,1,0
61908,52611,9571,0,0,62,62,0,1,0,1,0
61909,50827,445,0,0,70,70,0,1,0,1,0
61910,20371,35440,0,0,62,62,0,1,0,1,0
61911,8889,60297,0,0,60,60,0,1,0,1,0
61912,47013,37965,0,0,62,62,0,1,0,1,0
61913,39244,36829,0,0,146,146,0,1,0,1,0
61914,52975,23718,0,0,66,66,0,1,0,1,0
61915,50820,445,0,0,70,70,0,1,0,1,0
61916,50818,445,0,0,70,70,0,1,0,1,0
61917,50422,50584,0,0,66,66,0,1,0,1,0
61918,55875,445,0,0,70,70,0,1,0,1,0
61919,55874,445,0,0,70,70,0,1,0,1,0
61920,55873,445,0,0,70,70,0,1,0,1,0
61921,64177,44847,0,0,62,62,0,1,0,1,0
61922,56798,9571,0,0,62,62,0,1,0,1,0
61923,33469,61903,0,0,145,145,0,1,0,1,0
61924,443,10010,0,0,60,60,0,1,0,1,0
61925,43271,50584,0,0,146,146,0,1,0,1,0
61926,3964,51505,0,0,62,62,0,1,0,1,0
61927,61357,64147,0,0,62,62,0,1,0,1,0
61928,50813,445,0,0,70,70,0,1,0,1,0
61929,2404,35440,0,0,146,146,0,1,0,1,0
61930,46849,36237,0,0,66,66,0,1,0,1,0
61931,50812,445,0,0,70,70,0,1,0,1,0
61932,60960,49049,0,0,66,66,0,1,0,1,0
61933,62930,21247,0,0,66,66,0,1,0,1,0
61934,53353,26467,0,0,62,62,0,1,0,1,0
61935,64166,35440,0,0,66,66,0,1,0,1,0
61936,46116,51505,0,0,62,62,0,1,0,1,0
61937,51953,37965,0,0,66,66,0,1,0,1,0
61938,51273,445,0,0,66,66,0,1,0,1,0
61939,50808,445,0,0,70,70,0,1,0,1,0
61940,55868,445,0,0,70,70,0,1,0,1,0
61941,55862,445,0,0,70,70,0,1,0,1,0
61942,51570,443,51570,443,11204,3773,7431,29,132,12,17
61943,49275,53,23304,53,212,102,110,2,30,1,1
61944,52490,443,51639,443,23518,8884,14634,32,15,15,17
61945,57863,443,52780,443,1981,1155,826,19,86,10,9
61946,53209,80,42720,80,1452,484,968,8,15,5,3
61947,57413,443,19121,443,16749,7614,9135,74,17,34,40
61948,55635,53,55478,53,177,94,83,2,29,1,1
61949,55776,53,11095,53,272,110,162,2,29,1,1
61950,64611,53,9832,53,181,94,87,2,29,1,1
61951,58771,80,64938,80,2062,904,1158,10,258,6,4
61952,64762,53,23924,53,200,94,106,2,30,1,1
61953,57486,80,57486,80,1248,535,713,10,20,5,5
61954,55732,53,1656,53,194,102,92,2,30,1,1
61955,33057,80,61093,80,1151,711,440,10,15,5,5
61956,56481,443,31113,443,1853,1214,639,18,134,11,7
61957,51715,29358,11619,29358,414,136,278,6,16,3,3
61958,52313,80,52313,80,450,246,204,8,29,5,3
61959,51771,80,34714,80,76066,3663,72403,92,24,40,52
61960,56624,53,50985,53,196,102,94,2,30,1,1
61961,56730,53,45534,53,210,110,100,2,30,1,1
61962,65464,443,36070,443,395647,11870,383777,409,16,144,265
61963,59781,443,23445,443,546,180,366,10,28,4,6
61964,43055,80,43055,80,1246,533,713,10,20,5,5
61965,59752,443,31611,443,12150,1262,10888,29,41,13,16
61966,53196,443,1285,443,4371,1115,3256,19,19,9,10
61967,49939,53,36312,53,384,103,281,4,50,2,2
61968,51739,62163,31026,62163,70,70,0,2,8,2,0
61969,51118,80,26346,80,1952,1118,834,21,365,11,10
61970,55635,53,13643,53,177,94,83,2,30,1,1
61971,49963,53,54838,53,279,96,183,4,59,2,2
61972,64946,53,45329,53,210,102,108,2,30,1,1
61973,49614,53,48437,53,258,110,148,2,30,1,1
61974,55217,53,21902,53,189,102,87,2,30,1,1
61975,37984,443,32167,443,3149,1829,1320,22,315,12,10
61976,52730,443,26039,443,8040,2587,5453,39,16,23,16
61977,60368,443,14990,443,10483,4072,6411,20,26,9,11
61978,39036,443,62520,443,1768,541,1227,11,20,7,4
61979,64858,53,5118,53,819,102,717,2,30,1,1
61980,65298,53,31126,53,277,110,167,2,30,1,1
61981,56602,53,21237,53,197,102,95,2,30,1,1
61982,35338,443,9775,443,7504,2762,4742,35,61,17,18
61983,51773,80,63744,80,40993,2984,38009,57,24,28,29
61984,56768,10880,3397,10880,70,70,0,1,5,1,0
61985,55879,53,32478,53,200,94,106,2,30,1,1
61986,53049,443,20030,443,7393,2050,5343,34,92,16,18
61987,52997,443,41046,443,10754,4129,6625,42,112,20,22
61988,51768,80,6690,80,211684,9903,201781,247,27,109,138
61989,38891,80,9037,80,5491,2690,2801,13,15,7,6
61990,51770,80,6696,80,135293,6214,129079,161,24,71,90
61991,50970,80,27517,80,1123476,15099,1108377,963,39,223,740
61992,56482,443,53337,443,10788,6521,4267,61,134,31,30
61993,57414,443,40284,443,103144,2997,100147,114,16,36,78
61994,38305,443,38305,443,5510,2263,3247,22,40,13,9
61995,51738,47483,28405,47483,70,70,0,2,8,2,0
61996,51723,10622,28735,10622,70,70,0,1,5,1,0
61997,34157,443,57470,443,154,94,60,2,5,1,1
61998,59789,443,31655,443,5520,1212,4308,18,28,9,9
61999,46734,53,46734,53,314,98,216,2,29,1,1
62000,33022,443,32074,443,162,102,60,2,5,1,1
62001,55447,53,22356,53,194,102,92,2,29,1,1
62002,55769,53,28226,53,373,103,270,4,43,2,2
62003,56925,53,26704,53,275,110,165,2,29,1,1
62004,52310,80,52310,80,450,246,204,8,29,5,3
62005,59779,443,65358,443,18360,1734,16626,32,28,13,19
62006,64489,53,3033,53,320,97,223,4,50,2,2
62007,36452,53,36452,53,226,106,120,2,29,1,1
62008,51675,53,24941,53,168,78,90,2,29,1,1
62009,64742,53,25545,53,761,102,659,2,29,1,1
62010,49446,80,49446,80,5724,3966,1758,25,38,14,11
62011,60306,53,57588,53,168,78,90,2,29,1,1
62012,64890,53,55634,53,210,110,100,2,29,1,1
62013,52312,80,52312,80,450,246,204,8,29,5,3
62014,49557,53,50413,53,272,110,162,2,29,1,1
62015,59780,443,27949,443,19224,2358,16866,38,28,15,23
62016,65025,53,29192,53,786,110,676,2,29,1,1
62017,64890,53,13860,53,210,110,100,2,30,1,1
62018,55896,53,65305,53,184,94,90,2,30,1,1
62019,56154,53,34116,53,291,94,197,2,29,1,1
62020,56730,53,53565,53,210,110,100,2,30,1,1
62021,55217,53,28752,53,189,102,87,2,30,1,1
62022,41923,53,17859,53,168,78,90,2,30,1,1
62023,55498,53,3379,53,340,134,206,2,30,1,1
62024,56793,53,24911,53,196,102,94,2,30,1,1
62025,49864,53,65077,53,212,102,110,2,30,1,1
62026,64359,53,44275,53,196,102,94,2,30,1,1
62027,50921,443,40184,443,9516,1896,7620,21,127,11,10
62028,49959,443,21643,443,102240,4349,97891,128,136,46,82
62029,56050,53,45376,53,178,94,84,2,30,1,1
62030,49896,443,43604,443,5996,976,5020,19,35,10,9
62031,19473,44929,9531,44929,481,150,331,2,1200,1,1
62032,50683,443,25335,443,6414,1372,5042,19,171,9,10
62033,50893,443,25118,443,9452,1832,7620,20,130,10,10
62034,59494,443,29596,443,338,278,60,2,5,1,1
62035,53107,44060,27368,44060,70,70,0,1,5,1,0
62036,40375,443,13030,443,130,70,60,3,5,2,1
62037,37450,443,11367,443,617919,23432,594487,706,39,297,409
62038,64188,53,11006,53,299,98,201,4,57,2,2
62039,56624,53,20436,53,819,102,717,2,30,1,1
62040,64487,53,6176,53,225,110,115,2,30,1,1
62041,49213,53,21489,53,272,94,178,2,30,1,1
62042,57235,53,3428,53,212,102,110,2,30,1,1
62043,33806,443,17179,443,37541,4945,32596,69,127,31,38
62044,52993,443,38783,443,10754,4129,6625,42,112,20,22
62045,57879,80,31290,80,318,192,126,6,27,4,2
62046,51772,80,5918,80,93693,4469,89224,115,24,53,62
62047,51294,443,42258,443,162,102,60,2,5,1,1
62048,49612,80,42484,80,1388,562,826,11,315,6,5
62049,59776,443,24367,443,966,480,486,17,29,9,8
62050,57334,53,43556,53,210,110,100,2,30,1,1
62051,55403,53,28747,53,211,102,109,2,30,1,1
62052,56176,53,42328,53,194,102,92,2,30,1,1
62053,46865,80,11797,80,662,600,62,12,495,11,1
62054,50841,443,31504,443,10475,1518,8957,24,139,11,13
62055,59778,443,33771,443,6723,1014,5709,19,29,10,9
62056,46186,443,59452,443,10103,3482,6621,59,16,29,30
62057,40576,443,40576,443,4433,1526,2907,19,27,11,8
62058,49522,53,16817,53,688,185,503,6,45,3,3
62059,49128,443,6577,443,3062,1747,1315,17,16,9,8
62060,52797,443,22094,443,8355,1923,6432,32,16,18,14
62061,43634,80,30485,80,1151,711,440,10,15,5,5
62062,65414,53,34166,53,197,102,95,2,30,1,1
62063,56268,53,23212,53,210,102,108,2,30,1,1
62064,57334,53,14690,53,210,110,100,2,30,1,1
62065,56793,53,12485,53,196,102,94,2,30,1,1
62066,64153,53,64829,53,340,134,206,2,30,1,1
62067,56478,53,62940,53,200,102,98,2,30,1,1
62068,44847,6881,59803,6881,484,150,334,2,1200,1,1
62069,55649,443,18027,443,7045,2145,4900,18,136,8,10
62070,50939,443,38504,443,8058,1136,6922,19,126,9,10
62071,50680,443,16561,443,7066,1129,5937,19,172,9,10
62072,60880,443,53335,443,12278,1931,10347,32,56,18,14
62073,60873,443,47153,443,60954,33730,27224,101,63,50,51
62074,50894,80,58930,80,5900,751,5149,15,130,7,8
62075,56050,53,26569,53,178,94,84,2,30,1,1
62076,56522,53,58867,53,322,134,188,2,30,1,1
62077,55384,53,33566,53,212,102,110,2,30,1,1
62078,65246,53,1802,53,209,102,107,2,30,1,1
62079,49854,443,54861,443,5089,1037,4052,20,61,11,9
62080,65049,53,22516,53,210,110,100,2,30,1,1
62081,64513,53,7726,53,396,102,294,2,31,1,1
62082,57173,53,30572,53,322,110,212,4,31,2,2
62083,57294,443,32624,443,122959,4611,118348,142,150,51,91
62084,49473,53,57880,53,290,118,172,2,30,1,1
62085,64865,53,41424,53,423,102,321,2,30,1,1
62086,39569,443,64666,443,125906,21096,104810,172,130,68,104
62087,55313,443,62411,443,4005,1162,2843,17,142,8,9
62088,60849,443,12589,443,3364,1737,1627,15,360,8,7
62089,65496,123,10878,123,184,94,90,2,30,1,1
62090,55896,53,44537,53,184,94,90,2,30,1,1
62091,56997,123,16433,123,184,94,90,2,30,1,1
62092,49679,53,54923,53,166,86,80,2,30,1,1
62093,65418,53,64332,53,211,102,109,2,30,1,1
62094,56050,53,44342,53,178,94,84,2,30,1,1
62095,59278,53,0,0,86,86,0,1,30,1,0
62096,54369,53,50744,53,168,78,90,2,31,1,1
62097,55732,53,61011,53,194,102,92,2,30,1,1
62098,56602,53,29182,53,197,102,95,2,30,1,1
62099,57334,53,19722,53,210,110,100,2,30,1,1
62100,64825,53,52627,53,184,94,90,2,30,1,1
62101,64056,53,57608,53,383,94,289,2,30,1,1
62102,45614,123,42191,123,184,94,90,2,30,1,1
62103,49540,53,39432,53,198,110,88,2,31,1,1
62104,63965,53,54423,53,180,94,86,2,31,1,1
62105,57470,20014,49843,20014,528,528,0,9,1200,9,0
62106,65423,443,16318,443,5854,1796,4058,21,142,10,11
62107,48344,443,10226,443,68467,4750,63717,100,276,48,52
62108,42934,443,36835,443,4514,1928,2586,17,241,8,9
62109,49540,53,53210,53,198,110,88,2,30,1,1
62110,49890,443,45754,443,6068,1047,5021,20,50,11,9
62111,49885,443,59973,443,37539,4310,33229,63,51,27,36
62112,49858,443,16431,443,2027955,75406,1952549,2104,60,564,1540
62113,55951,53,13243,53,197,102,95,2,31,1,1
62114,57173,53,19613,53,216,110,106,2,31,1,1
62115,49889,443,5001,443,214782,13389,201393,277,50,98,179
62116,49177,53,40047,53,184,94,90,2,31,1,1
62117,64643,443,21220,443,3433,1192,2241,13,136,6,7
62118,49873,443,58284,443,14476,2843,11633,45,55,22,23
62119,49876,443,4745,443,5993,974,5019,19,54,10,9
62120,47534,443,60052,443,291717,11752,279965,319,137,123,196
62121,51221,53239,19108,53239,1487,594,893,19,1571,10,9
62122,55292,53,33154,53,211,102,109,2,31,1,1
62123,46866,80,59082,80,662,600,62,12,495,11,1
62124,53330,443,46161,443,3701,1232,2469,13,136,6,7
62125,56727,53,55377,53,250,86,164,4,52,2,2
62126,49963,53,15871,53,279,96,183,4,58,2,2
62127,49963,53,58470,53,564,191,373,6,62,3,3
62128,55922,53,46699,53,423,102,321,2,30,1,1
62129,56983,53,28765,53,424,108,316,4,55,2,2
62130,64180,53,4267,53,180,94,86,2,30,1,1
62131,64825,53,49543,53,184,94,90,2,31,1,1
62132,50031,53,36003,53,386,134,252,2,30,1,1
62133,49679,53,7089,53,166,86,80,2,31,1,1
62134,64297,53,33648,53,199,94,105,2,30,1,1
62135,56478,53,14582,53,200,102,98,2,30,1,1
62136,49839,443,14297,443,5026,973,4053,19,72,10,9
62137,56341,443,32673,443,49417,5511,43906,108,439,54,54
62138,55732,53,40584,53,194,102,92,2,31,1,1
62139,56366,443,56718,443,7234,4345,2889,27,235,15,12
62140,65049,53,4020,53,210,110,100,2,31,1,1
62141,49842,443,41562,443,5309,1043,4266,22,72,11,11
62142,55033,53,37383,53,182,94,88,2,31,1,1
62143,36902,443,18209,443,10252,2152,8100,38,126,18,20
62144,37264,443,36936,443,3068,1678,1390,17,241,9,8
62145,50692,443,11802,443,152,86,66,2,5,1,1
62146,53527,45626,13998,45626,70,70,0,1,5,1,0
62147,61705,80,47319,80,134,60,74,3,11,2,1
62148,50865,443,45042,443,6883,1378,5505,19,131,9,10
62149,49511,80,32515,80,1693924,34466,1659458,1627,230,522,1105
62150,50804,443,11310,443,6337,1378,4959,19,140,9,10
62151,50840,443,34565,443,8057,1135,6922,19,139,9,10
62152,53530,8999,1234,8999,70,70,0,1,5,1,0
62153,56736,53,58809,53,283,94,189,4,41,2,2
62154,56793,53,43867,53,196,102,94,2,30,1,1
62155,49824,53,46232,53,178,94,84,2,30,1,1
62156,64256,53,5483,53,334,94,240,2,31,1,1
62157,55896,53,45886,53,184,94,90,2,31,1,1
62158,49824,53,29358,53,178,94,84,2,31,1,1
62159,49883,443,3067,443,4960,1114,3846,21,51,12,9
62160,49894,443,1865,443,8633,2099,6534,29,35,15,14
62161,49875,443,6451,443,31715,20427,11288,103,54,54,49
62162,49827,443,61208,443,5523,3016,2507,36,75,20,16
62163,56524,53,60434,53,182,102,80,2,31,1,1
62164,13826,53,57057,53,200,94,106,2,31,1,1
62165,50265,64304,32485,64304,970,598,372,14,1201,8,6
62166,56430,443,5643,443,2274816,85295,2189521,2305,127,825,1480
62167,55049,5228,10544,5228,9193,2770,6423,51,5193,28,23
62168,55548,443,42567,443,12205,2036,10169,33,138,18,15
62169,53528,20485,28809,20485,70,70,0,1,5,1,0
62170,50864,443,18823,443,6663,1556,5107,21,132,10,11
62171,50919,443,47767,443,6412,1370,5042,19,129,9,10
62172,50828,443,49506,443,6337,1378,4959,19,140,9,10
62173,50867,443,26907,443,6351,1370,4981,18,131,9,9
62174,50914,443,19872,443,8058,1136,6922,19,129,9,10
62175,50800,443,31236,443,7067,1129,5938,19,141,9,10
62176,14084,43890,0,0,62,62,0,1,0,1,0
62177,56100,57470,0,0,62,62,0,1,0,1,0
62178,61845,11392,0,0,66,66,0,1,0,1,0
62179,50806,445,0,0,70,70,0,1,0,1,0
62180,12694,12446,0,0,62,62,0,1,0,1,0
62181,26573,44847,0,0,62,62,0,1,0,1,0
62182,6889,55108,0,0,143,143,0,1,0,1,0
62183,51413,54351,0,0,136,136,0,1,0,1,0
62184,49298,18593,0,0,145,145,0,1,0,1,0
62185,1987,26467,0,0,62,62,0,1,0,1,0
62186,51413,1,0,0,72,72,0,1,0,1,0
62187,49386,64147,0,0,62,62,0,1,0,1,0
62188,30951,50584,0,0,62,62,0,1,0,1,0
62189,51266,445,0,0,66,66,0,1,0,1,0
62190,14993,50584,0,0,62,62,0,1,0,1,0
62191,51263,445,0,0,66,66,0,1,0,1,0
62192,55855,445,0,0,70,70,0,1,0,1,0
62193,9775,30188,0,0,62,62,0,1,0,1,0
62194,50802,445,0,0,70,70,0,1,0,1,0
62195,8999,42873,0,0,146,146,0,1,0,1,0
62196,55851,445,0,0,70,70,0,1,0,1,0
62197,55850,445,0,0,70,70,0,1,0,1,0
62198,55847,445,0,0,70,70,0,1,0,1,0
62199,51262,445,0,0,66,66,0,1,0,1,0
62200,6069,45680,0,0,159,159,0,1,0,1,0
62201,48478,49903,0,0,62,62,0,1,0,1,0
62202,60923,49903,0,0,66,66,0,1,0,1,0
62203,58486,57470,0,0,66,66,0,1,0,1,0
62204,16275,23117,0,0,146,146,0,1,0,1,0
62205,55842,445,0,0,70,70,0,1,0,1,0
62206,14613,12446,0,0,66,66,0,1,0,1,0
62207,55840,445,0,0,70,70,0,1,0,1,0
62208,55838,445,0,0,70,70,0,1,0,1,0
62209,55836,445,0,0,70,70,0,1,0,1,0
62210,52666,40108,0,0,148,148,0,1,0,1,0
62211,51254,445,0,0,66,66,0,1,0,1,0
62212,18085,26467,0,0,66,66,0,1,0,1,0
62213,51247,445,0,0,66,66,0,1,0,1,0
62214,51248,445,0,0,66,66,0,1,0,1,0
62215,51245,445,0,0,66,66,0,1,0,1,0
62216,50789,445,0,0,70,70,0,1,0,1,0
62217,51233,43890,0,0,66,66,0,1,0,1,0
62218,23379,57866,0,0,146,146,0,1,0,1,0
62219,51243,445,0,0,66,66,0,1,0,1,0
62220,51244,445,0,0,66,66,0,1,0,1,0
62221,51241,445,0,0,66,66,0,1,0,1,0
62222,59586,57470,0,0,66,66,0,1,0,1,0
62223,62452,21247,0,0,66,66,0,1,0,1,0
62224,50786,445,0,0,70,70,0,1,0,1,0
62225,19838,23,0,0,60,60,0,1,0,1,0
62226,55835,445,0,0,70,70,0,1,0,1,0
62227,55833,445,0,0,70,70,0,1,0,1,0
62228,55828,445,0,0,70,70,0,1,0,1,0
62229,51240,445,0,0,66,66,0,1,0,1,0
62230,55827,445,0,0,70,70,0,1,0,1,0
62231,56967,35440,0,0,66,66,0,1,0,1,0
62232,51236,445,0,0,66,66,0,1,0,1,0
62233,51234,445,0,0,66,66,0,1,0,1,0
62234,51233,445,0,0,66,66,0,1,0,1,0
62235,55262,44847,0,0,62,62,0,1,0,1,0
62236,50781,445,0,0,70,70,0,1,0,1,0
62237,26888,23,0,0,60,60,0,1,0,1,0
62238,50780,445,0,0,70,70,0,1,0,1,0
62239,51230,445,0,0,66,66,0,1,0,1,0
62240,50668,58833,0,0,66,66,0,1,0,1,0
62241,50778,445,0,0,70,70,0,1,0,1,0
62242,25151,58833,0,0,146,146,0,1,0,1,0
62243,25342,8168,0,0,62,62,0,1,0,1,0
62244,54826,56205,0,0,66,66,0,1,0,1,0
62245,55821,445,0,0,70,70,0,1,0,1,0
62246,24351,57470,0,0,62,62,0,1,0,1,0
62247,55818,445,0,0,70,70,0,1,0,1,0
62248,55815,445,0,0,70,70,0,1,0,1,0
62249,46557,57866,0,0,66,66,0,1,0,1,0
62250,50853,50584,0,0,66,66,0,1,0,1,0
62251,50771,445,0,0,70,70,0,1,0,1,0
62252,51221,445,0,0,66,66,0,1,0,1,0
62253,25570,35440,0,0,62,62,0,1,0,1,0
62254,0,0,0,0,156,156,0,2,0,2,0
62255,0,0,0,0,244,244,0,2,0,2,0
62256,50769,445,0,0,70,70,0,1,0,1,0
62257,49359,64147,0,0,66,66,0,1,0,1,0
62258,6889,30170,0,0,143,143,0,1,0,1,0
62259,40990,10387,0,0,148,148,0,1,0,1,0
62260,50768,445,0,0,70,70,0,1,0,1,0
62261,50767,445,0,0,70,70,0,1,0,1,0
62262,50,64147,0,0,62,62,0,1,0,1,0
62263,51212,445,0,0,66,66,0,1,0,1,0
62264,50766,445,0,0,70,70,0,1,0,1,0
62265,58876,57470,0,0,66,66,0,1,0,1,0
62266,55800,445,0,0,70,70,0,1,0,1,0
62267,50761,445,0,0,70,70,0,1,0,1,0
62268,50760,445,0,0,70,70,0,1,0,1,0
62269,37213,36237,0,0,66,66,0,1,0,1,0
62270,6890,11204,0,0,146,146,0,1,0,1,0
62271,56411,50584,0,0,62,62,0,1,0,1,0
62272,51209,445,0,0,66,66,0,1,0,1,0
62273,50748,445,0,0,70,70,0,1,0,1,0
62274,50747,445,0,0,70,70,0,1,0,1,0
62275,53957,35440,0,0,146,146,0,1,0,1,0
62276,50745,445,0,0,70,70,0,1,0,1,0
62277,60132,50584,0,0,62,62,0,1,0,1,0
62278,25973,26467,0,0,66,66,0,1,0,1,0
62279,50738,445,0,0,70,70,0,1,0,1,0
62280,50737,445,0,0,70,70,0,1,0,1,0
62281,56327,44512,0,0,66,66,0,1,0,1,0
62282,23650,37807,0,0,62,62,0,1,0,1,0
62283,51201,445,0,0,66,66,0,1,0,1,0
62284,35657,48637,0,0,62,62,0,1,0,1,0
62285,34916,51185,0,0,62,62,0,1,0,1,0
62286,25523,35974,0,0,62,62,0,1,0,1,0
62287,51194,445,0,0,66,66,0,1,0,1,0
62288,25523,35974,0,0,145,145,0,1,0,1,0
62289,50200,44847,0,0,74,74,0,1,0,1,0
62290,60192,35440,0,0,66,66,0,1,0,1,0
62291,10753,22114,0,0,146,146,0,1,0,1,0
62292,50726,445,0,0,70,70,0,1,0,1,0
62293,25470,24748,0,0,143,143,0,1,0,1,0
62294,6890,27520,0,0,146,146,0,1,0,1,0
62295,52941,443,58388,443,14630,5941,8689,52,115,26,26
62296,60189,443,11334,443,10816,1112,9704,22,125,10,12
62297,50332,80,19945,80,2862,1465,1397,11,47,6,5
62298,60309,443,17740,443,130,70,60,3,5,2,1
62299,49860,443,20445,443,10754,2778,7976,38,59,19,19
62300,49893,443,34865,443,7115,1670,5445,24,35,13,11
62301,53138,443,56360,443,7141,2507,4634,28,42,13,15
62302,52912,443,9289,443,41094,14929,26165,126,116,69,57
62303,52942,443,55996,443,14696,5947,8749,53,115,26,27
62304,52921,443,44773,443,36892,20283,16609,191,116,77,114
62305,52879,443,43280,443,286404,12478,273926,379,118,130,249
62306,52887,80,9477,80,5694,2514,3180,36,118,19,17
62307,52918,443,11338,443,326078,45627,280451,737,116,252,485
62308,47744,443,50454,443,7761,2376,5385,24,256,12,12
62309,52928,443,12845,443,56910,3384,53526,85,115,33,52
62310,52940,443,39271,443,14640,5951,8689,52,115,26,26
62311,52938,443,4484,443,14896,6021,8875,56,115,27,29
62312,60187,443,13141,443,9875,1112,8763,21,125,10,11
62313,37066,443,58040,443,9705,4332,5373,32,321,17,15
62314,61714,443,30943,443,134,60,74,3,10,2,1
62315,53194,443,63620,443,1462,965,497,13,18,7,6
62316,53127,443,49935,443,68982,15774,53208,113,45,42,71
62317,53128,443,36411,443,72734,14614,58120,112,44,39,73
62318,52880,443,45002,443,1695880,25777,1670103,1423,118,264,1159
62319,53018,443,30354,443,48877,5205,43672,95,93,32,63
62320,52931,443,32527,443,23112,6278,16834,140,115,55,85
62321,60190,443,8550,443,10178,1101,9077,22,125,10,12
62322,53525,34759,11727,34759,70,70,0,1,5,1,0
62323,53195,443,48069,443,1462,965,497,13,18,7,6
62324,53179,80,43162,80,1628,828,800,10,25,6,4
62325,52943,443,54392,443,14640,5951,8689,52,115,26,26
62326,52930,443,54761,443,21194,5779,15415,118,115,47,71
62327,53115,443,63976,443,9616,6956,2660,39,47,21,18
62328,52898,80,57619,80,3020,1414,1606,30,118,16,14
62329,51411,443,64614,443,7842,1155,6687,19,105,10,9
62330,51265,63960,52529,63960,70,70,0,2,8,2,0
62331,45426,80,3986,80,416,210,206,7,28,4,3
62332,49175,2710,30746,2710,70,70,0,2,8,2,0
62333,44481,443,29524,443,6336,1633,4703,22,256,12,10
62334,49662,443,55920,443,9534,4029,5505,22,59,12,10
62335,48360,3389,48360,3389,4085,1916,2169,21,19,12,9
62336,45428,80,14591,80,350,210,140,6,28,4,2
62337,49649,443,64805,443,5964,674,5290,16,60,7,9
62338,55951,53,16889,53,194,99,95,2,31,1,1
62339,46980,443,8668,443,7633,5620,2013,31,60,19,12
62340,45427,80,37690,80,350,210,140,6,28,4,2
62341,50571,80,64124,80,300,174,126,5,15,3,2
62342,38306,443,65032,443,4580,1210,3370,17,28,10,7
62343,50848,80,48215,80,1213557,27203,1186354,1120,133,327,793
62344,50863,80,47507,80,5874,744,5130,14,131,7,7
62345,53524,45395,27489,45395,70,70,0,1,5,1,0
62346,49674,443,62205,443,8656,2060,6596,20,57,10,10
62347,56420,443,51933,443,5220,922,4298,17,135,10,7
62348,49722,443,17749,443,5943,850,5093,16,50,7,9
62349,60188,443,15594,443,9811,1112,8699,21,125,10,11
62350,52896,80,13613,80,3020,1414,1606,30,118,16,14
62351,45119,443,36541,443,5082,969,4113,18,30,10,8
62352,52904,443,65264,443,17521,6560,10961,55,117,28,27
62353,52903,443,57569,443,253281,6271,247010,276,117,66,210
62354,52939,443,34090,443,16053,6801,9252,51,115,26,25
62355,52876,443,35265,443,501046,7967,493079,419,118,69,350
62356,49894,443,19598,443,7418,2721,4697,23,20,12,11
62357,38808,443,46954,443,25120,1874,23246,39,171,17,22
62358,57595,443,62180,443,291,171,120,4,16,2,2
62359,50795,443,7705,443,18444,12288,6156,36,149,20,16
62360,64915,443,15491,443,4659604,120303,4539301,4651,74,1586,3065
62361,49177,53,33754,53,184,94,90,2,31,1,1
62362,49851,443,11118,443,6058,1038,5020,20,71,11,9
62363,59950,53,51206,53,395,115,280,2,30,1,1
62364,5938,47968,0,0,60,60,0,1,91,1,0
62365,57737,443,13855,443,15625,4662,10963,25,123,11,14
62366,52865,443,62658,443,120290,2988,117302,123,132,32,91
62367,52901,443,37617,443,87558,4155,83403,115,117,41,74
62368,52895,443,23981,443,18795,10297,8498,56,118,29,27
62369,53137,443,3588,443,7648,3641,4007,29,42,13,16
62370,53131,443,52675,443,33229,7810,25419,63,44,24,39
62371,50214,53,34671,53,789,110,679,2,31,1,1
62372,49364,53,62830,53,180,92,88,2,31,1,1
62373,54952,5228,14099,5228,12140,3028,9112,54,4653,28,26
62374,53005,443,10690,443,13028,4115,8913,45,95,23,22
62375,52897,80,31689,80,4292,1932,2360,32,118,17,15
62376,53002,443,30088,443,16537,4585,11952,46,96,24,22
62377,53129,443,62080,443,51742,10734,41008,85,44,33,52
62378,43568,80,8531,80,2277,1521,756,16,16,10,6
62379,56215,53,26623,53,216,110,106,2,31,1,1
62380,64914,443,15488,443,6120028,157580,5962448,6108,75,2083,4025
62381,39381,53,0,0,82,82,0,1,31,1,0
62382,47504,53,47504,53,174,77,97,2,30,1,1
62383,63945,53,52680,53,216,110,106,2,31,1,1
62384,65127,53,26912,53,188,96,92,2,31,1,1
62385,56322,53,7412,53,202,103,99,2,31,1,1
62386,57470,46772,63151,46772,528,528,0,9,1201,9,0
62387,57356,443,4225,443,7802,4189,3613,22,136,11,11
62388,55478,443,16411,443,23029908,732047,22297861,24550,183,8143,16407
62389,52925,5555,0,0,60,60,0,1,0,1,0
62390,55791,445,0,0,70,70,0,1,0,1,0
62391,30920,64147,0,0,62,62,0,1,0,1,0
62392,55788,445,0,0,70,70,0,1,0,1,0
62393,55787,445,0,0,70,70,0,1,0,1,0
62394,51187,445,0,0,66,66,0,1,0,1,0
62395,51185,445,0,0,66,66,0,1,0,1,0
62396,51186,445,0,0,66,66,0,1,0,1,0
62397,51184,445,0,0,66,66,0,1,0,1,0
62398,51182,445,0,0,66,66,0,1,0,1,0
62399,51183,445,0,0,66,66,0,1,0,1,0
62400,51181,445,0,0,66,66,0,1,0,1,0
62401,51179,445,0,0,66,66,0,1,0,1,0
62402,18655,50584,0,0,146,146,0,1,0,1,0
62403,64767,51221,0,0,62,62,0,1,0,1,0
62404,50722,445,0,0,70,70,0,1,0,1,0
62405,50102,17546,0,0,66,66,0,1,0,1,0
62406,13743,33720,0,0,159,159,0,1,0,1,0
62407,52917,443,43916,443,7148,2358,4790,40,116,18,22
62408,52952,443,15638,443,9381,3074,6307,47,114,24,23
62409,52924,443,50522,443,21789,7672,14117,78,115,39,39
62410,50404,80,8357,80,4242,3615,627,15,32,8,7
62411,50403,80,8423,80,4332,3596,736,14,32,8,6
62412,46346,35440,0,0,66,66,0,1,0,1,0
62413,56405,62413,0,0,66,66,0,1,0,1,0
62414,27517,23,0,0,60,60,0,1,0,1,0
62415,50712,445,0,0,70,70,0,1,0,1,0
62416,50711,445,0,0,70,70,0,1,0,1,0
62417,60192,35440,0,0,62,62,0,1,0,1,0
62418,55056,56205,0,0,66,66,0,1,0,1,0
62419,55779,445,0,0,70,70,0,1,0,1,0
62420,55776,445,0,0,70,70,0,1,0,1,0
62421,55772,445,0,0,70,70,0,1,0,1,0
62422,50707,445,0,0,70,70,0,1,0,1,0
62423,50708,445,0,0,70,70,0,1,0,1,0
62424,1431,30041,0,0,62,62,0,1,0,1,0
62425,50877,30041,0,0,66,66,0,1,0,1,0
62426,61329,51505,0,0,62,62,0,1,0,1,0
62427,50705,445,0,0,70,70,0,1,0,1,0
62428,51167,445,0,0,66,66,0,1,0,1,0
62429,51164,445,0,0,66,66,0,1,0,1,0
62430,51166,445,0,0,66,66,0,1,0,1,0
62431,55770,445,0,0,70,70,0,1,0,1,0
62432,58597,35440,0,0,66,66,0,1,0,1,0
62433,55767,445,0,0,70,70,0,1,0,1,0
62434,55762,445,0,0,70,70,0,1,0,1,0
62435,55761,445,0,0,70,70,0,1,0,1,0
62436,50875,53,15135,53,234,234,0,4,47,4,0
62437,49870,443,21099,443,6062,1042,5020,20,55,11,9
62438,49882,443,51154,443,79524,18512,61012,205,50,101,104
62439,56847,53,25632,53,225,86,139,2,30,1,1
62440,55190,53,57289,53,311,94,217,2,30,1,1
62441,55951,53,4112,53,197,102,95,2,30,1,1
62442,42853,443,43627,443,3508,2120,1388,20,241,10,10
62443,50265,33734,14802,33734,132,132,0,3,1200,3,0
62444,52975,443,20822,443,291803,6522,285281,284,113,58,226
62445,50771,80,8237,80,6420,677,5743,13,151,6,7
62446,50852,80,1179,80,1118864,18787,1100077,1036,132,280,756
62447,50859,443,27316,443,6886,1380,5506,19,132,9,10
62448,50895,443,56217,443,6354,1373,4981,18,129,9,9
62449,50866,443,31244,443,9517,1897,7620,21,130,11,10
62450,55947,53,33524,53,311,108,203,4,42,2,2
62451,48017,443,12876,443,198,78,120,4,6,2,2
62452,53543,51819,43192,51819,70,70,0,2,7,2,0
62453,50689,443,50217,443,152,86,66,2,4,1,1
62454,64991,443,64991,443,9107,1499,7608,20,75,11,9
62455,52965,443,44159,443,86041,4656,81385,102,113,34,68
62456,50849,80,37869,80,1218354,26709,1191645,1128,133,332,796
62457,50739,443,62875,443,6335,1376,4959,19,165,9,10
62458,56727,53,4531,53,250,86,164,4,46,2,2
62459,50770,443,41782,443,6350,1369,4981,18,151,9,9
62460,50682,80,52857,80,5237,680,4557,12,170,6,6
62461,49897,443,23230,443,33013,21249,11764,151,492,79,72
62462,50972,80,5146,80,1095399,7129,1088270,832,37,106,726
62463,50686,443,29049,443,6340,1381,4959,19,170,9,10
62464,50746,443,7838,443,6354,1372,4982,18,161,9,9
62465,60871,443,15673,443,95311,21869,73442,140,62,61,79
62466,50720,443,25123,443,6336,1377,4959,19,169,9,10
62467,50064,443,49945,443,4118,2209,1909,36,239,21,15
62468,50744,443,22315,443,6854,1380,5474,18,161,9,9
62469,50769,443,26960,443,6882,1377,5505,19,151,9,10
62470,50965,443,11513,443,8949,1200,7749,21,85,10,11
62471,50843,443,54645,443,6337,1378,4959,19,135,9,10
62472,57348,443,22476,443,6250,1312,4938,23,315,12,11
62473,61828,443,31671,443,7490,2688,4802,23,383,10,13
62474,50920,443,55566,443,6273,1375,4898,18,127,9,9
62475,56135,53,22804,53,542,112,430,4,34,2,2
62476,53544,22051,5953,22051,70,70,0,2,7,2,0
62477,49727,443,58320,443,4116,972,3144,15,50,8,7
62478,53522,24116,50290,24116,70,70,0,1,4,1,0
62479,49673,443,32250,443,6404,829,5575,18,57,9,9
62480,53203,443,27595,443,3656,2345,1311,18,17,9,9
62481,52846,80,43511,80,3626,1778,1848,36,143,19,17
62482,52990,443,9852,443,7093,2235,4858,39,111,20,19
62483,53081,443,13924,443,16157,6478,9679,46,83,23,23
62484,52951,443,13326,443,628801,19603,609198,708,114,227,481
62485,53163,443,16194,443,7432,1694,5738,23,27,12,11
62486,53027,443,45299,443,26309,3035,23274,69,92,27,42
62487,49499,443,13640,443,87970,5355,82615,141,483,55,86
62488,49775,53,55039,53,399,93,306,4,41,2,2
62489,49689,443,55526,443,1179,655,524,13,56,7,6
62490,49881,443,45580,443,5997,978,5019,19,53,10,9
62491,49900,443,21992,443,6896,2139,4757,31,33,15,16
62492,63927,53,30501,53,196,94,102,2,30,1,1
62493,65412,53,14297,53,305,118,187,2,30,1,1
62494,55281,53,43570,53,210,102,108,2,30,1,1
62495,43444,53,43444,53,314,98,216,2,30,1,1
62496,64694,53,57973,53,209,102,107,2,30,1,1
62497,64018,53,10598,53,229,94,135,2,30,1,1
62498,61060,53,61060,53,257,106,151,2,30,1,1
62499,53052,443,60187,443,8476,2030,6446,38,91,19,19
62500,56363,443,4827,443,4864,3011,1853,20,234,12,8
62501,53063,80,2438,80,2725,1228,1497,24,90,13,11
62502,53023,443,2353,443,9625,3512,6113,41,92,21,20
62503,53022,443,29069,443,15099,7828,7271,45,92,24,21
62504,53204,443,30061,443,3655,2344,1311,18,17,9,9
62505,53093,443,27460,443,6774,3651,3123,35,80,18,17
62506,53004,443,34423,443,18064,5135,12929,108,95,44,64
62507,52949,443,60761,443,9564,2054,7510,42,114,20,22
62508,53010,443,23300,443,31660,3248,28412,58,93,23,35
62509,53037,80,8932,80,2906,1233,1673,24,92,13,11
62510,52948,443,49245,443,9629,2119,7510,42,114,20,22
62511,51736,34343,5872,34343,70,70,0,2,8,2,0
62512,52955,443,58633,443,23572,2063,21509,46,114,20,26
62513,53201,443,51458,443,3655,2344,1311,18,17,9,9
62514,41059,443,46382,443,1248874,30382,1218492,1261,111,425,836
62515,53165,443,14639,443,7434,1695,5739,23,27,12,11
62516,49901,443,3004,443,4949,1047,3902,22,33,11,11
62517,53207,443,15704,443,3655,2344,1311,18,17,9,9
62518,49884,443,63837,443,5998,978,5020,19,50,10,9
62519,53156,443,62340,443,3814,2664,1150,22,28,12,10
62520,53199,443,19271,443,1582,965,617,15,18,7,8
62521,49869,443,47117,443,7910,1967,5943,30,55,15,15
62522,53187,443,36781,443,5244,1925,3319,33,21,17,16
62523,49857,443,36785,443,4221,1038,3183,19,59,11,8
62524,19236,53,19236,53,235,90,145,2,33,1,1
62525,53193,443,17954,443,1462,965,497,13,18,7,6
62526,49895,443,39538,443,6060,1040,5020,20,34,11,9
62527,58677,28678,3047,28678,1806,1806,0,22,225,22,0
62528,49826,443,4711,443,1738,1159,579,16,74,10,6
62529,53055,443,19489,443,17225,7769,9456,71,91,34,37
62530,35900,443,35900,443,5661,2414,3247,22,39,13,9
62531,49650,53,42506,53,248,110,138,2,30,1,1
62532,52944,443,11890,443,58499,47163,11336,106,115,59,47
62533,34989,80,37174,80,350,210,140,6,28,4,2
62534,54309,80,4585,80,552,280,272,9,30,5,4
62535,52886,80,7195,80,5688,2508,3180,36,118,19,17
62536,64371,53,21841,53,181,86,95,2,30,1,1
62537,49721,443,52287,443,4588,843,3745,14,52,7,7
62538,64701,53,54317,53,195,94,101,2,30,1,1
62539,50244,80,52530,80,136475,59298,77177,166,53,78,88
62540,55033,53,44325,53,182,94,88,2,30,1,1
62541,49724,443,6596,443,7226,844,6382,19,50,9,10
62542,51667,21391,14607,21391,1345,679,666,9,30,5,4
62543,51666,45702,58433,45702,1201,577,624,8,30,4,4
62544,52985,80,52009,80,3111,1364,1747,28,112,15,13
62545,53206,443,65067,443,3656,2345,1311,18,17,9,9
62546,52957,443,8095,443,38149,4388,33761,68,113,26,42
62547,53064,443,10926,443,8095,2586,5509,38,90,19,19
62548,53154,443,28335,443,3947,2796,1151,22,28,12,10
62549,53160,443,52369,443,2738,1904,834,18,28,10,8
62550,60881,443,31300,443,31109,2922,28187,54,52,26,28
62551,41657,443,13161,443,122547,6414,116133,160,81,61,99
62552,36262,443,11222,443,678861,22499,656362,749,19,290,459
62553,53241,443,45177,443,1950,1176,774,18,103,11,7
62554,50405,80,63982,80,4530,3395,1135,15,32,8,7
62555,49872,443,32419,443,4595,1038,3557,19,54,11,8
62556,49877,443,32997,443,37364,16799,20565,189,53,87,102
62557,49828,443,7626,443,1737,1158,579,16,74,10,6
62558,56362,443,29740,443,12746,7725,5021,39,234,24,15
62559,57424,53,8409,53,210,102,108,2,30,1,1
62560,56215,53,24448,53,216,110,106,2,30,1,1
62561,64749,53,21766,53,227,110,117,2,30,1,1
62562,63965,53,11899,53,180,94,86,2,30,1,1
62563,64029,443,14573,443,252,70,182,3,120,1,2
62564,35459,443,42175,443,2350,1392,958,17,275,9,8
62565,63127,55860,37307,55860,316,190,126,5,15,3,2
62566,49718,443,25229,443,4524,779,3745,13,52,6,7
62567,49723,443,63349,443,6780,710,6070,16,50,7,9
62568,49668,443,23437,443,7978,2204,5774,20,58,10,10
62569,49715,443,43667,443,4418,789,3629,13,54,6,7
62570,53035,443,38723,443,20048,9134,10914,96,92,39,57
62571,53161,443,30923,443,2731,1895,836,18,28,10,8
62572,52973,443,33521,443,9294,2728,6566,43,113,22,21
62573,52852,80,35656,80,7572,3232,4340,42,140,23,19
62574,53197,443,58160,443,1462,965,497,13,18,7,6
62575,53012,443,44779,443,13938,3220,10718,44,93,21,23
62576,49824,53,4911,53,392,88,304,4,53,2,2
62577,34988,80,55946,80,416,210,206,7,28,4,3
62578,35106,443,63708,443,309321,13076,296245,368,189,150,218
62579,49853,443,20017,443,11534,2076,9458,43,60,21,22
62580,54310,80,7871,80,552,280,272,9,30,5,4
62581,9707,3389,9707,3389,3441,1552,1889,17,21,10,7
62582,57917,443,1119,443,6520,1550,4970,19,54,11,8
62583,60878,443,38028,443,764899,31427,733472,883,60,368,515
62584,50868,80,40174,80,12388,742,11646,18,130,7,11
62585,50803,443,31091,443,6417,1376,5041,19,140,9,10
62586,50918,80,48461,80,9643,812,8831,18,128,8,10
62587,50681,443,36673,443,6888,1380,5508,19,171,9,10
62588,50801,443,41271,443,6893,1384,5509,19,140,9,10
62589,60840,443,45920,443,54975,32043,22932,71,319,40,31
62590,50745,80,27446,80,2977,680,2297,11,161,6,5
62591,60872,443,25312,443,27204,15677,11527,59,62,30,29
62592,50873,443,21465,443,6889,1381,5508,19,129,9,10
62593,50892,443,40533,443,8057,1135,6922,19,129,9,10
62594,50878,80,60118,80,325925,18062,307863,377,146,161,216
62595,50898,443,1887,443,6883,1378,5505,19,128,9,10
62596,51721,35426,54780,35426,70,70,0,1,5,1,0
62597,50944,443,36385,443,9517,1898,7619,21,85,11,10
62598,50850,443,34368,443,6341,1382,4959,19,132,9,10
62599,62705,443,21442,443,357841,77119,280722,646,142,316,330
62600,51735,50794,43847,50794,70,70,0,2,8,2,0
62601,36261,443,56856,443,1269784,41489,1228295,1339,37,478,861
62602,65463,443,25060,443,92752,4519,88233,105,15,39,66
62603,50690,443,9122,443,152,86,66,2,4,1,1
62604,53520,37553,29607,37553,70,70,0,1,4,1,0
62605,53531,48908,42269,48908,70,70,0,1,4,1,0
62606,40521,28678,47764,28678,1806,1806,0,22,225,22,0
62607,52640,443,13563,443,70,70,0,1,5,1,0
62608,49720,443,54089,443,4936,855,4081,17,52,7,10
62609,42925,443,37247,443,5617,1559,4058,22,138,13,9
62610,60191,443,1843,443,7292,950,6342,19,125,9,10
62611,49726,443,2292,443,3941,902,3039,13,50,7,6
62612,53155,443,52565,443,3866,2774,1092,21,28,12,9
62613,36256,443,38729,443,3936219,107920,3828299,3880,132,1208,2672
62614,53152,443,44569,443,16706,6162,10544,39,29,19,20
62615,52913,443,33752,443,50739,5508,45231,100,116,36,64
62616,49719,443,28042,443,4717,849,3868,15,52,7,8
62617,53079,443,11081,443,8233,5537,2696,40,84,21,19
62618,53192,443,46060,443,35788,2073,33715,54,21,20,34
62619,52857,443,23236,443,10234,2550,7684,47,139,23,24
62620,53164,443,1379,443,7434,1695,5739,23,27,12,11
62621,53140,443,40797,443,8349,1987,6362,23,30,12,11
62622,52853,80,51325,80,7502,3168,4334,41,140,22,19
62623,52959,443,64973,443,9257,2079,7178,39,113,19,20
62624,52891,443,27899,443,320255,9207,311048,343,117,107,236
62625,52866,80,44619,80,6022,2590,3432,37,131,20,17
62626,53198,443,2334,443,1462,965,497,13,18,7,6
62627,53186,443,23298,443,10332,2735,7597,36,21,17,19
62628,52961,443,6824,443,925322,25097,900225,971,113,287,684
62629,52956,443,14626,443,15659,3294,12365,60,114,25,35
62630,52970,443,47039,443,19221,5366,13855,88,113,36,52
62631,53159,443,33030,443,9711,3950,5761,38,28,22,16
62632,53094,443,6776,443,6726,3603,3123,34,80,17,17
62633,50968,443,54503,443,13683,6075,7608,58,5113,23,35
62634,50974,80,21113,80,1095989,7833,1088156,841,37,117,724
62635,49880,443,51797,443,1087632,32231,1055401,1112,53,334,778
62636,49868,443,19461,443,11578,2375,9203,47,55,22,25
62637,49856,443,10855,443,5512,978,4534,20,60,10,10
62638,49879,443,31980,443,6121,1042,5079,21,53,11,10
62639,64359,53,14911,53,196,102,94,2,30,1,1
62640,56524,53,26224,53,182,102,80,2,30,1,1
62641,55853,53,62979,53,228,110,118,2,30,1,1
62642,65361,53,62352,53,211,102,109,2,30,1,1
62643,64614,53,60972,53,168,86,82,2,31,1,1
62644,49855,443,64909,443,28887,9850,19037,96,60,41,55
62645,49871,443,47130,443,615040,25597,589443,704,54,245,459
62646,49829,443,43793,443,3026,1775,1251,23,74,14,9
62647,56364,443,28728,443,10427,6311,4116,33,234,20,13
62648,65432,53,33110,53,448,184,264,6,30,3,3
62649,56215,53,5017,53,216,110,106,2,30,1,1
62650,37297,443,18068,443,4514,1928,2586,17,240,8,9
62651,21133,59392,22505,59392,481,150,331,2,1199,1,1
62652,49961,53,9720,53,327,126,201,2,30,1,1
62653,50977,80,25806,80,1111949,11633,1100316,906,37,173,733
62654,52473,443,5513,443,1625,1038,587,14,28,8,6
62655,48252,443,55839,443,60300,47341,12959,192,39,108,84
62656,49671,443,7194,443,1485,940,545,13,57,7,6
62657,51685,80,11134,80,1516,481,1035,11,15,6,5
62658,54307,443,65534,443,5661,1444,4217,19,135,11,8
62659,56598,80,2431,80,234,234,0,4,12,4,0
62660,38171,443,40043,443,1649,980,669,14,28,7,7
62661,49725,443,45081,443,7162,780,6382,18,50,8,10
62662,53043,443,3283,443,11020,3760,7260,56,92,25,31
62663,52397,443,10007,443,9680,2399,7281,47,136,27,20
62664,52919,443,28761,443,7573,1986,5587,40,115,19,21
62665,53080,443,53725,443,108155,4527,103628,115,83,30,85
62666,52888,443,11223,443,12876,2739,10137,44,118,21,23
62667,52932,443,63575,443,13165,3626,9539,56,115,30,26
62668,52967,443,11017,443,9893,2231,7662,42,113,21,21
62669,53200,443,25558,443,1462,965,497,13,18,7,6
62670,52875,443,25381,443,89335,4699,84636,107,118,32,75
62671,52894,443,46843,443,5424,1445,3979,29,117,14,15
62672,52937,443,42865,443,22218,12408,9810,66,115,33,33
62673,53202,443,64942,443,3655,2344,1311,18,17,9,9
62674,29029,53,43871,53,323,77,246,4,30,2,2
62675,55081,53,46160,53,209,102,107,2,30,1,1
62676,57341,3389,57341,3389,3428,1714,1714,16,33,8,8
62677,49691,443,33512,443,1183,659,524,13,56,7,6
62678,49684,443,64157,443,9083,2300,6783,19,56,10,9
62679,50402,80,18324,80,5981,3589,2392,15,32,8,7
62680,53114,443,33125,443,15277,10027,5250,36,46,21,15
62681,52861,443,16498,443,3633587,34615,3598972,2964,137,514,2450
62682,52874,443,59388,443,392514,41757,350757,626,118,209,417
62683,52966,80,53251,80,2974,1352,1622,28,113,15,13
62684,53184,443,16399,443,13515,3057,10458,40,21,20,20
62685,52872,443,5601,443,110507,3940,106567,129,118,37,92
62686,53205,443,46818,443,3658,2347,1311,18,17,9,9
62687,53026,443,50319,443,14051,6332,7719,43,92,21,22
62688,65079,53,34794,53,272,94,178,2,30,1,1
62689,65049,53,16377,53,210,110,100,2,30,1,1
62690,49878,443,52783,443,5997,978,5019,19,53,10,9
62691,49841,443,32376,443,7084,1611,5473,29,71,15,14
62692,49840,443,9507,443,58656,12994,45662,148,71,64,84
62693,50403,53,9932,53,749,94,655,2,30,1,1
62694,56478,53,64286,53,200,102,98,2,30,1,1
62695,65218,53,47163,53,276,126,150,2,30,1,1
62696,49874,443,3516,443,6058,1037,5021,20,54,11,9
62697,49886,443,23328,443,7488,1598,5890,25,50,13,12
62698,45402,443,57057,443,7710,3375,4335,32,131,18,14
62699,56758,40000,5881,40000,70,70,0,1,5,1,0
62700,34990,80,31222,80,350,210,140,6,28,4,2
62701,49716,443,56032,443,4653,785,3868,14,52,6,8
62702,49717,443,52321,443,4876,855,4021,16,52,7,9
62703,53019,443,6559,443,30012,3461,26551,72,93,28,44
62704,53121,443,1605,443,10893,7149,3744,31,45,18,13
62705,53031,443,7092,443,16055,5856,10199,97,92,42,55
62706,52885,80,48034,80,5688,2508,3180,36,118,19,17
62707,53047,443,44730,443,13229,3527,9702,56,91,28,28
62708,53077,443,28917,443,6715,1415,5300,27,84,14,13
62709,36563,6851,45259,6851,7584,4075,3509,51,169,27,24
62710,52870,443,27625,443,113894,15573,98321,182,119,67,115
62711,52920,443,54361,443,31161,4934,26227,73,115,32,41
62712,49756,53,22675,53,243,118,125,2,30,1,1
62713,56881,53,21712,53,181,86,95,2,30,1,1
62714,49413,53,52444,53,231,110,121,2,30,1,1
62715,52989,443,57788,443,182945,23135,159810,191,111,63,128
62716,59988,443,59988,443,8589,2809,5780,30,16,15,15
62717,52428,80,60172,80,2516,1929,587,15,16,9,6
62718,56365,443,42336,443,4850,2997,1853,20,234,12,8
62719,56215,53,1097,53,216,110,106,2,30,1,1
62720,65127,53,45861,53,194,102,92,2,30,1,1
62721,56322,53,2088,53,209,110,99,2,30,1,1
62722,57074,53,27906,53,259,78,181,2,30,1,1
62723,49177,53,24852,53,184,94,90,2,30,1,1
62724,49627,53,57352,53,288,110,178,2,31,1,1
62725,64835,53,56147,53,200,102,98,2,31,1,1
62726,32299,40015,23096,40015,188,70,118,2,31,1,1
62727,5588,5588,0,0,3562,1936,1626,48,196,24,24
62728,64077,53,54964,53,199,94,105,2,30,1,1
62729,58981,443,5501,443,3155,836,2319,13,135,6,7
62730,57470,6881,59936,6881,132,132,0,3,1199,3,0
62731,6881,1564,62594,1564,324,150,174,2,1200,1,1
62732,57470,25089,59334,25089,132,132,0,3,1199,3,0
62733,52994,443,57845,443,10694,4129,6565,41,111,20,21
62734,52910,443,4102,443,179433,12614,166819,217,116,78,139
62735,52998,443,44367,443,22480,2705,19775,49,109,22,27
62736,56727,53,51350,53,250,86,164,4,54,2,2
62737,53029,443,57596,443,9246,1808,7438,35,92,17,18
62738,65056,53,43061,53,211,102,109,2,30,1,1
62739,41095,443,28178,443,108842,88940,19902,313,255,159,154
62740,52329,53,12571,53,294,86,208,2,30,1,1
62741,40682,443,13381,443,10010,4051,5959,32,346,17,15
62742,49897,443,33898,443,8586,1352,7234,27,34,13,14
62743,64814,53,5615,53,243,94,149,2,30,1,1
62744,56367,443,5869,443,4863,3011,1852,20,234,12,8
62745,64359,53,62943,53,196,102,94,2,30,1,1
62746,56617,53,16257,53,286,94,192,2,30,1,1
62747,55972,53,36064,53,193,102,91,2,30,1,1
62748,55559,53,59475,53,182,94,88,2,30,1,1
62749,65020,53,52884,53,289,102,187,2,30,1,1
62750,55951,53,63735,53,197,102,95,2,31,1,1
62751,59946,443,42319,443,11836,3531,8305,37,121,19,18
62752,60046,443,51072,443,8241,2346,5895,18,136,8,10
62753,47274,5223,2647,5223,4269,1451,2818,22,3002,13,9
62754,65277,53,17756,53,819,102,717,2,31,1,1
62755,55972,53,18787,53,193,102,91,2,31,1,1
62756,63945,53,11861,53,216,110,106,2,31,1,1
62757,60303,443,45517,443,7914400,166459,7747941,6839,775,1138,5701
62758,39615,443,10074,443,6133,1343,4790,22,275,12,10
62759,64742,53,40488,53,194,94,100,2,31,1,1
62760,57470,1,27948,1,132,132,0,3,1199,3,0
62761,57470,51413,17602,51413,330,330,0,6,1199,6,0
62762,57470,46501,13184,46501,132,132,0,3,1199,3,0
62763,50265,24387,12796,24387,132,132,0,3,1200,3,0
62764,50265,42698,16471,42698,726,726,0,12,1200,12,0
62765,58612,443,21355,443,154,94,60,2,5,1,1
62766,55759,445,0,0,70,70,0,1,0,1,0
62767,50699,445,0,0,70,70,0,1,0,1,0
62768,30114,65151,0,0,60,60,0,1,0,1,0
62769,43840,50265,0,0,72,72,0,1,0,1,0
62770,27328,21247,0,0,66,66,0,1,0,1,0
62771,44258,25,0,0,74,74,0,1,0,1,0
62772,54071,50265,0,0,66,66,0,1,0,1,0
62773,50692,445,0,0,70,70,0,1,0,1,0
62774,26792,37965,0,0,62,62,0,1,0,1,0
62775,42285,57470,0,0,62,62,0,1,0,1,0
62776,50689,445,0,0,70,70,0,1,0,1,0
62777,55746,445,0,0,70,70,0,1,0,1,0
62778,55745,445,0,0,70,70,0,1,0,1,0
62779,55743,445,0,0,70,70,0,1,0,1,0
62780,11136,15503,0,0,62,62,0,1,0,1,0
62781,50685,445,0,0,70,70,0,1,0,1,0
62782,50684,445,0,0,70,70,0,1,0,1,0
62783,4366,51505,0,0,62,62,0,1,0,1,0
62784,61865,35440,0,0,66,66,0,1,0,1,0
62785,53406,44847,0,0,66,66,0,1,0,1,0
62786,50680,445,0,0,70,70,0,1,0,1,0
62787,1042,64147,0,0,145,145,0,1,0,1,0
62788,51144,445,0,0,66,66,0,1,0,1,0
62789,55741,445,0,0,70,70,0,1,0,1,0
62790,55734,445,0,0,70,70,0,1,0,1,0
62791,50678,445,0,0,70,70,0,1,0,1,0
62792,50386,22114,0,0,62,62,0,1,0,1,0
62793,1027,65473,0,0,159,159,0,1,0,1,0
62794,36945,23,0,0,60,60,0,1,0,1,0
62795,22683,39210,0,0,60,60,0,1,0,1,0
62796,50081,57470,0,0,66,66,0,1,0,1,0
62797,2467,2767,0,0,66,66,0,1,0,1,0
62798,25412,23,0,0,60,60,0,1,0,1,0
62799,51137,445,0,0,66,66,0,1,0,1,0
62800,50674,445,0,0,70,70,0,1,0,1,0
62801,37042,48983,0,0,159,159,0,1,0,1,0
62802,2919,57866,0,0,62,62,0,1,0,1,0
62803,51134,445,0,0,66,66,0,1,0,1,0
62804,25739,64147,0,0,62,62,0,1,0,1,0
62805,55731,445,0,0,70,70,0,1,0,1,0
62806,62787,51221,0,0,66,66,0,1,0,1,0
62807,62632,35440,0,0,66,66,0,1,0,1,0
62808,55726,445,0,0,70,70,0,1,0,1,0
62809,55724,445,0,0,70,70,0,1,0,1,0
62810,55721,445,0,0,70,70,0,1,0,1,0
62811,51132,445,0,0,66,66,0,1,0,1,0
62812,17070,48817,0,0,140,140,0,1,0,1,0
62813,31136,50584,0,0,62,62,0,1,0,1,0
62814,39480,8055,0,0,148,148,0,1,0,1,0
62815,6057,51221,0,0,78,78,0,1,0,1,0
62816,61566,44847,0,0,66,66,0,1,0,1,0
62817,55714,445,0,0,70,70,0,1,0,1,0
62818,15793,64147,0,0,66,66,0,1,0,1,0
62819,55712,445,0,0,70,70,0,1,0,1,0
62820,55710,445,0,0,70,70,0,1,0,1,0
62821,55708,445,0,0,70,70,0,1,0,1,0
62822,50661,445,0,0,70,70,0,1,0,1,0
62823,51125,445,0,0,66,66,0,1,0,1,0
62824,60894,50584,0,0,66,66,0,1,0,1,0
62825,63331,51221,0,0,62,62,0,1,0,1,0
62826,2182,57354,0,0,145,145,0,1,0,1,0
62827,51121,445,0,0,66,66,0,1,0,1,0
62828,51117,445,0,0,66,66,0,1,0,1,0
62829,51120,445,0,0,66,66,0,1,0,1,0
62830,51114,445,0,0,66,66,0,1,0,1,0
62831,51113,445,0,0,66,66,0,1,0,1,0
62832,51112,445,0,0,66,66,0,1,0,1,0
62833,50658,445,0,0,70,70,0,1,0,1,0
62834,62696,50584,0,0,66,66,0,1,0,1,0
62835,58318,15503,0,0,66,66,0,1,0,1,0
62836,17760,50584,0,0,62,62,0,1,0,1,0
62837,33822,57470,0,0,66,66,0,1,0,1,0
62838,55707,445,0,0,70,70,0,1,0,1,0
62839,55705,445,0,0,70,70,0,1,0,1,0
62840,55703,445,0,0,70,70,0,1,0,1,0
62841,58326,50584,0,0,146,146,0,1,0,1,0
62842,51110,445,0,0,66,66,0,1,0,1,0
62843,55699,445,0,0,70,70,0,1,0,1,0
62844,50653,445,0,0,70,70,0,1,0,1,0
62845,51106,445,0,0,66,66,0,1,0,1,0
62846,50652,445,0,0,70,70,0,1,0,1,0
62847,51105,445,0,0,66,66,0,1,0,1,0
62848,51104,445,0,0,66,66,0,1,0,1,0
62849,50650,445,0,0,70,70,0,1,0,1,0
62850,0,0,0,0,320,320,0,5,0,5,0
62851,51101,445,0,0,66,66,0,1,0,1,0
62852,50116,22,0,0,60,60,0,1,0,1,0
62853,43129,20220,0,0,62,62,0,1,0,1,0
62854,55694,445,0,0,70,70,0,1,0,1,0
62855,45908,3383,0,0,60,60,0,1,0,1,0
62856,52459,33890,0,0,60,60,0,1,0,1,0
62857,6881,9074,0,0,143,143,0,1,0,1,0
62858,55685,445,0,0,70,70,0,1,0,1,0
62859,55684,445,0,0,70,70,0,1,0,1,0
62860,50643,445,0,0,70,70,0,1,0,1,0
62861,45941,23386,0,0,60,60,0,1,0,1,0
62862,50641,445,0,0,70,70,0,1,0,1,0
62863,51092,445,0,0,66,66,0,1,0,1,0
62864,49818,37965,0,0,62,62,0,1,0,1,0
62865,26198,64147,0,0,62,62,0,1,0,1,0
62866,13188,35440,0,0,66,66,0,1,0,1,0
62867,50640,445,0,0,70,70,0,1,0,1,0
62868,50639,445,0,0,70,70,0,1,0,1,0
62869,50638,445,0,0,70,70,0,1,0,1,0
62870,50635,445,0,0,70,70,0,1,0,1,0
62871,50632,445,0,0,70,70,0,1,0,1,0
62872,51083,445,0,0,66,66,0,1,0,1,0
62873,16948,990,0,0,60,60,0,1,0,1,0
62874,55672,445,0,0,70,70,0,1,0,1,0
62875,33457,27015,0,0,67,67,0,1,0,1,0
62876,55878,7302,0,0,62,62,0,1,0,1,0
62877,1446,35440,0,0,62,62,0,1,0,1,0
62878,50620,445,0,0,70,70,0,1,0,1,0
62879,50619,445,0,0,70,70,0,1,0,1,0
62880,50613,445,0,0,70,70,0,1,0,1,0
62881,63864,23,0,0,60,60,0,1,0,1,0
62882,63925,37965,0,0,66,66,0,1,0,1,0
62883,1873,37965,0,0,62,62,0,1,0,1,0
62884,63433,57866,0,0,66,66,0,1,0,1,0
62885,51080,445,0,0,66,66,0,1,0,1,0
62886,50610,445,0,0,70,70,0,1,0,1,0
62887,50609,445,0,0,70,70,0,1,0,1,0
62888,51073,445,0,0,66,66,0,1,0,1,0
62889,2995,26467,0,0,62,62,0,1,0,1,0
62890,123,123,15561,123,184,94,90,2,30,1,1
62891,64614,53,55255,53,168,86,82,2,30,1,1
62892,56117,53,10364,53,757,98,659,2,30,1,1
62893,55479,53,3977,53,789,110,679,2,30,1,1
62894,43095,443,16830,443,3067,1817,1250,18,16,8,10
62895,52089,443,15915,443,6032,3616,2416,39,187,20,19
62896,61399,80,3299,80,5518,527,4991,13,75,6,7
62897,56755,31774,8678,31774,378,192,186,7,15,4,3
62898,45377,443,49244,443,5291,3987,1304,19,255,11,8
62899,51719,13715,9141,13715,66,66,0,1,5,1,0
62900,64756,53,24462,53,757,98,659,2,30,1,1
62901,52933,80,52933,80,98765,5293,93472,131,199,48,83
62902,63720,55027,38364,55027,1233,902,331,12,17,8,4
62903,54853,443,64447,443,7689,3574,4115,65,308,32,33
62904,61397,80,22347,80,2500,531,1969,11,75,6,5
62905,38807,443,45968,443,99092,3694,95398,115,170,43,72
62906,50537,5223,31982,5223,12710,4688,8022,44,2961,19,25
62907,57108,53,22880,53,186,95,91,2,30,1,1
62908,55972,53,10428,53,186,95,91,2,30,1,1
62909,45937,443,35765,443,4592,697,3895,14,25,8,6
62910,53546,17203,56777,17203,320,140,180,6,7,3,3
62911,51717,63436,58721,63436,66,66,0,1,5,1,0
62912,50807,443,17833,443,9328,1709,7619,18,139,8,10
62913,57594,443,61887,443,291,171,120,4,15,2,2
62914,44036,443,28418,443,6599,3950,2649,36,186,20,16
62915,56617,3389,56617,3389,3425,1470,1955,16,17,8,8
62916,51718,55003,59957,55003,66,66,0,1,5,1,0
62917,61398,80,45091,80,2425,529,1896,11,75,6,5
62918,23228,443,23228,443,20540,5514,15026,52,76,29,23
62919,5588,5588,0,0,3498,1872,1626,48,200,24,24
62920,50061,443,9312,443,7199,2528,4671,18,76,10,8
62921,48965,443,50088,443,9519,4377,5142,33,354,17,16
62922,22452,443,22452,443,5785,2575,3210,24,76,14,10
62923,53545,27700,24861,27700,320,140,180,6,7,3,3
62924,63808,53,2452,53,578,286,292,9,15,5,4
62925,38809,443,49064,443,79659,3269,76390,96,170,37,59
62926,37570,443,53443,443,986,499,487,9,17,5,4
62927,64835,53,1399,53,200,102,98,2,30,1,1
62928,56243,53,64458,53,762,101,661,2,30,1,1
62929,55559,53,26431,53,180,92,88,2,30,1,1
62930,50870,5228,4125,5228,7069,1804,5265,20,3602,11,9
62931,16387,29288,0,0,60,60,0,1,61,1,0
62932,16387,64374,0,0,60,60,0,1,61,1,0
62933,16387,25523,0,0,60,60,0,1,61,1,0
62934,65460,53,42143,53,194,99,95,2,31,1,1
62935,51066,445,0,0,66,66,0,1,0,1,0
62936,1025,64147,0,0,62,62,0,1,0,1,0
62937,443,43775,0,0,97,97,0,1,0,1,0
62938,49418,57470,0,0,62,62,0,1,0,1,0
62939,62673,34159,0,0,66,66,0,1,0,1,0
62940,46495,4607,0,0,60,60,0,1,0,1,0
62941,56296,53,43298,53,216,110,106,2,30,1,1
62942,50582,53,45109,53,216,110,106,2,30,1,1
62943,65277,53,20067,53,196,102,94,2,30,1,1
62944,65127,53,38412,53,194,102,92,2,30,1,1
62945,50119,443,16718,443,15168,5689,9479,51,34,27,24
62946,49160,28890,3522,28890,830,150,680,4,1200,2,2
62947,57122,53,32018,53,216,110,106,2,30,1,1
62948,50120,443,54666,443,29503,9695,19808,55,34,30,25
62949,49364,53,61563,53,182,94,88,2,30,1,1
62950,49769,443,1740,443,13455,1982,11473,29,31,16,13
62951,56897,7003,14885,7003,1098,672,426,14,734,8,6
62952,64950,53,11191,53,326,88,238,4,52,2,2
62953,65460,53,26483,53,197,102,95,2,30,1,1
62954,51716,57137,20087,57137,70,70,0,1,5,1,0
62955,51720,51388,35731,51388,70,70,0,1,5,1,0
62956,49364,53,40148,53,182,94,88,2,30,1,1
62957,57108,53,35898,53,193,102,91,2,30,1,1
62958,55824,53,60939,53,819,102,717,2,30,1,1
62959,64614,53,52648,53,168,86,82,2,31,1,1
62960,36448,80,28179,80,1325,336,989,10,15,5,5
62961,51734,59825,40402,59825,70,70,0,2,8,2,0
62962,60385,59696,28455,59696,70,70,0,2,8,2,0
62963,34155,443,36605,443,154,94,60,2,5,1,1
62964,23270,443,23270,443,5802,2592,3210,24,76,14,10
62965,60382,62582,18649,62582,70,70,0,2,8,2,0
62966,56435,53,21877,53,193,102,91,2,30,1,1
62967,40804,8434,40804,8434,156,156,0,3,8,3,0
62968,64580,53,23762,53,199,102,97,2,30,1,1
62969,35666,443,50206,443,3389452,85022,3304430,3290,159,997,2293
62970,55824,53,12441,53,196,102,94,2,30,1,1
62971,57108,53,37838,53,193,102,91,2,30,1,1
62972,19840,7000,19840,7000,3610,2043,1567,16,17,9,7
62973,56234,443,33837,443,8971,2446,6525,50,347,23,27
62974,65134,53,31124,53,229,110,119,2,30,1,1
62975,36924,53,36924,53,257,106,151,2,30,1,1
62976,57122,53,3566,53,216,110,106,2,30,1,1
62977,65403,53,24512,53,249,102,147,2,30,1,1
62978,50561,53,34475,53,763,102,661,2,30,1,1
62979,63582,443,11318,443,6178,1669,4509,19,15,11,8
62980,50969,80,54293,80,921711,12229,909482,780,37,172,608
62981,52489,443,60427,443,32975,9028,23947,39,15,18,21
62982,60744,40010,53059,40010,316,136,180,6,5,3,3
62983,60381,26312,6064,26312,70,70,0,2,8,2,0
62984,48016,443,47269,443,138,78,60,2,5,1,1
62985,60306,443,28741,443,9188,3421,5767,43,83,19,24
62986,50973,80,49428,80,1095221,7065,1088156,829,36,105,724
62987,60380,55125,53805,55125,70,70,0,2,8,2,0
62988,53156,51689,64576,51689,546,306,240,9,142,5,4
62989,53541,59939,24806,59939,70,70,0,2,7,2,0
62990,37523,443,28556,443,154,94,60,2,4,1,1
62991,22352,443,22352,443,6899,3403,3496,27,76,16,11
62992,51733,30688,48958,30688,70,70,0,2,8,2,0
62993,57416,66,17429,66,70,70,0,2,7,2,0
62994,56712,53,4721,53,448,184,264,6,29,3,3
62995,50572,80,46272,80,62,62,0,1,5,1,0
62996,64968,53,11604,53,448,98,350,4,41,2,2
62997,52849,443,32844,443,7735,1260,6475,16,133,7,9
62998,65123,53,24943,53,307,110,197,2,29,1,1
62999,23276,443,23276,443,4668,1745,2923,21,76,12,9
63000,55559,53,16251,53,182,94,88,2,30,1,1
63001,49177,53,27104,53,184,94,90,2,30,1,1
63002,55559,53,6941,53,182,94,88,2,29,1,1
63003,55017,53,20456,53,288,110,178,2,29,1,1
63004,64580,53,13673,53,199,102,97,2,30,1,1
63005,57108,53,1595,53,193,102,91,2,30,1,1
63006,56322,53,24189,53,209,110,99,2,30,1,1
63007,64835,53,60535,53,200,102,98,2,31,1,1
63008,60047,443,20320,443,229060,38515,190545,283,135,113,170
63009,52155,80,42520,80,1056,682,374,10,15,6,4
63010,56862,53,7245,53,198,94,104,2,30,1,1
63011,49364,53,15202,53,182,94,88,2,30,1,1
63012,56829,53,48980,53,199,102,97,2,30,1,1
63013,33048,443,57285,443,90054,6681,83373,104,133,33,71
63014,49168,443,13690,443,519325,13798,505527,535,18,193,342
63015,55342,443,55342,443,5593,2346,3247,22,39,13,9
63016,49648,7275,24792,7275,8962,1625,7337,28,16,15,13
63017,48632,443,58774,443,12433,4515,7918,32,136,17,15
63018,48631,443,20403,443,42910,5005,37905,72,136,36,36
63019,50582,53,14787,53,216,110,106,2,30,1,1
63020,57330,53,31519,53,228,94,134,2,30,1,1
63021,65049,443,55584,443,12674,1396,11278,12,139,2,10
63022,17750,30022,45838,30022,481,150,331,2,1200,1,1
63023,51732,54299,27558,54299,70,70,0,2,8,2,0
63024,64586,80,64586,80,123115,6863,116252,160,29,76,84
63025,56435,53,33982,53,193,102,91,2,30,1,1
63026,64615,53,40640,53,198,94,104,2,30,1,1
63027,56829,53,59229,53,199,102,97,2,30,1,1
63028,55535,53,57254,53,199,102,97,2,30,1,1
63029,58082,443,14473,443,45314943,1391230,43923713,47149,303,15196,31953
63030,49249,443,43033,443,35406,17785,17621,79,141,40,39
63031,55535,53,2360,53,199,102,97,2,31,1,1
63032,50265,6881,13047,6881,491,150,341,2,1200,1,1
63033,50008,53,47667,53,193,102,91,2,31,1,1
63034,63733,47013,45780,47013,66,66,0,2,8,2,0
63035,48408,443,3268,443,115036,11567,103469,189,103,92,97
63036,64357,53,38839,53,469,103,366,4,43,2,2
63037,43078,80,13694,80,1052,612,440,10,15,5,5
63038,50971,80,41640,80,1094437,6233,1088204,817,36,92,725
63039,63945,53,38413,53,216,110,106,2,30,1,1
63040,27999,443,45047,443,5577,1390,4187,19,15,9,10
63041,61676,443,64478,443,6353,1520,4833,20,17,12,8
63042,60900,443,23820,443,134,60,74,3,6,2,1
63043,45540,8100,25472,8100,234,234,0,4,12,4,0
63044,64659,53,14647,53,464,99,365,4,39,2,2
63045,45227,80,43141,80,1114,534,580,12,16,7,5
63046,43175,53,11498,53,194,86,108,2,30,1,1
63047,50598,445,0,0,70,70,0,1,0,1,0
63048,25565,55690,0,0,60,60,0,1,0,1,0
63049,52668,51221,0,0,66,66,0,1,0,1,0
63050,55664,445,0,0,70,70,0,1,0,1,0
63051,55660,445,0,0,70,70,0,1,0,1,0
63052,55659,445,0,0,70,70,0,1,0,1,0
63053,51948,37965,0,0,62,62,0,1,0,1,0
63054,51052,445,0,0,66,66,0,1,0,1,0
63055,51054,445,0,0,66,66,0,1,0,1,0
63056,51057,445,0,0,66,66,0,1,0,1,0
63057,51051,445,0,0,66,66,0,1,0,1,0
63058,51058,445,0,0,66,66,0,1,0,1,0
63059,51055,445,0,0,66,66,0,1,0,1,0
63060,51056,445,0,0,66,66,0,1,0,1,0
63061,51050,445,0,0,66,66,0,1,0,1,0
63062,5180,57866,0,0,66,66,0,1,0,1,0
63063,48544,44847,0,0,146,146,0,1,0,1,0
63064,49501,11392,0,0,66,66,0,1,0,1,0
63065,57896,1,0,0,100,100,0,1,0,1,0
63066,55618,56205,0,0,66,66,0,1,0,1,0
63067,29706,50584,0,0,66,66,0,1,0,1,0
63068,5121,35440,0,0,62,62,0,1,0,1,0
63069,25151,58833,0,0,62,62,0,1,0,1,0
63070,50594,445,0,0,70,70,0,1,0,1,0
63071,56564,9571,0,0,78,78,0,1,0,1,0
63072,44933,26467,0,0,62,62,0,1,0,1,0
63073,28584,37965,0,0,62,62,0,1,0,1,0
63074,41836,23,0,0,60,60,0,1,0,1,0
63075,47910,7454,0,0,60,60,0,1,0,1,0
63076,9471,23,0,0,60,60,0,1,0,1,0
63077,50583,445,0,0,70,70,0,1,0,1,0
63078,50585,445,0,0,70,70,0,1,0,1,0
63079,6889,47807,0,0,143,143,0,1,0,1,0
63080,50581,445,0,0,70,70,0,1,0,1,0
63081,50579,445,0,0,70,70,0,1,0,1,0
63082,62148,37965,0,0,62,62,0,1,0,1,0
63083,50578,445,0,0,70,70,0,1,0,1,0
63084,1025,35447,0,0,62,62,0,1,0,1,0
63085,55654,445,0,0,70,70,0,1,0,1,0
63086,55649,445,0,0,70,70,0,1,0,1,0
63087,55644,445,0,0,70,70,0,1,0,1,0
63088,44318,51180,0,0,74,74,0,1,0,1,0
63089,51038,445,0,0,66,66,0,1,0,1,0
63090,51037,445,0,0,66,66,0,1,0,1,0
63091,51035,445,0,0,66,66,0,1,0,1,0
63092,26379,23,0,0,60,60,0,1,0,1,0
63093,6980,48543,0,0,139,139,0,1,0,1,0
63094,20389,64147,0,0,66,66,0,1,0,1,0
63095,55641,445,0,0,70,70,0,1,0,1,0
63096,11404,64147,0,0,62,62,0,1,0,1,0
63097,64000,44847,0,0,66,66,0,1,0,1,0
63098,60246,44612,0,0,66,66,0,1,0,1,0
63099,11136,15503,0,0,145,145,0,1,0,1,0
63100,11136,17500,0,0,62,62,0,1,0,1,0
63101,11136,57587,0,0,62,62,0,1,0,1,0
63102,55639,445,0,0,70,70,0,1,0,1,0
63103,50572,445,0,0,70,70,0,1,0,1,0
63104,28832,36237,0,0,66,66,0,1,0,1,0
63105,55635,445,0,0,70,70,0,1,0,1,0
63106,55634,445,0,0,70,70,0,1,0,1,0
63107,55632,445,0,0,70,70,0,1,0,1,0
63108,30923,12883,0,0,157,157,0,1,0,1,0
63109,57837,64147,0,0,66,66,0,1,0,1,0
63110,50564,445,0,0,70,70,0,1,0,1,0
63111,50563,445,0,0,70,70,0,1,0,1,0
63112,59597,37965,0,0,66,66,0,1,0,1,0
63113,5223,44091,0,0,220,220,0,1,0,1,0
63114,50558,445,0,0,70,70,0,1,0,1,0
63115,6975,29028,0,0,139,139,0,1,0,1,0
63116,55621,445,0,0,70,70,0,1,0,1,0
63117,55619,445,0,0,70,70,0,1,0,1,0
63118,55615,445,0,0,70,70,0,1,0,1,0
63119,6975,26543,0,0,139,139,0,1,0,1,0
63120,50556,445,0,0,70,70,0,1,0,1,0
63121,5637,37965,0,0,62,62,0,1,0,1,0
63122,58486,57470,0,0,66,66,0,1,0,1,0
63123,38681,15503,0,0,74,74,0,1,0,1,0
63124,9756,26467,0,0,62,62,0,1,0,1,0
63125,50052,65008,0,0,60,60,0,1,0,1,0
63126,50552,445,0,0,70,70,0,1,0,1,0
63127,51963,22114,0,0,66,66,0,1,0,1,0
63128,4041,50584,0,0,62,62,0,1,0,1,0
63129,58849,64147,0,0,66,66,0,1,0,1,0
63130,51085,56205,0,0,66,66,0,1,0,1,0
63131,42075,36237,0,0,62,62,0,1,0,1,0
63132,50551,445,0,0,70,70,0,1,0,1,0
63133,65016,37965,0,0,66,66,0,1,0,1,0
63134,51014,445,0,0,66,66,0,1,0,1,0
63135,42252,33303,0,0,60,60,0,1,0,1,0
63136,24504,37965,0,0,62,62,0,1,0,1,0
63137,55613,445,0,0,70,70,0,1,0,1,0
63138,55606,445,0,0,70,70,0,1,0,1,0
63139,60184,37965,0,0,66,66,0,1,0,1,0
63140,3352,50584,0,0,66,66,0,1,0,1,0
63141,50546,445,0,0,70,70,0,1,0,1,0
63142,3052,20421,0,0,104,104,0,1,0,1,0
63143,21998,51221,0,0,62,62,0,1,0,1,0
63144,51009,445,0,0,66,66,0,1,0,1,0
63145,61148,37965,0,0,66,66,0,1,0,1,0
63146,42917,52952,0,0,62,62,0,1,0,1,0
63147,51006,445,0,0,66,66,0,1,0,1,0
63148,55601,445,0,0,70,70,0,1,0,1,0
63149,55595,445,0,0,70,70,0,1,0,1,0
63150,55591,445,0,0,70,70,0,1,0,1,0
63151,55592,445,0,0,70,70,0,1,0,1,0
63152,52788,64147,0,0,66,66,0,1,0,1,0
63153,51004,445,0,0,66,66,0,1,0,1,0
63154,55966,57866,0,0,66,66,0,1,0,1,0
63155,36538,64147,0,0,62,62,0,1,0,1,0
63156,53927,64147,0,0,66,66,0,1,0,1,0
63157,11136,15503,0,0,62,62,0,1,0,1,0
63158,5661,37965,0,0,62,62,0,1,0,1,0
63159,52934,26467,0,0,66,66,0,1,0,1,0
63160,9532,56205,0,0,146,146,0,1,0,1,0
63161,56793,53,56695,53,192,98,94,2,0,1,1
63162,50533,445,0,0,70,70,0,1,0,1,0
63163,55586,445,0,0,70,70,0,1,0,1,0
63164,49711,14984,0,0,66,66,0,1,0,1,0
63165,5200,6643,0,0,145,145,0,1,0,1,0
63166,52328,44847,0,0,62,62,0,1,0,1,0
63167,51339,50584,0,0,66,66,0,1,0,1,0
63168,55584,445,0,0,70,70,0,1,0,1,0
63169,55582,445,0,0,70,70,0,1,0,1,0
63170,55580,445,0,0,70,70,0,1,0,1,0
63171,50995,445,0,0,66,66,0,1,0,1,0
63172,9265,37965,0,0,62,62,0,1,0,1,0
63173,50530,445,0,0,70,70,0,1,0,1,0
63174,50994,445,0,0,66,66,0,1,0,1,0
63175,50993,445,0,0,66,66,0,1,0,1,0
63176,50989,445,0,0,66,66,0,1,0,1,0
63177,33822,57470,0,0,66,66,0,1,0,1,0
63178,50987,445,0,0,66,66,0,1,0,1,0
63179,50985,445,0,0,66,66,0,1,0,1,0
63180,50984,445,0,0,66,66,0,1,0,1,0
63181,52690,7302,0,0,66,66,0,1,0,1,0
63182,57954,48817,0,0,78,78,0,1,0,1,0
63183,51353,46314,0,0,145,145,0,1,0,1,0
63184,15056,2222,0,0,60,60,0,1,0,1,0
63185,57360,18375,0,0,66,66,0,1,0,1,0
63186,443,10010,0,0,60,60,0,1,0,1,0
63187,50525,445,0,0,70,70,0,1,0,1,0
63188,19367,35440,0,0,146,146,0,1,0,1,0
63189,55578,445,0,0,70,70,0,1,0,1,0
63190,55572,445,0,0,70,70,0,1,0,1,0
63191,55573,445,0,0,70,70,0,1,0,1,0
63192,50524,445,0,0,70,70,0,1,0,1,0
63193,50982,445,0,0,66,66,0,1,0,1,0
63194,55571,445,0,0,70,70,0,1,0,1,0
63195,40898,5555,0,0,60,60,0,1,0,1,0
63196,50979,445,0,0,66,66,0,1,0,1,0
63197,1028,64147,0,0,62,62,0,1,0,1,0
63198,50522,445,0,0,70,70,0,1,0,1,0
63199,11552,44847,0,0,62,62,0,1,0,1,0
63200,50977,445,0,0,66,66,0,1,0,1,0
63201,50975,445,0,0,66,66,0,1,0,1,0
63202,53957,35440,0,0,62,62,0,1,0,1,0
63203,14255,2767,0,0,62,62,0,1,0,1,0
63204,50973,445,0,0,66,66,0,1,0,1,0
63205,53960,30041,0,0,66,66,0,1,0,1,0
63206,49502,44847,0,0,66,66,0,1,0,1,0
63207,7307,23,0,0,60,60,0,1,0,1,0
63208,55566,445,0,0,70,70,0,1,0,1,0
63209,32051,37965,0,0,62,62,0,1,0,1,0
63210,50515,445,0,0,70,70,0,1,0,1,0
63211,46389,27098,0,0,66,66,0,1,0,1,0
63212,45964,55559,0,0,60,60,0,1,0,1,0
63213,55559,445,0,0,70,70,0,1,0,1,0
63214,55554,445,0,0,70,70,0,1,0,1,0
63215,35347,20238,0,0,66,66,0,1,0,1,0
63216,50513,445,0,0,70,70,0,1,0,1,0
63217,7377,57470,0,0,62,62,0,1,0,1,0
63218,54165,443,54165,443,147750,13521,134229,182,92,84,98
63219,23406,443,23406,443,5368,1609,3759,21,75,12,9
63220,58520,443,24680,443,9429,3621,5808,60,80,26,34
63221,53912,3478,60537,3478,3532,1792,1740,58,88,29,29
63222,65114,53,35237,53,192,98,94,2,30,1,1
63223,60272,443,24375,443,1853,1214,639,18,87,11,7
63224,54887,443,54887,443,5573,2326,3247,22,40,13,9
63225,65154,443,37170,443,5753,3034,2719,52,281,25,27
63226,50967,443,62336,443,5841,1986,3855,19,17,11,8
63227,62306,443,62306,443,5442,2195,3247,22,39,13,9
63228,60387,32087,24462,32087,320,140,180,6,7,3,3
63229,63166,443,63166,443,5407,2160,3247,22,38,13,9
63230,53436,443,59367,443,7941,2678,5263,25,122,12,13
63231,64289,53,24247,53,198,101,97,2,30,1,1
63232,50387,443,41513,443,8507,1945,6562,21,33,10,11
63233,58884,15000,25949,15000,138,78,60,2,5,1,1
63234,59395,443,39581,443,5817,1995,3822,19,16,10,9
63235,53109,41661,38343,41661,320,140,180,6,8,3,3
63236,37965,24475,30249,24475,480,149,331,2,1200,1,1
63237,52173,443,52173,443,201007,10015,190992,239,22,100,139
63238,64600,80,64600,80,98859,6426,92433,136,27,68,68
63239,49430,443,47050,443,18859,5795,13064,62,3666,28,34
63240,49660,53,64845,53,186,95,91,2,30,1,1
63241,50172,443,51694,443,3756,1914,1842,19,361,9,10
63242,57547,80,39933,80,32368,2187,30181,45,337,23,22
63243,46477,443,29699,443,4900,904,3996,16,97,9,7
63244,46478,443,23649,443,493,280,213,8,97,5,3
63245,65176,53,13076,53,299,103,196,4,51,2,2
63246,41624,15000,41127,15000,130,70,60,2,5,1,1
63247,50008,53,29808,53,186,95,91,2,30,1,1
63248,49154,80,61897,80,2438,565,1873,10,75,6,4
63249,63403,443,54530,443,4470,1597,2873,16,138,8,8
63250,49866,443,40314,443,2937,717,2220,14,136,6,8
63251,30960,45676,24387,45676,396,396,0,7,3616,7,0
63252,53151,29500,62396,29500,514,274,240,8,143,4,4
63253,64926,53,43197,53,192,98,94,2,40,1,1
63254,50012,7000,50012,7000,3132,815,2317,14,16,7,7
63255,51731,39392,6820,39392,70,70,0,2,8,2,0
63256,51709,40705,29645,40705,66,66,0,1,5,1,0
63257,59396,443,16679,443,5801,1995,3806,19,16,10,9
63258,55535,53,31917,53,198,101,97,2,30,1,1
63259,52174,443,52174,443,55503,7279,48224,79,22,32,47
63260,60271,443,5474,443,10324,8406,1918,44,87,26,18
63261,65201,53,7188,53,216,110,106,2,30,1,1
63262,55090,53,47013,53,192,98,94,2,30,1,1
63263,54387,5228,7370,5228,7019,1592,5427,25,3600,14,11
63264,56296,53,27962,53,216,110,106,2,30,1,1
63265,59649,443,47146,443,11784,7785,3999,55,120,28,27
63266,38603,5228,52662,5228,3534,1679,1855,30,3640,11,19
63267,50965,445,0,0,66,66,0,1,0,1,0
63268,50512,445,0,0,70,70,0,1,0,1,0
63269,39100,2767,0,0,62,62,0,1,0,1,0
63270,50511,445,0,0,70,70,0,1,0,1,0
63271,50510,445,0,0,70,70,0,1,0,1,0
63272,50507,445,0,0,70,70,0,1,0,1,0
63273,50506,445,0,0,70,70,0,1,0,1,0
63274,55142,26467,0,0,62,62,0,1,0,1,0
63275,17777,30188,0,0,62,62,0,1,0,1,0
63276,10965,22114,0,0,62,62,0,1,0,1,0
63277,10965,22114,0,0,146,146,0,1,0,1,0
63278,50955,445,0,0,66,66,0,1,0,1,0
63279,65201,53,5294,53,216,110,106,2,30,1,1
63280,62331,61689,0,0,66,66,0,1,0,1,0
63281,55543,445,0,0,70,70,0,1,0,1,0
63282,53233,51221,0,0,66,66,0,1,0,1,0
63283,50492,445,0,0,70,70,0,1,0,1,0
63284,50490,445,0,0,70,70,0,1,0,1,0
63285,50485,445,0,0,70,70,0,1,0,1,0
63286,50482,445,0,0,70,70,0,1,0,1,0
63287,50481,445,0,0,70,70,0,1,0,1,0
63288,38363,5900,0,0,60,60,0,1,0,1,0
63289,50953,445,0,0,66,66,0,1,0,1,0
63290,45912,44847,0,0,62,62,0,1,0,1,0
63291,50945,445,0,0,66,66,0,1,0,1,0
63292,56973,443,44291,443,7481,2264,5217,22,135,10,12
63293,64869,443,59977,443,6454,1227,5227,18,122,9,9
63294,52916,443,43880,443,5455,1388,4067,17,15,9,8
63295,44633,443,21223,443,5715,1536,4179,24,16,13,11
63296,50869,80,23647,80,28291,3346,24945,46,144,25,21
63297,53540,34134,43313,34134,70,70,0,2,7,2,0
63298,37987,49152,22842,49152,156,156,0,3,7,3,0
63299,41995,80,63213,80,1105,634,471,11,15,6,5
63300,52171,443,52171,443,154883,8710,146173,182,23,69,113
63301,55535,53,24278,53,199,102,97,2,29,1,1
63302,56322,53,19228,53,209,110,99,2,29,1,1
63303,50008,53,33522,53,193,102,91,2,29,1,1
63304,56615,443,6112,443,22938,14436,8502,43,41,23,20
63305,47856,443,54908,443,7816,2371,5445,34,255,18,16
63306,63734,28221,59198,28221,66,66,0,2,7,2,0
63307,63732,40642,31051,40642,66,66,0,2,7,2,0
63308,53536,34200,55904,34200,70,70,0,2,7,2,0
63309,46641,8100,62793,8100,234,234,0,4,11,4,0
63310,39953,80,18059,80,1035,564,471,10,15,5,5
63311,48015,443,20608,443,138,78,60,2,4,1,1
63312,55972,53,35969,53,193,102,91,2,29,1,1
63313,55090,53,34414,53,196,102,94,2,29,1,1
63314,55090,53,59676,53,196,102,94,2,29,1,1
63315,56296,53,37666,53,216,110,106,2,30,1,1
63316,53041,443,62358,443,2881,346,2535,12,120,5,7
63317,17735,53,27345,53,223,86,137,2,29,1,1
63318,64835,53,33008,53,200,102,98,2,29,1,1
63319,56296,53,12716,53,216,110,106,2,29,1,1
63320,57455,123,24910,123,184,94,90,2,29,1,1
63321,55090,53,17815,53,196,102,94,2,30,1,1
63322,56597,80,61984,80,234,234,0,4,12,4,0
63323,51712,53203,62336,53203,70,70,0,1,5,1,0
63324,51710,43069,28929,43069,70,70,0,1,5,1,0
63325,53106,59478,22060,59478,70,70,0,1,5,1,0
63326,49413,443,7382,443,44505,6962,37543,64,48,21,43
63327,65114,53,28927,53,196,102,94,2,30,1,1
63328,49173,27402,64212,27402,70,70,0,1,5,1,0
63329,56764,45797,41990,45797,164,70,94,2,5,1,1
63330,47975,443,46443,443,8301,2172,6129,25,255,12,13
63331,60942,443,40230,443,5081,896,4185,16,70,8,8
63332,65208,53,46888,53,637,178,459,6,70,3,3
63333,56847,443,59529,443,35160,6404,28756,82,196,31,51
63334,46550,443,33261,443,7330,4420,2910,31,316,16,15
63335,34994,443,34994,443,5046,2069,2977,20,15,11,9
63336,37234,53,61804,53,168,78,90,2,30,1,1
63337,52176,443,52176,443,126525,6370,120155,147,22,56,91
63338,50008,53,59037,53,359,95,264,4,46,2,2
63339,63964,53,52901,53,196,94,102,2,30,1,1
63340,57780,53,53500,53,70,70,0,1,30,1,0
63341,6881,6881,26370,6881,502,150,352,2,1200,1,1
63342,49542,443,62121,443,40423,35897,4526,52,16,33,19
63343,65460,53,30831,53,197,102,95,2,30,1,1
63344,53542,50321,25266,50321,320,140,180,6,6,3,3
63345,56765,1841,2876,1841,70,70,0,1,5,1,0
63346,45214,443,34615,443,6641,4617,2024,34,80,18,16
63347,57470,34617,39417,34617,481,150,331,2,1199,1,1
63348,39348,443,17067,443,28301,21778,6523,88,125,49,39
63349,59683,443,22150,443,13310,4422,8888,47,136,27,20
63350,57582,80,30299,80,370,222,148,6,48,4,2
63351,60156,443,49389,443,178,118,60,2,15,1,1
63352,50900,80,42676,80,26867,2743,24124,45,140,23,22
63353,52088,443,13388,443,16165,3877,12288,53,186,25,28
63354,50975,80,56708,80,1095845,7641,1088204,839,35,114,725
63355,50976,80,46012,80,1094127,5977,1088150,812,35,88,724
63356,37988,49152,27635,49152,156,156,0,3,7,3,0
63357,27998,443,50249,443,5515,1388,4127,18,15,9,9
63358,52917,443,10403,443,5583,1390,4193,19,14,9,10
63359,56925,80,48459,80,214,140,74,4,25,3,1
63360,50385,443,20761,443,11098,2853,8245,25,33,12,13
63361,53715,443,45128,443,70,70,0,2,8,2,0
63362,56680,8100,25887,8100,234,234,0,4,11,4,0
63363,62729,51558,61898,51558,70,70,0,1,4,1,0
63364,53517,48019,30847,48019,70,70,0,1,4,1,0
63365,54964,443,18537,443,24232,10141,14091,74,76,39,35
63366,50378,443,15906,443,8663,1983,6680,21,33,10,11
63367,65176,53,64803,53,299,103,196,4,51,2,2
63368,49660,53,23772,53,193,102,91,2,30,1,1
63369,63945,53,51432,53,216,110,106,2,29,1,1
63370,49450,53,27588,53,227,94,133,2,29,1,1
63371,65127,53,53558,53,194,102,92,2,29,1,1
63372,64416,53,53808,53,211,94,117,2,30,1,1
63373,64414,53,58315,53,406,142,264,2,30,1,1
63374,11582,41599,27860,41599,70,70,0,2,8,2,0
63375,60715,80,28604,80,198,78,120,4,11,2,2
63376,52485,443,22795,443,22817,7615,15202,30,16,16,14
63377,56315,123,48493,123,184,94,90,2,30,1,1
63378,43374,443,52439,443,10176,2162,8014,25,186,14,11
63379,51713,33724,27696,33724,70,70,0,1,5,1,0
63380,56756,13973,64423,13973,70,70,0,1,5,1,0
63381,64614,53,61495,53,538,179,359,6,63,3,3
63382,64289,53,50043,53,199,102,97,2,30,1,1
63383,58984,443,13660,443,4874459,114404,4760055,4469,188,1112,3357
63384,64289,53,28932,53,199,102,97,2,30,1,1
63385,65201,53,42204,53,216,110,106,2,30,1,1
63386,64289,53,64357,53,199,102,97,2,30,1,1
63387,56536,443,9088,443,8866,2743,6123,23,139,11,12
63388,51711,1027,5156,1027,70,70,0,1,5,1,0
63389,52848,443,15385,443,6218,1239,4979,14,133,7,7
63390,56926,80,46037,80,214,140,74,4,25,3,1
63391,49820,123,49820,123,184,94,90,2,30,1,1
63392,65460,53,40464,53,197,102,95,2,30,1,1
63393,65201,53,38349,53,216,110,106,2,30,1,1
63394,61178,53,58018,53,290,86,204,2,30,1,1
63395,49222,53,61468,53,418,150,268,2,30,1,1
63396,48555,53,5829,53,215,86,129,2,30,1,1
63397,65114,53,27541,53,196,102,94,2,31,1,1
63398,57947,443,51760,443,3282,781,2501,17,136,8,9
63399,54631,443,52521,443,2352,1394,958,17,275,9,8
63400,51077,80,9544,80,9133,1055,8078,17,151,8,9
63401,6881,7560,34838,7560,509,150,359,2,1199,1,1
63402,51610,443,19441,443,6952,3608,3344,27,21,14,13
63403,60379,34301,5453,34301,320,140,180,6,7,3,3
63404,58701,27030,51697,27030,70,70,0,2,9,2,0
63405,42157,443,25655,443,4819,2903,1916,29,81,15,14
63406,49660,53,56463,53,193,102,91,2,31,1,1
63407,65515,53,22832,53,338,107,231,4,39,2,2
63408,60318,80,34962,80,2714,2154,560,12,26,7,5
63409,61382,443,28176,443,32082,12801,19281,62,150,25,37
63410,42922,80,41285,80,234,234,0,4,12,4,0
63411,49701,443,31912,443,13022,1500,11522,30,23,15,15
63412,3964,51505,0,0,62,62,0,1,0,1,0
63413,50939,445,0,0,66,66,0,1,0,1,0
63414,50470,445,0,0,70,70,0,1,0,1,0
63415,59196,34962,0,0,148,148,0,1,0,1,0
63416,443,39878,0,0,74,74,0,1,0,1,0
63417,49680,26467,0,0,146,146,0,1,0,1,0
63418,443,32698,0,0,89,89,0,1,0,1,0
63419,11020,62413,0,0,62,62,0,1,0,1,0
63420,11967,57470,0,0,62,62,0,1,0,1,0
63421,53030,56205,0,0,66,66,0,1,0,1,0
63422,13947,37965,0,0,145,145,0,1,0,1,0
63423,55536,445,0,0,70,70,0,1,0,1,0
63424,55532,445,0,0,70,70,0,1,0,1,0
63425,55531,445,0,0,70,70,0,1,0,1,0
63426,50926,445,0,0,66,66,0,1,0,1,0
63427,50928,445,0,0,66,66,0,1,0,1,0
63428,50929,445,0,0,66,66,0,1,0,1,0
63429,50925,445,0,0,66,66,0,1,0,1,0
63430,4607,6004,0,0,70,70,0,1,0,1,0
63431,50927,445,0,0,66,66,0,1,0,1,0
63432,50930,445,0,0,66,66,0,1,0,1,0
63433,50924,445,0,0,66,66,0,1,0,1,0
63434,50923,445,0,0,66,66,0,1,0,1,0
63435,50466,445,0,0,70,70,0,1,0,1,0
63436,64166,35440,0,0,66,66,0,1,0,1,0
63437,47013,37965,0,0,62,62,0,1,0,1,0
63438,51953,37965,0,0,66,66,0,1,0,1,0
63439,50457,445,0,0,70,70,0,1,0,1,0
63440,50455,445,0,0,70,70,0,1,0,1,0
63441,50453,445,0,0,70,70,0,1,0,1,0
63442,50454,445,0,0,70,70,0,1,0,1,0
63443,61845,11392,0,0,66,66,0,1,0,1,0
63444,50449,445,0,0,70,70,0,1,0,1,0
63445,37234,44847,0,0,66,66,0,1,0,1,0
63446,38041,10104,0,0,146,146,0,1,0,1,0
63447,21294,57470,0,0,62,62,0,1,0,1,0
63448,38664,37965,0,0,145,145,0,1,0,1,0
63449,55523,445,0,0,70,70,0,1,0,1,0
63450,55520,445,0,0,70,70,0,1,0,1,0
63451,55516,445,0,0,70,70,0,1,0,1,0
63452,41852,35440,0,0,62,62,0,1,0,1,0
63453,49717,666,0,0,60,60,0,1,0,1,0
63454,51413,1,0,0,72,72,0,1,0,1,0
63455,30303,30303,0,0,171,171,0,1,0,1,0
63456,14993,50584,0,0,62,62,0,1,0,1,0
63457,50910,445,0,0,66,66,0,1,0,1,0
63458,50908,445,0,0,66,66,0,1,0,1,0
63459,50907,445,0,0,66,66,0,1,0,1,0
63460,2904,44847,0,0,78,78,0,1,0,1,0
63461,53869,56205,0,0,62,62,0,1,0,1,0
63462,55514,445,0,0,70,70,0,1,0,1,0
63463,30399,44847,0,0,146,146,0,1,0,1,0
63464,50444,445,0,0,70,70,0,1,0,1,0
63465,58715,57470,0,0,66,66,0,1,0,1,0
63466,55511,445,0,0,70,70,0,1,0,1,0
63467,55504,445,0,0,70,70,0,1,0,1,0
63468,55502,445,0,0,70,70,0,1,0,1,0
63469,55500,445,0,0,70,70,0,1,0,1,0
63470,58486,57470,0,0,66,66,0,1,0,1,0
63471,50436,445,0,0,70,70,0,1,0,1,0
63472,50971,443,37029,443,469,403,66,4,0,3,1
63473,50970,443,47824,443,469,403,66,4,0,3,1
63474,14613,12446,0,0,66,66,0,1,0,1,0
63475,12694,12446,0,0,62,62,0,1,0,1,0
63476,50433,445,0,0,70,70,0,1,0,1,0
63477,6881,6881,0,0,146,146,0,1,0,1,0
63478,6057,51221,0,0,78,78,0,1,0,1,0
63479,18085,26467,0,0,66,66,0,1,0,1,0
63480,8239,37965,0,0,146,146,0,1,0,1,0
63481,33405,37965,0,0,62,62,0,1,0,1,0
63482,50140,44847,0,0,62,62,0,1,0,1,0
63483,53796,17546,0,0,62,62,0,1,0,1,0
63484,50429,445,0,0,70,70,0,1,0,1,0
63485,37316,22114,0,0,62,62,0,1,0,1,0
63486,50428,445,0,0,70,70,0,1,0,1,0
63487,55491,445,0,0,70,70,0,1,0,1,0
63488,55489,445,0,0,70,70,0,1,0,1,0
63489,55487,445,0,0,70,70,0,1,0,1,0
63490,45908,3383,0,0,60,60,0,1,0,1,0
63491,60617,64147,0,0,62,62,0,1,0,1,0
63492,50424,445,0,0,70,70,0,1,0,1,0
63493,61600,56205,0,0,66,66,0,1,0,1,0
63494,50052,65008,0,0,60,60,0,1,0,1,0
63495,50423,445,0,0,70,70,0,1,0,1,0
63496,50886,445,0,0,66,66,0,1,0,1,0
63497,56103,21247,0,0,66,66,0,1,0,1,0
63498,57434,50584,0,0,62,62,0,1,0,1,0
63499,55485,445,0,0,70,70,0,1,0,1,0
63500,55483,445,0,0,70,70,0,1,0,1,0
63501,54826,56205,0,0,66,66,0,1,0,1,0
63502,40611,9571,0,0,72,72,0,1,0,1,0
63503,51514,50584,0,0,62,62,0,1,0,1,0
63504,50418,445,0,0,70,70,0,1,0,1,0
63505,32124,30188,0,0,62,62,0,1,0,1,0
63506,50853,50584,0,0,66,66,0,1,0,1,0
63507,2791,7302,0,0,62,62,0,1,0,1,0
63508,50881,445,0,0,66,66,0,1,0,1,0
63509,1027,9822,0,0,146,146,0,1,0,1,0
63510,50878,445,0,0,66,66,0,1,0,1,0
63511,53771,37965,0,0,66,66,0,1,0,1,0
63512,55471,445,0,0,70,70,0,1,0,1,0
63513,55466,445,0,0,70,70,0,1,0,1,0
63514,55467,445,0,0,70,70,0,1,0,1,0
63515,55463,445,0,0,70,70,0,1,0,1,0
63516,54346,44847,0,0,66,66,0,1,0,1,0
63517,50875,445,0,0,66,66,0,1,0,1,0
63518,45766,2323,0,0,60,60,0,1,0,1,0
63519,58876,57470,0,0,66,66,0,1,0,1,0
63520,24351,57470,0,0,62,62,0,1,0,1,0
63521,18592,44612,0,0,62,62,0,1,0,1,0
63522,6909,57470,0,0,62,62,0,1,0,1,0
63523,50405,445,0,0,70,70,0,1,0,1,0
63524,55458,445,0,0,70,70,0,1,0,1,0
63525,2704,37,0,0,60,60,0,1,0,1,0
63526,57226,51505,0,0,66,66,0,1,0,1,0
63527,63287,44847,0,0,62,62,0,1,0,1,0
63528,50402,445,0,0,70,70,0,1,0,1,0
63529,56411,50584,0,0,62,62,0,1,0,1,0
63530,55456,445,0,0,70,70,0,1,0,1,0
63531,55454,445,0,0,70,70,0,1,0,1,0
63532,55453,445,0,0,70,70,0,1,0,1,0
63533,1036,64147,0,0,62,62,0,1,0,1,0
63534,50868,445,0,0,66,66,0,1,0,1,0
63535,25973,26467,0,0,66,66,0,1,0,1,0
63536,50865,445,0,0,66,66,0,1,0,1,0
63537,50863,445,0,0,66,66,0,1,0,1,0
63538,50861,445,0,0,66,66,0,1,0,1,0
63539,50856,445,0,0,66,66,0,1,0,1,0
63540,50859,445,0,0,66,66,0,1,0,1,0
63541,50858,445,0,0,66,66,0,1,0,1,0
63542,63786,35440,0,0,66,66,0,1,0,1,0
63543,62569,44847,0,0,66,66,0,1,0,1,0
63544,58238,23,0,0,60,60,0,1,0,1,0
63545,50397,445,0,0,70,70,0,1,0,1,0
63546,35657,48637,0,0,145,145,0,1,0,1,0
63547,50396,445,0,0,70,70,0,1,0,1,0
63548,50200,44847,0,0,74,74,0,1,0,1,0
63549,55450,445,0,0,70,70,0,1,0,1,0
63550,55448,445,0,0,70,70,0,1,0,1,0
63551,55446,445,0,0,70,70,0,1,0,1,0
63552,50394,445,0,0,70,70,0,1,0,1,0
63553,50854,445,0,0,66,66,0,1,0,1,0
63554,52034,26467,0,0,62,62,0,1,0,1,0
63555,55443,445,0,0,70,70,0,1,0,1,0
63556,56783,43890,0,0,66,66,0,1,0,1,0
63557,15274,19473,0,0,62,62,0,1,0,1,0
63558,54540,22,0,0,60,60,0,1,0,1,0
63559,50850,445,0,0,66,66,0,1,0,1,0
63560,50971,44847,0,0,62,62,0,1,0,1,0
63561,58916,21247,0,0,146,146,0,1,0,1,0
63562,50849,445,0,0,66,66,0,1,0,1,0
63563,50848,445,0,0,66,66,0,1,0,1,0
63564,50584,51748,57588,51748,1356,300,1056,6,1200,3,3
63565,56526,80,57143,80,1056,682,374,10,15,6,4
63566,57149,443,55393,443,1647,1375,272,9,37,5,4
63567,60069,443,60069,443,5610,2363,3247,22,40,13,9
63568,60323,443,19514,443,1743,1164,579,16,25,10,6
63569,60324,443,7520,443,1743,1164,579,16,25,10,6
63570,62238,443,62238,443,58141,3051,55090,78,78,29,49
63571,51648,80,61615,80,3227,2425,802,9,31,5,4
63572,63383,53,63383,53,235,90,145,2,33,1,1
63573,2267,53,19148,53,826,826,0,8,44,8,0
63574,38085,443,21750,443,234,234,0,4,12,4,0
63575,49573,80,24541,80,180917,5183,175734,175,65,49,126
63576,51730,33399,62466,33399,70,70,0,2,8,2,0
63577,64565,443,57848,443,24984,2042,22942,41,33,19,22
63578,49579,80,10648,80,277736,7810,269926,277,65,91,186
63579,49577,80,46203,80,147113,4021,143092,144,65,41,103
63580,60321,443,49674,443,1743,1164,579,16,25,10,6
63581,50047,443,50047,443,4534,1627,2907,19,27,11,8
63582,56014,443,56014,443,4334,1427,2907,19,30,11,8
63583,60320,443,16711,443,1743,1164,579,16,25,10,6
63584,51704,9266,12391,9266,66,66,0,1,5,1,0
63585,61692,443,18049,443,126,60,66,3,10,2,1
63586,51727,1024,33037,1024,70,70,0,2,8,2,0
63587,51705,59244,12307,59244,66,66,0,1,5,1,0
63588,62235,443,62235,443,16675,2296,14379,37,78,17,20
63589,63102,443,30669,443,8848,3081,5767,56,335,26,30
63590,60832,5222,60932,5222,3848,1039,2809,37,662,11,26
63591,56465,443,52483,443,6081,844,5237,17,15,9,8
63592,63976,53,34685,53,200,102,98,2,30,1,1
63593,5588,5588,0,0,3562,1936,1626,48,194,24,24
63594,57256,443,52300,443,47762,39522,8240,77,332,43,34
63595,50121,443,24047,443,307104860,2750998,304353862,234597,6122,15017,219580
63596,56177,443,61837,443,6826,5299,1527,22,330,12,10
63597,50060,80,8335,80,2425,529,1896,11,75,6,5
63598,60322,443,12700,443,1743,1164,579,16,25,10,6
63599,22419,1433,22419,1433,146,60,86,2,9,1,1
63600,49576,80,6202,80,174140,4942,169198,166,65,47,119
63601,30960,45656,54549,45656,66,66,0,1,3600,1,0
63602,48817,6889,48817,6889,480,149,331,2,1200,1,1
63603,50584,6881,63450,6881,1320,300,1020,6,1200,3,3
63604,50584,62833,22282,62833,1275,300,975,6,1200,3,3
63605,56597,53,9477,53,197,197,0,3,60,3,0
63606,62102,443,60782,443,3182,1568,1614,8,121,4,4
63607,50584,54321,2526,54321,1275,300,975,6,1200,3,3
63608,50584,30773,22058,30773,1356,300,1056,6,1200,3,3
63609,50584,45270,4666,45270,1377,300,1077,6,1200,3,3
63610,30960,45665,23931,45665,462,462,0,8,3632,8,0
63611,50845,445,0,0,66,66,0,1,0,1,0
63612,51062,1433,0,0,60,60,0,1,0,1,0
63613,57750,37965,0,0,62,62,0,1,0,1,0
63614,50387,445,0,0,70,70,0,1,0,1,0
63615,55440,445,0,0,70,70,0,1,0,1,0
63616,50385,445,0,0,70,70,0,1,0,1,0
63617,50102,17546,0,0,66,66,0,1,0,1,0
63618,55432,445,0,0,70,70,0,1,0,1,0
63619,55428,445,0,0,70,70,0,1,0,1,0
63620,50384,445,0,0,70,70,0,1,0,1,0
63621,443,25740,0,0,131,131,0,1,0,1,0
63622,50383,445,0,0,70,70,0,1,0,1,0
63623,27889,32480,0,0,100,100,0,1,0,1,0
63624,50382,445,0,0,70,70,0,1,0,1,0
63625,60192,35440,0,0,62,62,0,1,0,1,0
63626,50378,445,0,0,70,70,0,1,0,1,0
63627,50377,445,0,0,70,70,0,1,0,1,0
63628,50837,445,0,0,66,66,0,1,0,1,0
63629,443,10010,0,0,60,60,0,1,0,1,0
63630,44258,25,0,0,74,74,0,1,0,1,0
63631,45941,23386,0,0,60,60,0,1,0,1,0
63632,6881,26296,0,0,157,157,0,1,0,1,0
63633,59371,22114,0,0,62,62,0,1,0,1,0
63634,11842,35440,0,0,66,66,0,1,0,1,0
63635,50362,445,0,0,70,70,0,1,0,1,0
63636,50361,445,0,0,70,70,0,1,0,1,0
63637,50359,445,0,0,70,70,0,1,0,1,0
63638,50827,445,0,0,66,66,0,1,0,1,0
63639,58912,11392,0,0,66,66,0,1,0,1,0
63640,55415,445,0,0,70,70,0,1,0,1,0
63641,50351,445,0,0,70,70,0,1,0,1,0
63642,50210,26467,0,0,62,62,0,1,0,1,0
63643,5223,44091,0,0,66,66,0,1,0,1,0
63644,58597,35440,0,0,66,66,0,1,0,1,0
63645,61173,2323,0,0,60,60,0,1,0,1,0
63646,50824,445,0,0,66,66,0,1,0,1,0
63647,47398,7302,0,0,62,62,0,1,0,1,0
63648,39839,67,0,0,60,60,0,1,0,1,0
63649,43271,50584,0,0,62,62,0,1,0,1,0
63650,17702,6881,0,0,66,66,0,1,0,1,0
63651,27328,21247,0,0,66,66,0,1,0,1,0
63652,60292,7129,0,0,62,62,0,1,0,1,0
63653,43840,50265,0,0,72,72,0,1,0,1,0
63654,62092,35440,0,0,66,66,0,1,0,1,0
63655,54071,50265,0,0,66,66,0,1,0,1,0
63656,64106,64147,0,0,66,66,0,1,0,1,0
63657,50818,445,0,0,66,66,0,1,0,1,0
63658,50340,445,0,0,70,70,0,1,0,1,0
63659,50807,445,0,0,66,66,0,1,0,1,0
63660,50336,445,0,0,70,70,0,1,0,1,0
63661,55407,445,0,0,70,70,0,1,0,1,0
63662,55403,445,0,0,70,70,0,1,0,1,0
63663,55404,445,0,0,70,70,0,1,0,1,0
63664,53472,17,0,0,60,60,0,1,0,1,0
63665,59969,443,49407,443,6655,1166,5489,21,360,11,10
63666,45001,443,55898,443,570,318,252,10,20,6,4
63667,50584,6889,64241,6889,1326,300,1026,6,1200,3,3
63668,50584,28020,62483,28020,1302,300,1002,6,1200,3,3
63669,50584,54993,58004,54993,652,300,352,4,1200,3,1
63670,58248,53,0,0,633,83,550,2,30,1,1
63671,50880,80,36202,80,395978,13168,382810,411,143,151,260
63672,59779,443,2318,443,5834,1810,4024,24,17,13,11
63673,50535,22,50535,22,6292,2375,3917,35,20,19,16
63674,57594,443,55656,443,614577,24675,589902,673,149,228,445
63675,51737,54691,48488,54691,316,136,180,6,5,3,3
63676,65476,53,44080,53,226,110,116,2,29,1,1
63677,65304,53,52702,53,194,86,108,2,29,1,1
63678,50056,27018,43222,27018,468,390,78,5,29,4,1
63679,62678,53,62678,53,216,90,126,2,30,1,1
63680,50584,51413,45972,51413,1275,300,975,6,1200,3,3
63681,59162,80,16258,80,1031,314,717,13,175,3,10
63682,65176,53,35354,53,511,195,316,6,56,3,3
63683,42500,443,20918,443,8932,2039,6893,23,24,12,11
63684,49885,443,30250,443,4626083,113708,4512375,4382,213,1198,3184
63685,43210,443,51289,443,5960402,99613,5860789,5017,133,952,4065
63686,52314,443,46456,443,3448,1612,1836,31,36,17,14
63687,35498,80,39354,80,1270,387,883,16,392,4,12
63688,49608,80,59432,80,145752,3240,142512,128,61,23,105
63689,62237,443,62237,443,169315,5255,164060,190,77,66,124
63690,60742,20010,63644,20010,70,70,0,2,8,2,0
63691,51729,63553,13105,63553,70,70,0,2,8,2,0
63692,63106,443,7897,443,8712,3748,4964,51,255,23,28
63693,49577,53,54563,53,384,94,290,2,30,1,1
63694,49703,80,27292,80,71256,962,70294,63,52,11,52
63695,49700,80,44971,80,71320,1026,70294,64,52,12,52
63696,49702,80,5138,80,71256,962,70294,63,52,11,52
63697,60961,443,5669,443,75122,4244,70878,101,45,48,53
63698,60239,53,53135,53,219,102,117,2,30,1,1
63699,55610,53,9648,53,265,91,174,4,36,2,2
63700,57170,53,13134,53,298,102,196,4,36,2,2
63701,60777,443,22998,443,10417,2617,7800,32,15,17,15
63702,50618,443,50618,443,4351,1444,2907,19,28,11,8
63703,54810,80,61461,80,6098,1916,4182,31,357,16,15
63704,60959,443,46440,443,17149,2543,14606,40,46,22,18
63705,49634,443,7107,443,1575,988,587,13,35,7,6
63706,50318,80,21534,80,3855,828,3027,11,15,5,6
63707,60960,443,48167,443,7488,1552,5936,23,46,13,10
63708,49359,53,57768,53,102,102,0,1,60,1,0
63709,58248,53,0,0,186,83,103,2,30,1,1
63710,60989,443,62484,443,3182,1568,1614,8,120,4,4
63711,57798,443,21508,443,12877,5188,7689,27,130,12,15
63712,65005,53,2818,53,239,94,145,2,30,1,1
63713,50584,54741,14563,54741,868,150,718,4,1200,2,2
63714,50584,15926,55734,15926,1377,300,1077,6,1200,3,3
63715,49711,80,42345,80,2269,821,1448,15,51,8,7
63716,49701,80,63516,80,70321,956,69365,62,52,11,51
63717,62236,443,62236,443,28126,3114,25012,50,77,22,28
63718,51708,21278,38128,21278,70,70,0,1,5,1,0
63719,55581,64301,29198,64301,316,190,126,5,15,3,2
63720,65008,53,8162,53,312,94,218,2,30,1,1
63721,57266,53,22077,53,209,102,107,2,30,1,1
63722,2267,53,3037,53,826,826,0,8,44,8,0
63723,49891,443,20308,443,1820,1101,719,18,73,10,8
63724,51571,443,51571,443,1724,916,808,17,128,7,10
63725,52315,443,14653,443,24304,2974,21330,57,34,31,26
63726,49609,80,24955,80,11534,719,10815,18,61,7,11
63727,51572,443,51572,443,1724,916,808,17,128,7,10
63728,53188,443,8819,443,7878,3197,4681,22,18,11,11
63729,56009,53,4440,53,232,94,138,2,30,1,1
63730,50584,25935,2865,25935,1377,300,1077,6,1200,3,3
63731,50584,55624,58737,55624,1326,300,1026,6,1200,3,3
63732,44847,6881,3655,6881,324,150,174,2,1201,1,1
63733,50584,51413,47261,51413,1275,300,975,6,1200,3,3
63734,55104,443,37071,443,10470,3626,6844,20,131,9,11
63735,55385,443,7012,443,11771,2624,9147,50,20,25,25
63736,44586,443,61467,443,122708,5797,116911,169,132,75,94
63737,55036,443,41925,443,10001,2547,7454,27,35,14,13
63738,50929,80,17624,80,9630744,98097,9532647,7804,123,1387,6417
63739,60319,80,61391,80,194,128,66,4,25,3,1
63740,52177,443,52177,443,38013,6855,31158,58,21,25,33
63741,62233,443,62233,443,41941,3388,38553,67,77,26,41
63742,63976,53,54161,53,200,102,98,2,33,1,1
63743,51703,3010,58034,3010,70,70,0,1,5,1,0
63744,56463,443,48725,443,6364,1147,5217,19,24,11,8
63745,49892,443,65121,443,1820,1101,719,18,73,10,8
63746,64584,80,64584,80,142674,8057,134617,192,27,94,98
63747,65176,53,60246,53,299,103,196,4,53,2,2
63748,49698,80,3522,80,140258,1720,138538,117,52,18,99
63749,24009,53,46041,53,223,86,137,2,29,1,1
63750,61669,443,27122,443,12453,3460,8993,43,18,24,19
63751,49660,53,59057,53,193,102,91,2,29,1,1
63752,53392,53,53392,53,832,106,726,2,30,1,1
63753,65073,53,55415,53,325,102,223,2,29,1,1
63754,65114,53,15041,53,196,102,94,2,29,1,1
63755,7060,53,45870,53,197,94,103,2,30,1,1
63756,58409,53,57147,53,307,86,221,2,30,1,1
63757,56459,53,55165,53,392,86,306,2,30,1,1
63758,49412,443,56019,443,46271,6834,39437,63,47,19,44
63759,27393,53,7301,53,168,78,90,2,30,1,1
63760,55330,53,4334,53,216,102,114,2,30,1,1
63761,50584,56112,8598,56112,1377,300,1077,6,1200,3,3
63762,50584,61467,32483,61467,1377,300,1077,6,1200,3,3
63763,50584,11888,51615,11888,1356,300,1056,6,1200,3,3
63764,59970,443,18481,443,6720,1166,5554,22,360,11,11
63765,50584,40420,46560,40420,868,150,718,4,1200,2,2
63766,50584,8999,18180,8999,1356,300,1056,6,1200,3,3
63767,50584,49376,27285,49376,1320,300,1020,6,1200,3,3
63768,50584,54157,4800,54157,1377,300,1077,6,1200,3,3
63769,50584,6889,7914,6889,1326,300,1026,6,1200,3,3
63770,13971,53,13971,53,220,90,130,2,30,1,1
63771,63976,53,50670,53,200,102,98,2,30,1,1
63772,49538,53,56684,53,258,102,156,2,30,1,1
63773,50584,21094,39450,21094,1356,300,1056,6,1200,3,3
63774,63542,3389,63542,3389,3504,1790,1714,17,32,9,8
63775,54525,80,24122,80,50436663,1205750,49230913,49415,198,16827,32588
63776,51725,32787,39792,32787,70,70,0,2,8,2,0
63777,51706,30673,17118,30673,70,70,0,1,5,1,0
63778,49630,443,54596,443,7776,2266,5510,17,35,9,8
63779,65278,53,45335,53,264,110,154,2,30,1,1
63780,58828,53,32002,53,215,102,113,2,30,1,1
63781,50584,38578,41911,38578,1377,300,1077,6,1200,3,3
63782,50584,16455,26852,16455,1356,300,1056,6,1200,3,3
63783,55584,34914,32488,34914,504,318,186,8,15,5,3
63784,43817,53,0,0,82,82,0,2,40,2,0
63785,49688,443,44354,443,318,192,126,6,53,4,2
63786,63718,80,18056,80,314,192,122,6,15,4,2
63787,64038,53,4227,53,321,102,219,2,30,1,1
63788,58562,53,31864,53,215,102,113,2,30,1,1
63789,41267,443,45130,443,8248,876,7372,25,186,9,16
63790,50584,51413,31560,51413,800,150,650,4,1200,2,2
63791,50584,49001,36650,49001,1290,300,990,6,1200,3,3
63792,50584,47174,17468,47174,300,300,0,3,1200,3,0
63793,55877,62071,53667,62071,481,150,331,2,1200,1,1
63794,53936,443,5510,443,886,70,816,14,166,2,12
63795,49782,80,13908,80,1661,1147,514,9,210,5,4
63796,50584,8569,42866,8569,1356,300,1056,6,1200,3,3
63797,50584,6889,50435,6889,1326,300,1026,6,1200,3,3
63798,6881,666,16595,666,268,150,118,2,1199,1,1
63799,19987,53,54747,53,208,86,122,2,30,1,1
63800,64745,53,11106,53,196,94,102,2,31,1,1
63801,38770,5228,21583,5228,6033,1874,4159,33,4073,11,22
63802,46999,993,56009,993,45153,20621,24532,323,43,165,158
63803,50939,80,16478,80,1375,1038,337,7,137,4,3
63804,54366,443,39148,443,17629,5828,11801,39,41,20,19
63805,50933,80,44380,80,9932735,85391,9847344,7875,123,1237,6638
63806,64602,80,64602,80,18594,5204,13390,42,26,25,17
63807,52482,443,8869,443,26154,6874,19280,35,17,16,19
63808,36716,53,54815,53,224,78,146,2,31,1,1
63809,50796,445,0,0,66,66,0,1,0,1,0
63810,50802,445,0,0,66,66,0,1,0,1,0
63811,50800,445,0,0,66,66,0,1,0,1,0
63812,50795,445,0,0,66,66,0,1,0,1,0
63813,50798,445,0,0,66,66,0,1,0,1,0
63814,50799,445,0,0,66,66,0,1,0,1,0
63815,50797,445,0,0,66,66,0,1,0,1,0
63816,50794,445,0,0,66,66,0,1,0,1,0
63817,27125,51221,0,0,62,62,0,1,0,1,0
63818,51535,64147,0,0,66,66,0,1,0,1,0
63819,59477,36829,0,0,66,66,0,1,0,1,0
63820,50327,445,0,0,70,70,0,1,0,1,0
63821,50325,445,0,0,70,70,0,1,0,1,0
63822,50322,445,0,0,70,70,0,1,0,1,0
63823,50321,445,0,0,70,70,0,1,0,1,0
63824,55704,64097,0,0,66,66,0,1,0,1,0
63825,58338,3369,0,0,60,60,0,1,0,1,0
63826,50319,445,0,0,70,70,0,1,0,1,0
63827,50113,51505,0,0,66,66,0,1,0,1,0
63828,19394,44847,0,0,66,66,0,1,0,1,0
63829,35718,20238,0,0,62,62,0,1,0,1,0
63830,55397,445,0,0,70,70,0,1,0,1,0
63831,55394,445,0,0,70,70,0,1,0,1,0
63832,55387,445,0,0,70,70,0,1,0,1,0
63833,64767,51221,0,0,62,62,0,1,0,1,0
63834,62787,51221,0,0,66,66,0,1,0,1,0
63835,37538,37965,0,0,66,66,0,1,0,1,0
63836,35377,43890,0,0,62,62,0,1,0,1,0
63837,50780,445,0,0,66,66,0,1,0,1,0
63838,50782,445,0,0,66,66,0,1,0,1,0
63839,50779,445,0,0,66,66,0,1,0,1,0
63840,55663,44847,0,0,62,62,0,1,0,1,0
63841,50313,445,0,0,70,70,0,1,0,1,0
63842,20706,37965,0,0,62,62,0,1,0,1,0
63843,50626,43890,0,0,62,62,0,1,0,1,0
63844,42969,8146,0,0,62,62,0,1,0,1,0
63845,19963,2767,0,0,66,66,0,1,0,1,0
63846,55386,445,0,0,70,70,0,1,0,1,0
63847,51973,44847,0,0,66,66,0,1,0,1,0
63848,62663,35253,0,0,66,66,0,1,0,1,0
63849,55383,445,0,0,70,70,0,1,0,1,0
63850,55377,445,0,0,70,70,0,1,0,1,0
63851,55375,445,0,0,70,70,0,1,0,1,0
63852,55373,445,0,0,70,70,0,1,0,1,0
63853,50306,445,0,0,70,70,0,1,0,1,0
63854,50304,445,0,0,70,70,0,1,0,1,0
63855,6057,51221,0,0,78,78,0,1,0,1,0
63856,64059,30188,0,0,62,62,0,1,0,1,0
63857,58014,39004,0,0,62,62,0,1,0,1,0
63858,12668,42707,0,0,62,62,0,1,0,1,0
63859,9520,32480,0,0,62,62,0,1,0,1,0
63860,50299,445,0,0,70,70,0,1,0,1,0
63861,50298,445,0,0,70,70,0,1,0,1,0
63862,59374,51505,0,0,62,62,0,1,0,1,0
63863,55364,445,0,0,70,70,0,1,0,1,0
63864,55360,445,0,0,70,70,0,1,0,1,0
63865,55359,445,0,0,70,70,0,1,0,1,0
63866,50294,445,0,0,70,70,0,1,0,1,0
63867,60894,50584,0,0,66,66,0,1,0,1,0
63868,11136,57587,0,0,145,145,0,1,0,1,0
63869,17760,50584,0,0,62,62,0,1,0,1,0
63870,60092,51505,0,0,62,62,0,1,0,1,0
63871,50293,445,0,0,70,70,0,1,0,1,0
63872,50840,57470,0,0,66,66,0,1,0,1,0
63873,11825,38338,0,0,86,86,0,1,0,1,0
63874,58036,443,0,0,1097,1097,0,1,0,1,0
63875,0,0,0,0,134,64,70,2,0,1,1
63876,64191,44847,0,0,66,66,0,1,0,1,0
63877,443,50755,0,0,102,102,0,1,0,1,0
63878,1256,50584,0,0,146,146,0,1,0,1,0
63879,443,10010,0,0,60,60,0,1,0,1,0
63880,3407,57866,0,0,66,66,0,1,0,1,0
63881,50759,445,0,0,66,66,0,1,0,1,0
63882,5195,64147,0,0,66,66,0,1,0,1,0
63883,63503,42707,0,0,66,66,0,1,0,1,0
63884,55358,445,0,0,70,70,0,1,0,1,0
63885,55357,445,0,0,70,70,0,1,0,1,0
63886,50288,445,0,0,70,70,0,1,0,1,0
63887,56216,50584,0,0,62,62,0,1,0,1,0
63888,50753,445,0,0,66,66,0,1,0,1,0
63889,26795,6881,0,0,146,146,0,1,0,1,0
63890,50750,445,0,0,66,66,0,1,0,1,0
63891,55344,445,0,0,70,70,0,1,0,1,0
63892,13188,35440,0,0,66,66,0,1,0,1,0
63893,11777,37965,0,0,62,62,0,1,0,1,0
63894,55341,445,0,0,70,70,0,1,0,1,0
63895,55339,445,0,0,70,70,0,1,0,1,0
63896,55335,445,0,0,70,70,0,1,0,1,0
63897,50748,445,0,0,66,66,0,1,0,1,0
63898,50274,445,0,0,70,70,0,1,0,1,0
63899,45941,23386,0,0,60,60,0,1,0,1,0
63900,63888,57470,0,0,62,62,0,1,0,1,0
63901,50271,445,0,0,70,70,0,1,0,1,0
63902,60524,64147,0,0,66,66,0,1,0,1,0
63903,11651,64147,0,0,145,145,0,1,0,1,0
63904,55330,445,0,0,70,70,0,1,0,1,0
63905,5223,61002,0,0,161,161,0,1,0,1,0
63906,63433,57866,0,0,66,66,0,1,0,1,0
63907,64616,53,29802,53,184,80,104,2,30,1,1
63908,61046,443,61046,443,5830,2583,3247,22,40,13,9
63909,40710,5228,9746,5228,4065,2585,1480,28,40,14,14
63910,40709,53,32661,53,221,75,146,2,30,1,1
63911,50968,80,19228,80,109660,1992,107668,99,35,20,79
63912,5588,5588,0,0,3498,1872,1626,48,195,24,24
63913,993,54634,0,0,66,66,0,1,90,1,0
63914,52765,443,14674,443,283,163,120,4,16,2,2
63915,47740,443,62722,443,6234,4369,1865,25,316,12,13
63916,50967,80,65454,80,1439,697,742,12,35,6,6
63917,56149,80,45182,80,1286,403,883,16,400,4,12
63918,50312,80,15679,80,17102,1099,16003,19,16,5,14
63919,54368,443,18976,443,10707,2548,8159,27,39,15,12
63920,34338,443,23040,443,8152,3395,4757,27,18,15,12
63921,56896,80,32594,80,2684,2550,134,7,16,5,2
63922,46488,443,7780,443,87129,6924,80205,126,258,49,77
63923,54360,443,12392,443,7723,2282,5441,22,255,11,11
63924,23293,443,23293,443,50236,37417,12819,67,19,41,26
63925,56759,55201,4487,55201,70,70,0,2,8,2,0
63926,24037,443,24037,443,3611,2177,1434,24,17,13,11
63927,53535,1393,2385,1393,70,70,0,2,8,2,0
63928,57595,80,57595,80,254,120,134,5,26,3,2
63929,51724,25807,54569,25807,70,70,0,2,8,2,0
63930,48381,53,16694,53,221,75,146,2,30,1,1
63931,59808,443,49702,443,147637,6160,141477,164,121,56,108
63932,65404,443,46166,443,63040,3063,59977,78,129,30,48
63933,42298,40030,5035,40030,146,84,62,2,31,1,1
63934,50073,443,21032,443,9873,2384,7489,25,242,14,11
63935,55328,445,0,0,70,70,0,1,0,1,0
63936,55326,445,0,0,70,70,0,1,0,1,0
63937,55324,445,0,0,70,70,0,1,0,1,0
63938,50282,37965,0,0,66,66,0,1,0,1,0
63939,50739,445,0,0,66,66,0,1,0,1,0
63940,33215,37965,0,0,62,62,0,1,0,1,0
63941,32974,37965,0,0,66,66,0,1,0,1,0
63942,50962,5900,0,0,60,60,0,1,0,1,0
63943,50736,445,0,0,66,66,0,1,0,1,0
63944,50733,445,0,0,66,66,0,1,0,1,0
63945,50732,445,0,0,66,66,0,1,0,1,0
63946,50731,445,0,0,66,66,0,1,0,1,0
63947,50730,445,0,0,66,66,0,1,0,1,0
63948,50728,445,0,0,66,66,0,1,0,1,0
63949,50266,445,0,0,70,70,0,1,0,1,0
63950,46090,50584,0,0,66,66,0,1,0,1,0
63951,50265,445,0,0,70,70,0,1,0,1,0
63952,443,29326,0,0,82,82,0,1,0,1,0
63953,63729,6969,55353,6969,66,66,0,2,8,2,0
63954,48203,80,21963,80,946,531,415,11,315,6,5
63955,1924,80,29370,80,214,140,74,4,15,3,1
63956,50263,445,0,0,70,70,0,1,0,1,0
63957,57493,443,0,0,60,60,0,1,0,1,0
63958,55323,445,0,0,70,70,0,1,0,1,0
63959,55318,445,0,0,70,70,0,1,0,1,0
63960,55320,445,0,0,70,70,0,1,0,1,0
63961,50725,445,0,0,66,66,0,1,0,1,0
63962,40703,5900,0,0,60,60,0,1,0,1,0
63963,24311,22617,0,0,60,60,0,1,0,1,0
63964,55315,445,0,0,70,70,0,1,0,1,0
63965,34716,23,0,0,60,60,0,1,0,1,0
63966,58338,3362,0,0,60,60,0,1,0,1,0
63967,58338,3362,0,0,60,60,0,1,0,1,0
63968,50723,445,0,0,66,66,0,1,0,1,0
63969,49057,5900,0,0,60,60,0,1,0,1,0
63970,50721,445,0,0,66,66,0,1,0,1,0
63971,50720,445,0,0,66,66,0,1,0,1,0
63972,23061,23,0,0,60,60,0,1,0,1,0
63973,59037,51505,0,0,66,66,0,1,0,1,0
63974,60435,35440,0,0,62,62,0,1,0,1,0
63975,50717,445,0,0,66,66,0,1,0,1,0
63976,5180,57866,0,0,66,66,0,1,0,1,0
63977,49501,11392,0,0,66,66,0,1,0,1,0
63978,50256,445,0,0,70,70,0,1,0,1,0
63979,5223,1210,0,0,103,103,0,1,0,1,0
63980,55618,56205,0,0,66,66,0,1,0,1,0
63981,50254,445,0,0,70,70,0,1,0,1,0
63982,52431,64147,0,0,62,62,0,1,0,1,0
63983,58849,64147,0,0,66,66,0,1,0,1,0
63984,55310,445,0,0,70,70,0,1,0,1,0
63985,51426,52700,0,0,100,100,0,1,0,1,0
63986,50253,445,0,0,70,70,0,1,0,1,0
63987,23807,44847,0,0,66,66,0,1,0,1,0
63988,52910,51221,0,0,78,78,0,1,0,1,0
63989,55302,445,0,0,70,70,0,1,0,1,0
63990,55300,445,0,0,70,70,0,1,0,1,0
63991,50252,445,0,0,70,70,0,1,0,1,0
63992,50251,445,0,0,70,70,0,1,0,1,0
63993,54095,26467,0,0,62,62,0,1,0,1,0
63994,50249,445,0,0,70,70,0,1,0,1,0
63995,50246,445,0,0,70,70,0,1,0,1,0
63996,50438,19426,0,0,62,62,0,1,0,1,0
63997,51130,61689,0,0,66,66,0,1,0,1,0
63998,515,10214,0,0,62,62,0,1,0,1,0
63999,50708,445,0,0,66,66,0,1,0,1,0
64000,7744,32480,0,0,62,62,0,1,0,1,0
64001,443,29326,0,0,82,82,0,1,0,1,0
64002,12232,18593,0,0,139,139,0,1,0,1,0
64003,64277,30188,0,0,62,62,0,1,0,1,0
64004,50233,445,0,0,70,70,0,1,0,1,0
64005,50231,445,0,0,70,70,0,1,0,1,0
64006,50230,445,0,0,70,70,0,1,0,1,0
64007,50222,445,0,0,70,70,0,1,0,1,0
64008,50223,445,0,0,70,70,0,1,0,1,0
64009,65024,51505,0,0,62,62,0,1,0,1,0
64010,5223,44091,0,0,66,66,0,1,0,1,0
64011,5223,44091,0,0,119,119,0,1,0,1,0
64012,5223,44091,0,0,167,167,0,1,0,1,0
64013,6712,161,0,0,82,82,0,1,0,1,0
64014,443,10010,0,0,60,60,0,1,0,1,0
64015,52218,31573,0,0,62,62,0,1,0,1,0
64016,50699,445,0,0,66,66,0,1,0,1,0
64017,443,22238,0,0,112,112,0,1,0,1,0
64018,44147,64147,0,0,62,62,0,1,0,1,0
64019,28832,36237,0,0,66,66,0,1,0,1,0
64020,55288,445,0,0,70,70,0,1,0,1,0
64021,44411,37965,0,0,62,62,0,1,0,1,0
64022,64601,80,64601,80,56887,6820,50067,90,25,49,41
64023,58081,3389,58081,3389,3549,1594,1955,18,16,10,8
64024,60743,40010,9730,40010,316,136,180,6,6,3,3
64025,58438,53,46803,53,246,102,144,2,29,1,1
64026,54373,443,3920,443,16029,6377,9652,46,37,24,22
64027,54363,443,18639,443,23766,10707,13059,80,42,41,39
64028,50316,80,27928,80,1677,862,815,10,15,5,5
64029,54348,443,31489,443,27760,9709,18051,56,45,27,29
64030,53817,443,11999,443,7443,2043,5400,34,255,17,17
64031,53515,39608,40902,39608,70,70,0,1,4,1,0
64032,33637,443,44559,443,24214,18131,6083,81,118,44,37
64033,26758,443,6342,443,20851,15854,4997,36,20,20,16
64034,46985,993,3733,993,9725,3931,5794,46,48,25,21
64035,50028,53,56615,53,323,110,213,2,29,1,1
64036,50013,53,8122,53,662,195,467,6,39,3,3
64037,61670,443,47830,443,5943,1991,3952,23,17,14,9
64038,38413,53,37201,53,199,94,105,2,29,1,1
64039,37752,53,54109,53,220,78,142,2,30,1,1
64040,59437,53,35841,53,215,86,129,2,29,1,1
64041,58602,53,5583,53,197,86,111,2,29,1,1
64042,56763,27734,6083,27734,70,70,0,1,5,1,0
64043,34413,443,27966,443,8107,2200,5907,34,255,16,18
64044,42805,443,52110,443,130,70,60,2,15,1,1
64045,49445,80,19716,80,1586,808,778,13,45,7,6
64046,54374,443,44819,443,9131,3499,5632,39,24,21,18
64047,43221,443,25236,443,72183,3193,68990,89,20,34,55
64048,49166,53,8191,53,468,93,375,4,34,2,2
64049,55580,45817,63033,45817,70,70,0,1,5,1,0
64050,51702,33451,34580,33451,70,70,0,1,5,1,0
64051,55585,48063,46430,48063,70,70,0,2,8,2,0
64052,64593,53,5715,53,602,93,509,4,42,2,2
64053,43532,80,43879,80,1449,364,1085,13,15,6,7
64054,65318,53,16200,53,395,102,293,2,30,1,1
64055,43782,7275,17092,7275,4955,1749,3206,24,16,15,9
64056,57768,7635,57768,7635,138,78,60,2,6,1,1
64057,35105,443,59131,443,639937,14873,625064,627,230,188,439
64058,43402,53,65461,53,241,78,163,2,30,1,1
64059,56762,25080,40998,25080,70,70,0,1,5,1,0
64060,49812,53,37839,53,195,86,109,2,30,1,1
64061,39417,53,53271,53,224,78,146,2,30,1,1
64062,52785,443,33714,443,5806,1059,4747,16,63,8,8
64063,4683,53,49166,53,207,86,121,2,30,1,1
64064,40885,443,32340,443,4014,1592,2422,17,147,9,8
64065,49980,443,59748,443,7227,4437,2790,29,271,16,13
64066,59420,53,63231,53,224,78,146,2,30,1,1
64067,62103,443,43175,443,6345,3495,2850,18,120,9,9
64068,57470,1136,15403,1136,402,132,270,6,1209,3,3
64069,49505,53,46670,53,232,110,122,2,30,1,1
64070,52203,80,56885,80,432,246,186,7,40,4,3
64071,49154,53,7041,53,763,204,559,6,40,3,3
64072,49792,53,58447,53,339,110,229,2,30,1,1
64073,59801,443,35070,443,5678,2820,2858,25,141,11,14
64074,61675,80,46507,80,5108,676,4432,14,15,7,7
64075,60308,443,13749,443,5445,1072,4373,24,80,11,13
64076,55583,14822,28217,14822,70,70,0,1,5,1,0
64077,52402,53,52402,53,212,98,114,2,30,1,1
64078,49230,53,32099,53,195,94,101,2,30,1,1
64079,59943,443,41706,443,2979,914,2065,10,120,5,5
64080,64585,80,64585,80,405673,21057,384616,519,26,252,267
64081,49416,443,60307,443,27484,4857,22627,42,46,15,27
64082,49646,443,41538,443,5647,1832,3815,16,36,9,7
64083,60307,443,42783,443,5574,1200,4374,26,80,13,13
64084,51140,443,48264,443,5759,1904,3855,19,15,11,8
64085,53374,443,16272,443,4317,1134,3183,16,26,9,7
64086,55579,58420,44629,58420,70,70,0,1,5,1,0
64087,53375,443,59892,443,4317,1134,3183,16,26,9,7
64088,65461,443,11386,443,396698,11870,384828,409,16,144,265
64089,33099,443,5841,443,11110,1700,9410,33,750,11,22
64090,56595,80,43530,80,234,234,0,4,12,4,0
64091,39135,443,24335,443,8286,2195,6091,24,256,12,12
64092,44363,443,4525,443,10667,2992,7675,32,560,17,15
64093,33327,53,12719,53,199,94,105,2,29,1,1
64094,51069,80,24367,80,254,128,126,5,15,3,2
64095,47993,443,45711,443,5272,1535,3737,17,35,12,5
64096,53868,53,29458,53,86,86,0,1,30,1,0
64097,53663,80,16666,80,149148,7515,141633,197,20,95,102
64098,55582,26957,64555,26957,70,70,0,1,5,1,0
64099,50377,80,8000,80,1451,796,655,11,31,6,5
64100,63709,21989,3950,21989,696,508,188,10,16,7,3
64101,58866,53,56575,53,355,118,237,2,29,1,1
64102,60425,443,26007,443,1541,1004,537,14,26,8,6
64103,64947,53,12228,53,402,118,284,2,29,1,1
64104,61412,53,24202,53,225,78,147,2,30,1,1
64105,50355,443,60927,443,4137,2232,1905,13,132,8,5
64106,41677,443,61867,443,7292,1489,5803,21,187,11,10
64107,37965,51719,40903,51719,481,150,331,2,1199,1,1
64108,35101,443,31000,443,4988930,161289,4827641,5384,290,1964,3420
64109,51701,24343,49961,24343,70,70,0,1,5,1,0
64110,55578,45682,64868,45682,70,70,0,1,5,1,0
64111,50313,80,63654,80,736,670,66,6,15,5,1
64112,46619,123,26763,123,184,94,90,2,30,1,1
64113,36928,53,43446,53,241,78,163,2,30,1,1
64114,37383,443,62473,443,11389,4837,6552,27,120,13,14
64115,56761,34725,47498,34725,70,70,0,1,5,1,0
64116,53180,443,55711,443,7876,3195,4681,22,20,11,11
64117,5588,5588,0,0,3562,1936,1626,48,192,24,24
64118,60302,443,30801,443,39850,4375,35475,73,80,31,42
64119,57318,53,50520,53,418,88,330,4,41,2,2
64120,55586,17332,63048,17332,70,70,0,2,8,2,0
64121,44674,80,41945,80,1298,624,674,12,16,5,7
64122,60374,17432,21315,17432,564,318,246,9,18,5,4
64123,53283,443,23870,443,9121,2486,6635,22,45,13,9
64124,64772,53,2611,53,633,231,402,6,47,3,3
64125,59793,443,44894,443,41635,3977,37658,63,121,25,38
64126,42025,443,40368,443,2394,1365,1029,18,275,9,9
64127,62101,443,33220,443,1867,250,1617,8,120,4,4
64128,56429,443,9683,443,355939,9284,346655,365,121,125,240
64129,15503,21394,46725,21394,479,150,329,2,1200,1,1
64130,6882,24271,34047,24271,228,118,110,2,1200,1,1
64131,51726,18475,34444,18475,316,136,180,6,7,3,3
64132,40299,443,53474,443,9574,2600,6974,29,136,16,13
64133,64000,53,61132,53,214,102,112,2,30,1,1
64134,51108,53,64155,53,168,78,90,2,30,1,1
64135,57099,53,12968,53,278,102,176,2,31,1,1
64136,52208,80,51352,80,372,246,126,6,28,4,2
64137,56408,443,56408,443,4373,1466,2907,19,28,11,8
64138,10602,3389,10602,3389,3910,1805,2105,20,19,12,8
64139,50961,80,36404,80,5730066,61301,5668765,4686,81,891,3795
64140,50308,80,8289,80,1083,653,430,8,16,5,3
64141,58959,53,45652,53,307,86,221,2,30,1,1
64142,30654,51221,0,0,72,72,0,1,0,1,0
64143,63062,35440,0,0,62,62,0,1,0,1,0
64144,49150,51505,0,0,146,146,0,1,0,1,0
64145,61495,37965,0,0,66,66,0,1,0,1,0
64146,53479,23,0,0,60,60,0,1,0,1,0
64147,50696,445,0,0,66,66,0,1,0,1,0
64148,28584,37965,0,0,62,62,0,1,0,1,0
64149,21173,37965,0,0,145,145,0,1,0,1,0
64150,43704,465,0,0,60,60,0,1,0,1,0
64151,443,29326,0,0,82,82,0,1,0,1,0
64152,64382,44847,0,0,66,66,0,1,0,1,0
64153,50211,445,0,0,70,70,0,1,0,1,0
64154,57837,64147,0,0,66,66,0,1,0,1,0
64155,59241,62413,0,0,66,66,0,1,0,1,0
64156,4431,32480,0,0,66,66,0,1,0,1,0
64157,53051,44847,0,0,66,66,0,1,0,1,0
64158,50681,445,0,0,66,66,0,1,0,1,0
64159,50636,23117,0,0,62,62,0,1,0,1,0
64160,64880,64147,0,0,62,62,0,1,0,1,0
64161,4041,50584,0,0,62,62,0,1,0,1,0
64162,2704,37,0,0,60,60,0,1,0,1,0
64163,64279,23718,0,0,146,146,0,1,0,1,0
64164,50207,445,0,0,70,70,0,1,0,1,0
64165,62148,37965,0,0,62,62,0,1,0,1,0
64166,50968,443,1243,443,469,403,66,4,0,3,1
64167,50969,443,54163,443,469,403,66,4,0,3,1
64168,56942,443,61847,443,494,420,74,4,0,3,1
64169,47063,15503,0,0,62,62,0,1,0,1,0
64170,55278,445,0,0,70,70,0,1,0,1,0
64171,55276,445,0,0,70,70,0,1,0,1,0
64172,55275,445,0,0,70,70,0,1,0,1,0
64173,61706,64147,0,0,62,62,0,1,0,1,0
64174,50674,445,0,0,66,66,0,1,0,1,0
64175,50670,445,0,0,66,66,0,1,0,1,0
64176,50668,445,0,0,66,66,0,1,0,1,0
64177,50673,445,0,0,66,66,0,1,0,1,0
64178,50671,445,0,0,66,66,0,1,0,1,0
64179,50672,445,0,0,66,66,0,1,0,1,0
64180,50666,445,0,0,66,66,0,1,0,1,0
64181,50667,445,0,0,66,66,0,1,0,1,0
64182,50198,445,0,0,70,70,0,1,0,1,0
64183,50196,445,0,0,70,70,0,1,0,1,0
64184,50195,445,0,0,70,70,0,1,0,1,0
64185,50192,445,0,0,70,70,0,1,0,1,0
64186,12694,12446,0,0,145,145,0,1,0,1,0
64187,51085,56205,0,0,66,66,0,1,0,1,0
64188,50191,445,0,0,70,70,0,1,0,1,0
64189,54080,26467,0,0,62,62,0,1,0,1,0
64190,6057,51221,0,0,78,78,0,1,0,1,0
64191,6666,401,0,0,60,60,0,1,0,1,0
64192,60184,37965,0,0,66,66,0,1,0,1,0
64193,51948,37965,0,0,62,62,0,1,0,1,0
64194,443,29326,0,0,82,82,0,1,0,1,0
64195,50561,55777,0,0,62,62,0,1,0,1,0
64196,55273,445,0,0,70,70,0,1,0,1,0
64197,55265,445,0,0,70,70,0,1,0,1,0
64198,55261,445,0,0,70,70,0,1,0,1,0
64199,59059,80,0,0,62,62,0,1,0,1,0
64200,50184,445,0,0,70,70,0,1,0,1,0
64201,50654,445,0,0,66,66,0,1,0,1,0
64202,50652,445,0,0,66,66,0,1,0,1,0
64203,50653,445,0,0,66,66,0,1,0,1,0
64204,3352,50584,0,0,66,66,0,1,0,1,0
64205,55258,445,0,0,70,70,0,1,0,1,0
64206,25151,58833,0,0,62,62,0,1,0,1,0
64207,14903,10387,0,0,159,159,0,1,0,1,0
64208,50177,445,0,0,70,70,0,1,0,1,0
64209,55255,445,0,0,70,70,0,1,0,1,0
64210,50174,445,0,0,70,70,0,1,0,1,0
64211,45941,23386,0,0,60,60,0,1,0,1,0
64212,57107,64147,0,0,66,66,0,1,0,1,0
64213,55252,445,0,0,70,70,0,1,0,1,0
64214,55251,445,0,0,70,70,0,1,0,1,0
64215,55244,445,0,0,70,70,0,1,0,1,0
64216,5223,1210,0,0,103,103,0,1,0,1,0
64217,51716,44847,0,0,62,62,0,1,0,1,0
64218,50065,44847,0,0,62,62,0,1,0,1,0
64219,35849,30188,0,0,146,146,0,1,0,1,0
64220,50170,445,0,0,70,70,0,1,0,1,0
64221,36538,64147,0,0,62,62,0,1,0,1,0
64222,50169,445,0,0,70,70,0,1,0,1,0
64223,0,0,0,0,60,60,0,1,0,1,0
64224,0,0,0,0,480,244,236,4,0,2,2
64225,19416,23,0,0,60,60,0,1,0,1,0
64226,24037,53415,0,0,76,76,0,1,0,1,0
64227,50165,445,0,0,70,70,0,1,0,1,0
64228,57360,18375,0,0,66,66,0,1,0,1,0
64229,55235,445,0,0,70,70,0,1,0,1,0
64230,55236,445,0,0,70,70,0,1,0,1,0
64231,55231,445,0,0,70,70,0,1,0,1,0
64232,60441,5900,0,0,60,60,0,1,0,1,0
64233,50375,50584,0,0,62,62,0,1,0,1,0
64234,50163,445,0,0,70,70,0,1,0,1,0
64235,68,67,0,0,594,594,0,1,0,1,0
64236,53957,35440,0,0,62,62,0,1,0,1,0
64237,42995,26467,0,0,62,62,0,1,0,1,0
64238,11552,44847,0,0,62,62,0,1,0,1,0
64239,53960,30041,0,0,66,66,0,1,0,1,0
64240,50159,445,0,0,70,70,0,1,0,1,0
64241,50632,445,0,0,66,66,0,1,0,1,0
64242,55230,445,0,0,70,70,0,1,0,1,0
64243,55228,445,0,0,70,70,0,1,0,1,0
64244,52451,56205,0,0,66,66,0,1,0,1,0
64245,49386,64147,0,0,62,62,0,1,0,1,0
64246,3777,64097,0,0,146,146,0,1,0,1,0
64247,58446,56205,0,0,62,62,0,1,0,1,0
64248,39100,2767,0,0,62,62,0,1,0,1,0
64249,5223,1210,0,0,66,66,0,1,0,1,0
64250,50626,445,0,0,66,66,0,1,0,1,0
64251,50834,64147,0,0,62,62,0,1,0,1,0
64252,50622,445,0,0,66,66,0,1,0,1,0
64253,57763,52752,0,0,66,66,0,1,0,1,0
64254,42298,40002,11642,40002,724,550,174,4,30,2,2
64255,53471,8118,42759,8118,1745,1091,654,10,31,5,5
64256,57814,443,32836,443,6162,925,5237,18,108,10,8
64257,53004,80,58597,80,9956,2570,7386,21,335,10,11
64258,58700,443,30626,443,8124,1079,7045,16,26,8,8
64259,42298,51408,45869,51408,725,325,400,12,31,6,6
64260,49631,53,0,0,82,82,0,1,30,1,0
64261,52461,443,54450,443,16541,4900,11641,62,131,26,36
64262,57263,443,6071,443,7748,3859,3889,20,148,10,10
64263,52916,80,53748,80,4266,1776,2490,20,367,11,9
64264,60152,80,38610,80,1056,682,374,10,15,6,4
64265,53000,80,5659,80,1991,686,1305,10,335,6,4
64266,52096,443,12292,443,86745,6260,80485,121,32,58,63
64267,42298,40018,26921,40018,148,86,62,2,30,1,1
64268,12299,53,12299,53,229,89,140,2,30,1,1
64269,51167,443,46694,443,13777,1743,12034,26,31,12,14
64270,50301,80,40498,80,7979,802,7177,17,39,8,9
64271,63707,28423,64677,28423,564,382,182,9,16,6,3
64272,38725,80,37134,80,130,70,60,2,15,1,1
64273,49816,80,56471,80,130,70,60,2,15,1,1
64274,43314,443,11137,443,27958,21973,5985,77,403,43,34
64275,37780,443,20085,443,1403708,31893,1371815,1301,162,292,1009
64276,51728,55504,11641,55504,316,136,180,6,6,3,3
64277,39540,80,37629,80,130,70,60,2,15,1,1
64278,63728,11785,52016,11785,66,66,0,2,8,2,0
64279,42298,40031,35344,40031,1346,662,684,8,32,4,4
64280,56753,38028,14806,38028,156,66,90,2,5,1,1
64281,46981,443,34961,443,2809,1884,925,19,25,11,8
64282,51698,63846,26436,63846,66,66,0,1,5,1,0
64283,5588,5588,0,0,3562,1936,1626,48,191,24,24
64284,65045,53,53307,53,194,99,95,2,30,1,1
64285,35905,443,10061,443,8272,2091,6181,25,331,12,13
64286,42298,40001,24361,40001,140,78,62,2,31,1,1
64287,42298,40007,30822,40007,143,81,62,2,31,1,1
64288,50027,80,48247,80,3648,2069,1579,16,85,9,7
64289,53852,80,48149,80,130,70,60,2,15,1,1
64290,52999,80,62826,80,1991,686,1305,10,335,6,4
64291,52930,80,36918,80,76193,2105,74088,75,359,23,52
64292,52928,80,52040,80,1996,691,1305,10,359,6,4
64293,51699,37224,26533,37224,66,66,0,1,5,1,0
64294,57813,443,65376,443,6163,925,5238,18,109,10,8
64295,56754,14715,43516,14715,66,66,0,1,5,1,0
64296,35965,443,35465,443,14940,9434,5506,30,105,17,13
64297,50380,80,4994,80,3190,980,2210,13,30,7,6
64298,39796,443,27327,443,7425,2276,5149,24,16,12,12
64299,56876,443,56876,443,18542,1778,16764,30,17,15,15
64300,42298,40036,17125,40036,141,79,62,2,30,1,1
64301,34717,53,24183,53,168,78,90,2,31,1,1
64302,42298,40006,18530,40006,243,180,63,2,31,1,1
64303,54521,443,4685,443,1574197,46737,1527460,1590,34,557,1033
64304,56524,53,52908,53,711,87,624,2,31,1,1
64305,42298,40002,3434,40002,241,178,63,2,31,1,1
64306,55461,443,39176,443,2341,540,1801,9,121,5,4
64307,33624,443,6639,443,247438,52606,194832,305,237,124,181
64308,63587,443,60950,443,10576,3685,6891,46,92,24,22
64309,35087,443,32747,443,6053,3586,2467,17,135,8,9
64310,42298,40025,58686,40025,140,78,62,2,31,1,1
64311,42298,40019,18664,40019,597,79,518,2,31,1,1
64312,42298,443,10335,443,64,64,0,1,31,1,0
64313,50875,443,41381,443,1786,172,1614,7,121,3,4
64314,123,123,7719,123,184,94,90,2,31,1,1
64315,52797,443,2237,443,6876,3332,3544,22,140,11,11
64316,5938,37145,0,0,60,60,0,1,90,1,0
64317,55216,445,0,0,70,70,0,1,0,1,0
64318,51426,59737,0,0,100,100,0,1,0,1,0
64319,50146,445,0,0,70,70,0,1,0,1,0
64320,55212,445,0,0,70,70,0,1,0,1,0
64321,55211,445,0,0,70,70,0,1,0,1,0
64322,55207,445,0,0,70,70,0,1,0,1,0
64323,50620,445,0,0,66,66,0,1,0,1,0
64324,53314,64097,0,0,66,66,0,1,0,1,0
64325,50143,445,0,0,70,70,0,1,0,1,0
64326,21998,51221,0,0,62,62,0,1,0,1,0
64327,53233,51221,0,0,66,66,0,1,0,1,0
64328,62331,61689,0,0,66,66,0,1,0,1,0
64329,51769,80,52683,80,74039,4367,69672,91,19,40,51
64330,50877,80,27709,80,186520,11545,174975,222,141,96,126
64331,46417,443,30278,443,359878,6703,353175,325,36,88,237
64332,58972,80,64079,80,943,513,430,9,14,6,3
64333,52207,80,29595,80,372,246,126,6,27,4,2
64334,65045,53,16728,53,197,102,95,2,29,1,1
64335,56051,53,2559,53,249,102,147,2,29,1,1
64336,50935,80,3414,80,8167195,108448,8058747,7107,121,1531,5576
64337,34765,5222,48630,5222,10109,3480,6629,72,615,38,34
64338,51567,443,51567,443,1654,916,738,16,126,7,9
64339,49952,53,43225,53,196,94,102,2,30,1,1
64340,35190,80,55473,80,130,70,60,2,14,1,1
64341,50890,80,12548,80,290951,15209,275742,327,141,132,195
64342,52206,80,42642,80,372,246,126,6,27,4,2
64343,29025,53,29025,53,235,90,145,2,31,1,1
64344,61713,80,49521,80,134,60,74,3,5,2,1
64345,61707,80,47062,80,134,60,74,3,4,2,1
64346,53350,80,3605,80,1712,913,799,12,273,7,5
64347,47655,53,46246,53,168,78,90,2,29,1,1
64348,64045,53,1404,53,1011,232,779,6,55,3,3
64349,50876,80,52453,80,121344,7345,113999,144,141,61,83
64350,64735,53,29173,53,350,118,232,2,29,1,1
64351,49811,53,32866,53,308,110,198,2,29,1,1
64352,64382,53,40543,53,278,102,176,2,30,1,1
64353,65450,53,49502,53,336,110,226,2,30,1,1
64354,33954,53,7602,53,168,78,90,2,29,1,1
64355,52182,53,52182,53,832,106,726,2,30,1,1
64356,49232,53,52451,53,242,78,164,2,29,1,1
64357,51723,10622,43836,10622,70,70,0,2,8,2,0
64358,59601,443,24962,443,162,102,60,2,5,1,1
64359,53181,443,19571,443,2309,1443,866,16,17,8,8
64360,52607,80,12616,80,2543,691,1852,13,30,8,5
64361,42298,40022,6562,40022,148,86,62,2,30,1,1
64362,23331,53,23331,53,242,98,144,2,30,1,1
64363,53298,80,1119,80,12660,7492,5168,27,274,14,13
64364,56377,80,8742,80,1633,943,690,15,72,8,7
64365,55887,53,55333,53,212,94,118,2,30,1,1
64366,53002,80,19802,80,1601,761,840,10,334,6,4
64367,50892,80,51133,80,256436,14131,242305,283,141,111,172
64368,56862,443,9641,443,7819,1662,6157,20,76,11,9
64369,46746,443,33868,443,7002,4142,2860,46,1485,29,17
64370,57092,53,3743,53,228,102,126,2,30,1,1
64371,43705,443,47459,443,8060,2001,6059,24,19,14,10
64372,52626,80,56571,80,2820,1466,1354,20,534,11,9
64373,64351,53,15747,53,228,102,126,2,30,1,1
64374,37707,53,28750,53,168,78,90,2,30,1,1
64375,50886,80,22505,80,312952,13869,299083,347,141,138,209
64376,49976,53,5693,53,393,110,283,2,30,1,1
64377,42298,40007,6536,40007,148,86,62,2,30,1,1
64378,54367,3389,54367,3389,4365,2581,1784,20,32,11,9
64379,62768,443,53717,443,30902,6307,24595,86,269,36,50
64380,50883,80,64742,80,204646,11741,192905,240,141,104,136
64381,53006,80,12227,80,1988,742,1246,10,334,6,4
64382,52960,80,43936,80,82011,2937,79074,91,358,34,57
64383,59877,80,9809,80,1306,557,749,10,25,6,4
64384,55179,53,7582,53,194,102,92,2,33,1,1
64385,50873,80,11525,80,173653,9305,164348,189,141,73,116
64386,50414,80,48434,80,1657,1246,411,8,15,5,3
64387,49287,53,21721,53,405,90,315,4,59,2,2
64388,42298,40007,31436,40007,148,86,62,2,30,1,1
64389,65306,53,12072,53,244,94,150,2,30,1,1
64390,45725,443,40804,443,8600,4882,3718,44,225,23,21
64391,55028,443,3475,443,1403116,30089,1373027,1321,32,404,917
64392,43208,443,45939,443,4296557,96359,4200198,3781,143,838,2943
64393,50934,80,52977,80,10213447,100765,10112682,8215,121,1412,6803
64394,42298,40022,48973,40022,730,548,182,4,30,2,2
64395,60193,443,30919,443,677029,102078,574951,1152,455,559,593
64396,63712,21917,18745,21917,504,382,122,8,15,6,2
64397,52481,443,46031,443,6270,1368,4902,22,15,12,10
64398,53206,80,36804,80,2622,1074,1548,14,282,8,6
64399,52209,80,41464,80,372,246,126,6,27,4,2
64400,53107,44060,63943,44060,70,70,0,2,8,2,0
64401,43412,80,13841,80,78,78,0,1,4,1,0
64402,36927,80,32507,80,130,70,60,2,14,1,1
64403,65462,443,5746,443,92384,4519,87865,105,15,39,66
64404,52210,80,30096,80,372,246,126,6,30,4,2
64405,60470,443,16410,443,7289,1899,5390,29,317,16,13
64406,53886,443,35805,443,6074,1579,4495,18,125,11,7
64407,65045,53,56055,53,197,102,95,2,32,1,1
64408,63366,30365,36289,30365,70,70,0,1,4,1,0
64409,63704,28291,53778,28291,504,382,122,8,15,6,2
64410,50889,80,11268,80,397616,15684,381932,419,141,157,262
64411,65233,53,6826,53,448,130,318,4,44,2,2
64412,65169,80,56657,80,1516,481,1035,11,15,6,5
64413,47729,443,6419,443,15600,2166,13434,32,205,16,16
64414,54498,443,44231,443,8060,2001,6059,24,19,14,10
64415,64454,53,61289,53,293,110,183,2,29,1,1
64416,65309,53,47712,53,258,110,148,2,30,1,1
64417,57604,53,48752,53,290,86,204,2,29,1,1
64418,54385,53,14777,53,168,78,90,2,30,1,1
64419,50887,80,30027,80,256649,11414,245235,280,141,111,169
64420,56404,80,13755,80,17376,1687,15689,28,40,12,16
64421,55320,53,12991,53,239,102,137,2,30,1,1
64422,58151,53,58151,53,241,98,143,2,30,1,1
64423,42298,40020,48690,40020,148,86,62,2,30,1,1
64424,41910,443,63630,443,9358,2304,7054,39,120,20,19
64425,60520,53,60520,53,198,90,108,2,30,1,1
64426,55087,53,44618,53,344,110,234,2,30,1,1
64427,50388,53,36843,53,177,94,83,2,30,1,1
64428,42298,40038,63975,40038,148,86,62,2,30,1,1
64429,42298,40031,52392,40031,156,94,62,2,30,1,1
64430,57589,53,7858,53,165,78,87,2,30,1,1
64431,42298,40015,12335,40015,140,78,62,2,31,1,1
64432,42298,40022,41026,40022,717,551,166,4,31,2,2
64433,36567,443,58934,443,2341,1054,1287,20,299,7,13
64434,64575,53,36717,53,268,110,158,2,31,1,1
64435,53028,80,12775,80,3470,1464,2006,21,190,10,11
64436,60735,28080,14759,28080,70,70,0,1,5,1,0
64437,56376,80,29400,80,1635,945,690,15,72,8,7
64438,50884,80,30103,80,238059,13790,224269,276,141,113,163
64439,43465,80,31398,80,1352,848,504,13,255,8,5
64440,5588,5588,0,0,3498,1872,1626,48,195,24,24
64441,42298,40005,19733,40005,148,86,62,2,30,1,1
64442,42298,40017,13967,40017,148,86,62,2,30,1,1
64443,54942,53,0,0,168,74,94,2,30,1,1
64444,52951,80,38288,80,6266,4430,1836,22,358,13,9
64445,51697,60619,59919,60619,70,70,0,1,5,1,0
64446,57802,80,24943,80,2762,2628,134,8,17,6,2
64447,53271,443,53446,443,34908,2650,32258,52,45,23,29
64448,64006,53,16897,53,394,96,298,4,47,2,2
64449,65519,53,27344,53,321,102,219,2,30,1,1
64450,42298,40005,17939,40005,263,182,81,2,30,1,1
64451,42298,40039,50865,40039,602,86,516,2,30,1,1
64452,50882,80,51896,80,207895,10483,197412,229,141,90,139
64453,52946,80,56196,80,4085,2870,1215,23,358,14,9
64454,55004,443,32429,443,1334906,33112,1301794,1315,35,446,869
64455,52959,80,37640,80,122572,3630,118942,128,358,46,82
64456,53534,40960,13903,40960,320,140,180,6,6,3,3
64457,36486,80,36486,80,15249,1015,14234,24,29,9,15
64458,56375,80,51111,80,1609,919,690,15,72,8,7
64459,50874,80,33456,80,331828,15003,316825,363,141,140,223
64460,55350,53,18566,53,315,95,220,4,50,2,2
64461,41776,443,6550,443,32434,15588,16846,164,1128,83,81
64462,42298,40008,62209,40008,148,86,62,2,30,1,1
64463,42298,40042,16142,40042,148,86,62,2,30,1,1
64464,42298,40028,40095,40028,563,86,477,2,30,1,1
64465,10151,51413,40673,51413,460,150,310,2,1200,1,1
64466,42298,40032,22903,40032,720,549,171,4,30,2,2
64467,49899,53,23402,53,718,94,624,2,30,1,1
64468,52824,443,27899,443,4114,2920,1194,19,80,11,8
64469,39508,53,12625,53,78,78,0,1,30,1,0
64470,65454,53,35372,53,218,86,132,2,31,1,1
64471,27269,53,56522,53,199,94,105,2,31,1,1
64472,42298,40010,41895,40010,1082,86,996,2,31,1,1
64473,42298,40030,21853,40030,546,486,60,2,30,1,1
64474,42298,40014,14476,40014,148,86,62,2,31,1,1
64475,52431,443,19671,443,7396,3677,3719,16,120,8,8
64476,64744,53,33076,53,376,118,258,2,30,1,1
64477,42298,40014,10112,40014,140,78,62,2,31,1,1
64478,51221,6881,43660,6881,479,150,329,2,1200,1,1
64479,42298,40010,33875,40010,148,86,62,2,31,1,1
64480,57587,443,4519,443,15613,1408,14205,32,125,15,17
64481,59570,443,54074,443,6713,3052,3661,49,5974,15,34
64482,57588,53,31636,53,165,78,87,2,30,1,1
64483,49428,53,34747,53,267,94,173,2,31,1,1
64484,42298,40020,47579,40020,148,86,62,2,31,1,1
64485,42298,40021,40004,40021,148,86,62,2,31,1,1
64486,39992,443,33603,443,3470,1045,2425,13,121,6,7
64487,53512,23280,49318,23280,1950,957,993,17,17,10,7
64488,50291,80,56837,80,442,250,192,8,45,5,3
64489,59494,443,39878,443,448,78,370,6,25,1,5
64490,50881,80,32099,80,128327,7366,120961,154,141,67,87
64491,51510,443,23309,443,1047,560,487,10,16,6,4
64492,50938,80,32549,80,10272889,104948,10167941,8416,121,1525,6891
64493,49758,443,14307,443,17412,6917,10495,38,63,20,18
64494,44924,53,44924,53,235,90,145,2,32,1,1
64495,53522,24116,32649,24116,70,70,0,2,8,2,0
64496,55640,53,37187,53,797,208,589,6,67,3,3
64497,57959,21247,0,0,66,66,0,1,0,1,0
64498,55203,445,0,0,70,70,0,1,0,1,0
64499,55199,445,0,0,70,70,0,1,0,1,0
64500,55198,445,0,0,70,70,0,1,0,1,0
64501,55196,445,0,0,70,70,0,1,0,1,0
64502,50611,445,0,0,66,66,0,1,0,1,0
64503,50138,445,0,0,70,70,0,1,0,1,0
64504,50604,445,0,0,66,66,0,1,0,1,0
64505,50610,445,0,0,66,66,0,1,0,1,0
64506,50606,445,0,0,66,66,0,1,0,1,0
64507,5223,1210,0,0,66,66,0,1,0,1,0
64508,5223,1210,0,0,103,103,0,1,0,1,0
64509,50137,445,0,0,70,70,0,1,0,1,0
64510,45912,44847,0,0,62,62,0,1,0,1,0
64511,50603,445,0,0,66,66,0,1,0,1,0
64512,50602,445,0,0,66,66,0,1,0,1,0
64513,50601,445,0,0,66,66,0,1,0,1,0
64514,50135,445,0,0,70,70,0,1,0,1,0
64515,1025,64147,0,0,62,62,0,1,0,1,0
64516,31062,50584,0,0,62,62,0,1,0,1,0
64517,64177,44847,0,0,66,66,0,1,0,1,0
64518,55193,445,0,0,70,70,0,1,0,1,0
64519,55191,445,0,0,70,70,0,1,0,1,0
64520,55190,445,0,0,70,70,0,1,0,1,0
64521,52611,9571,0,0,62,62,0,1,0,1,0
64522,59942,22114,0,0,62,62,0,1,0,1,0
64523,50596,445,0,0,66,66,0,1,0,1,0
64524,56798,9571,0,0,66,66,0,1,0,1,0
64525,53030,56205,0,0,66,66,0,1,0,1,0
64526,54827,50432,0,0,109,109,0,1,0,1,0
64527,55187,445,0,0,70,70,0,1,0,1,0
64528,50595,445,0,0,66,66,0,1,0,1,0
64529,10494,23,0,0,60,60,0,1,0,1,0
64530,1773,11392,0,0,62,62,0,1,0,1,0
64531,50593,445,0,0,66,66,0,1,0,1,0
64532,50592,445,0,0,66,66,0,1,0,1,0
64533,55212,53733,0,0,66,66,0,1,0,1,0
64534,50128,445,0,0,70,70,0,1,0,1,0
64535,61670,57470,0,0,74,74,0,1,0,1,0
64536,2704,37,0,0,60,60,0,1,0,1,0
64537,50589,445,0,0,66,66,0,1,0,1,0
64538,4607,6004,0,0,70,70,0,1,0,1,0
64539,50126,445,0,0,70,70,0,1,0,1,0
64540,55919,64147,0,0,62,62,0,1,0,1,0
64541,50125,445,0,0,70,70,0,1,0,1,0
64542,50124,445,0,0,70,70,0,1,0,1,0
64543,55182,445,0,0,70,70,0,1,0,1,0
64544,50123,445,0,0,70,70,0,1,0,1,0
64545,49578,80,61645,80,25846,2486,23360,39,50,16,23
64546,50118,445,0,0,70,70,0,1,0,1,0
64547,50119,445,0,0,70,70,0,1,0,1,0
64548,55172,445,0,0,70,70,0,1,0,1,0
64549,55173,445,0,0,70,70,0,1,0,1,0
64550,26573,44847,0,0,66,66,0,1,0,1,0
64551,42469,30188,0,0,62,62,0,1,0,1,0
64552,29145,8168,0,0,62,62,0,1,0,1,0
64553,9775,30188,0,0,62,62,0,1,0,1,0
64554,50578,445,0,0,66,66,0,1,0,1,0
64555,9544,11392,0,0,62,62,0,1,0,1,0
64556,50105,445,0,0,70,70,0,1,0,1,0
64557,50104,445,0,0,70,70,0,1,0,1,0
64558,50100,445,0,0,70,70,0,1,0,1,0
64559,56564,9571,0,0,78,78,0,1,0,1,0
64560,56100,57470,0,0,62,62,0,1,0,1,0
64561,50095,445,0,0,70,70,0,1,0,1,0
64562,50094,445,0,0,70,70,0,1,0,1,0
64563,20939,60461,0,0,60,60,0,1,0,1,0
64564,61357,64147,0,0,62,62,0,1,0,1,0
64565,37234,44847,0,0,66,66,0,1,0,1,0
64566,20939,60461,0,0,60,60,0,1,0,1,0
64567,2904,44847,0,0,78,78,0,1,0,1,0
64568,50571,445,0,0,66,66,0,1,0,1,0
64569,55160,445,0,0,70,70,0,1,0,1,0
64570,2704,37,0,0,60,60,0,1,0,1,0
64571,45941,23386,0,0,60,60,0,1,0,1,0
64572,50568,445,0,0,66,66,0,1,0,1,0
64573,17916,23,0,0,60,60,0,1,0,1,0
64574,50082,445,0,0,70,70,0,1,0,1,0
64575,21294,57470,0,0,62,62,0,1,0,1,0
64576,58715,57470,0,0,66,66,0,1,0,1,0
64577,58635,51505,0,0,62,62,0,1,0,1,0
64578,53353,26467,0,0,62,62,0,1,0,1,0
64579,25342,8168,0,0,66,66,0,1,0,1,0
64580,7916,23,0,0,60,60,0,1,0,1,0
64581,50562,445,0,0,66,66,0,1,0,1,0
64582,51233,43890,0,0,66,66,0,1,0,1,0
64583,62588,57470,0,0,146,146,0,1,0,1,0
64584,50553,445,0,0,66,66,0,1,0,1,0
64585,50078,445,0,0,70,70,0,1,0,1,0
64586,2791,7302,0,0,62,62,0,1,0,1,0
64587,11967,57470,0,0,62,62,0,1,0,1,0
64588,6057,51221,0,0,78,78,0,1,0,1,0
64589,50067,445,0,0,70,70,0,1,0,1,0
64590,50069,445,0,0,70,70,0,1,0,1,0
64591,13160,7905,0,0,62,62,0,1,0,1,0
64592,50065,445,0,0,70,70,0,1,0,1,0
64593,50064,445,0,0,70,70,0,1,0,1,0
64594,55152,445,0,0,70,70,0,1,0,1,0
64595,55148,445,0,0,70,70,0,1,0,1,0
64596,55147,445,0,0,70,70,0,1,0,1,0
64597,55262,44847,0,0,62,62,0,1,0,1,0
64598,50061,445,0,0,70,70,0,1,0,1,0
64599,50546,445,0,0,66,66,0,1,0,1,0
64600,50544,445,0,0,66,66,0,1,0,1,0
64601,50545,445,0,0,66,66,0,1,0,1,0
64602,50543,445,0,0,66,66,0,1,0,1,0
64603,50542,445,0,0,66,66,0,1,0,1,0
64604,50539,445,0,0,66,66,0,1,0,1,0
64605,50540,445,0,0,66,66,0,1,0,1,0
64606,50538,445,0,0,66,66,0,1,0,1,0
64607,13179,57866,0,0,62,62,0,1,0,1,0
64608,42753,56205,0,0,62,62,0,1,0,1,0
64609,61600,56205,0,0,66,66,0,1,0,1,0
64610,57955,44847,0,0,62,62,0,1,0,1,0
64611,59586,57470,0,0,66,66,0,1,0,1,0
64612,443,63113,0,0,100,100,0,1,0,1,0
64613,11136,17500,0,0,145,145,0,1,0,1,0
64614,50055,445,0,0,70,70,0,1,0,1,0
64615,65528,62413,0,0,62,62,0,1,0,1,0
64616,55145,445,0,0,70,70,0,1,0,1,0
64617,55133,445,0,0,70,70,0,1,0,1,0
64618,55131,445,0,0,70,70,0,1,0,1,0
64619,35940,47808,0,0,60,60,0,1,0,1,0
64620,58023,47808,0,0,60,60,0,1,0,1,0
64621,50526,445,0,0,66,66,0,1,0,1,0
64622,50524,445,0,0,66,66,0,1,0,1,0
64623,50525,445,0,0,66,66,0,1,0,1,0
64624,0,0,0,0,600,306,294,6,0,3,3
64625,0,0,0,0,600,306,294,6,0,3,3
64626,0,0,0,0,600,306,294,6,0,3,3
64627,53771,37965,0,0,66,66,0,1,0,1,0
64628,33405,37965,0,0,62,62,0,1,0,1,0
64629,52321,26467,0,0,62,62,0,1,0,1,0
64630,55129,445,0,0,70,70,0,1,0,1,0
64631,50048,445,0,0,70,70,0,1,0,1,0
64632,65493,51221,0,0,62,62,0,1,0,1,0
64633,1487,35440,0,0,146,146,0,1,0,1,0
64634,54346,44847,0,0,66,66,0,1,0,1,0
64635,50046,445,0,0,70,70,0,1,0,1,0
64636,50,64147,0,0,66,66,0,1,0,1,0
64637,55127,445,0,0,70,70,0,1,0,1,0
64638,18592,44612,0,0,62,62,0,1,0,1,0
64639,55123,445,0,0,70,70,0,1,0,1,0
64640,55120,445,0,0,70,70,0,1,0,1,0
64641,55117,445,0,0,70,70,0,1,0,1,0
64642,46627,36237,0,0,62,62,0,1,0,1,0
64643,45941,23388,0,0,60,60,0,1,0,1,0
64644,37213,36237,0,0,66,66,0,1,0,1,0
64645,50041,445,0,0,70,70,0,1,0,1,0
64646,50040,445,0,0,70,70,0,1,0,1,0
64647,57226,51505,0,0,66,66,0,1,0,1,0
64648,3272,1433,0,0,60,60,0,1,0,1,0
64649,26799,50584,0,0,146,146,0,1,0,1,0
64650,60132,50584,0,0,66,66,0,1,0,1,0
64651,50036,445,0,0,70,70,0,1,0,1,0
64652,23650,37807,0,0,66,66,0,1,0,1,0
64653,49812,26467,0,0,62,62,0,1,0,1,0
64654,63786,35440,0,0,66,66,0,1,0,1,0
64655,62569,44847,0,0,66,66,0,1,0,1,0
64656,62348,51221,0,0,72,72,0,1,0,1,0
64657,50035,445,0,0,70,70,0,1,0,1,0
64658,55109,445,0,0,70,70,0,1,0,1,0
64659,55108,445,0,0,70,70,0,1,0,1,0
64660,55103,445,0,0,70,70,0,1,0,1,0
64661,47832,50584,0,0,62,62,0,1,0,1,0
64662,6666,3389,0,0,60,60,0,1,0,1,0
64663,8999,57470,0,0,146,146,0,1,0,1,0
64664,15313,34068,0,0,146,146,0,1,0,1,0
64665,50030,445,0,0,70,70,0,1,0,1,0
64666,19099,56205,0,0,62,62,0,1,0,1,0
64667,42298,4126,11425,4126,132,64,68,2,30,1,1
64668,50450,80,35672,80,2781,563,2218,11,125,6,5
64669,53189,80,57818,80,1873,713,1160,10,15,5,5
64670,48757,443,52585,443,6353,1075,5278,18,33,10,8
64671,50334,443,44789,443,8863,1567,7296,24,41,12,12
64672,50348,443,42997,443,1385,868,517,12,30,6,6
64673,50017,443,23366,443,56408,47400,9008,88,138,49,39
64674,58196,53,55117,53,578,286,292,9,16,5,4
64675,48758,443,1312,443,6353,1075,5278,18,33,10,8
64676,50388,443,13080,443,6734,4301,2433,21,29,12,9
64677,53525,34759,57554,34759,70,70,0,2,8,2,0
64678,57957,80,26267,80,3524,1945,1579,32,131,17,15
64679,54192,443,18650,443,17821,7006,10815,95,448,48,47
64680,42298,40018,41162,40018,629,83,546,4,31,2,2
64681,57170,53,64269,53,200,102,98,2,31,1,1
64682,50451,80,13158,80,2673,564,2109,11,125,6,5
64683,42298,58000,33594,58000,596,256,340,10,30,5,5
64684,61484,443,59400,443,9479,3507,5972,24,16,12,12
64685,53191,80,63359,80,1871,712,1159,10,15,5,5
64686,42298,40023,18178,40023,1531,729,802,10,31,5,5
64687,42298,40023,34639,40023,1188,567,621,6,31,3,3
64688,59513,53,30834,53,212,92,120,2,30,1,1
64689,57200,53,48391,53,711,87,624,2,30,1,1
64690,35041,80,18613,80,3515,1137,2378,12,30,7,5
64691,42298,40029,57945,40029,652,83,569,4,31,2,2
64692,50391,443,17235,443,5968,985,4983,17,29,8,9
64693,27735,53,27735,53,235,90,145,2,32,1,1
64694,39200,443,57759,443,8918,2361,6557,35,255,18,17
64695,53524,45395,6631,45395,70,70,0,2,8,2,0
64696,49473,80,51676,80,388,262,126,7,29,5,2
64697,48754,443,18594,443,6490,1145,5345,20,33,11,9
64698,50336,443,6025,443,8814,1579,7235,24,41,12,12
64699,50347,443,6764,443,1385,868,517,12,30,6,6
64700,48755,443,25931,443,6423,1145,5278,19,33,11,8
64701,53190,80,50867,80,1873,713,1160,10,15,5,5
64702,49272,7000,49272,7000,3132,815,2317,14,15,7,7
64703,54942,53,0,0,631,74,557,2,30,1,1
64704,50028,443,29629,443,15425,9901,5524,33,84,17,16
64705,57866,53,0,0,216,80,136,2,30,1,1
64706,5588,5588,0,0,3562,1936,1626,48,195,24,24
64707,42298,40009,62202,40009,148,86,62,2,30,1,1
64708,55587,32217,8141,32217,320,140,180,6,6,3,3
64709,50373,443,36496,443,4695,859,3836,17,30,9,8
64710,50374,443,25596,443,4749,859,3890,18,30,9,9
64711,50349,443,62395,443,1385,868,517,12,30,6,6
64712,60424,443,16988,443,1477,940,537,13,26,7,6
64713,50345,443,44342,443,1385,868,517,12,30,6,6
64714,33818,443,39799,443,16265,3132,13133,54,276,26,28
64715,50375,443,20024,443,4707,865,3842,17,30,9,8
64716,50346,443,6974,443,1385,868,517,12,30,6,6
64717,42298,40040,5414,40040,140,78,62,2,30,1,1
64718,48756,443,37837,443,6353,1075,5278,18,33,10,8
64719,42298,40027,29472,40027,144,82,62,2,30,1,1
64720,5588,5588,0,0,3498,1872,1626,48,195,24,24
64721,42298,40008,56571,40008,206,84,122,4,31,2,2
64722,123,123,49338,123,184,94,90,2,30,1,1
64723,59390,53,43106,53,184,86,98,2,31,1,1
64724,49608,53,10158,53,170,87,83,2,31,1,1
64725,55179,53,36377,53,188,96,92,2,31,1,1
64726,49160,9703,22798,9703,842,150,692,4,1200,2,2
64727,61741,443,4502,443,68851,3430,65421,93,121,35,58
64728,57470,5382,65418,5382,2411,1328,1083,19,1200,11,8
64729,53500,443,28730,443,3036,975,2061,14,136,7,7
64730,50503,445,0,0,66,66,0,1,0,1,0
64731,57750,37965,0,0,62,62,0,1,0,1,0
64732,55100,445,0,0,70,70,0,1,0,1,0
64733,55099,445,0,0,70,70,0,1,0,1,0
64734,51197,30188,0,0,66,66,0,1,0,1,0
64735,44746,37965,0,0,62,62,0,1,0,1,0
64736,42298,25161,56288,25161,138,70,68,2,30,1,1
64737,65196,53,4463,53,177,94,83,2,30,1,1
64738,64369,53,59649,53,240,110,130,2,30,1,1
64739,35414,53,44913,53,168,78,90,2,30,1,1
64740,50876,443,55719,443,1786,172,1614,7,120,3,4
64741,55718,27025,19303,27025,1778,1386,392,8,30,4,4
64742,38167,443,36158,443,6150,914,5236,18,16,10,8
64743,48731,443,51910,443,769074,31261,737813,876,165,356,520
64744,51861,53,51861,53,305,160,145,3,33,2,1
64745,63727,61557,39781,61557,312,132,180,6,6,3,3
64746,63976,53,54023,53,200,102,98,2,33,1,1
64747,42298,40028,3543,40028,148,86,62,2,29,1,1
64748,62332,53,0,0,633,75,558,2,29,1,1
64749,65196,53,58386,53,177,94,83,2,30,1,1
64750,49935,53,55130,53,458,111,347,4,59,2,2
64751,50305,80,32825,80,5500,2829,2671,19,34,10,9
64752,53527,45626,48951,45626,70,70,0,2,7,2,0
64753,50875,80,60669,80,141059,7791,133268,168,140,72,96
64754,48726,443,17212,443,6644134,184008,6460126,6659,204,2197,4462
64755,50931,80,59351,80,7978844,97517,7881327,6752,120,1393,5359
64756,60406,443,21053,443,8404,1892,6512,23,30,12,11
64757,33664,80,64127,80,3667,1654,2013,20,189,11,9
64758,53530,8999,38471,8999,70,70,0,2,7,2,0
64759,49838,53,62523,53,866,221,645,6,56,3,3
64760,42298,40005,13329,40005,148,86,62,2,29,1,1
64761,1156,53,45394,53,278,86,192,2,29,1,1
64762,64250,53,22733,53,314,102,212,2,29,1,1
64763,62486,53,33326,53,303,303,0,4,47,4,0
64764,64284,53,35627,53,306,94,212,2,29,1,1
64765,52107,53,0,0,621,77,544,2,29,1,1
64766,65482,53,17558,53,278,126,152,2,30,1,1
64767,42019,443,22698,443,21620,7973,13647,112,488,57,55
64768,55577,80,44269,80,70,70,0,1,5,1,0
64769,56751,32300,2097,32300,70,70,0,1,5,1,0
64770,38258,443,9287,443,5714,1536,4178,24,21,13,11
64771,49901,7000,49901,7000,3310,1535,1775,15,15,8,7
64772,53737,443,33568,443,12192,3674,8518,53,454,26,27
64773,49415,443,33045,443,29561,4857,24704,44,44,15,29
64774,42298,40016,11792,40016,148,86,62,2,30,1,1
64775,42298,40016,13493,40016,148,86,62,2,30,1,1
64776,42298,443,6175,443,70,70,0,1,30,1,0
64777,53182,443,48630,443,6094,1073,5021,19,15,10,9
64778,51499,443,64851,443,43980,3500,40480,65,16,31,34
64779,54991,53,33819,53,177,94,83,2,30,1,1
64780,52021,443,14701,443,7508,2350,5158,37,1323,21,16
64781,42298,40039,27373,40039,148,86,62,2,30,1,1
64782,52394,53,35816,53,168,78,90,2,30,1,1
64783,57353,443,37638,443,150,150,0,1,5,1,0
64784,51498,443,51057,443,29265,2836,26429,47,16,21,26
64785,50893,80,33062,80,149442,8423,141019,177,140,76,101
64786,50390,443,34358,443,1328,876,452,11,29,6,5
64787,50401,443,36442,443,1124,594,530,12,26,6,6
64788,50398,80,47950,80,318,192,126,6,26,4,2
64789,50400,443,29231,443,1124,594,530,12,26,6,6
64790,50379,443,5364,443,6748,1843,4905,21,29,11,10
64791,49472,80,16724,80,318,192,126,6,28,4,2
64792,2582,80,2582,80,8395,700,7695,17,15,8,9
64793,50395,443,41606,443,6205,2761,3444,25,28,14,11
64794,50394,443,25886,443,7584,1848,5736,19,29,10,9
64795,39609,53,46701,53,168,78,90,2,30,1,1
64796,34531,80,18192,80,467664,17895,449769,610,355,265,345
64797,35814,443,26348,443,5205,1251,3954,18,15,10,8
64798,39158,53,23110,53,168,78,90,2,30,1,1
64799,64803,53,24000,53,303,303,0,4,47,4,0
64800,50914,443,65485,443,6813,1729,5084,18,16,10,8
64801,42222,53,45931,53,209,86,123,2,30,1,1
64802,56825,53,3164,53,177,94,83,2,30,1,1
64803,39684,443,56331,443,5150,853,4297,16,34,9,7
64804,57839,53,57631,53,231,231,0,4,47,4,0
64805,42298,40008,65439,40008,140,78,62,2,30,1,1
64806,55776,53,24282,53,168,78,90,2,30,1,1
64807,42298,40001,45646,40001,156,94,62,2,30,1,1
64808,49855,53,54307,53,212,102,110,2,30,1,1
64809,65445,53,5000,53,718,94,624,2,30,1,1
64810,34430,53,54160,53,199,94,105,2,30,1,1
64811,57031,443,21412,443,2963,797,2166,10,120,5,5
64812,42298,40033,43978,40033,245,182,63,2,30,1,1
64813,33107,443,4785,443,3820081,140348,3679733,4457,136,1736,2721
64814,50444,443,13843,443,5593,996,4597,22,127,11,11
64815,49832,443,25686,443,8589,2871,5718,26,46,14,12
64816,50392,443,55310,443,1125,595,530,12,29,6,6
64817,50411,80,65137,80,1657,1246,411,8,15,5,3
64818,61229,53,16392,53,261,261,0,4,47,4,0
64819,59615,53,32493,53,320,94,226,2,30,1,1
64820,56825,53,56167,53,177,94,83,2,30,1,1
64821,42298,40031,8368,40031,157,94,63,2,30,1,1
64822,57170,53,47776,53,200,102,98,2,30,1,1
64823,50393,443,64712,443,1125,595,530,12,29,6,6
64824,50888,80,61019,80,538995,15959,523036,552,140,201,351
64825,50165,80,3536,80,17387,9304,8083,30,56,19,11
64826,41049,443,3441,443,197239,6098,191141,213,170,75,138
64827,50915,443,63177,443,9599,3465,6134,20,16,11,9
64828,40189,80,30791,80,5043,1656,3387,18,205,10,8
64829,50879,80,6049,80,15453,3281,12172,29,140,16,13
64830,56891,53,55899,53,226,110,116,2,30,1,1
64831,64737,53,9334,53,269,110,159,2,30,1,1
64832,42298,40042,19672,40042,148,86,62,2,30,1,1
64833,42298,40016,35583,40016,157,94,63,2,30,1,1
64834,52724,80,24269,80,9532,745,8787,18,113,9,9
64835,42657,443,20758,443,10204,2106,8098,37,255,19,18
64836,51502,443,28500,443,10204,5034,5170,45,16,25,20
64837,56758,40000,32207,40000,70,70,0,2,8,2,0
64838,56568,53,11893,53,306,306,0,4,47,4,0
64839,35497,443,49704,443,162,102,60,2,4,1,1
64840,51695,37590,12016,37590,70,70,0,1,5,1,0
64841,55575,31948,50458,31948,70,70,0,1,5,1,0
64842,47264,80,26226,80,1737,796,941,12,16,7,5
64843,50542,443,16831,443,5347,2537,2810,17,120,8,9
64844,50947,80,65255,80,5427472,61630,5365842,4509,79,894,3615
64845,64842,53,15693,53,340,95,245,4,47,2,2
64846,50945,80,53857,80,6920116,91852,6828264,6765,79,1277,5488
64847,50399,80,19756,80,318,192,126,6,26,4,2
64848,51157,443,53993,443,5378,1423,3955,19,22,11,8
64849,42658,443,41427,443,10170,2072,8098,37,255,19,18
64850,50292,80,5743,80,442,250,192,8,44,5,3
64851,53520,37553,50212,37553,70,70,0,2,7,2,0
64852,53528,20485,38765,20485,70,70,0,2,7,2,0
64853,53531,48908,54109,48908,70,70,0,2,7,2,0
64854,48729,443,23852,443,8504354,221135,8283219,8447,196,2721,5726
64855,51500,443,12798,443,49843,3506,46337,77,16,39,38
64856,65447,53,29961,53,330,105,225,4,37,2,2
64857,51630,80,41968,80,7679,5325,2354,15,29,8,7
64858,62597,53,49610,53,306,306,0,4,47,4,0
64859,49827,443,4607,443,21625,7638,13987,45,48,24,21
64860,50913,443,27670,443,5057,851,4206,15,16,9,6
64861,42298,40009,56378,40009,148,86,62,2,29,1,1
64862,50894,80,18419,80,53024,5569,47455,72,140,35,37
64863,27288,53,2459,53,199,94,105,2,30,1,1
64864,43057,80,9462,80,1195,401,794,9,16,5,4
64865,62332,53,0,0,170,75,95,2,29,1,1
64866,52107,53,0,0,210,77,133,2,29,1,1
64867,57866,53,0,0,627,80,547,2,29,1,1
64868,50388,53,14304,53,177,94,83,2,29,1,1
64869,42298,40012,32444,40012,148,86,62,2,29,1,1
64870,42298,40031,50162,40031,1341,657,684,8,30,4,4
64871,46295,443,11323,443,9938,1398,8540,9,128,1,8
64872,42298,40034,23763,40034,588,86,502,2,30,1,1
64873,42298,40013,37939,40013,205,83,122,4,30,2,2
64874,55875,53,42726,53,228,110,118,2,30,1,1
64875,42298,40023,18406,40023,1487,743,744,10,30,5,5
64876,30188,36914,20864,36914,2668,1950,718,16,7827,14,2
64877,42298,40003,32102,40003,206,84,122,4,30,2,2
64878,51576,443,48626,443,21523,4681,16842,37,149,18,19
64879,44816,80,47339,80,130,70,60,2,15,1,1
64880,56752,43888,19580,43888,70,70,0,1,5,1,0
64881,53185,443,12844,443,8020,1134,6886,23,15,11,12
64882,54951,443,4064,443,30123,21849,8274,65,77,38,27
64883,51496,443,41580,443,1177,624,553,12,16,7,5
64884,53183,443,26366,443,6094,1073,5021,19,15,10,9
64885,50958,53,30226,53,264,264,0,4,47,4,0
64886,53986,53,63410,53,306,306,0,4,47,4,0
64887,42298,40031,17629,40031,148,86,62,2,30,1,1
64888,53789,53,48550,53,168,78,90,2,30,1,1
64889,52074,53,21333,53,199,94,105,2,30,1,1
64890,42298,40022,65114,40022,148,86,62,2,30,1,1
64891,55866,53,14599,53,168,78,90,2,30,1,1
64892,42298,40037,29650,40037,208,86,122,4,30,2,2
64893,50407,80,54250,80,1388,917,471,11,26,6,5
64894,53105,61310,38041,61310,70,70,0,1,5,1,0
64895,51696,14370,13279,14370,70,70,0,1,5,1,0
64896,41050,443,28705,443,137809,4697,133112,153,170,55,98
64897,55593,53,39878,53,288,288,0,4,47,4,0
64898,55610,53,57817,53,181,94,87,2,30,1,1
64899,57171,53,25491,53,214,102,112,2,30,1,1
64900,49197,53,54717,53,214,102,112,2,30,1,1
64901,52838,53,22296,53,168,78,90,2,30,1,1
64902,42140,443,52282,443,12322,3893,8429,28,139,13,15
64903,50891,80,64394,80,136656,9764,126892,162,140,70,92
64904,51721,35426,42015,35426,70,70,0,2,8,2,0
64905,56745,56518,23267,56518,1556,588,968,11,16,6,5
64906,58472,53,35113,53,246,246,0,4,47,4,0
64907,42298,40013,31078,40013,140,78,62,2,30,1,1
64908,42298,40022,27294,40022,156,94,62,2,30,1,1
64909,64237,53,49326,53,227,110,117,2,31,1,1
64910,57470,39608,19893,39608,330,330,0,6,1199,6,0
64911,49608,53,36244,53,177,94,83,2,31,1,1
64912,42632,443,43354,443,4299,1870,2429,17,150,8,9
64913,62197,443,16977,443,3937,1210,2727,18,134,8,10
64914,57470,58210,46855,58210,2118,858,1260,28,1261,14,14
64915,64994,443,32046,443,3547,1351,2196,17,135,8,9
64916,61636,25735,61636,25735,3828,1516,2312,29,5271,18,11
64917,61279,443,45971,443,4076,1378,2698,14,136,7,7
64918,19473,6889,17971,6889,481,150,331,2,1200,1,1
64919,53514,8999,20953,8999,70,70,0,1,5,1,0
64920,49950,80,40840,80,51651,48866,2785,74,20,38,36
64921,56735,53283,31023,53283,4188,1648,2540,17,19,9,8
64922,50922,80,57250,80,9219616,105865,9113751,7687,120,1487,6200
64923,55664,53,23659,53,177,94,83,2,30,1,1
64924,63705,19652,30539,19652,70,70,0,1,5,1,0
64925,45813,5222,28803,5222,5723,3023,2700,58,548,32,26
64926,50872,80,50084,80,54441,4387,50054,75,140,37,38
64927,55708,8060,17338,8060,70,70,0,1,5,1,0
64928,51401,443,22599,443,202,70,132,3,11,1,2
64929,37953,1935,23472,1935,3623810,67493,3556317,3486,35,943,2543
64930,42298,40039,40294,40039,211,89,122,4,30,2,2
64931,42298,40035,3337,40035,207,85,122,4,30,2,2
64932,46346,35440,0,0,66,66,0,1,0,1,0
64933,25363,23,0,0,60,60,0,1,0,1,0
64934,56405,62413,0,0,66,66,0,1,0,1,0
64935,45908,3383,0,0,60,60,0,1,0,1,0
64936,47020,2323,0,0,60,60,0,1,0,1,0
64937,50497,445,0,0,66,66,0,1,0,1,0
64938,50017,445,0,0,70,70,0,1,0,1,0
64939,61329,51505,0,0,66,66,0,1,0,1,0
64940,6881,33720,0,0,157,157,0,1,0,1,0
64941,50494,445,0,0,66,66,0,1,0,1,0
64942,55088,445,0,0,70,70,0,1,0,1,0
64943,6881,6881,0,0,146,146,0,1,0,1,0
64944,55084,445,0,0,70,70,0,1,0,1,0
64945,55083,445,0,0,70,70,0,1,0,1,0
64946,55081,445,0,0,70,70,0,1,0,1,0
64947,50490,445,0,0,66,66,0,1,0,1,0
64948,50014,445,0,0,70,70,0,1,0,1,0
64949,57434,50584,0,0,62,62,0,1,0,1,0
64950,1574,50584,0,0,62,62,0,1,0,1,0
64951,18624,29434,0,0,148,148,0,1,0,1,0
64952,11842,35440,0,0,66,66,0,1,0,1,0
64953,49747,37965,0,0,62,62,0,1,0,1,0
64954,55701,55777,0,0,62,62,0,1,0,1,0
64955,55075,445,0,0,70,70,0,1,0,1,0
64956,34914,25604,0,0,145,145,0,1,0,1,0
64957,59785,14914,0,0,143,143,0,1,0,1,0
64958,50010,445,0,0,70,70,0,1,0,1,0
64959,55072,445,0,0,70,70,0,1,0,1,0
64960,55070,445,0,0,70,70,0,1,0,1,0
64961,55068,445,0,0,70,70,0,1,0,1,0
64962,17702,6881,0,0,66,66,0,1,0,1,0
64963,58912,11392,0,0,66,66,0,1,0,1,0
64964,50008,445,0,0,70,70,0,1,0,1,0
64965,50483,445,0,0,66,66,0,1,0,1,0
64966,43271,50584,0,0,62,62,0,1,0,1,0
64967,6666,21,0,0,60,60,0,1,0,1,0
64968,50482,445,0,0,66,66,0,1,0,1,0
64969,50479,445,0,0,66,66,0,1,0,1,0
64970,50477,445,0,0,66,66,0,1,0,1,0
64971,50006,445,0,0,70,70,0,1,0,1,0
64972,50475,445,0,0,66,66,0,1,0,1,0
64973,50474,445,0,0,66,66,0,1,0,1,0
64974,50472,445,0,0,66,66,0,1,0,1,0
64975,41447,26467,0,0,62,62,0,1,0,1,0
64976,30114,65151,0,0,60,60,0,1,0,1,0
64977,64106,64147,0,0,66,66,0,1,0,1,0
64978,33498,5529,0,0,145,145,0,1,0,1,0
64979,47398,7302,0,0,62,62,0,1,0,1,0
64980,55066,445,0,0,70,70,0,1,0,1,0
64981,55064,445,0,0,70,70,0,1,0,1,0
64982,55060,445,0,0,70,70,0,1,0,1,0
64983,40500,48009,0,0,146,146,0,1,0,1,0
64984,11136,15503,0,0,62,62,0,1,0,1,0
64985,50469,445,0,0,66,66,0,1,0,1,0
64986,55059,445,0,0,70,70,0,1,0,1,0
64987,4817,11392,0,0,146,146,0,1,0,1,0
64988,50467,445,0,0,66,66,0,1,0,1,0
64989,49999,445,0,0,70,70,0,1,0,1,0
64990,50465,445,0,0,66,66,0,1,0,1,0
64991,50464,445,0,0,66,66,0,1,0,1,0
64992,49997,445,0,0,70,70,0,1,0,1,0
64993,443,43775,0,0,97,97,0,1,0,1,0
64994,50461,445,0,0,66,66,0,1,0,1,0
64995,45908,33330,0,0,60,60,0,1,0,1,0
64996,50386,22114,0,0,66,66,0,1,0,1,0
64997,42576,30188,0,0,146,146,0,1,0,1,0
64998,59477,36829,0,0,66,66,0,1,0,1,0
64999,49996,445,0,0,70,70,0,1,0,1,0
65000,9544,7302,0,0,62,62,0,1,0,1,0
65001,49995,445,0,0,70,70,0,1,0,1,0
65002,49994,445,0,0,70,70,0,1,0,1,0
65003,49992,445,0,0,70,70,0,1,0,1,0
65004,49988,445,0,0,70,70,0,1,0,1,0
65005,26792,37965,0,0,62,62,0,1,0,1,0
65006,58725,7302,0,0,66,66,0,1,0,1,0
65007,55055,445,0,0,70,70,0,1,0,1,0
65008,37837,37965,0,0,62,62,0,1,0,1,0
65009,55049,445,0,0,70,70,0,1,0,1,0
65010,55044,445,0,0,70,70,0,1,0,1,0
65011,35718,20238,0,0,62,62,0,1,0,1,0
65012,50113,51505,0,0,66,66,0,1,0,1,0
65013,49976,445,0,0,70,70,0,1,0,1,0
65014,49975,445,0,0,70,70,0,1,0,1,0
65015,19394,44847,0,0,66,66,0,1,0,1,0
65016,53710,443,55386,443,499,425,74,4,0,3,1
65017,53711,443,24841,443,499,425,74,4,0,3,1
65018,53706,443,53579,443,499,425,74,4,0,3,1
65019,53705,443,11151,443,499,425,74,4,0,3,1
65020,49973,445,0,0,70,70,0,1,0,1,0
65021,50453,445,0,0,66,66,0,1,0,1,0
65022,49965,445,0,0,70,70,0,1,0,1,0
65023,49966,445,0,0,70,70,0,1,0,1,0
65024,37538,37965,0,0,66,66,0,1,0,1,0
65025,20706,37965,0,0,62,62,0,1,0,1,0
65026,2919,57866,0,0,66,66,0,1,0,1,0
65027,3428,22,0,0,60,60,0,1,0,1,0
65028,19963,2767,0,0,66,66,0,1,0,1,0
65029,22683,39210,0,0,60,60,0,1,0,1,0
65030,42969,8146,0,0,62,62,0,1,0,1,0
65031,62632,35440,0,0,66,66,0,1,0,1,0
65032,51973,44847,0,0,66,66,0,1,0,1,0
65033,50443,445,0,0,66,66,0,1,0,1,0
65034,42285,57470,0,0,62,62,0,1,0,1,0
65035,55031,445,0,0,70,70,0,1,0,1,0
65036,16762,61689,0,0,62,62,0,1,0,1,0
65037,15793,64147,0,0,66,66,0,1,0,1,0
65038,49954,445,0,0,70,70,0,1,0,1,0
65039,6057,51221,0,0,78,78,0,1,0,1,0
65040,50441,445,0,0,66,66,0,1,0,1,0
65041,52780,37965,0,0,66,66,0,1,0,1,0
65042,50432,445,0,0,66,66,0,1,0,1,0
65043,50424,445,0,0,66,66,0,1,0,1,0
65044,59374,51505,0,0,62,62,0,1,0,1,0
65045,49950,445,0,0,70,70,0,1,0,1,0
65046,56396,5900,0,0,60,60,0,1,0,1,0
65047,58318,15503,0,0,66,66,0,1,0,1,0
65048,63331,51221,0,0,62,62,0,1,0,1,0
65049,49941,445,0,0,70,70,0,1,0,1,0
65050,49939,445,0,0,70,70,0,1,0,1,0
65051,49935,445,0,0,70,70,0,1,0,1,0
65052,49936,445,0,0,70,70,0,1,0,1,0
65053,49570,5900,0,0,60,60,0,1,0,1,0
65054,49934,445,0,0,70,70,0,1,0,1,0
65055,55024,445,0,0,70,70,0,1,0,1,0
65056,55021,445,0,0,70,70,0,1,0,1,0
65057,55019,445,0,0,70,70,0,1,0,1,0
65058,43611,61903,0,0,148,148,0,1,0,1,0
65059,56927,64147,0,0,145,145,0,1,0,1,0
65060,50413,445,0,0,66,66,0,1,0,1,0
65061,50418,445,0,0,66,66,0,1,0,1,0
65062,50416,445,0,0,66,66,0,1,0,1,0
65063,50417,445,0,0,66,66,0,1,0,1,0
65064,50415,445,0,0,66,66,0,1,0,1,0
65065,50414,445,0,0,66,66,0,1,0,1,0
65066,50412,445,0,0,66,66,0,1,0,1,0
65067,50411,445,0,0,66,66,0,1,0,1,0
65068,0,0,0,0,320,320,0,5,0,5,0
65069,3630,26467,0,0,66,66,0,1,0,1,0
65070,25739,64147,0,0,62,62,0,1,0,1,0
65071,6916,52700,0,0,100,100,0,1,0,1,0
65072,3407,57866,0,0,66,66,0,1,0,1,0
65073,64191,44847,0,0,66,66,0,1,0,1,0
65074,10921,19847,0,0,62,62,0,1,0,1,0
65075,63503,42707,0,0,66,66,0,1,0,1,0
65076,12668,42707,0,0,62,62,0,1,0,1,0
65077,59586,56205,0,0,62,62,0,1,0,1,0
65078,49927,445,0,0,70,70,0,1,0,1,0
65079,16059,22114,0,0,146,146,0,1,0,1,0
65080,41812,8080,0,0,60,60,0,1,0,1,0
65081,41813,8080,0,0,60,60,0,1,0,1,0
65082,55012,445,0,0,70,70,0,1,0,1,0
65083,55010,445,0,0,70,70,0,1,0,1,0
65084,55003,445,0,0,70,70,0,1,0,1,0
65085,29022,23,0,0,60,60,0,1,0,1,0
65086,49818,37965,0,0,66,66,0,1,0,1,0
65087,49920,445,0,0,70,70,0,1,0,1,0
65088,50397,445,0,0,66,66,0,1,0,1,0
65089,50398,445,0,0,66,66,0,1,0,1,0
65090,50395,445,0,0,66,66,0,1,0,1,0
65091,49917,445,0,0,70,70,0,1,0,1,0
65092,26497,64147,0,0,66,66,0,1,0,1,0
65093,54955,7302,0,0,62,62,0,1,0,1,0
65094,55001,445,0,0,70,70,0,1,0,1,0
65095,54999,445,0,0,70,70,0,1,0,1,0
65096,49913,445,0,0,70,70,0,1,0,1,0
65097,54997,445,0,0,70,70,0,1,0,1,0
65098,54993,445,0,0,70,70,0,1,0,1,0
65099,54991,445,0,0,70,70,0,1,0,1,0
65100,49912,445,0,0,70,70,0,1,0,1,0
65101,55878,7302,0,0,66,66,0,1,0,1,0
65102,30559,64147,0,0,62,62,0,1,0,1,0
65103,36727,443,3578,443,27009,7414,19595,46,122,21,25
65104,63708,29685,60492,29685,66,66,0,1,5,1,0
65105,50304,443,23238,443,3565,1947,1618,19,15,9,10
65106,5588,5588,0,0,3562,1936,1626,48,195,24,24
65107,59735,443,59735,443,4730,1823,2907,19,28,11,8
65108,49181,443,9716,443,50097,3666,46431,79,256,36,43
65109,56980,53,42285,53,267,87,180,4,38,2,2
65110,51719,13715,5835,13715,70,70,0,2,8,2,0
65111,61474,443,20361,443,114674,4457,110217,127,48,46,81
65112,61483,443,51261,443,107901,5004,102897,127,46,53,74
65113,5588,5588,0,0,3562,1936,1626,48,192,24,24
65114,51718,55003,38571,55003,70,70,0,2,8,2,0
65115,59646,5223,10066,5223,139,139,0,1,5,1,0
65116,44223,443,7488,443,63895,4604,59291,80,276,34,46
65117,63697,25010,4091,25010,504,382,122,8,16,6,2
65118,56689,53,4538,53,177,91,86,3,38,2,1
65119,53486,443,39031,443,8879,2420,6459,32,255,17,15
65120,14112,443,14112,443,25629,5823,19806,44,179,25,19
65121,50303,443,45984,443,3051,1801,1250,18,15,8,10
65122,44908,443,9126,443,2931,1940,991,19,25,10,9
65123,56748,35148,18439,35148,66,66,0,1,5,1,0
65124,48979,15000,58069,15000,130,70,60,2,5,1,1
65125,51692,25565,11654,25565,66,66,0,1,5,1,0
65126,56747,42333,2469,42333,66,66,0,1,5,1,0
65127,52862,80,51424,80,3150,1478,1672,32,131,17,15
65128,41610,443,48992,443,9488,2196,7292,25,26,14,11
65129,61478,443,38710,443,45313,3360,41953,61,47,26,35
65130,61479,443,17440,443,104543,5227,99316,130,47,57,73
65131,60492,443,48948,443,81016,8373,72643,122,339,57,65
65132,42298,40026,9867,40026,212,90,122,4,30,2,2
65133,58301,53,36478,53,233,102,131,2,30,1,1
65134,61482,443,17696,443,49181,3553,45628,65,46,29,36
65135,63834,27037,60626,27037,1592,1386,206,6,31,4,2
65136,49900,7000,49900,7000,2958,1567,1391,15,15,8,7
65137,51717,63436,12791,63436,70,70,0,2,8,2,0
65138,61477,443,48304,443,30516,3311,27205,49,47,25,24
65139,52694,443,37161,443,10384,4563,5821,34,436,17,17
65140,47362,443,49001,443,8263,2100,6163,34,255,16,18
65141,63683,20299,57737,20299,502,380,122,7,19,5,2
65142,51002,443,58115,443,3536,2198,1338,18,332,9,9
65143,1063,7302,0,0,62,62,0,1,0,1,0
65144,58099,44847,0,0,62,62,0,1,0,1,0
65145,33215,37965,0,0,62,62,0,1,0,1,0
65146,59037,28370,0,0,62,62,0,1,0,1,0
65147,32974,37965,0,0,66,66,0,1,0,1,0
65148,45941,23386,0,0,60,60,0,1,0,1,0
65149,37230,554,0,0,60,60,0,1,0,1,0
65150,49908,445,0,0,70,70,0,1,0,1,0
65151,18889,50584,0,0,146,146,0,1,0,1,0
65152,46090,50584,0,0,66,66,0,1,0,1,0
65153,12549,50265,0,0,146,146,0,1,0,1,0
65154,49907,445,0,0,70,70,0,1,0,1,0
65155,60223,67,0,0,60,60,0,1,0,1,0
65156,1446,35440,0,0,66,66,0,1,0,1,0
65157,54981,445,0,0,70,70,0,1,0,1,0
65158,54979,445,0,0,70,70,0,1,0,1,0
65159,54975,445,0,0,70,70,0,1,0,1,0
65160,62673,34159,0,0,66,66,0,1,0,1,0
65161,49900,4500,1746,4500,78,78,0,1,5,1,0
65162,53098,30840,23341,30840,898,454,444,13,22,8,5
65163,37571,53,19977,53,164,78,86,2,30,1,1
65164,61030,53,15331,53,167,78,89,2,30,1,1
65165,49414,443,63863,443,43326,4905,38421,56,43,16,40
65166,62592,443,27957,443,11741,7040,4701,40,172,22,18
65167,56689,53,17079,53,264,91,173,4,38,2,2
65168,56594,80,5980,80,234,234,0,4,11,4,0
65169,58621,53,5007,53,256,94,162,2,29,1,1
65170,42298,40014,17083,40014,216,94,122,4,29,2,2
65171,42298,40042,61783,40042,273,73,200,4,29,2,2
65172,65164,53,40444,53,265,102,163,2,29,1,1
65173,60561,53,50880,53,343,86,257,2,30,1,1
65174,34517,443,44047,443,5996,1967,4029,17,99,10,7
65175,36836,443,63140,443,7195,1791,5404,18,99,11,7
65176,50958,80,62860,80,5730351,74236,5656115,4865,78,1088,3777
65177,55836,443,16714,443,3538,2015,1523,28,323,14,14
65178,36586,80,45063,80,1114,534,580,12,15,7,5
65179,56980,53,33367,53,267,87,180,4,38,2,2
65180,53513,51354,18257,51354,70,70,0,1,4,1,0
65181,123,123,49669,123,184,94,90,2,29,1,1
65182,50142,443,40604,443,9040,2349,6691,22,64,13,9
65183,50936,80,62610,80,10423067,111935,10311132,8558,119,1601,6957
65184,50960,80,58959,80,5533225,44880,5488345,4345,78,654,3691
65185,42298,40005,47580,40005,211,89,122,4,29,2,2
65186,51716,57137,62764,57137,70,70,0,2,8,2,0
65187,63710,54740,50464,54740,70,70,0,1,4,1,0
65188,60394,53,18080,53,330,94,236,2,30,1,1
65189,56765,443,20044,443,12038195,322404,11715791,12026,153,3435,8591
65190,55470,53,6327,53,197,102,95,2,30,1,1
65191,65461,53,1880,53,268,110,158,2,30,1,1
65192,51811,443,57601,443,18108,1782,16326,31,215,15,16
65193,57340,2258,57340,2258,156,156,0,3,8,3,0
65194,51693,56308,27101,56308,70,70,0,1,5,1,0
65195,41152,443,5083,443,1848,1139,709,14,579,8,6
65196,51497,443,45992,443,4945,1060,3885,21,15,12,9
65197,36256,443,43168,443,3871,2466,1405,22,95,12,10
65198,49164,53,4974,53,212,94,118,2,30,1,1
65199,49997,53,42386,53,264,102,162,2,30,1,1
65200,64354,53,25529,53,240,78,162,2,30,1,1
65201,57664,53,41830,53,168,78,90,2,30,1,1
65202,52558,443,32057,443,3530,1002,2528,12,120,6,6
65203,63691,53,63691,53,198,90,108,2,30,1,1
65204,46069,80,2181,80,2684,2550,134,7,17,5,2
65205,51720,51388,49576,51388,70,70,0,2,8,2,0
65206,38901,53,60941,53,168,78,90,2,30,1,1
65207,56980,53,28670,53,267,87,180,4,38,2,2
65208,50572,80,21152,80,132,132,0,2,8,2,0
65209,52481,443,2836,443,70,70,0,1,5,1,0
65210,43591,443,60892,443,1848,1141,707,14,566,8,6
65211,56917,443,25330,443,14033,1591,12442,26,132,10,16
65212,61665,443,16320,443,6279,1859,4420,25,16,14,11
65213,49520,53,55540,53,229,102,127,2,30,1,1
65214,49899,7000,49899,7000,758568,17631,740937,772,17,269,503
65215,54341,443,8795,443,10046,3300,6746,23,61,14,9
65216,36289,53,0,0,86,86,0,1,30,1,0
65217,56937,8200,52360,8200,78,78,0,1,30,1,0
65218,48857,53,48857,53,213,82,131,2,30,1,1
65219,35112,443,57886,443,3242,1248,1994,26,362,7,19
65220,55024,443,1691,443,552073,14113,537960,536,31,176,360
65221,49394,443,39992,443,6211,1869,4342,18,181,8,10
65222,64495,443,32988,443,1786,172,1614,7,120,3,4
65223,41128,443,53510,443,3474,2349,1125,29,3438,17,12
65224,64626,53,31838,53,326,102,224,2,30,1,1
65225,49608,53,46552,53,177,94,83,2,30,1,1
65226,55470,53,12953,53,197,102,95,2,33,1,1
65227,51691,5543,12224,5543,70,70,0,1,5,1,0
65228,36158,443,34202,443,9808,3005,6803,36,255,19,17
65229,52717,53,4391,53,277,94,183,2,30,1,1
65230,49700,53,14464,53,165,78,87,2,30,1,1
65231,33771,53,38746,53,506,316,190,3,30,2,1
65232,6881,41019,41697,41019,150,150,0,1,1200,1,0
65233,51147,443,55855,443,6162,925,5237,18,52,10,8
65234,47831,53,0,0,86,86,0,1,30,1,0
65235,61973,53,11068,53,222,94,128,2,30,1,1
65236,63811,443,59225,443,25707,7559,18148,53,121,24,29
65237,61431,443,56520,443,352310,324883,27427,389,300,270,119
65238,14641,443,14641,443,254281,66535,187746,336,317,183,153
65239,60441,443,36416,443,3211,1964,1247,25,263,13,12
65240,54961,53,55140,53,375,99,276,4,54,2,2
65241,47594,443,65055,443,5447,1074,4373,21,17,10,11
65242,52860,443,7208,443,7683,2076,5607,42,131,21,21
65243,53510,58706,37396,58706,492,306,186,8,16,5,3
65244,34169,443,8049,443,6507,1060,5447,22,255,12,10
65245,63698,59517,14181,59517,504,382,122,8,15,6,2
65246,50871,80,63200,80,94083,6192,87891,121,139,57,64
65247,42298,40013,38063,40013,209,87,122,4,29,2,2
65248,63711,47951,19949,47951,70,70,0,1,4,1,0
65249,63715,29834,21653,29834,70,70,0,1,4,1,0
65250,63714,48477,18811,48477,70,70,0,1,4,1,0
65251,53321,80,20263,80,3483,2072,1411,21,214,17,4
65252,42298,40007,10253,40007,273,73,200,4,29,2,2
65253,59486,53,24146,53,316,86,230,2,29,1,1
65254,54991,53,13574,53,177,94,83,2,29,1,1
65255,55317,53,22104,53,94,94,0,1,30,1,0
65256,55828,443,52104,443,5278,1026,4252,20,15,11,9
65257,64401,53,5392,53,293,94,199,2,30,1,1
65258,123,123,5546,123,184,94,90,2,29,1,1
65259,55664,53,60480,53,177,94,83,2,29,1,1
65260,54991,53,42971,53,253,87,166,4,29,2,2
65261,42298,40007,25770,40007,206,84,122,4,29,2,2
65262,42298,40024,27133,40024,207,85,122,4,29,2,2
65263,42298,40029,56928,40029,208,86,122,4,29,2,2
65264,42298,40036,28327,40036,205,83,122,4,29,2,2
65265,64254,53,25297,53,211,78,133,2,30,1,1
65266,64905,53,16169,53,245,94,151,2,30,1,1
65267,59165,53,3283,53,186,78,108,2,30,1,1
65268,61113,27045,20306,27045,1778,1386,392,8,30,4,4
65269,55179,53,63963,53,194,102,92,2,30,1,1
65270,64209,53,25156,53,277,94,183,2,30,1,1
65271,59610,53,54271,53,191,78,113,2,30,1,1
65272,55801,53,42672,53,222,102,120,2,30,1,1
65273,49529,53,23720,53,211,94,117,2,30,1,1
65274,53169,443,5040,443,6716,922,5794,20,20,10,10
65275,50136,443,32292,443,23193,8487,14706,57,55,28,29
65276,60972,443,43346,443,10208,5093,5115,46,15,27,19
65277,65383,53,42198,53,267,94,173,2,30,1,1
65278,62139,53,5155,53,291,78,213,2,30,1,1
65279,57067,53,11101,53,252,102,150,2,30,1,1
65280,33305,53,29793,53,168,78,90,2,30,1,1
65281,59393,443,45183,443,1664,914,750,15,275,7,8
65282,63692,42635,61565,42635,562,380,182,8,15,5,3
65283,55179,53,20932,53,194,102,92,2,35,1,1
65284,56980,53,33611,53,526,188,338,6,48,3,3
65285,62293,443,13135,443,4755,1142,3613,15,273,8,7
65286,21133,17068,30422,17068,481,150,331,2,1199,1,1
65287,52559,443,18708,443,4479,2526,1953,10,120,6,4
65288,63853,443,40585,443,3182,1568,1614,8,120,4,4
65289,6881,10385,61159,10385,118,118,0,1,1199,1,0
65290,6881,13234,11039,13234,324,150,174,2,1201,1,1
65291,53523,5362,54435,5362,320,140,180,6,6,3,3
65292,53521,443,39860,443,710,350,360,12,33,6,6
65293,47008,443,47008,443,4373,1466,2907,19,27,11,8
65294,23174,80,23174,80,490,264,226,8,31,5,3
65295,62640,443,62640,443,27723,5572,22151,59,47,31,28
65296,50932,80,42211,80,11381441,121813,11259628,9309,119,1741,7568
65297,64650,53,46185,53,257,126,131,2,30,1,1
65298,3497,53,3497,53,222,90,132,2,30,1,1
65299,65186,53,5333,53,285,94,191,2,30,1,1
65300,49942,53,42485,53,177,94,83,2,31,1,1
65301,53171,443,14871,443,3220,2010,1210,20,19,10,10
65302,50946,80,36199,80,5870176,83236,5786940,5053,78,1161,3892
65303,4960,53,26982,53,222,86,136,2,30,1,1
65304,49585,53,59933,53,718,94,624,2,30,1,1
65305,60739,40010,46673,40010,316,136,180,6,6,3,3
65306,52632,443,1395,443,4399,1857,2542,28,136,14,14
65307,49312,53,2239,53,184,86,98,2,30,1,1
65308,49878,53,64175,53,327,102,225,2,30,1,1
65309,65018,53,40867,53,198,94,104,2,30,1,1
65310,20345,57470,0,0,146,146,0,1,0,1,0
65311,30417,51505,0,0,146,146,0,1,0,1,0
65312,49902,445,0,0,70,70,0,1,0,1,0
65313,52668,51221,0,0,66,66,0,1,0,1,0
65314,46495,4607,0,0,60,60,0,1,0,1,0
65315,49418,57470,0,0,66,66,0,1,0,1,0
65316,59037,51505,0,0,66,66,0,1,0,1,0
65317,50602,26467,0,0,66,66,0,1,0,1,0
65318,50374,445,0,0,66,66,0,1,0,1,0
65319,5244,35440,0,0,66,66,0,1,0,1,0
65320,64757,52700,0,0,62,62,0,1,0,1,0
65321,54973,445,0,0,70,70,0,1,0,1,0
65322,54972,445,0,0,70,70,0,1,0,1,0
65323,59169,56205,0,0,62,62,0,1,0,1,0
65324,23807,44847,0,0,66,66,0,1,0,1,0
65325,26879,37965,0,0,145,145,0,1,0,1,0
65326,49889,445,0,0,70,70,0,1,0,1,0
65327,43329,50584,0,0,146,146,0,1,0,1,0
65328,51130,61689,0,0,66,66,0,1,0,1,0
65329,50368,445,0,0,66,66,0,1,0,1,0
65330,62941,57470,0,0,74,74,0,1,0,1,0
65331,50366,445,0,0,66,66,0,1,0,1,0
65332,61670,57470,0,0,74,74,0,1,0,1,0
65333,49886,445,0,0,70,70,0,1,0,1,0
65334,2995,26467,0,0,62,62,0,1,0,1,0
65335,54963,445,0,0,70,70,0,1,0,1,0
65336,64437,56205,0,0,66,66,0,1,0,1,0
65337,54958,445,0,0,70,70,0,1,0,1,0
65338,54955,445,0,0,70,70,0,1,0,1,0
65339,54951,445,0,0,70,70,0,1,0,1,0
65340,49160,63766,0,0,146,146,0,1,0,1,0
65341,5575,8889,0,0,495,495,0,1,0,1,0
65342,16370,56205,0,0,62,62,0,1,0,1,0
65343,50365,445,0,0,66,66,0,1,0,1,0
65344,11136,57587,0,0,62,62,0,1,0,1,0
65345,11136,17500,0,0,62,62,0,1,0,1,0
65346,49964,64147,0,0,66,66,0,1,0,1,0
65347,49882,445,0,0,70,70,0,1,0,1,0
65348,5223,13602,0,0,66,66,0,1,0,1,0
65349,54945,445,0,0,70,70,0,1,0,1,0
65350,49880,445,0,0,70,70,0,1,0,1,0
65351,61495,37965,0,0,66,66,0,1,0,1,0
65352,44411,37965,0,0,62,62,0,1,0,1,0
65353,54944,445,0,0,70,70,0,1,0,1,0
65354,54943,445,0,0,70,70,0,1,0,1,0
65355,54941,445,0,0,70,70,0,1,0,1,0
65356,49878,445,0,0,70,70,0,1,0,1,0
65357,50355,445,0,0,66,66,0,1,0,1,0
65358,6889,60888,0,0,139,139,0,1,0,1,0
65359,9717,22114,0,0,146,146,0,1,0,1,0
65360,45941,23388,0,0,60,60,0,1,0,1,0
65361,64382,44847,0,0,66,66,0,1,0,1,0
65362,50353,445,0,0,66,66,0,1,0,1,0
65363,50352,445,0,0,66,66,0,1,0,1,0
65364,50350,445,0,0,66,66,0,1,0,1,0
65365,50347,445,0,0,66,66,0,1,0,1,0
65366,50346,445,0,0,66,66,0,1,0,1,0
65367,50345,445,0,0,66,66,0,1,0,1,0
65368,50337,37965,0,0,66,66,0,1,0,1,0
65369,59241,62413,0,0,66,66,0,1,0,1,0
65370,7744,32480,0,0,62,62,0,1,0,1,0
65371,4431,32480,0,0,66,66,0,1,0,1,0
65372,6773,57470,0,0,62,62,0,1,0,1,0
65373,53051,44847,0,0,66,66,0,1,0,1,0
65374,44933,26467,0,0,62,62,0,1,0,1,0
65375,56564,9571,0,0,78,78,0,1,0,1,0
65376,64335,35440,0,0,62,62,0,1,0,1,0
65377,9756,26467,0,0,66,66,0,1,0,1,0
65378,54938,445,0,0,70,70,0,1,0,1,0
65379,54935,445,0,0,70,70,0,1,0,1,0
65380,54932,445,0,0,70,70,0,1,0,1,0
65381,49871,445,0,0,70,70,0,1,0,1,0
65382,30794,37965,0,0,62,62,0,1,0,1,0
65383,50343,445,0,0,66,66,0,1,0,1,0
65384,54931,445,0,0,70,70,0,1,0,1,0
65385,49869,445,0,0,70,70,0,1,0,1,0
65386,50339,445,0,0,66,66,0,1,0,1,0
65387,50337,445,0,0,66,66,0,1,0,1,0
65388,50335,445,0,0,66,66,0,1,0,1,0
65389,49868,445,0,0,70,70,0,1,0,1,0
65390,50333,445,0,0,66,66,0,1,0,1,0
65391,5637,37965,0,0,62,62,0,1,0,1,0
65392,42252,33306,0,0,60,60,0,1,0,1,0
65393,49867,445,0,0,70,70,0,1,0,1,0
65394,49866,445,0,0,70,70,0,1,0,1,0
65395,49864,445,0,0,70,70,0,1,0,1,0
65396,49861,445,0,0,70,70,0,1,0,1,0
65397,53828,2323,0,0,60,60,0,1,0,1,0
65398,54930,445,0,0,70,70,0,1,0,1,0
65399,54922,445,0,0,70,70,0,1,0,1,0
65400,54914,445,0,0,70,70,0,1,0,1,0
65401,49848,445,0,0,70,70,0,1,0,1,0
65402,49846,445,0,0,70,70,0,1,0,1,0
65403,49845,445,0,0,70,70,0,1,0,1,0
65404,49837,445,0,0,70,70,0,1,0,1,0
65405,49838,445,0,0,70,70,0,1,0,1,0
65406,30654,51221,0,0,72,72,0,1,0,1,0
65407,6057,51221,0,0,78,78,0,1,0,1,0
65408,53813,11392,0,0,62,62,0,1,0,1,0
65409,50325,445,0,0,66,66,0,1,0,1,0
65410,61023,26467,0,0,62,62,0,1,0,1,0
65411,56827,63710,0,0,62,62,0,1,0,1,0
65412,24504,37965,0,0,62,62,0,1,0,1,0
65413,52934,26467,0,0,66,66,0,1,0,1,0
65414,49487,60043,0,0,62,62,0,1,0,1,0
65415,50315,445,0,0,66,66,0,1,0,1,0
65416,54909,445,0,0,70,70,0,1,0,1,0
65417,49826,445,0,0,70,70,0,1,0,1,0
65418,5661,37965,0,0,66,66,0,1,0,1,0
65419,44147,64147,0,0,62,62,0,1,0,1,0
65420,57107,64147,0,0,66,66,0,1,0,1,0
65421,11136,15503,0,0,145,145,0,1,0,1,0
65422,40489,1433,0,0,60,60,0,1,0,1,0
65423,53912,26467,0,0,66,66,0,1,0,1,0
65424,9381,35440,0,0,62,62,0,1,0,1,0
65425,50313,445,0,0,66,66,0,1,0,1,0
65426,52328,44847,0,0,66,66,0,1,0,1,0
65427,9265,37965,0,0,66,66,0,1,0,1,0
65428,53358,23,0,0,60,60,0,1,0,1,0
65429,62914,11392,0,0,62,62,0,1,0,1,0
65430,50306,445,0,0,66,66,0,1,0,1,0
65431,49821,445,0,0,70,70,0,1,0,1,0
65432,50303,445,0,0,66,66,0,1,0,1,0
65433,13223,1310,0,0,62,62,0,1,0,1,0
65434,24021,6881,0,0,146,146,0,1,0,1,0
65435,52600,22,0,0,60,60,0,1,0,1,0
65436,51320,37965,0,0,62,62,0,1,0,1,0
65437,49812,445,0,0,70,70,0,1,0,1,0
65438,49810,445,0,0,70,70,0,1,0,1,0
65439,1027,23684,0,0,159,159,0,1,0,1,0
65440,49809,445,0,0,70,70,0,1,0,1,0
65441,49808,445,0,0,70,70,0,1,0,1,0
65442,49804,445,0,0,70,70,0,1,0,1,0
65443,64572,37965,0,0,66,66,0,1,0,1,0
65444,54894,445,0,0,70,70,0,1,0,1,0
65445,54891,445,0,0,70,70,0,1,0,1,0
65446,54892,445,0,0,70,70,0,1,0,1,0
65447,50285,445,0,0,66,66,0,1,0,1,0
65448,50289,445,0,0,66,66,0,1,0,1,0
65449,50290,445,0,0,66,66,0,1,0,1,0
65450,50286,445,0,0,66,66,0,1,0,1,0
65451,50284,445,0,0,66,66,0,1,0,1,0
65452,50288,445,0,0,66,66,0,1,0,1,0
65453,50287,445,0,0,66,66,0,1,0,1,0
65454,50282,445,0,0,66,66,0,1,0,1,0
65455,62739,21416,0,0,145,145,0,1,0,1,0
65456,49502,44847,0,0,66,66,0,1,0,1,0
65457,49798,445,0,0,70,70,0,1,0,1,0
65458,2609,35993,0,0,146,146,0,1,0,1,0
65459,14438,51505,0,0,62,62,0,1,0,1,0
65460,54889,445,0,0,70,70,0,1,0,1,0
65461,54880,445,0,0,70,70,0,1,0,1,0
65462,54875,445,0,0,70,70,0,1,0,1,0
65463,49791,445,0,0,70,70,0,1,0,1,0
65464,40078,44847,0,0,62,62,0,1,0,1,0
65465,49788,445,0,0,70,70,0,1,0,1,0
65466,51098,60043,0,0,62,62,0,1,0,1,0
65467,5938,35070,0,0,60,60,0,1,90,1,0
65468,14092,80,14092,80,3182,2082,1100,18,86,10,8
65469,51689,4765,24946,4765,66,66,0,1,5,1,0
65470,22345,80,22345,80,490,264,226,8,30,5,3
65471,64677,53,12416,53,172,88,84,2,31,1,1
65472,50366,80,53987,80,318,192,126,6,28,4,2
65473,50358,80,31825,80,318,192,126,6,28,4,2
65474,50369,80,41191,80,318,192,126,6,28,4,2
65475,53506,50144,41476,50144,492,306,186,8,15,5,3
65476,55216,53,59483,53,711,87,624,2,30,1,1
65477,58956,53,19380,53,213,89,124,2,30,1,1
65478,55850,443,8932,443,2883,642,2241,13,135,6,7
65479,64385,443,4632,443,3677,1168,2509,17,120,8,9
65480,56456,443,10392,443,3528,1162,2366,10,120,5,5
65481,51000,443,31109,443,41713,34380,7333,67,333,38,29
65482,51709,40705,43195,40705,70,70,0,2,8,2,0
65483,5394,23,5394,23,124,60,64,2,5,1,1
65484,50370,80,12726,80,318,192,126,6,28,4,2
65485,50359,80,41698,80,318,192,126,6,28,4,2
65486,41340,80,50400,80,2426,1540,886,14,23,8,6
65487,61308,443,22375,443,44341,5858,38483,102,195,42,60
65488,50367,80,15574,80,318,192,126,6,28,4,2
65489,30023,3389,30023,3389,4145,1976,2169,22,19,13,9
65490,55015,443,8354,443,1786,172,1614,7,120,3,4
65491,55726,27015,16348,27015,1173,924,249,6,30,3,3
65492,56457,443,49133,443,3654,1144,2510,10,120,5,5
65493,59021,443,44226,443,4596,1442,3154,24,154,11,13
65494,53518,29500,52778,29500,320,140,180,6,7,3,3
65495,51688,47961,35098,47961,66,66,0,1,5,1,0
65496,57031,53,9800,53,170,87,83,2,31,1,1
65497,60375,32277,60465,32277,70,70,0,1,5,1,0
65498,57904,443,64826,443,7912,3215,4697,23,20,12,11
65499,50343,80,49722,80,22233,10123,12110,37,28,16,21
65500,50360,80,16489,80,318,192,126,6,28,4,2
65501,50438,3389,50438,3389,3429,1474,1955,16,16,8,8
65502,50361,80,40866,80,318,192,126,6,28,4,2
65503,50368,80,46672,80,318,192,126,6,28,4,2
65504,49681,53,1706,53,170,87,83,2,30,1,1
65505,35608,443,62915,443,5776,1880,3896,19,272,11,8
65506,57137,53,7336,53,711,87,624,2,30,1,1
65507,5938,22455,0,0,60,60,0,1,90,1,0
65508,36226,60038,0,0,66,66,0,1,91,1,0
65509,49559,53,6355,53,164,84,80,2,31,1,1
65510,57292,53,56725,53,170,87,83,2,31,1,1
65511,58574,443,3429,443,3447,788,2659,13,135,6,7
65512,56985,53,45052,53,711,87,624,2,31,1,1
65513,50269,445,0,0,66,66,0,1,0,1,0
65514,50270,445,0,0,66,66,0,1,0,1,0
65515,50268,445,0,0,66,66,0,1,0,1,0
65516,56103,21247,0,0,66,66,0,1,0,1,0
65517,54874,445,0,0,70,70,0,1,0,1,0
65518,54013,37965,0,0,66,66,0,1,0,1,0
65519,49784,445,0,0,70,70,0,1,0,1,0
65520,49783,445,0,0,70,70,0,1,0,1,0
65521,42995,26467,0,0,62,62,0,1,0,1,0
65522,53314,64097,0,0,66,66,0,1,0,1,0
65523,55142,26467,0,0,66,66,0,1,0,1,0
65524,53848,36237,0,0,62,62,0,1,0,1,0
65525,65323,53,33275,53,356,118,238,2,30,1,1
65526,51710,43069,65147,43069,70,70,0,2,8,2,0
65527,63691,80,13237,80,314,192,122,6,15,4,2
65528,50964,80,13485,80,4680740,67312,4613428,4675,77,985,3690
65529,54871,445,0,0,70,70,0,1,0,1,0
65530,54870,445,0,0,70,70,0,1,0,1,0
65531,54867,445,0,0,70,70,0,1,0,1,0
